ⲛⲁⲓ	ⲛⲁⲓ	ⲛⲁ|ⲓ
ⲛϩⲣⲏⲓ	ⲛϩⲣⲏⲓ	ⲛ|ϩⲣⲏⲓ
ⲙⲙⲟⲛ	ⲙⲙⲟⲛ	ⲙⲙⲟ|ⲛ
ⲉϯϣⲉⲩⲛⲓ	ⲉ|ϯ|ϣⲉⲩⲛⲓ	ⲉ|ϯϣⲉⲩⲛⲓ
ⲛϩⲏⲧ	ⲛ|ϩⲏⲧ	ⲛϩⲏⲧ
ⲛⲉⲁϥⲑⲱⲛ	ⲛⲉ|ⲁ|ϥ|ⲑⲱⲛ	ⲛ|ⲉⲁ|ϥ|ⲑⲱⲛ
ϧⲉⲛⲡⲉϩⲟⲟⲩ	ϧⲉⲛ|ⲡ|ⲉϩⲟⲟⲩ	ϧⲉⲛ|ⲡⲉ|ϩⲟⲟⲩ
ⲛⲉ	ⲛⲉ	ⲛ|ⲉ
ϯⲛⲟⲩ	ϯⲛⲟⲩ	ϯ|ⲛⲟⲩ
ⲛⲕⲟⲧ	ⲛ|ⲕⲟⲧ	ⲛⲕⲟⲧ
ⲙⲙⲱⲟⲩ	ⲙⲙⲱ|ⲟⲩ	ⲙ|ⲙⲱⲟⲩ
ⲙⲫⲟⲟⲩ	ⲙ|ⲫ|ⲟⲟⲩ	ⲙ|ⲫⲟⲟⲩ
ⲉⲣⲙⲉⲑⲣⲉ	ⲉⲣ|ⲙⲉⲑⲣⲉ	ⲉⲣⲙⲉⲑⲣⲉ
ⲉⲧⲁⲥⲛⲁⲩ	ⲉⲧ|ⲁ|ⲥ|ⲛⲁⲩ	ⲉ|ⲧⲁ|ⲥⲛⲁⲩ
ⲉϩⲣⲁⲩ	ⲉϩⲣⲁ|ⲩ	ⲉ|ϩⲣⲁ|ⲩ
ⲉⲙⲁϣⲱ	ⲉⲙⲁϣⲱ	ⲉ|ⲙⲁϣⲱ
ϣⲁⲫⲟⲟⲩ	ϣⲁ|ⲫ|ⲟⲟⲩ	ϣⲁ|ⲫⲟⲟⲩ
ⲉⲧⲉⲛϧⲏⲧϥ	ⲉⲧⲉ|ⲛϧⲏⲧ|ϥ	ⲉⲧⲉ|ⲛ|ϧⲏⲧ|ϥ
ⲛⲱⲟⲩ	ⲛⲱ|ⲟⲩ	ⲛ|ⲱⲟⲩ
ⲉⲡⲧⲏⲣϥ	ⲉ|ⲡ|ⲧⲏⲣϥ	ⲉ|ⲡ|ⲧⲏⲣ|ϥ
ⲙⲡⲉⲙⲑⲟ	ⲙ|ⲡⲉ|ⲙⲑⲟ	ⲙ|ⲡ|ⲉⲙⲑⲟ
ⲁϥⲉⲣⲙⲕⲁϩ	ⲁ|ϥ|ⲉⲣ|ⲙⲕⲁϩ	ⲁ|ϥ|ⲉⲣⲙⲕⲁϩ
ⲙⲡⲉⲧϩⲱⲟⲩ	ⲙ|ⲡ|ⲉⲧ|ϩⲱⲟⲩ	ⲙ|ⲡⲉⲧϩⲱⲟⲩ
ⲛⲁⲓⲥⲁϫⲓ	ⲛⲁ|ⲓ|ⲥⲁϫⲓ	ⲛⲁⲓ|ⲥⲁϫⲓ
ⲙⲙⲁⲩⲁⲧϥ	ⲙⲙⲁⲩⲁⲧ|ϥ	ⲙ|ⲙⲁⲩⲁⲧ|ϥ
ⲙⲡⲟⲩⲣⲟ	ⲙ|ⲡ|ⲟⲩⲣⲟ	ⲙ|ⲡⲟⲩ|ⲣⲟ
ⲙⲡⲓⲛⲁⲩ	ⲙ|ⲡⲓ|ⲛⲁⲩ	ⲙⲡ|ⲓ|ⲛⲁⲩ
ⲛⲱⲓⲕ	ⲛ|ⲱⲓⲕ	ⲛⲱⲓⲕ
ⲉⲉⲣϩⲱⲃ	ⲉ|ⲉⲣ|ϩⲱⲃ	ⲉ|ⲉⲣϩⲱⲃ
ⲙⲙⲏⲛⲓ	ⲙ|ⲙⲏⲛⲓ	ⲙⲙⲏⲛⲓ
ⲛϩⲟⲩⲟ	ⲛ|ϩⲟⲩⲟ	ⲛϩⲟⲩⲟ
ϩⲁⲛⲕⲉⲭⲱⲟⲩⲛⲓ	ϩⲁⲛ|ⲕⲉ|ⲭⲱⲟⲩⲛⲓ	ϩⲁⲛ|ⲕⲉⲭⲱⲟⲩⲛⲓ
ⲛⲟⲩⲛⲟⲩ	ⲛ|ⲟⲩⲛⲟⲩ	ⲛ|ⲟⲩ|ⲛⲟⲩ
ⲛⲁⲧⲱⲟⲩⲛⲟⲩ	ⲛⲁ|ⲧⲱⲟⲩⲛ|ⲟⲩ	ⲛⲁ|ⲧⲱⲟⲩⲛⲟⲩ
ⲛϧⲣⲏⲓ	ⲛϧⲣⲏⲓ	ⲛ|ϧⲣⲏⲓ
ⲉϥⲉⲣϩⲱⲃ	ⲉ|ϥ|ⲉⲣϩⲱⲃ	ⲉ|ϥ|ⲉⲣ|ϩⲱⲃ
ⲛⲁⲩ	ⲛⲁⲩ	ⲛⲁ|ⲩ
ⲛⲁϥϣⲟⲡ	ⲛⲁ|ϥ|ϣⲟⲡ	ⲛ|ⲁ|ϥ|ϣⲟⲡ
ⲛⲟⲙϯ	ⲛ|ⲟⲙϯ	ⲛⲟⲙϯ
ⲙⲡⲉϥⲟⲩⲱϣ	ⲙⲡⲉ|ϥ|ⲟⲩⲱϣ	ⲙ|ⲡⲉϥ|ⲟⲩⲱϣ
ⲛⲧⲉⲧⲉⲛⲥⲱⲧⲉⲙ	ⲛ|ⲧⲉⲧⲉⲛ|ⲥⲱⲧⲉⲙ	ⲛⲧⲉ|ⲧⲉⲛ|ⲥⲱⲧⲉⲙ
ⲁⲣⲓⲉⲙⲓ	ⲁⲣⲓⲉⲙⲓ	ⲁⲣⲓ|ⲉⲙⲓ
ⲁϥϯⲱⲙⲥ	ⲁ|ϥ|ϯ|ⲱⲙⲥ	ⲁ|ϥ|ϯⲱⲙⲥ
ϫⲉⲟⲩⲏⲓ	ϫⲉ|ⲟⲩⲏⲓ	ϫⲉ|ⲟⲩ|ⲏⲓ
ⲛϩⲁⲛⲁⲧⲟⲟⲩⲓ	ⲛ|ϩⲁⲛⲁⲧⲟⲟⲩⲓ	ⲛ|ϩⲁⲛ|ⲁⲧⲟⲟⲩⲓ
ⲡⲉⲧⲉⲛⲓⲱⲧ	ⲡⲉⲧⲉⲛ|ⲓⲱⲧ	ⲡ|ⲉⲧⲉⲛ|ⲓⲱⲧ
ⲙⲁϩⲁⲡ	ⲙⲁ|ϩⲁⲡ	ⲙⲁϩⲁⲡ
ⲙⲡⲥⲉⲡⲓ	ⲙⲡ|ⲥ|ⲉⲡⲓ	ⲙ|ⲡ|ⲥⲉⲡⲓ
ⲉⲑⲃⲏⲧⲉⲛ	ⲉⲑⲃⲏⲧ|ⲉⲛ	ⲉⲑⲃⲏⲧⲉ|ⲛ
ϧⲁⲧⲟⲧⲉⲛ	ϧⲁⲧⲟⲧ|ⲉⲛ	ϧⲁⲧⲟⲧⲉ|ⲛ
ⲉⲣⲁⲧ	ⲉ|ⲣⲁⲧ	ⲉⲣⲁⲧ
ϣⲁⲑⲛⲁⲩ	ϣⲁ|ⲑ|ⲛⲁⲩ	ϣⲁ|ⲑⲛⲁⲩ
ⲛⲟⲩⲛⲓϣϯ	ⲛ|ⲟⲩ|ⲛⲓϣϯ	ⲛⲟⲩ|ⲛⲓϣϯ
ⲉϯⲱⲙⲥ	ⲉ|ϯ|ⲱⲙⲥ	ⲉ|ϯⲱⲙⲥ
ⲉⲥⲓⲛⲓ	ⲉ|ⲥⲓⲛⲓ	ⲉ|ⲥ|ⲓⲛⲓ
ϣⲁⲩϭⲛⲉϫⲱⲟⲩ	ϣⲁ|ⲩ|ϭⲛⲉ|ϫⲱ|ⲟⲩ	ϣⲁ|ⲩ|ϭⲛⲉϫⲱ|ⲟⲩ
ⲛϯϩⲁⲡ	ⲛ|ϯϩⲁⲡ	ⲛϯϩⲁⲡ
ⲉϫⲱⲕ	ⲉϫⲱ|ⲕ	ⲉ|ϫⲱⲕ
ⲉϯⲛⲟⲩ	ⲉ|ϯⲛⲟⲩ	ⲉ|ϯ|ⲛⲟⲩ
ⲉⲩⲉⲧⲱⲟⲩⲛⲟⲩ	ⲉⲩⲉ|ⲧⲱⲟⲩⲛⲟⲩ	ⲉⲩⲉ|ⲧⲱⲟⲩⲛ|ⲟⲩ
