.	PUNCT	.
β	FM	β
γ	FM	γ
θἰνδικτίονος	FM	θἰνδικτίονος
ϣ	V	ϣ
ϣ	V	ⲱϣ
ϣϣⲏⲛ	N	ϣϣⲏⲛ
ϣϣⲏⲟⲩ	N	ϣϣⲏⲟⲩ
ϣϣⲟⲧ	N	ϣϣⲟⲧ
ϣϣⲱⲟⲩ	N	ϣϣⲱⲟⲩ
ϣϣⲱⲧ	N	ϣϣⲟⲧ
ϣϥⲱ	N	ϣϥⲱ
ϣϧⲁⲧ	N	ϣϧⲉⲗⲧ
ϣϧⲉⲗⲧ	N	ϣϧⲉⲗⲧ
ϣϩⲓϫ	N	ϣϩⲓϫ
ϣϫⲁⲡ	N	ϣϫⲁⲡ
ϣϫⲉ	N	ϣϫⲉ
ϣϫⲉⲙϫⲟⲙ	V	ϣϫⲉⲙϫⲟⲙ
ϣϫⲏⲓ	N	ϣϫⲏⲓ
ϣϫⲏⲟⲩ	N	ϣϫⲉ
ϣϫⲟⲙ	N	ϣϫⲟⲙ
ϣϫⲟⲙ	V	ϣϫⲟⲙ
ϣϫⲱⲧ	N	ϣϫⲱⲧ
ϣϭⲏⲛ	N	ϣϭⲏⲛ
ϣϭⲏⲣ	V	ϣϭⲏⲣ
ϣϭⲛⲏⲛ	N	ϣϭⲛⲏⲛ
ϣϭⲛⲏⲛ	V	ϣϭⲛⲏⲛ
ϣϭⲟⲣ	N	ϣϭⲟⲣ
ϣϭⲟⲩⲣ	N	ϣϭⲟⲩⲣ
ϣⲁ	AAOR	ϣⲁⲣⲉ
ϣⲁ	PREP	ϣⲁ
ϣⲁ	V	ϣⲁ
ϣⲁ	V	ϣⲁⲣⲉ
ϣⲁϣ	N	ϣⲁϣ
ϣⲁϣ	V	ϣⲁϣ
ϣⲁϣ	V	ϣⲱϣ
ϣⲁϣ	VSTAT	ϣⲱϣ
ϣⲁϣϥ	N	ϣⲁϣ
ϣⲁϣϥⲧ	N	ϣⲁϣ
ϣⲁϣⲓ	VSTAT	ϣⲁϣⲓ
ϣⲁϣⲛⲓ	V	ϣⲁϣⲛⲓ
ϣⲁϣⲧ	N	ϣⲁϣ
ϣⲁϣⲧ	V	ⲥⲱϣⲧ
ϣⲁϣⲧ	VSTAT	ⲥⲱϣⲧ
ϣⲁϥⲉ	N	ϣⲁϥⲉ
ϣⲁϥⲓ	V	ϣⲁϥⲓ
ϣⲁϥⲓⲱⲟⲩ	VSTAT	ϣⲁϥⲓ
ϣⲁϥⲟⲩⲣⲓ	N	ϣⲁϥⲟⲩⲣⲓ
ϣⲁϩ	N	ϣⲁϩ
ϣⲁϩϣⲉϩ	V	ϣⲁϩϣⲉϩ
ϣⲁϩϣⲱϩ	VSTAT	ϣⲁϩϣⲉϩ
ϣⲁϩⲗ	N	ϣⲁϩⲗ
ϣⲁⲑⲟⲩⲗ	N	ϣⲁⲑⲱⲗ
ϣⲁⲑⲱⲗ	N	ϣⲁⲑⲱⲗ
ϣⲁⲓ	N	ϣⲁⲓ
ϣⲁⲓ	V	ϣⲁⲓ
ϣⲁⲓⲣⲓ	N	ϣⲁⲓⲣⲓ
ϣⲁⲓⲣⲓ	V	ϣⲁⲣⲓ
ϣⲁⲓⲱⲟⲩ	VSTAT	ϣⲁⲓ
ϣⲁⲗ	N	ϣⲁⲗ
ϣⲁⲗ	N	ϣⲟⲗ
ϣⲁⲗⲁⲩⲕⲓ	N	ϣⲁⲗⲟⲩⲕⲓ
ϣⲁⲗⲉ	N	ϭⲁⲗⲉ
ϣⲁⲗⲟⲩⲕⲓ	N	ϣⲁⲗⲟⲩⲕⲓ
ϣⲁⲗⲟⲩⲕⲥ	N	ϭⲁⲗⲟⲩⲕⲥ
ϣⲁⲗⲧⲁⲙ	N	ϣⲁⲗⲧⲁⲙ
ϣⲁⲙ	V	ϣⲙⲁ
ϣⲁⲙϣⲉ	V	ϣⲉⲙϣⲓ
ϣⲁⲛ	CONJ	ϣⲁⲛ
ϣⲁⲛϣ	V	ϣⲁⲛϣ
ϣⲁⲛⲉϣ	V	ϣⲁⲛϣ
ϣⲁⲛⲉⲩϣ	VSTAT	ϣⲁⲛϣ
ϣⲁⲛⲉⲩϣⲧ	VSTAT	ϣⲁⲛϣ
ϣⲁⲛⲟⲩϣ	V	ϣⲁⲛϣ
ϣⲁⲛⲧ	ALIM	ϣⲁⲧⲉ
ϣⲁⲛⲧⲉ	ALIM	ϣⲁⲧⲉ
ϣⲁⲧⲉ	ALIM	ϣⲁⲧⲉ
ϣⲁⲛⲧ	N	ϣⲁⲓ
ϣⲁⲡ	VSTAT	ϣⲱⲡ
ϣⲁⲣ	N	ϣⲁⲣ
ϣⲁⲣⲃⲁ	N	ϣⲁⲣⲃⲁ
ϣⲁⲣⲉ	AAOR	ϣⲁⲣⲉ
ϣⲁⲣⲉ	V	ϣⲁⲣⲉ
ϣⲁⲣⲓ	N	ϣⲁⲣⲓ
ϣⲁⲣⲓ	V	ϣⲁⲣⲓ
ϣⲁⲣⲕⲉ	N	ϣⲁⲣⲕⲉ
ϣⲁⲣⲟ	PREP	ϣⲁ
ϣⲁⲣⲟ	N	ϣⲁⲣⲟ
ϣⲁⲣⲟⲩ	N	ϣⲁⲣⲟ
ϣⲁⲧ	V	ϣⲁⲧⲉ
ϣⲁⲧ	V	ϣⲓϯ
ϣⲁⲧ	V	ϣⲱⲧ
ϣⲁⲧ	VSTAT	ϣⲓϯ
ϣⲁⲧ	VSTAT	ϣⲱⲧ
ϣⲁⲧⲉ	V	ϣⲁⲧⲉ
ϣⲁⲩ	N	ϣⲁⲩ
ϣⲃⲉ	N	ϣⲃⲉ
ϣⲃⲓⲛ	N	ϣⲃⲓⲛ
ϣⲃⲟϯ	N	ϣⲃⲱⲧ
ϣⲃⲱ	N	ϣϥⲱ
ϣⲃⲱⲃⲓ	N	ϣⲃⲱⲃⲓ
ϣⲃⲱⲧ	N	ϣⲃⲱⲧ
ϣⲉ	N	ϣⲉ
ϣⲉ	PREP	ϣⲉ
ϣⲉ	V	ϣⲉ
ϣⲉϣ	V	ϣⲱϣ
ϣⲉϣⲧ	V	ⲥⲱϣⲧ
ϣⲉⲃ	V	ϣⲱⲡ
ϣⲉⲃϣⲉⲃ	V	ϣⲟⲃϣⲉⲃ
ϣⲉⲃϣⲓ	N	ϣⲉⲃϣⲓ
ϣⲉⲃϣⲱⲃ	VSTAT	ϣⲟⲃϣⲉⲃ
ϣⲉⲃϣⲱⲡ	VSTAT	ϣⲟⲃϣⲉⲃ
ϣⲉⲃⲓ	V	ϣⲉⲃⲓ
ϣⲉⲃⲟⲓϣ	N	ϣⲉⲃⲟⲓϣ
ϣⲉⲃⲧ	V	ϣⲱⲃⲧ
ϣⲉⲕ	V	ϣⲱⲕ
ϣⲉⲕϣⲱⲕ	VSTAT	ϣⲟⲕϣⲉⲕ
ϣⲉⲗ	N	ϣⲁⲗ
ϣⲉⲗ	V	ϣⲱⲗ
ϣⲉⲗϣⲉⲗ	V	ϣⲉⲗϣⲉⲗ
ϣⲉⲗϣⲏⲓⲗⲓ	N	ϣⲉⲗϣⲏⲓⲗⲓ
ϣⲉⲗϣⲏⲗⲓ	N	ϣⲉⲗϣⲏⲓⲗⲓ
ϣⲉⲗⲉⲙ	V	ϣⲉⲗⲉⲙ
ϣⲉⲗⲉⲙ	V	ϣⲱⲗⲉⲙ
ϣⲉⲗⲉⲧ	N	ϣⲉⲗⲉⲧ
ϣⲉⲗⲧⲁⲙ	N	ϣⲁⲗⲧⲁⲙ
ϣⲉⲙ	V	ϣⲙⲁ
ϣⲉⲙϣⲉ	V	ϣⲉⲙϣⲓ
ϣⲉⲙϣⲏϫⲓ	V	ϣⲉⲙϣⲏϫⲓ
ϣⲉⲙϣⲏⲧ	V	ϣⲉⲙϣⲓ
ϣⲉⲙϣⲓ	V	ϣⲉⲙϣⲓ
ϣⲉⲙⲏⲣ	N	ϣⲉⲙⲏⲣ
ϣⲉⲙⲙⲟ	N	ϣⲉⲙⲙⲟ
ϣⲉⲙⲙⲱⲟⲩ	N	ϣⲉⲙⲙⲟ
ϣⲉⲛ	V	ϣⲓⲛⲓ
ϣⲉⲛϥⲓ	N	ϣⲉⲛϥⲓ
ϣⲉⲛϩⲏⲧ	V	ϣⲉⲛϩⲏⲧ
ϣⲉⲛⲉϣ	V	ϣⲁⲛϣ
ϣⲉⲛⲥ	N	ϣⲉⲛⲥ
ϣⲉⲛⲧ	V	ϣⲱⲛⲧ
ϣⲉⲛⲧⲏⲥ	N	ϣⲉⲛⲧⲏⲥ
ϣⲉⲛⲧⲱ	N	ϣⲉⲛⲧⲱ
ϣⲉⲛⲧⲱⲗⲓ	N	ϣⲉⲛⲧⲱⲗⲓ
ϣⲉⲡ	V	ϣⲱⲡ
ϣⲉⲡ	VSTAT	ϣⲱⲡ
ϣⲉⲡϣⲱⲃ	VSTAT	ϣⲟⲃϣⲉⲃ
ϣⲉⲡϣⲱⲡ	VSTAT	ϣⲟⲃϣⲉⲃ
ϣⲉⲣ	V	ϣⲱⲣ
ϣⲉⲣϣⲓ	N	ϣⲉⲣϣⲓ
ϣⲉⲣϣⲱⲣ	V	ϣⲟⲣϣⲉⲣ
ϣⲉⲣⲓ	N	ϣⲏⲣⲓ
ϣⲉⲣⲡ	V	ϣⲱⲣⲡ
ϣⲉⲧ	V	ϣⲓϯ
ϣⲉⲧϣⲱⲧ	V	ϣⲟⲧϣⲉⲧ
ϣⲉⲧϣⲱⲧ	VSTAT	ϣⲟⲧϣⲉⲧ
ϣⲉⲩⲛⲓ	N	ϣⲉⲩⲛⲓ
ϣⲏϣ	VSTAT	ϣⲱϣ
ϣⲏϥ	VSTAT	ϣⲱϥ
ϣⲏϥⲓ	V	ϣⲏϥⲓ
ϣⲏⲃ	VSTAT	ϣⲱⲡ
ϣⲏⲓ	N	ϣⲏⲓ
ϣⲏⲓϥⲓ	N	ϣⲉⲛϥⲓ
ϣⲏⲓⲃⲓ	N	ϣⲏⲓⲃⲓ
ϣⲏⲓⲃⲓ	N	ϣⲏⲟⲩⲓ
ϣⲏⲕ	VSTAT	ϣⲱⲕ
ϣⲏⲗ	VSTAT	ϣⲱⲗ
ϣⲏⲙ	N	ϣⲏⲙ
ϣⲏⲟⲩ	N	ϣϣⲏⲟⲩ
ϣⲏⲟⲩ	VSTAT	ϣⲓ
ϣⲏⲟⲩ	VSTAT	ϣⲓⲁⲓ
ϣⲏⲟⲩⲓ	N	ϣⲏⲟⲩⲓ
ϣⲏⲡ	VSTAT	ϣⲱⲡ
ϣⲏⲣⲓ	N	ϣⲏⲣⲓ
ϣⲑⲁϯ	N	ϣⲧⲁϯ
ϣⲑⲉ	N	ϣⲧⲉ
ϣⲑⲉϩ	N	ϣⲑⲉϩ
ϣⲑⲉϩ	N	ϣⲧⲉ
ϣⲑⲉⲣⲧⲉⲣ	V	ϣⲑⲟⲣⲧⲉⲣ
ϣⲑⲏⲛ	N	ϣⲑⲏⲛ
ϣⲑⲟⲣⲧⲉⲣ	V	ϣⲑⲟⲣⲧⲉⲣ
ϣⲑⲟⲩⲓⲧ	V	ϣⲑⲟⲩⲓⲧ
ϣⲑⲱⲧ	N	ϣⲑⲱⲧ
ϣⲓ	N	ϣⲓ
ϣⲓ	V	ϣⲓ
ϣⲓϣⲉⲙ	N	ϣⲓϣⲉⲙ
ϣⲓϯ	V	ϣⲓϯ
ϣⲓⲁⲓ	V	ϣⲓⲁⲓ
ϣⲓⲃϯ	V	ϣⲓⲃϯ
ϣⲓⲏ	N	ϣⲓⲏ
ϣⲓⲏ	V	ϣⲓⲏ
ϣⲓⲕⲓ	V	ϣⲓⲕⲓ
ϣⲓⲛⲓ	V	ϣⲓⲛⲓ
ϣⲓⲡⲓ	V	ϣⲓⲡⲓ
ϣⲓⲧ	V	ϣⲓ
ϣⲓⲧⲥ	N	ϣⲓⲧⲥ
ϣⲓⲱ	N	ϣⲓⲱ
ϣⲕⲁⲕ	N	ϣⲕⲁⲕ
ϣⲕⲁⲡ	V	ϣⲕⲁⲡ
ϣⲕⲱϯ	N	ϣⲕⲱϯ
ϣⲗⲁϩ	V	ϣⲗⲁϩ
ϣⲗⲁⲙ	V	ϭⲗⲁⲙ
ϣⲗⲉⲙⲗⲉⲙ	V	ϣⲗⲉⲙⲗⲉⲙ
ϣⲗⲉⲙⲗⲟⲙ	V	ϣⲗⲉⲙⲗⲉⲙ
ϣⲗⲏⲓⲙⲓ	N	ϣⲗⲏⲓⲙⲓ
ϣⲗⲏⲗ	V	ϣⲗⲏⲗ
ϣⲗⲟϥ	N	ϣⲗⲟϥ
ϣⲗⲟⲗ	N	ϣⲗⲟⲗ
ϣⲗⲱϫ	N	ϭⲗⲟϫ
ϣⲗⲱⲗ	N	ϣⲗⲟⲗ
ϣⲗⲱⲟⲩϣ	N	ϭⲗⲱⲟⲩϣ
ϣⲗⲱⲧ	N	ϭⲗⲱⲧ
ϣⲙⲁ	V	ϣⲙⲁ
ϣⲙⲉ	N	ϣⲙⲟⲩ
ϣⲙⲟⲩ	N	ϣⲙⲟⲩ
ϣⲙⲟⲩⲓ	N	ϣⲙⲟⲩ
ϣⲙⲱⲟⲩ	N	ϣⲟⲙ
ϣⲛ	N	ϣⲏⲣⲓ
ϣⲛⲁⲩ	N	ϣⲛⲁⲩ
ϣⲛⲉ	N	ϣⲛⲉ
ϣⲛⲏ	N	ϣⲛⲉ
ϣⲛⲏ	N	ϣⲛⲏ
ϣⲛⲏⲟⲩ	N	ϣⲛⲉ
ϣⲛⲏⲟⲩ	N	ϣⲛⲏⲟⲩ
ϣⲛⲟϥ	N	ϭⲛⲟϥ
ϣⲛⲟⲩϥ	N	ϣⲛⲟⲩϥ
ϣⲛⲟⲩϥ	N	ϭⲛⲟϥ
ϣⲟ	NUM	ϣⲟ
ϣⲟϣ	N	ϣⲟϣ
ϣⲟϣ	V	ϣⲱϣ
ϣⲟϣⲟⲩ	N	ϣⲟϣ
ϣⲟϣⲟⲩ	N	ϣⲟϣⲟⲩ
ϣⲟϣⲡⲓ	N	ϣⲟϣⲡⲓ
ϣⲟϣⲧ	N	ϣⲟϣⲧ
ϣⲟϣⲧ	VSTAT	ⲥⲱϣⲧ
ϣⲟϥ	V	ϣⲱϥ
ϣⲟϥⲧ	VSTAT	ϣⲱϥⲧ
ϣⲟϫⲡ	VSTAT	ⲥⲱϫⲡ
ϣⲟϯ	N	ϣϣⲟⲧ
ϣⲟϯ	N	ϣⲱⲧ
ϣⲟⲃ	V	ϣⲱⲡ
ϣⲟⲃϣⲉⲃ	V	ϣⲟⲃϣⲉⲃ
ϣⲟⲃϣⲉⲡ	V	ϣⲟⲃϣⲉⲃ
ϣⲟⲃⲧ	V	ϣⲱⲃⲧ
ϣⲟⲑⲣⲉϥ	N	ϣⲟⲧⲣⲉϥ
ϣⲟⲓϣ	V	ϣⲟⲓϣ
ϣⲟⲕ	V	ϣⲱⲕ
ϣⲟⲕϣⲉⲕ	V	ϣⲟⲕϣⲉⲕ
ϣⲟⲕϩ	V	ϣⲱⲕϩ
ϣⲟⲕⲓ	V	ϣⲱⲕ
ϣⲟⲗ	N	ϣⲟⲗ
ϣⲟⲗ	V	ϣⲱⲗ
ϣⲟⲗϩ	V	ϣⲱⲗϩ
ϣⲟⲗϩ	VSTAT	ϣⲗⲁϩ
ϣⲟⲗϩ	VSTAT	ϣⲱⲗϩ
ϣⲟⲗϩⲥ	N	ϣⲟⲗϩⲥ
ϣⲟⲗⲃⲓ	N	ϭⲟⲗⲃⲓ
ϣⲟⲗⲕ	V	ϣⲱⲗⲕ
ϣⲟⲗⲙⲉⲥ	N	ϣⲟⲗⲙⲉⲥ
ϣⲟⲙ	N	ϣⲟⲙ
ϣⲟⲙ	VSTAT	ϣⲙⲁ
ϣⲟⲛϩ	V	ϣⲟⲛϩ
ϣⲟⲛϯ	N	ϣⲟⲛϯ
ϣⲟⲛⲧ	V	ϣⲱⲛⲧ
ϣⲟⲛⲧ	VSTAT	ϣⲱⲛⲧ
ϣⲟⲡ	N	ϣⲟⲡ
ϣⲟⲡ	N	ϣⲱⲡⲓ
ϣⲟⲡ	N	ϭⲟⲡ
ϣⲟⲡ	V	ϣⲱⲡ
ϣⲟⲡ	VSTAT	ϣⲱⲡⲓ
ϣⲟⲡϣⲉⲃ	V	ϣⲟⲃϣⲉⲃ
ϣⲟⲡϣⲉⲡ	V	ϣⲟⲃϣⲉⲃ
ϣⲟⲡⲧ	V	ϣⲱⲃⲧ
ϣⲟⲣ	V	ϣⲱⲣ
ϣⲟⲣϣⲉⲣ	V	ϣⲟⲣϣⲉⲣ
ϣⲟⲣⲡ	N	ϣⲟⲣⲡ
ϣⲟⲣⲡ	V	ϣⲱⲣⲡ
ϣⲟⲣⲧ	VSTAT	ϣⲱⲣⲧ
ϣⲟⲣⲧϥ	N	ϣⲟⲧⲣⲉϥ
ϣⲟⲧ	VSTAT	ϣⲱⲧ
ϣⲟⲧϣⲉⲧ	V	ϣⲟⲧϣⲉⲧ
ϣⲟⲧϣⲉⲧ	V	ϭⲟⲧϭⲉⲧ
ϣⲟⲧⲉⲙ	VSTAT	ϣⲱⲧⲉⲙ
ϣⲟⲧⲣⲉϥ	N	ϣⲟⲧⲣⲉϥ
ϣⲟⲩ	N	ϣⲁⲩ
ϣⲟⲩ	N	ϣⲏⲣⲓ
ϣⲟⲩ	V	ϣⲟⲩⲟ
ϣⲟⲩϣⲏⲧ	N	ϣⲟⲩϣⲏⲧ
ϣⲟⲩϣⲓⲧⲥ	N	ϣⲟⲩϣⲓⲧⲥ
ϣⲟⲩϣⲟⲩ	V	ϣⲟⲩϣⲟⲩ
ϣⲟⲩϣⲧ	N	ϣⲟⲩϣⲧ
ϣⲟⲩϣⲧ	V	ϫⲟⲩϣⲧ
ϣⲟⲩϣⲱⲟⲩϣⲓ	N	ϣⲟⲩϣⲱⲟⲩϣⲓ
ϣⲟⲩϫ	N	ϫⲟⲩϫ
ϣⲟⲩⲉ	V	ϣⲟⲩⲟ
ϣⲟⲩⲛⲓⲥ	N	ϣⲟⲩⲛⲓⲥ
ϣⲟⲩⲟ	V	ϣⲟⲩⲟ
ϣⲟⲩⲣⲏ	N	ϣⲟⲩⲣⲏ
ϣⲟⲩⲱ	V	ϣⲟⲩⲟ
ϣⲟⲩⲱⲟⲩ	VSTAT	ϣⲱⲟⲩⲓ
ϣⲡ	V	ϣⲱⲡ
ϣⲣⲟ	N	ϣⲣⲱ
ϣⲣⲱ	N	ϣⲣⲱ
ϣⲧ	V	ϣⲱⲧ
ϣⲧⲁϯ	N	ϣⲧⲁϯ
ϣⲧⲉ	N	ϣⲧⲉ
ϣⲧⲉ	V	ϣⲧⲟ
ϣⲧⲉⲕⲟ	N	ϣⲧⲉⲕⲟ
ϣⲧⲉⲕⲱⲟⲩ	N	ϣⲧⲉⲕⲟ
ϣⲧⲉⲙ	NEG	ϣⲧⲉⲙ
ϣⲧⲉⲣⲑⲱⲣ	V	ϣⲑⲟⲣⲧⲉⲣ
ϣⲧⲉⲣⲑⲱⲣ	V	ϣⲧⲉⲣⲑⲱⲣ
ϣⲧⲉⲣⲑⲱⲣ	VSTAT	ϣⲑⲟⲣⲧⲉⲣ
ϣⲧⲏ	V	ϣⲧⲟ
ϣⲧⲏⲟⲩⲧ	VSTAT	ϣⲧⲟ
ϣⲧⲙ	V	ϣⲧⲙ
ϣⲧⲙⲟ	V	ⲧϣⲙⲟ
ϣⲧⲟ	V	ϣⲧⲟ
ϣⲫⲉⲣⲓ	N	ϣⲫⲏⲣ
ϣⲫⲏⲣ	N	ϣⲫⲏⲣ
ϣⲫⲏⲣⲓ	N	ϣⲫⲏⲣⲓ
ϣⲱ	N	ϣⲱ
ϣⲱϣ	N	ϣⲟϣ
ϣⲱϣ	V	ϣⲱϣ
ϣⲱϣⲉⲛ	N	ϣⲱϣⲉⲛ
ϣⲱϣⲧ	N	ϣⲟϣⲧ
ϣⲱϣⲧ	V	ⲥⲱϣⲧ
ϣⲱϥ	V	ϣⲱϥ
ϣⲱϥⲑ	N	ϣⲱϥⲑ
ϣⲱϥⲧ	V	ϣⲱϥⲧ
ϣⲱϩⲉⲃ	V	ϣⲱⲃϩ
ϣⲱϩⲡ	V	ϣⲱⲃϩ
ϣⲱϯ	N	ϣⲱϯ
ϣⲱϯ	V	ϣⲱⲧ
ϣⲱⲃϣ	N	ϣⲱⲡϣ
ϣⲱⲃϩ	V	ϣⲱⲃϩ
ϣⲱⲃⲧ	V	ϣⲱⲃⲧ
ϣⲱⲓ	N	ϣⲱⲓ
ϣⲱⲓϣ	N	ϣⲱⲓϣ
ϣⲱⲕ	V	ϣⲱⲕ
ϣⲱⲕϩ	V	ϣⲱⲕϩ
ϣⲱⲕⲓ	V	ϣⲱⲕ
ϣⲱⲕⲓ	V	ϣⲱⲕⲓ
ϣⲱⲗ	V	ϣⲱⲗ
ϣⲱⲗϩ	V	ϣⲱⲗϩ
ϣⲱⲗⲉⲙ	V	ϣⲱⲗⲉⲙ
ϣⲱⲗⲕ	V	ϣⲱⲗⲕ
ϣⲱⲗⲡⲓ	N	ϣⲱⲗⲡⲓ
ϣⲱⲙ	N	ϣⲟⲙ
ϣⲱⲙ	N	ϣⲱⲙ
ϣⲱⲙⲓ	N	ϣⲟⲙ
ϣⲱⲙⲓ	N	ϣⲱⲙⲓ
ϣⲱⲛⲓ	N	ϣⲱⲛⲓ
ϣⲱⲛⲓ	V	ϣⲱⲛⲓ
ϣⲱⲛⲧ	V	ϣⲱⲛⲧ
ϣⲱⲟⲩ	VSTAT	ϣⲱⲟⲩⲓ
ϣⲱⲟⲩϣⲓ	N	ϣⲟⲩϣⲱⲟⲩϣⲓ
ϣⲱⲟⲩⲓ	V	ϣⲱⲟⲩⲓ
ϣⲱⲡ	N	ϣⲟⲡ
ϣⲱⲡ	N	ϣⲱⲡ
ϣⲱⲡ	V	ϣⲱⲡ
ϣⲱⲡϣ	N	ϣⲱⲡϣ
ϣⲱⲡϩ	V	ϣⲱⲃϩ
ϣⲱⲡⲓ	N	ϣⲱⲡⲓ
ϣⲱⲡⲓ	V	ϣⲱⲡⲓ
ϣⲱⲡⲧ	V	ϣⲱⲃⲧ
ϣⲱⲣ	V	ϣⲱⲣ
ϣⲱⲣϣⲓ	N	ϣⲱⲣϣⲓ
ϣⲱⲣⲡ	V	ϣⲱⲣⲡ
ϣⲱⲣⲧ	V	ϣⲱⲣⲧ
ϣⲱⲧ	N	ϣⲱⲧ
ϣⲱⲧ	V	ϣⲓϯ
ϣⲱⲧ	V	ϣⲱⲧ
ϣⲱⲧⲉⲙ	V	ϣⲱⲧⲉⲙ
ϥ	CONJ	ⲛⲑⲟϥ
ϥ	PPERO	ⲛⲑⲟϥ
ϥ	PPERS	ⲛⲑⲟϥ
ϥ	PPOS	ⲛⲧⲟϥ
ϥⲁⲓ	N	ⲃⲁⲓ
ϥⲁⲓ	V	ϥⲁⲓ
ϥⲁⲓ	V	ϥⲓ
ϥⲉϫ	V	ϥⲱϫⲓ
ϥⲉϫϧⲉⲙⲥ	V	ϥⲉϫϧⲉⲙⲥ
ϥⲉⲛⲧ	N	ϥⲉⲛⲧ
ϥⲉⲛⲧ	N	ⲃⲟⲛϯ
ϥⲉⲣϥⲱⲣ	V	ϥⲟⲣϥⲉⲣ
ϥⲉⲧ	V	ϥⲱϯ
ϥⲏϫ	VSTAT	ϥⲱϫⲓ
ϥⲏϯ	VSTAT	ϥⲱϯ
ϥⲓ	V	ϥⲓ
ϥⲓⲕⲟϩⲓ	N	ϥⲓⲕⲟϩⲓ
ϥⲓⲧ	V	ϥⲓ
ϥⲟϫ	V	ϥⲱϫⲓ
ϥⲟϫⲓ	V	ϥⲱϫⲓ
ϥⲟϯ	V	ϥⲱϯ
ϥⲟⲓ	N	ϥⲟⲓ
ϥⲟⲕⲁⲥⲓ	N	ϥⲟⲩⲕⲁⲥⲓ
ϥⲟⲣϥⲉⲣ	V	ϥⲟⲣϥⲉⲣ
ϥⲟⲣⲓ	N	ϥⲟⲣⲓ
ϥⲟⲧ	V	ϥⲱϯ
ϥⲟⲧⲥ	VSTAT	ϥⲟⲧⲥ
ϥⲟⲩⲕⲁⲥⲓ	N	ϥⲟⲩⲕⲁⲥⲓ
ϥⲣⲉ	N	ϥⲣⲉ
ϥⲱϫⲓ	V	ϥⲱϫⲓ
ϥⲱϯ	N	ϥⲱϯ
ϥⲱϯ	V	ϥⲱϯ
ϥⲱϯⲁ	N	ϥⲱϯⲁ
ϥⲱⲉ	N	ϥⲱⲉ
ϥⲱⲓ	N	ϥⲟⲓ
ϥⲱⲓ	N	ϥⲱⲉ
ϥⲱⲓ	N	ϥⲱⲓ
ϥⲱⲥⲓ	N	ϥⲱⲥⲓ
ϧⲁ	PREP	ϧⲁ
ϧⲁϧ	V	ϧⲱϧ
ϧⲁϫⲱ	PREP	ϧⲁϫⲉⲛ
ϧⲁϯ	V	ϧⲁϯ
ϧⲁⲉ	N	ϧⲁⲉ
ϧⲁⲉⲩ	N	ϧⲁⲉ
ϧⲁⲏ	N	ϧⲁⲉ
ϧⲁⲑ	VSTAT	ϧⲑⲁⲓ
ϧⲁⲑⲉⲃ	V	ϧⲱⲧⲉⲃ
ϧⲁⲓ	N	ϧⲁⲓ
ϧⲁⲓⲉ	N	ϧⲁⲉ
ϧⲁⲓⲏ	N	ϧⲁⲉ
ϧⲁⲣⲁ	N	ϧⲣⲱⲟⲩ
ϧⲁⲣⲁϭⲱⲟⲩⲧⲥ	N	ⲥⲁⲣⲁϫⲱϥ
ϧⲁⲣⲁⲃⲁⲓ	N	ϧⲁⲣⲁⲃⲁⲓ
ϧⲁⲣⲁⲧ	PREP	ϧⲁⲣⲁⲧ
ϧⲁⲣⲟ	PREP	ϧⲁ
ϧⲁⲣⲱ	PREP	ϧⲁ
ϧⲁⲥ	V	ϧⲓⲥⲓ
ϧⲁⲧ	V	ϧⲓϯ
ϧⲁⲧϩⲏ	ADV	ϧⲁⲧϩⲏ
ϧⲁⲧⲉⲃ	V	ϧⲱⲧⲉⲃ
ϧⲁⲧⲟⲧ	PREP	ϧⲁⲧⲉⲛ
ϧⲁⲧⲟⲧⲉ	PREP	ϧⲁⲧⲉⲛ
ϧⲉ	N	ϧⲉ
ϧⲉⲕ	V	ϧⲱⲕ
ϧⲉⲕ	V	ϩⲱⲕⲓ
ϧⲉⲗϧⲉⲗⲧ	N	ϧⲉⲗϧⲉⲗⲧ
ϧⲉⲗϧⲟⲗ	V	ϧⲟⲗϧⲉⲗ
ϧⲉⲗϧⲱⲗ	V	ϧⲟⲗϧⲉⲗ
ϧⲉⲗϧⲱⲗ	VSTAT	ϧⲟⲗϧⲉⲗ
ϧⲉⲗⲃⲓ	N	ϧⲉⲗⲡⲓ
ϧⲉⲗⲉⲃϣ	N	ϧⲉⲗⲓⲃϣ
ϧⲉⲗⲓⲃϣ	N	ϧⲉⲗⲓⲃϣ
ϧⲉⲗⲗⲟ	N	ϧⲉⲗⲗⲟ
ϧⲉⲗⲗⲟⲓ	N	ϧⲉⲗⲗⲟ
ϧⲉⲗⲗⲱ	N	ϧⲉⲗⲗⲟ
ϧⲉⲗⲙⲉϩⲓ	N	ϧⲉⲗⲙⲉϩⲓ
ϧⲉⲗⲡⲓ	N	ϧⲉⲗⲡⲓ
ϧⲉⲙϧⲱⲙ	V	ϧⲟⲙϧⲉⲙ
ϧⲉⲙϧⲱⲙ	VSTAT	ϧⲟⲙϧⲉⲙ
ϧⲉⲙⲥ	N	ϧⲉⲙⲥ
ϧⲉⲛ	PREP	ϧⲉⲛ
ϧⲉⲛⲧ	VSTAT	ϧⲱⲛⲧ
ϧⲉⲛⲧ	VSTAT	ϩⲱⲛⲧ
ϧⲉⲣϧⲉⲣ	V	ϧⲉⲣϧⲉⲣ
ϧⲉⲣⲉⲃ	N	ϧⲉⲣⲉⲃ
ϧⲉⲧϧⲉⲧ	V	ϧⲟⲧϧⲉⲧ
ϧⲉⲧϧⲱⲧ	V	ϧⲟⲧϧⲉⲧ
ϧⲉⲧϧⲱⲧ	VSTAT	ϧⲟⲧϧⲉⲧ
ϧⲉⲧⲉⲃ	V	ϧⲱⲧⲉⲃ
ϧⲏϧ	VSTAT	ϧⲱϧ
ϧⲏⲃⲓ	N	ϧⲏⲓⲃⲓ
ϧⲏⲃⲓ	N	ϩⲏⲃⲓ
ϧⲏⲃⲥ	N	ϧⲏⲃⲥ
ϧⲏⲓⲃⲓ	N	ϧⲏⲓⲃⲓ
ϧⲏⲓⲃⲓ	N	ϩⲏⲃⲓ
ϧⲏⲕ	VSTAT	ϧⲱⲕ
ϧⲏⲕ	VSTAT	ϩⲱⲕⲓ
ϧⲏⲙ	V	ϧⲙⲟⲙ
ϧⲏⲙ	VSTAT	ϧⲙⲟⲙ
ϧⲏⲧ	N	ϧⲏⲧ
ϧⲑⲁⲓ	V	ϧⲑⲁⲓ
ϧⲓϯ	V	ϧⲓϯ
ϧⲓⲣ	N	ϧⲓⲣ
ϧⲓⲥⲓ	N	ϧⲓⲥⲓ
ϧⲓⲥⲓ	V	ϧⲓⲥⲓ
ϧⲙⲟⲙ	N	ϧⲙⲟⲙ
ϧⲙⲟⲙ	V	ϧⲙⲟⲙ
ϧⲛⲧ	V	ϩⲱⲛⲧ
ϧⲟⲑⲃ	V	ϧⲱⲧⲉⲃ
ϧⲟⲑⲃⲉ	V	ϧⲱⲧⲉⲃ
ϧⲟⲕ	V	ϧⲟⲕ
ϧⲟⲕ	V	ϧⲱⲕ
ϧⲟⲕ	V	ϩⲱⲕⲓ
ϧⲟⲗϧⲉⲗ	V	ϧⲟⲗϧⲉⲗ
ϧⲟⲙϧⲉⲙ	V	ϧⲟⲙϧⲉⲙ
ϧⲟⲙϧⲉⲙ	V	ϩⲟⲙϩⲉⲙ
ϧⲟⲛⲧ	V	ϩⲱⲛⲧ
ϧⲟⲥⲓ	VSTAT	ϧⲓⲥⲓ
ϧⲟⲧ	VSTAT	ϧⲑⲁⲓ
ϧⲟⲧϧⲉⲧ	V	ϧⲟⲧϧⲉⲧ
ϧⲟⲩⲛ	N	ϧⲟⲩⲛ
ϧⲣⲁϫⲣⲉϫ	V	ϧⲣⲁϫⲣⲉϫ
ϧⲣⲉ	N	ϧⲣⲉ
ϧⲣⲏⲓ	N	ϧⲣⲏⲓ
ϧⲣⲏⲟⲩⲓ	N	ϧⲣⲉ
ϧⲣⲟϯ	N	ϧⲣⲟϯ
ϧⲣⲱⲟⲩ	N	ϧⲣⲱⲟⲩ
ϧⲱϧ	V	ϧⲱϧ
ϧⲱⲕ	V	ϧⲱⲕ
ϧⲱⲕ	V	ϩⲱⲕⲓ
ϧⲱⲕⲓ	V	ϩⲱⲕⲓ
ϧⲱⲗ	V	ϩⲱⲗ
ϧⲱⲛϫ	V	ϧⲱⲛϫ
ϧⲱⲛⲧ	V	ϧⲱⲛⲧ
ϧⲱⲛⲧ	V	ϩⲱⲛⲧ
ϧⲱⲧⲉⲃ	V	ϧⲱⲧⲉⲃ
ϩϥⲟⲧ	N	ϩϥⲟⲧ
ϩϥⲟⲩⲣ	N	ϩϥⲟⲩⲣ
ϩϥⲱ	N	ϩⲟϥ
ϩϥⲱⲧ	N	ϩϥⲟⲧ
ϩϯⲧ	N	ϩϯⲧ
ϩⲁ	PREP	ϩⲁ
ϩⲁϩ	N	ϩⲁϩ
ϩⲁϫⲁⲣ	N	ϩⲁⲣⲁϫ
ϩⲁϫⲓ	N	ϩⲁϫⲓ
ϩⲁⲅⲓⲁⲍⲉ	V	ϩⲁⲅⲓⲁⲍⲉ
ϩⲁⲅⲓⲁⲥⲙⲟⲥ	N	ϩⲁⲅⲓⲁⲥⲙⲟⲥ
ϩⲁⲅⲓⲟⲥ	N	ϩⲁⲅⲓⲟⲥ
ϩⲁⲅⲓⲱⲥⲩⲛⲏ	N	ϩⲁⲅⲓⲱⲥⲩⲛⲏ
ϩⲁⲅⲓⲱⲧⲁⲧⲟⲥ	N	ϩⲁⲅⲓⲱⲧⲁⲧⲟⲥ
ϩⲁⲅⲛⲟⲛ	N	ϩⲁⲅⲛⲟⲛ
ϩⲁⲑⲏⲣ	N	ϩⲁⲑⲏⲣ
ϩⲁⲑⲱⲣ	N	ϩⲁⲑⲱⲣ
ϩⲁⲓ	N	ϩⲁⲓ
ϩⲁⲓⲣⲉⲥⲓⲥ	N	ϩⲁⲓⲣⲉⲥⲓⲥ
ϩⲁⲓⲣⲉⲧⲓⲕⲟⲥ	N	ϩⲁⲓⲣⲉⲧⲓⲕⲟⲥ
ϩⲁⲗ	N	ϩⲁⲗ
ϩⲁⲗⲁϯ	N	ϩⲁⲗⲏⲧ
ϩⲁⲗⲁⲕ	N	ϩⲁⲗⲁⲕ
ϩⲁⲗⲁⲕⲙⲓ	N	ϩⲓⲗⲁⲕⲙⲓ
ϩⲁⲗⲁⲥⲥⲁ	N	ϩⲁⲗⲁⲥⲥⲁ
ϩⲁⲗⲉ	N	ϩⲁⲗⲉ
ϩⲁⲗⲏ	N	ϩⲁⲗⲏ
ϩⲁⲗⲏⲥⲓⲥ	N	ϩⲁⲗⲏⲥⲓⲥ
ϩⲁⲗⲏⲧ	N	ϩⲁⲗⲏⲧ
ϩⲁⲗⲓⲉⲩⲥ	N	ϩⲁⲗⲓⲉⲩⲥ
ϩⲁⲗⲕⲟⲩ	N	ϩⲁⲗⲕⲟⲩ
ϩⲁⲗⲗⲟⲩⲥ	N	ϩⲁⲗⲗⲟⲩⲥ
ϩⲁⲗⲙⲏ	N	ϩⲁⲗⲙⲏ
ϩⲁⲗⲙⲓ	N	ϩⲁⲗⲙⲓ
ϩⲁⲗⲩⲥⲓⲥ	N	ϩⲁⲗⲩⲥⲓⲥ
ϩⲁⲗⲱⲙ	N	ϩⲁⲗⲱⲙ
ϩⲁⲙ	N	ϩⲁⲙ
ϩⲁⲙⲁ	CONJ	ϩⲁⲙⲁ
ϩⲁⲙⲏⲛ	N	ϩⲁⲙⲏⲛ
ϩⲁⲙⲏⲛ	PTC	ϩⲁⲙⲏⲛ
ϩⲁⲛ	ART	ⲟⲩ
ϩⲁⲛⲁⲧⲟⲟⲩⲓ	N	ϩⲁⲛⲁⲧⲟⲟⲩⲓ
ϩⲁⲡ	N	ϩⲁⲡ
ϩⲁⲡⲓ	N	ϩⲁⲡⲓ
ϩⲁⲡⲗⲟⲩⲛ	N	ϩⲁⲡⲗⲟⲩⲛ
ϩⲁⲡⲗⲟⲩⲥ	N	ϩⲁⲡⲗⲟⲩⲥ
ϩⲁⲡⲗⲱⲥ	ADV	ϩⲁⲡⲗⲱⲥ
ϩⲁⲣⲁϫ	N	ϩⲁⲣⲁϫ
ϩⲁⲣⲙⲁ	N	ϩⲁⲣⲙⲁ
ϩⲁⲣⲙⲉⲛⲓⲟⲥ	N	ϩⲁⲣⲙⲉⲛⲓⲟⲥ
ϩⲁⲣⲙⲟⲍⲉ	V	ϩⲁⲣⲙⲟⲍⲉ
ϩⲁⲣⲙⲟⲛⲓⲁ	N	ϩⲁⲣⲙⲟⲛⲓⲁ
ϩⲁⲣⲙⲟⲥ	N	ϩⲁⲣⲙⲟⲥ
ϩⲁⲣⲟ	PREP	ϩⲁ
ϩⲁⲣⲡⲁⲍⲉ	V	ϩⲁⲣⲡⲁⲍⲉ
ϩⲁⲧ	N	ϩⲁⲧ
ϩⲃⲏⲟⲩⲓ	N	ϩⲱⲃ
ϩⲃⲟⲥ	N	ϩⲃⲟⲥ
ϩⲃⲟⲩⲓ	N	ϩⲓϥⲟⲩⲓ
ϩⲃⲟⲩⲓ	N	ϩⲟϥ
ϩⲃⲥ	V	ϩⲱⲃⲥ
ϩⲉ	N	ϩⲉ
ϩⲉϫϩⲉϫ	V	ϩⲟϫϩⲉϫ
ϩⲉϫϩⲟϫ	VSTAT	ϩⲟϫϩⲉϫ
ϩⲉϫϩⲱϫ	V	ϩⲟϫϩⲉϫ
ϩⲉϫϩⲱϫ	VSTAT	ϩⲟϫϩⲉϫ
ϩⲉⲃ	N	ϩⲱⲃ
ϩⲉⲃⲇⲟⲙⲁⲥ	N	ϩⲉⲃⲇⲟⲙⲁⲥ
ϩⲉⲃⲓ	N	ϩⲉⲃⲓ
ϩⲉⲃⲓ	N	ⲉⲃⲓ
ϩⲉⲃⲓ	V	ϩⲉⲃⲓ
ϩⲉⲃⲣⲁⲓⲁ	N	ϩⲉⲃⲣⲁⲓⲁ
ϩⲉⲃⲣⲁⲓⲟⲥ	N	ϩⲉⲃⲣⲁⲓⲟⲥ
ϩⲉⲑⲛⲓⲕⲟⲥ	N	ϩⲉⲑⲛⲓⲕⲟⲥ
ϩⲉⲑⲛⲟⲥ	N	ⲉⲑⲛⲟⲥ
ϩⲉⲑⲟⲥ	N	ϩⲉⲑⲟⲥ
ϩⲉⲓ	V	ϩⲉⲓ
ϩⲉⲓⲙⲁⲣⲙⲉⲛⲏ	N	ϩⲉⲓⲙⲁⲣⲙⲉⲛⲏ
ϩⲉⲕⲁⲧⲟⲛⲧⲁⲣⲭⲟⲥ	N	ϩⲉⲕⲁⲧⲟⲛⲧⲁⲣⲭⲟⲥ
ϩⲉⲗ	N	ϩⲉⲗⲓ
ϩⲉⲗϩⲉⲗ	V	ϩⲉⲗϩⲉⲗ
ϩⲉⲗⲉⲙ	V	ϩⲱⲗⲉⲙ
ϩⲉⲗⲓ	N	ϩⲉⲗⲓ
ϩⲉⲗⲗⲏⲛ	N	ϩⲉⲗⲗⲏⲛ
ϩⲉⲗⲗⲏⲛⲟⲥ	N	ϩⲉⲗⲗⲏⲛⲟⲥ
ϩⲉⲗⲟⲥ	N	ϩⲉⲗⲟⲥ
ϩⲉⲗⲡⲓⲍⲉ	V	ϩⲉⲗⲡⲓⲍⲉ
ϩⲉⲗⲡⲓⲥ	N	ϩⲉⲗⲡⲓⲥ
ϩⲉⲙ	V	ϩⲱⲙⲓ
ϩⲉⲙϩⲉⲙ	V	ϩⲉⲙϩⲉⲙ
ϩⲉⲙϩⲉⲙ	V	ϩⲟⲙϩⲉⲙ
ϩⲉⲙϩⲱⲙ	V	ϩⲟⲙϩⲉⲙ
ϩⲉⲙⲏⲣⲁ	N	ϩⲉⲙⲏⲣⲁ
ϩⲉⲙⲓ	N	ϩⲉⲙⲓ
ϩⲉⲙⲓ	N	ϩⲏⲙⲓ
ϩⲉⲙⲕⲓ	N	ϩⲉⲙⲕⲓ
ϩⲉⲙⲥⲓ	V	ϩⲉⲙⲥⲓ
ϩⲉⲛ	V	ϩⲉⲛ
ϩⲉⲛϩⲉⲛ	V	ϩⲟⲛϩⲉⲛ
ϩⲉⲛϩⲱⲛ	V	ϩⲟⲛϩⲉⲛ
ϩⲉⲛⲛⲁⲥ	N	ϩⲉⲛⲛⲁⲥ
ϩⲉⲝⲓⲥ	N	ϩⲉⲝⲓⲥ
ϩⲉⲡ	V	ϩⲱⲡ
ϩⲉⲣϣ	V	ϩⲉⲣϣ
ϩⲉⲣⲓ	V	ϩⲉⲣⲓ
ϩⲉⲣⲙⲉⲛⲉⲩⲉ	V	ϩⲉⲣⲙⲉⲛⲉⲩⲉ
ϩⲉⲣⲙⲉⲛⲉⲩⲧⲏⲥ	N	ϩⲉⲣⲙⲉⲛⲉⲩⲧⲏⲥ
ϩⲉⲣⲙⲏⲛⲉⲓⲁ	N	ϩⲉⲣⲙⲏⲛⲉⲓⲁ
ϩⲉⲣⲙⲏⲛⲉⲩⲉ	V	ϩⲉⲣⲙⲏⲛⲉⲩⲉ
ϩⲉⲣⲙⲏⲥ	NPROP	ϩⲉⲣⲙⲏⲥ
ϩⲉⲧⲁⲍⲉ	V	ϩⲉⲧⲁⲍⲉ
ϩⲉⲧⲁⲓⲣⲁ	N	ϩⲉⲧⲁⲓⲣⲁ
ϩⲉⲧⲟⲓⲙⲟⲥ	N	ϩⲉⲧⲟⲓⲙⲟⲥ
ϩⲉⲧⲡ	V	ϩⲱⲧⲡ
ϩⲉⲩⲣⲉⲙⲁ	N	ϩⲉⲩⲣⲉⲙⲁ
ϩⲉⲱⲥ	CONJ	ϩⲉⲱⲥ
ϩⲏ	N	ϩⲏ
ϩⲏϣ	VSTAT	ϩⲱϣ
ϩⲏⲃⲓ	N	ϩⲏⲃⲓ
ϩⲏⲅⲉⲙⲟⲛⲓⲁ	N	ϩⲏⲅⲉⲙⲟⲛⲓⲁ
ϩⲏⲅⲉⲙⲱⲛ	N	ϩⲏⲅⲉⲙⲱⲛ
ϩⲏⲅⲉⲙⲱⲛⲓⲕⲟⲛ	N	ϩⲏⲅⲉⲙⲱⲛⲓⲕⲟⲛ
ϩⲏⲅⲟⲩⲙⲉⲛⲟⲥ	N	ϩⲏⲅⲟⲩⲙⲉⲛⲟⲥ
ϩⲏⲇⲁⲛⲏ	V	ϩⲏⲇⲁⲛⲏ
ϩⲏⲇⲟⲛⲏ	N	ϩⲏⲇⲟⲛⲏ
ϩⲏⲓ	V	ϩⲉⲓ
ϩⲏⲓⲃⲓ	N	ϩⲏⲃⲓ
ϩⲏⲗ	VSTAT	ϩⲱⲗ
ϩⲏⲗⲉⲓⲁⲥ	NPROP	ϩⲏⲗⲉⲓⲁⲥ
ϩⲏⲗⲓϭⲓⲁ	N	ϩⲏⲗⲓϭⲓⲁ
ϩⲏⲗⲓⲕⲓⲁ	N	ϩⲏⲗⲓⲕⲓⲁ
ϩⲏⲗⲓⲟⲥ	N	ϩⲏⲗⲓⲟⲥ
ϩⲏⲙⲏ	N	ϩⲏⲙⲓ
ϩⲏⲙⲏ	N	ϩⲙⲏ
ϩⲏⲙⲓ	N	ϩⲏⲙⲓ
ϩⲏⲟⲩ	N	ϩⲏⲟⲩ
ϩⲏⲡ	VSTAT	ϩⲱⲡ
ϩⲏⲡⲁⲣ	N	ϩⲏⲡⲁⲣ
ϩⲏⲡⲡⲉ	PTC	ϩⲏⲡⲡⲉ
ϩⲏⲣⲱⲇⲏⲥ	NPROP	ϩⲏⲣⲱⲇⲏⲥ
ϩⲏⲣⲱⲇⲓⲁⲛⲟⲥ	N	ϩⲏⲣⲱⲇⲓⲁⲛⲟⲥ
ϩⲏⲣⲱⲇⲓⲁⲥ	N	ϩⲏⲣⲱⲇⲓⲁⲥ
ϩⲏⲣⲱⲇⲓⲁⲥ	NPROP	ϩⲏⲣⲱⲇⲓⲁⲥ
ϩⲏⲧ	N	ϩⲏⲧ
ϩⲑⲏ	N	ϩⲏⲧ
ϩⲑⲟ	N	ϩⲑⲟ
ϩⲑⲟⲣ	N	ϩⲑⲟ
ϩⲑⲟⲣⲓ	N	ϩⲑⲟ
ϩⲑⲱⲣ	N	ϩⲁⲑⲱⲣ
ϩⲑⲱⲣ	N	ϩⲑⲟ
ϩⲓ	PREP	ϩⲓ
ϩⲓ	V	ϩⲓⲟⲩⲓ
ϩⲓϣⲛⲉ	V	ϩⲓϣⲛⲉ
ϩⲓϥⲟⲩⲓ	N	ϩⲓϥⲟⲩⲓ
ϩⲓϫⲉⲛ	PREP	ϩⲓϫⲉⲛ
ϩⲓϫⲱ	PREP	ϩⲓϫⲉⲛ
ϩⲓϯ	V	ϧⲓϯ
ϩⲓⲁⲧⲣⲟⲥ	N	ϩⲓⲁⲧⲣⲟⲥ
ϩⲓⲇⲉⲙⲱⲛ	V	ϩⲓⲇⲉⲙⲱⲛ
ϩⲓⲇⲓⲱⲧⲏⲥ	N	ϩⲓⲇⲓⲱⲧⲏⲥ
ϩⲓⲉ	N	ϩⲓⲉ
ϩⲓⲉⲃⲓ	N	ϩⲓⲏⲃ
ϩⲓⲉⲣⲁ	N	ϩⲓⲉⲣⲁ
ϩⲓⲉⲣⲉⲩⲥ	N	ϩⲓⲉⲣⲉⲩⲥ
ϩⲓⲉⲣⲓⲭⲱ	N	ϩⲓⲉⲣⲓⲭⲱ
ϩⲓⲉⲣⲟⲛ	N	ϩⲓⲉⲣⲟⲛ
ϩⲓⲉⲣⲟⲥⲟⲗⲩⲙⲁ	NPROP	ϩⲓⲉⲣⲟⲥⲟⲗⲩⲙⲁ
ϩⲓⲉⲣⲟⲩⲥⲁⲗⲏⲙ	NPROP	ϩⲓⲉⲣⲟⲩⲥⲁⲗⲏⲙ
ϩⲓⲉⲣⲟⲫⲁⲛⲧⲏⲥ	N	ϩⲓⲉⲣⲟⲫⲁⲛⲧⲏⲥ
ϩⲓⲉⲩ	N	ϩⲓⲉ
ϩⲓⲏ	N	ϩⲓⲉ
ϩⲓⲏⲃ	N	ϩⲓⲏⲃ
ϩⲓⲏⲟⲩ	N	ϩⲓⲉ
ϩⲓⲏⲣⲡ	V	ϩⲓⲏⲣⲡ
ϩⲓⲕ	N	ϩⲓⲕ
ϩⲓⲕⲁⲛⲟⲥ	N	ϩⲓⲕⲁⲛⲟⲥ
ϩⲓⲕⲱⲛ	N	ϩⲓⲕⲱⲛ
ϩⲓⲗⲁⲕⲙⲓ	N	ϩⲓⲗⲁⲕⲙⲓ
ϩⲓⲗⲓⲕⲣⲓⲛⲏⲥ	N	ϩⲓⲗⲓⲕⲣⲓⲛⲏⲥ
ϩⲓⲙⲁⲣⲙⲉⲛⲏ	N	ϩⲓⲙⲁⲣⲙⲉⲛⲏ
ϩⲓⲙⲉⲣⲟⲥ	N	ϩⲓⲙⲉⲣⲟⲥ
ϩⲓⲙⲏ	N	ϩⲏⲙⲓ
ϩⲓⲙⲏⲣ	NPROP	ϩⲓⲙⲏⲣ
ϩⲓⲛ	N	ϩⲓⲛ
ϩⲓⲛⲁ	CONJ	ϩⲓⲛⲁ
ϩⲓⲛⲓ	V	ϩⲓⲛⲓ
ϩⲓⲛⲓⲙ	V	ϩⲓⲛⲓⲙ
ϩⲓⲟⲓ	V	ϩⲓⲟⲓ
ϩⲓⲟⲙⲓ	N	ⲥϩⲓⲙⲓ
ϩⲓⲟⲩⲓ	V	ϩⲓⲟⲩⲓ
ϩⲓⲡⲟⲩⲓ	N	ϩⲓϥⲟⲩⲓ
ϩⲓⲡⲡⲉⲩⲥ	N	ϩⲓⲡⲡⲉⲩⲥ
ϩⲓⲡⲡⲓⲕⲟⲥ	N	ϩⲓⲡⲡⲓⲕⲟⲥ
ϩⲓⲣ	VSTAT	ϩⲓⲣ
ϩⲓⲣⲉⲛ	PREP	ϩⲓⲣⲉⲛ
ϩⲓⲥⲁⲅⲅⲉⲗⲟⲥ	V	ϩⲓⲥⲁⲅⲅⲉⲗⲟⲥ
ϩⲓⲥⲓ	V	ϩⲓⲥⲓ
ϩⲓⲥⲓⲟⲛ	N	ϩⲓⲥⲓⲟⲛ
ϩⲓⲥⲟⲛ	N	ϩⲓⲥⲟⲛ
ϩⲓⲥⲟⲥ	N	ϩⲓⲥⲟⲥ
ϩⲓⲥⲧⲟⲣⲓⲍⲉ	V	ϩⲓⲥⲧⲟⲣⲓⲍⲉ
ϩⲓⲧ	N	ϩⲓⲧ
ϩⲓⲧ	V	ϩⲓⲟⲩⲓ
ϩⲓⲧⲁⲗⲓⲕⲏ	N	ϩⲓⲧⲁⲗⲓⲕⲏ
ϩⲓⲧⲉⲛ	PREP	ϩⲓⲧⲉⲛ
ϩⲓⲧⲟⲧ	PREP	ϩⲓⲧⲉⲛ
ϩⲓⲱⲓϣ	N	ϩⲓⲱⲓϣ
ϩⲓⲱⲓϣ	V	ϩⲓⲱⲓϣ
ϩⲓⲱⲟⲩⲧ	VSTAT	ϩⲉⲓ
ϩⲓⲱⲧ	PREP	ϩⲓ
ϩⲓⲱⲧ	PREP	ϩⲓⲱⲧ
ϩⲕⲟ	V	ϩⲕⲟ
ϩⲗⲓ	N	ϩⲗⲓ
ϩⲗⲓϫⲓ	N	ϩⲗⲓϫⲓ
ϩⲗⲟϫ	V	ϩⲗⲟϫ
ϩⲗⲟⲗ	N	ϩⲗⲟⲗ
ϩⲗⲟⲗⲓ	V	ϩⲗⲟⲗⲓ
ϩⲗⲟⲩⲗ	N	ϩⲗⲟⲩⲗ
ϩⲗⲟⲩⲗⲱⲟⲩ	VSTAT	ϩⲗⲟⲩⲗⲱⲟⲩ
ϩⲗⲱⲓⲗⲓ	V	ϩⲗⲱⲓⲗⲓ
ϩⲙⲏ	N	ϩⲙⲏ
ϩⲙⲏϯ	N	ⲙⲏϯ
ϩⲙⲟⲧ	N	ϩⲙⲟⲧ
ϩⲙⲟⲩ	N	ϩⲙⲟⲩ
ϩⲙⲱⲧ	N	ϩⲙⲟⲧ
ϩⲛⲁⲩ	N	ϩⲛⲁⲩ
ϩⲛⲓⲙ	V	ϩⲓⲛⲓⲙ
ϩⲛⲧⲟⲩ	N	ϩⲉⲛⲧⲟⲩ
ϩⲛⲧⲟⲩ	N	ϩⲛⲧⲟⲩ
ϩⲟ	N	ϩⲟ
ϩⲟϥ	N	ϩⲟϥ
ϩⲟϥⲧ	V	ⲱϥⲧ
ϩⲟϫϩⲉϫ	N	ϩⲟϫϩⲉϫ
ϩⲟϫϩⲉϫ	V	ϩⲟϫϩⲉϫ
ϩⲟϫⲡ	V	ϩⲟϫⲡ
ϩⲟϭⲡ	V	ϩⲟϭⲡ
ϩⲟϯ	N	ϩⲟϯ
ϩⲟⲃⲟⲗⲟⲥ	N	ϩⲟⲃⲟⲗⲟⲥ
ϩⲟⲃⲥ	V	ϩⲱⲃⲥ
ϩⲟⲃⲥ	VSTAT	ϩⲱⲃⲥ
ϩⲟⲇⲟⲥ	N	ϩⲟⲇⲟⲥ
ϩⲟⲓ	N	ϩⲟⲓ
ϩⲟⲓⲟⲛ	N	ϩⲟⲓⲟⲛ
ϩⲟⲕⲉⲣ	VSTAT	ϩⲕⲟ
ϩⲟⲕⲗⲉϥ	N	ϩⲟⲕⲗⲉϥ
ϩⲟⲗϫ	VSTAT	ϩⲗⲟϫ
ϩⲟⲗϫⲓ	V	ϩⲱⲗϫ
ϩⲟⲗⲓ	N	ϩⲟⲗⲓ
ϩⲟⲗⲓⲅⲟⲛ	N	ϩⲟⲗⲓⲅⲟⲛ
ϩⲟⲗⲕ	VSTAT	ϩⲱⲗⲕ
ϩⲟⲗⲕⲓ	N	ϩⲟⲗⲕⲓ
ϩⲟⲗⲙ	V	ϩⲱⲗⲉⲙ
ϩⲟⲗⲟⲕⲁⲩⲧⲱⲙⲁ	N	ϩⲟⲗⲟⲕⲁⲩⲧⲱⲙⲁ
ϩⲟⲗⲟⲕⲟⲧⲧⲓⲛⲟⲥ	N	ϩⲟⲗⲟⲕⲟⲧⲧⲓⲛⲟⲥ
ϩⲟⲗⲟⲛ	N	ϩⲟⲗⲟⲛ
ϩⲟⲗⲟⲥⲏⲣⲓⲕⲕⲟⲛ	N	ϩⲟⲗⲟⲥⲏⲣⲓⲕⲕⲟⲛ
ϩⲟⲗⲱⲥ	ADV	ϩⲟⲗⲱⲥ
ϩⲟⲙ	N	ϩⲟⲙ
ϩⲟⲙ	V	ϩⲱⲙⲓ
ϩⲟⲙϩⲉⲙ	V	ϩⲟⲙϩⲉⲙ
ϩⲟⲙϫ	VSTAT	ϩⲟⲙϫ
ϩⲟⲙⲃⲉ	N	ϩⲟⲙⲃⲉ
ϩⲟⲙⲏⲣⲟⲥ	N	ϩⲟⲙⲏⲣⲟⲥ
ϩⲟⲙⲓ	VSTAT	ϩⲱⲙⲓ
ϩⲟⲙⲓⲗⲓⲁ	N	ϩⲟⲙⲓⲗⲓⲁ
ϩⲟⲙⲟⲗⲟⲅⲉⲓ	V	ϩⲟⲙⲟⲗⲟⲅⲉⲓ
ϩⲟⲙⲟⲗⲟⲅⲉⲓⲁ	N	ϩⲟⲙⲟⲗⲟⲅⲉⲓⲁ
ϩⲟⲙⲟⲗⲟⲅⲏⲧⲏⲥ	N	ϩⲟⲙⲟⲗⲟⲅⲏⲧⲏⲥ
ϩⲟⲙⲟⲗⲟⲅⲓⲁ	N	ϩⲟⲙⲟⲗⲟⲅⲓⲁ
ϩⲟⲙⲟⲛⲟⲓ	V	ϩⲟⲙⲟⲛⲟⲓ
ϩⲟⲙⲟⲛⲟⲓⲁ	N	ϩⲟⲙⲟⲛⲟⲓⲁ
ϩⲟⲙⲟⲟⲩⲥⲓⲟⲛ	N	ϩⲟⲙⲟⲟⲩⲥⲓⲟⲛ
ϩⲟⲙⲟⲟⲩⲥⲓⲟⲥ	N	ϩⲟⲙⲟⲟⲩⲥⲓⲟⲥ
ϩⲟⲙⲧ	N	ϩⲟⲙⲧ
ϩⲟⲙⲱⲥ	ADV	ϩⲟⲙⲱⲥ
ϩⲟⲛϩⲉⲛ	V	ϩⲟⲛϩⲉⲛ
ϩⲟⲛⲧ	N	ϩⲟⲛⲧ
ϩⲟⲟⲩⲓ	VSTAT	ϩⲓⲟⲩⲓ
ϩⲟⲡ	N	ϩⲟⲡ
ϩⲟⲡ	V	ϩⲱⲡ
ϩⲟⲡⲗⲟⲛ	N	ϩⲟⲡⲗⲟⲛ
ϩⲟⲡⲟⲧⲉ	CONJ	ϩⲟⲡⲟⲧⲉ
ϩⲟⲡⲟⲩ	ADV	ϩⲟⲡⲟⲩ
ϩⲟⲡⲥ	V	ϩⲱⲃⲥ
ϩⲟⲡⲥ	VSTAT	ϩⲱⲃⲥ
ϩⲟⲡⲧ	V	ϩⲱⲧⲡ
ϩⲟⲡⲧ	VSTAT	ⲱⲧⲡ
ϩⲟⲡⲱⲥ	ADV	ϩⲟⲡⲱⲥ
ϩⲟⲣϣ	VSTAT	ϩⲣⲟϣ
ϩⲟⲣϫ	V	ϩⲟⲣϫ
ϩⲟⲣⲁⲥⲓⲥ	N	ϩⲟⲣⲁⲥⲓⲥ
ϩⲟⲣⲓⲍⲉ	V	ϩⲟⲣⲓⲍⲉ
ϩⲟⲣⲙⲁⲕⲏ	N	ϩⲟⲣⲙⲁⲕⲏ
ϩⲟⲣⲙⲏ	N	ϩⲟⲣⲙⲏ
ϩⲟⲣⲙⲓⲥⲕⲟⲥ	N	ϩⲟⲣⲙⲓⲥⲕⲟⲥ
ϩⲟⲣⲟⲙⲁ	N	ϩⲟⲣⲟⲙⲁ
ϩⲟⲣⲟⲥ	N	ϩⲟⲣⲟⲥ
ϩⲟⲣⲡ	V	ϩⲱⲣⲡ
ϩⲟⲣⲡ	VSTAT	ϩⲱⲣⲡ
ϩⲟⲣⲧ	V	ϩⲟⲣⲧ
ϩⲟⲣⲧϥ	N	ϩⲟⲣⲧϥ
ϩⲟⲥ	N	ϩⲟⲥ
ϩⲟⲥ	N	ϩⲱⲥ
ϩⲟⲥⲉⲙ	N	ϩⲟⲥⲉⲙ
ϩⲟⲥⲓⲱⲧⲁⲧⲟⲥ	N	ϩⲟⲥⲓⲱⲧⲁⲧⲟⲥ
ϩⲟⲥⲟⲛ	ADV	ϩⲟⲥⲟⲛ
ϩⲟⲥⲟⲛ	N	ϩⲟⲥⲟⲛ
ϩⲟⲧ	N	ϩⲟⲧ
ϩⲟⲧⲁⲛ	CONJ	ϩⲟⲧⲁⲛ
ϩⲟⲧⲉ	CONJ	ϩⲟⲧⲉ
ϩⲟⲧⲉ	N	ϩⲟⲧⲉ
ϩⲟⲧⲉⲣ	VSTAT	ϩⲟⲧⲉⲣ
ϩⲟⲧⲓ	CONJ	ϩⲟⲧⲓ
ϩⲟⲧⲡ	V	ϩⲱⲧⲡ
ϩⲟⲧⲡ	VSTAT	ϩⲱⲧⲡ
ϩⲟⲧⲡ	VSTAT	ⲱⲧⲡ
ϩⲟⲩϥ	N	ϩⲟⲩϥ
ϩⲟⲩⲁϯ	N	ϩⲟⲩⲓⲧ
ϩⲟⲩⲏⲟⲩ	V	ϩⲟⲩⲏⲟⲩ
ϩⲟⲩⲓϯ	N	ϩⲟⲩⲓⲧ
ϩⲟⲩⲓⲧ	N	ϩⲟⲩⲓⲧ
ϩⲟⲩⲟ	N	ϩⲟⲩⲟ
ϩⲟⲩⲣⲱ	V	ϩⲟⲩⲣⲱ
ϩⲟⲩⲣⲱⲟⲩ	VSTAT	ϩⲉⲣⲓ
ϩⲣⲁ	N	ϩⲟ
ϩⲣⲁ	V	ϩⲣⲁ
ϩⲣⲁⲃⲃⲉⲓ	N	ϩⲣⲁⲃⲃⲉⲓ
ϩⲣⲁⲃⲃⲟⲩⲛⲉⲓ	V	ϩⲣⲁⲃⲃⲟⲩⲛⲉⲓ
ϩⲣⲁⲙⲛⲟⲥ	N	ϩⲣⲁⲙⲛⲟⲥ
ϩⲣⲁⲭⲁ	N	ϩⲣⲁⲭⲁ
ϩⲣⲁⲭⲏⲗ	NPROP	ϩⲣⲁⲭⲏⲗ
ϩⲣⲉ	N	ϩⲟ
ϩⲣⲉ	N	ϩⲣⲏⲓ
ϩⲣⲉϥ	N	ϩⲣⲉϥ
ϩⲣⲉⲃⲉⲕⲕⲁ	NPROP	ϩⲣⲉⲃⲉⲕⲕⲁ
ϩⲣⲉⲡⲓⲍⲉ	V	ϩⲣⲉⲡⲓⲍⲉ
ϩⲣⲉⲩⲙⲁ	N	ϩⲣⲉⲩⲙⲁ
ϩⲣⲏⲓ	N	ϩⲣⲏⲓ
ϩⲣⲏⲣⲓ	N	ϩⲣⲏⲣⲓ
ϩⲣⲏⲧⲟⲛ	N	ϩⲣⲏⲧⲟⲛ
ϩⲣⲏⲧⲱⲣ	N	ϩⲣⲏⲧⲱⲣ
ϩⲣⲓⲙ	N	ϩⲣⲓⲙ
ϩⲣⲙⲁⲛ	N	ϩⲣⲙⲁⲛ
ϩⲣⲟϣ	V	ϩⲣⲟϣ
ϩⲣⲟⲕⲉⲩⲉ	V	ϩⲣⲟⲕⲉⲩⲉ
ϩⲣⲟⲩⲃ	N	ϩϥⲟⲩⲣ
ϩⲣⲟⲩⲃⲃⲁⲉⲓ	N	ϩⲣⲟⲩⲃⲃⲁⲉⲓ
ϩⲣⲟⲩⲣ	V	ϩⲣⲟⲩⲣ
ϩⲣⲟⲩⲫⲟⲥ	NPROP	ϩⲣⲟⲩⲫⲟⲥ
ϩⲣⲱ	N	ϩⲣⲱ
ϩⲣⲱ	V	ϩⲣⲁ
ϩⲣⲱⲙⲁⲓⲕⲟⲛ	N	ϩⲣⲱⲙⲁⲓⲕⲟⲛ
ϩⲣⲱⲙⲁⲓⲟⲥ	N	ϩⲣⲱⲙⲁⲓⲟⲥ
ϩⲣⲱⲙⲁⲛⲓⲁ	NPROP	ϩⲣⲱⲙⲁⲛⲓⲁ
ϩⲣⲱⲙⲁⲛⲟⲥ	NPROP	ϩⲣⲱⲙⲁⲛⲟⲥ
ϩⲣⲱⲙⲏ	NPROP	ϩⲣⲱⲙⲏ
ϩⲣⲱⲧ	N	ϩⲣⲱⲧ
ϩⲧⲓⲧ	N	ϩϯⲧ
ϩⲧⲟⲡ	N	ϩⲧⲟⲡ
ϩⲩⲁⲕⲓⲛⲑⲓⲛⲟⲛ	N	ϩⲩⲁⲕⲓⲛⲑⲓⲛⲟⲛ
ϩⲩⲁⲕⲓⲛⲑⲟⲥ	N	ϩⲩⲁⲕⲓⲛⲑⲟⲥ
ϩⲩⲃⲣⲓⲍⲉ	V	ϩⲩⲃⲣⲓⲍⲉ
ϩⲩⲇⲁⲛⲉ	V	ϩⲩⲇⲁⲛⲉ
ϩⲩⲇⲟⲩⲙⲉⲁ	NPROP	ϩⲩⲇⲟⲩⲙⲉⲁ
ϩⲩⲇⲣⲓⲁ	N	ϩⲩⲇⲣⲓⲁ
ϩⲩⲇⲣⲟⲡⲓⲕⲟⲥ	N	ϩⲩⲇⲣⲟⲡⲓⲕⲟⲥ
ϩⲩⲗⲁⲕⲙⲓ	N	ϩⲓⲗⲁⲕⲙⲓ
ϩⲩⲗⲏ	N	ϩⲩⲗⲏ
ϩⲩⲗⲓⲕⲏ	N	ϩⲩⲗⲓⲕⲏ
ϩⲩⲗⲓⲕⲟⲛ	N	ϩⲩⲗⲓⲕⲟⲛ
ϩⲩⲗⲓⲕⲟⲥ	N	ϩⲩⲗⲓⲕⲟⲥ
ϩⲩⲙⲏ	N	ϩⲙⲏ
ϩⲩⲙⲏⲛ	N	ϩⲩⲙⲏⲛ
ϩⲩⲙⲛⲉⲩⲉ	V	ϩⲩⲙⲛⲉⲩⲉ
ϩⲩⲙⲛⲓ	V	ϩⲩⲙⲛⲓ
ϩⲩⲙⲛⲟⲗⲟⲅⲉⲓ	V	ϩⲩⲙⲛⲟⲗⲟⲅⲉⲓ
ϩⲩⲙⲛⲟⲗⲟⲅⲓⲁ	N	ϩⲩⲙⲛⲟⲗⲟⲅⲓⲁ
ϩⲩⲙⲛⲟⲥ	N	ϩⲩⲙⲛⲟⲥ
ϩⲩⲙⲛⲱⲧⲟⲥ	N	ϩⲩⲙⲛⲱⲧⲟⲥ
ϩⲩⲡⲁⲣⲏⲥ	N	ϩⲩⲡⲁⲣⲏⲥ
ϩⲩⲡⲁⲣⲝⲓⲥ	N	ϩⲩⲡⲁⲣⲝⲓⲥ
ϩⲩⲡⲁⲣⲭⲟⲛⲧⲁ	N	ϩⲩⲡⲁⲣⲭⲟⲛⲧⲁ
ϩⲩⲡⲉⲣⲉⲥⲓⲁ	N	ϩⲩⲡⲉⲣⲉⲥⲓⲁ
ϩⲩⲡⲉⲣⲉⲧⲉⲓ	V	ϩⲩⲡⲉⲣⲉⲧⲉⲓ
ϩⲩⲡⲉⲣⲉⲧⲏⲥ	N	ϩⲩⲡⲉⲣⲉⲧⲏⲥ
ϩⲩⲡⲏⲣⲉⲥⲓⲁ	N	ϩⲩⲡⲏⲣⲉⲥⲓⲁ
ϩⲩⲡⲏⲣⲉⲧⲉⲓ	V	ϩⲩⲡⲏⲣⲉⲧⲉⲓ
ϩⲩⲡⲏⲣⲉⲧⲏⲥ	N	ϩⲩⲡⲏⲣⲉⲧⲏⲥ
ϩⲩⲡⲏⲣⲉⲭⲓⲟⲥ	N	ϩⲩⲡⲏⲣⲉⲭⲓⲟⲥ
ϩⲩⲡⲟⲅⲣⲁⲫⲉ	V	ϩⲩⲡⲟⲅⲣⲁⲫⲉ
ϩⲩⲡⲟⲅⲣⲁⲫⲉⲩⲥ	N	ϩⲩⲡⲟⲅⲣⲁⲫⲉⲩⲥ
ϩⲩⲡⲟⲅⲣⲁⲫⲏ	V	ϩⲩⲡⲟⲅⲣⲁⲫⲏ
ϩⲩⲡⲟⲇⲓⲁⲕⲟⲛⲟⲥ	N	ϩⲩⲡⲟⲇⲓⲁⲕⲟⲛⲟⲥ
ϩⲩⲡⲟⲇⲓⲁⲕⲱⲛ	N	ϩⲩⲡⲟⲇⲓⲁⲕⲱⲛ
ϩⲩⲡⲟⲕⲉⲓⲥⲑⲁⲓ	V	ϩⲩⲡⲟⲕⲉⲓⲥⲑⲁⲓ
ϩⲩⲡⲟⲕⲟⲣⲉⲩⲉ	V	ϩⲩⲡⲟⲕⲟⲣⲉⲩⲉ
ϩⲩⲡⲟⲕⲣⲓⲛⲉ	V	ϩⲩⲡⲟⲕⲣⲓⲛⲉ
ϩⲩⲡⲟⲕⲣⲓⲥⲓⲥ	N	ϩⲩⲡⲟⲕⲣⲓⲥⲓⲥ
ϩⲩⲡⲟⲕⲣⲓⲧⲏⲥ	N	ϩⲩⲡⲟⲕⲣⲓⲧⲏⲥ
ϩⲩⲡⲟⲗⲩⲙⲯⲓⲥ	N	ϩⲩⲡⲟⲗⲩⲙⲯⲓⲥ
ϩⲩⲡⲟⲙⲉⲓⲛⲉ	V	ϩⲩⲡⲟⲙⲉⲓⲛⲉ
ϩⲩⲡⲟⲙⲓⲛⲉ	V	ϩⲩⲡⲟⲙⲓⲛⲉ
ϩⲩⲡⲟⲙⲛⲏⲙⲁ	N	ϩⲩⲡⲟⲙⲛⲏⲙⲁ
ϩⲩⲡⲟⲙⲛⲏⲥⲓⲥ	N	ϩⲩⲡⲟⲙⲛⲏⲥⲓⲥ
ϩⲩⲡⲟⲙⲛⲏⲥⲕⲉ	V	ϩⲩⲡⲟⲙⲛⲏⲥⲕⲉ
ϩⲩⲡⲟⲙⲟⲛⲏ	N	ϩⲩⲡⲟⲙⲟⲛⲏ
ϩⲩⲡⲟⲡⲟⲇⲓⲟⲛ	N	ϩⲩⲡⲟⲡⲟⲇⲓⲟⲛ
ϩⲩⲡⲟⲥⲧⲁⲥⲓⲥ	N	ϩⲩⲡⲟⲥⲧⲁⲥⲓⲥ
ϩⲩⲡⲟⲧⲁⲅⲏ	N	ϩⲩⲡⲟⲧⲁⲅⲏ
ϩⲩⲡⲟⲧⲁⲥⲥⲉ	V	ϩⲩⲡⲟⲧⲁⲥⲥⲉ
ϩⲩⲡⲟⲩⲣⲅⲉⲓ	V	ϩⲩⲡⲟⲩⲣⲅⲉⲓ
ϩⲩⲡⲟⲩⲣⲅⲓⲥⲑⲉ	V	ϩⲩⲡⲟⲩⲣⲅⲓⲥⲑⲉ
ϩⲩⲡⲟⲭⲟⲣⲉⲓ	V	ϩⲩⲡⲟⲭⲟⲣⲉⲓ
ϩⲩⲡⲱⲣⲁⲟⲛ	N	ϩⲩⲡⲱⲣⲁⲟⲛ
ϩⲩⲥⲥⲱⲡⲟⲥ	N	ϩⲩⲥⲥⲱⲡⲟⲥ
ϩⲱ	IMOD	ϩⲱⲱ
ϩⲱ	IMOD_PPERO	ϩⲱ_ⲁⲛⲟⲕ
ϩⲱ	N	ϩⲱ
ϩⲱ	V	ϩⲱ
ϩⲱϣ	V	ϩⲱϣ
ϩⲱϯ	N	ϩⲱϯ
ϩⲱϯ	V	ϩⲱϯ
ϩⲱⲃ	N	ϩⲱⲃ
ϩⲱⲃ	N	ϩⲱⲡ
ϩⲱⲃ	V	ϩⲱⲃ
ϩⲱⲃⲥ	V	ϩⲱⲃⲥ
ϩⲱⲓϯ	N	ϩⲱⲓϯ
ϩⲱⲓⲙⲓ	N	ϩⲱⲓⲙⲓ
ϩⲱⲓⲣⲓ	N	ϩⲱⲓⲣⲓ
ϩⲱⲕⲓ	V	ϩⲱⲕⲓ
ϩⲱⲗ	V	ϩⲱⲗ
ϩⲱⲗϥ	ADV	ϩⲱⲗϥ
ϩⲱⲗϫ	V	ϩⲱⲗϫ
ϩⲱⲗⲉⲙ	V	ϩⲱⲗⲉⲙ
ϩⲱⲗⲕ	V	ϩⲱⲗⲕ
ϩⲱⲗⲱⲥ	ADV	ϩⲱⲗⲱⲥ
ϩⲱⲙⲓ	V	ϩⲱⲙⲓ
ϩⲱⲛ	V	ϩⲱⲛ
ϩⲱⲛⲧ	V	ϩⲱⲛⲧ
ϩⲱⲟⲩ	VSTAT	ϩⲱⲟⲩ
ϩⲱⲟⲩϣ	V	ϩⲱⲟⲩϣ
ϩⲱⲟⲩⲓ	VSTAT	ϩⲓⲟⲩⲓ
ϩⲱⲟⲩⲧ	N	ϩⲱⲟⲩⲧ
ϩⲱⲡ	N	ϩⲱⲡ
ϩⲱⲡ	V	ϩⲱⲡ
ϩⲱⲡⲥ	V	ϩⲱⲃⲥ
ϩⲱⲣ	V	ϩⲱⲣ
ϩⲱⲣⲃ	V	ϩⲱⲣⲃ
ϩⲱⲣⲓⲍⲉ	V	ϩⲱⲣⲓⲍⲉ
ϩⲱⲣⲡ	V	ϩⲱⲣⲡ
ϩⲱⲥ	CONJ	ϩⲱⲥ
ϩⲱⲥ	N	ϩⲱⲥ
ϩⲱⲥ	V	ϩⲱⲥ
ϩⲱⲥⲧⲉ	CONJ	ϩⲱⲥⲧⲉ
ϩⲱⲧ	N	ϩⲱⲧ
ϩⲱⲧϥ	V	ϩⲱⲧϥ
ϩⲱⲧⲡ	V	ϩⲱⲧⲡ
ϩⲱⲧⲡ	V	ⲱⲧⲡ
ϫⲁϥ	N	ϫⲁϥ
ϫⲁϥ	VSTAT	ϫⲟⲩϥ
ϫⲁϥϫⲓϥ	N	ϫⲁϥϫⲓϥ
ϫⲁϥⲓ	VSTAT	ϫⲏϥ
ϫⲁϩϫ	V	ϫⲁϩϫⲉϩ
ϫⲁϩϫⲉϩ	V	ϫⲁϩϫⲉϩ
ϫⲁϩⲛⲓ	N	ϫⲁϩⲛⲓ
ϫⲁϫ	N	ϫⲱϫ
ϫⲁϫ	V	ϫⲱϫⲓ
ϫⲁϫ	VSTAT	ϫⲱϫⲓ
ϫⲁϫϩ	V	ϫⲁϩϫⲉϩ
ϫⲁϫⲉⲃ	VSTAT	ϫⲱϫⲉⲃ
ϫⲁϫⲓ	N	ϫⲁϫⲓ
ϫⲁϫⲓⲑⲱⲗ	N	ϫⲁϫⲓⲑⲱⲗ
ϫⲁϫⲱ	N	ϫⲁϫⲱ
ϫⲁϭⲁⲩ	N	ϫⲁϭⲏ
ϫⲁϭⲉ	N	ϫⲁϭⲉ
ϫⲁϭⲉⲩ	N	ϫⲁϭⲉ
ϫⲁϭⲏ	N	ϫⲁϭⲏ
ϫⲁⲃϫⲓⲃ	N	ϫⲁⲃϫⲓⲃ
ϫⲁⲃⲓ	VSTAT	ϫⲉⲃⲓⲱⲟⲩ
ϫⲁⲓ	V	ϫⲁⲓ
ϫⲁⲓⲉ	V	ϫⲁⲓⲉ
ϫⲁⲓⲟ	V	ϫⲁⲓⲉ
ϫⲁⲓⲱⲟⲩ	VSTAT	ϫⲁⲓⲉ
ϫⲁⲗ	N	ϫⲁⲗ
ϫⲁⲗϫⲉϩ	V	ϫⲁϩϫⲉϩ
ϫⲁⲗϫⲟⲩ	N	ϫⲉⲗϫⲟⲩ
ϫⲁⲗⲏⲟⲩⲧ	VSTAT	ϫⲱⲓⲗⲓ
ϫⲁⲗⲓⲙ	N	ϫⲁⲗⲓⲙ
ϫⲁⲙⲁⲩⲗⲓ	N	ϭⲁⲙⲟⲩⲗ
ϫⲁⲙⲉⲩⲗⲓ	N	ϭⲁⲙⲟⲩⲗ
ϫⲁⲙⲏ	N	ϫⲁⲙⲏ
ϫⲁⲙⲟⲩⲗ	N	ϭⲁⲙⲟⲩⲗ
ϫⲁⲛⲏ	N	ϫⲁⲛⲏ
ϫⲁⲛⲏϩⲓ	N	ϫⲁⲛⲏϩⲓ
ϫⲁⲛⲓϫⲓ	N	ϫⲁⲛⲓϫⲓ
ϫⲁⲛⲟ	N	ϫⲁⲛⲟ
ϫⲁⲡϫⲉⲡ	V	ϫⲁⲡϫⲉⲡ
ϫⲁⲡϫⲓⲡ	N	ϫⲁϥϫⲓϥ
ϫⲁⲡⲁϫⲓ	N	ϫⲁⲡⲓϫⲓ
ϫⲁⲡⲓ	N	ϫⲁⲡⲓ
ϫⲁⲡⲓϫⲓ	N	ϫⲁⲡⲓϫⲓ
ϫⲁⲡⲟϫⲓ	N	ϫⲁⲫⲟϫⲓ
ϫⲁⲣⲁⲙⲡⲟ	N	ϫⲁⲣⲁⲙⲡⲟ
ϫⲁⲣⲉⲃ	V	ϫⲁⲣⲉⲃ
ϫⲁⲣⲡ	V	ϫⲁⲣⲉⲃ
ϫⲁⲫⲁⲧ	N	ϫⲁⲫⲁⲧ
ϫⲁⲫⲓϫⲓ	N	ϫⲁⲡⲓϫⲓ
ϫⲁⲫⲟϫⲓ	N	ϫⲁⲫⲟϫⲓ
ϫⲉ	CONJ	ϫⲉ
ϫⲉ	N	ϫⲉ
ϫⲉ	PTC	ϫⲉ
ϫⲉ	V	ϫⲱ
ϫⲉϣ	V	ϫⲱϣ
ϫⲉϣϫⲱϣ	V	ϫⲟϣϫⲉϣ
ϫⲉϣⲥ	N	ϫⲉϫⲥ
ϫⲉϥ	V	ϫⲟⲩϥ
ϫⲉϥϫⲓϥ	N	ϫⲁϥϫⲓϥ
ϫⲉϥϫⲱϥ	V	ϫⲟϥϫⲉϥ
ϫⲉϥϫⲱϥ	VSTAT	ϫⲟϥϫⲉϥ
ϫⲉϫ	V	ϫⲱϫⲓ
ϫⲉϫⲉⲃ	V	ϫⲱϫⲉⲃ
ϫⲉϫⲟⲩ	N	ϫⲉⲗϫⲟⲩ
ϫⲉϫⲣⲉ	N	ϫⲉϫⲣⲉ
ϫⲉϫⲣⲏⲥ	N	ϫⲓⲕⲣⲏⲥ
ϫⲉϫⲥ	N	ϫⲉϫⲥ
ϫⲉⲃϫⲓⲡ	N	ϫⲁϥϫⲓϥ
ϫⲉⲃⲓⲱⲟⲩ	VSTAT	ϫⲉⲃⲓⲱⲟⲩ
ϫⲉⲃⲣⲟ	N	ϫⲉⲡⲣⲟ
ϫⲉⲃⲥ	N	ϫⲉⲃⲥ
ϫⲉⲃⲥ	V	ϫⲱⲃⲥ
ϫⲉⲕ	V	ϫⲱⲕ
ϫⲉⲕϩ	V	ϫⲟⲩⲕϩ
ϫⲉⲕϫⲓⲕ	N	ϫⲉⲕϫⲓⲕ
ϫⲉⲕϫⲱⲕ	VSTAT	ϫⲟⲕϫⲉⲕ
ϫⲉⲕⲉⲙ	V	ϫⲱⲕⲉⲙ
ϫⲉⲗ	V	ϫⲱⲗ
ϫⲉⲗ	V	ⲕⲱⲗ
ϫⲉⲗϥⲁⲩ	N	ϫⲉⲗϥⲁⲩ
ϫⲉⲗϫⲉⲗ	V	ϫⲉⲗϫⲉⲗ
ϫⲉⲗϫⲟⲩ	N	ϫⲉⲗϫⲟⲩ
ϫⲉⲗϫⲱⲗ	V	ϫⲉⲗϫⲉⲗ
ϫⲉⲗϫⲱⲗ	V	ϫⲉⲗϫⲱⲗ
ϫⲉⲗⲓ	N	ϫⲉⲗⲓ
ϫⲉⲗⲕⲉⲥ	N	ϫⲉⲗⲕⲉⲥ
ϫⲉⲗⲕⲏⲥ	N	ϫⲉⲗⲕⲉⲥ
ϫⲉⲙ	V	ϫⲓⲙⲓ
ϫⲉⲙϫⲟⲙ	V	ϫⲉⲙϫⲟⲙ
ϫⲉⲙϫⲱⲙ	V	ϫⲟⲙϫⲉⲙ
ϫⲉⲙⲙⲟ	V	ϫⲉⲙⲙⲟ
ϫⲉⲙⲫⲉϩ	N	ϫⲉⲙⲫⲉϩ
ϫⲉⲛϩ	N	ϫⲉⲛϩ
ϫⲉⲛϫⲉⲛ	V	ϫⲉⲛϫⲉⲛ
ϫⲉⲛⲉⲫⲱⲣ	N	ϫⲉⲛⲉⲫⲱⲣ
ϫⲉⲟⲩⲁ	N	ϫⲉⲟⲩⲁ
ϫⲉⲟⲩⲁ	V	ϫⲉⲟⲩⲁ
ϫⲉⲡ	V	ϭⲱⲡⲓ
ϫⲉⲡⲣⲟ	N	ϫⲉⲡⲣⲟ
ϫⲉⲣ	V	ϫⲉⲣ
ϫⲉⲣ	V	ϫⲱⲣ
ϫⲉⲣϫ	V	ϫⲱⲣϫ
ϫⲉⲣϫⲓ	N	ϫⲉⲣϫⲓ
ϫⲉⲣⲉⲃ	V	ϫⲁⲣⲉⲃ
ϫⲉⲥ	N	ϫⲟⲥ
ϫⲉⲩ	V	ϫⲉⲩ
ϫⲉⲫⲣⲟ	N	ϫⲉⲡⲣⲟ
ϫⲏ	N	ϫⲏ
ϫⲏϣ	VSTAT	ϫⲱϣ
ϫⲏϥ	VSTAT	ϫⲏϥ
ϫⲏϥ	VSTAT	ϫⲟⲩϥ
ϫⲏϥ	VSTAT	ϫⲱϥ
ϫⲏϫ	VSTAT	ϫⲱϫ
ϫⲏϫⲓ	VSTAT	ϫⲱϫⲓ
ϫⲏⲃ	VSTAT	ϭⲱⲡⲓ
ϫⲏⲓ	N	ϫⲏⲓ
ϫⲏⲕ	VSTAT	ϫⲱⲕ
ϫⲏⲗ	VSTAT	ϫⲱⲗ
ϫⲏⲗ	VSTAT	ⲕⲱⲗ
ϫⲏⲛ	VSTAT	ϭⲛⲟⲛ
ϫⲏⲟⲩ	VSTAT	ϫⲏⲟⲩ
ϫⲏⲣ	VSTAT	ϫⲉⲣ
ϫⲏⲣ	VSTAT	ϫⲱⲣ
ϫⲏⲣⲓ	N	ϫⲏⲣⲓ
ϫⲏⲥ	V	ϫⲏⲥ
ϫⲓ	N	ϫⲱ
ϫⲓϫ	N	ϫⲓϫ
ϫⲓϫⲓ	N	ϫⲓϫⲓ
ϫⲓϫⲓ	V	ϫⲓϫⲓ
ϫⲓϭⲱⲓ	N	ϫⲓϭⲱⲓ
ϫⲓⲕⲗⲏⲣⲟⲛⲟⲙⲓⲁ	V	ϫⲓⲕⲗⲏⲣⲟⲛⲟⲙⲓⲁ
ϫⲓⲕⲣⲏⲥ	N	ϫⲓⲕⲣⲏⲥ
ϫⲓⲕⲣⲟⲥ	N	ϫⲓⲕⲣⲏⲥ
ϫⲓⲙⲓ	V	ϫⲓⲙⲓ
ϫⲓⲙⲫⲉ	N	ϫⲓⲙⲫⲉϩ
ϫⲓⲙⲫⲉϩ	N	ϫⲓⲙⲫⲉϩ
ϫⲓⲙⲫⲟϩ	N	ϫⲓⲙⲫⲉϩ
ϫⲓⲛ	V	ϫⲓⲛ
ϫⲓⲛϫⲓⲛ	N	ϫⲓⲛϫⲓⲛ
ϫⲓⲛϭⲱⲣ	N	ϫⲓⲛϭⲱⲣ
ϫⲓⲛⲓⲣⲓ	N	ϫⲏⲣⲓ
ϫⲓⲛⲫⲉϩ	N	ϫⲓⲙⲫⲉϩ
ϫⲓⲣ	N	ϫⲓⲣ
ϫⲓⲥⲙⲓⲥ	N	ϫⲓⲥⲙⲓⲥ
ϫⲕⲟ	V	ϫⲕⲟ
ϫⲗⲟϫ	N	ϭⲗⲟϫ
ϫⲟ	N	ϫⲟ
ϫⲟ	V	ϫⲟ
ϫⲟ	V	ϫⲱ
ϫⲟ	V	ⲭⲱ
ϫⲟϣ	V	ϫⲱϣ
ϫⲟϣϫⲉϣ	V	ϫⲟϣϫⲉϣ
ϫⲟϥ	V	ϫⲟⲩϥ
ϫⲟϥ	VSTAT	ϫⲱϥ
ϫⲟϥϫⲉϥ	V	ϫⲟϥϫⲉϥ
ϫⲟϫ	V	ϫⲱϫ
ϫⲟϫ	V	ϫⲱϫⲓ
ϫⲟϫⲉⲃ	VSTAT	ϫⲱϫⲉⲃ
ϫⲟϫⲥ	N	ϫⲉϫⲥ
ϫⲟⲃⲥ	V	ϫⲱⲃⲥ
ϫⲟⲃⲥ	VSTAT	ϫⲱⲃⲥ
ϫⲟⲉⲓ	N	ϫⲟⲉⲓ
ϫⲟⲓ	N	ϫⲟⲓ
ϫⲟⲓ	N	ϫⲱ
ϫⲟⲕ	V	ϫⲱⲕ
ϫⲟⲕϩ	V	ϫⲟⲩⲕϩ
ϫⲟⲕϫⲉⲕ	V	ϫⲟⲕϫⲉⲕ
ϫⲟⲕⲉⲙ	VSTAT	ϫⲱⲕⲉⲙ
ϫⲟⲕⲉⲣ	VSTAT	ϫⲟⲩⲕⲉⲣ
ϫⲟⲕⲙ	V	ϫⲱⲕⲉⲙ
ϫⲟⲕⲥⲓ	N	ϫⲟⲕⲥⲓ
ϫⲟⲗ	N	ϫⲟⲗ
ϫⲟⲗ	V	ϫⲱⲗ
ϫⲟⲗ	V	ⲕⲱⲗ
ϫⲟⲗϩ	V	ϫⲱⲗϩ
ϫⲟⲗϩ	VSTAT	ϫⲱⲗϩ
ϫⲟⲗϫ	V	ϫⲱⲗϫ
ϫⲟⲗϫ	VSTAT	ϫⲱⲗϫ
ϫⲟⲗⲃⲓ	N	ϫⲟⲗⲃⲓ
ϫⲟⲗⲓ	N	ϫⲟⲗⲓ
ϫⲟⲗⲕ	V	ϫⲱⲗⲕ
ϫⲟⲗⲕ	VSTAT	ϫⲱⲗⲕ
ϫⲟⲙ	N	ϫⲟⲙ
ϫⲟⲙ	V	ϫⲟⲙ
ϫⲟⲙϫⲉⲙ	V	ϫⲟⲙϫⲉⲙ
ϫⲟⲛ	N	ϫⲟⲛ
ϫⲟⲛⲥ	N	ϫⲟⲛⲥ
ϫⲟⲛⲧ	VSTAT	ϫⲱⲛⲧ
ϫⲟⲡ	V	ϫⲟⲡ
ϫⲟⲡ	V	ϭⲱⲡⲓ
ϫⲟⲣ	V	ϫⲉⲣ
ϫⲟⲣ	V	ϫⲱⲣ
ϫⲟⲣ	VSTAT	ϫⲱⲣⲓ
ϫⲟⲣϩ	VSTAT	ϭⲣⲟϩ
ϫⲟⲣϫ	V	ϫⲱⲣϫ
ϫⲟⲣϫ	VSTAT	ϫⲱⲣϫ
ϫⲟⲣϯ	N	ϫⲟⲣϯ
ϫⲟⲣⲃⲉⲥ	N	ϫⲟⲣⲃⲉⲥ
ϫⲟⲥ	N	ϫⲟⲥ
ϫⲟⲥⲉⲙ	N	ϫⲟⲥⲉⲙ
ϫⲟⲧ	V	ϫⲱ
ϫⲟⲧϩ	V	ϭⲱⲧϩ
ϫⲟⲧϩ	VSTAT	ϭⲱⲧϩ
ϫⲟⲩϣⲧ	V	ϫⲟⲩϣⲧ
ϫⲟⲩϥ	V	ϫⲟⲩϥ
ϫⲟⲩϫ	N	ϫⲟⲩϫ
ϫⲟⲩⲕϩ	V	ϫⲟⲩⲕϩ
ϫⲟⲩⲕⲉⲣ	V	ϫⲟⲩⲕⲉⲣ
ϫⲟⲩⲗ	N	ϫⲟⲩⲗ
ϫⲣⲟϫ	N	ϫⲣⲟϫ
ϫⲣⲱϫ	N	ϫⲣⲟϫ
ϫⲫⲉ	V	ϫⲫⲟ
ϫⲫⲏⲟⲩⲧ	VSTAT	ϫⲫⲟ
ϫⲫⲓ	V	ϫⲫⲓ
ϫⲫⲓⲏⲧ	VSTAT	ϫⲫⲓⲟ
ϫⲫⲓⲟ	V	ϫⲫⲓⲟ
ϫⲫⲟ	V	ϫⲫⲟ
ϫⲫⲟⲓ	N	ϫⲫⲟⲓ
ϫⲫⲟⲧ	N	ϫⲫⲟⲧ
ϫⲫⲱϯ	N	ϫⲫⲟⲧ
ϫⲫⲱⲧ	N	ϫⲫⲟⲧ
ϫⲱ	N	ϫⲱ
ϫⲱ	V	ϫⲱ
ϫⲱϣ	V	ϫⲱϣ
ϫⲱϥ	V	ϫⲟⲩϥ
ϫⲱϥ	V	ϫⲱϥ
ϫⲱϥⲓ	N	ϫⲱϥⲓ
ϫⲱϩⲧ	V	ϭⲱⲧϩ
ϫⲱϫ	N	ϫⲱϫ
ϫⲱϫ	V	ϫⲱϫ
ϫⲱϫⲉⲃ	V	ϫⲱϫⲉⲃ
ϫⲱϫⲓ	V	ϫⲱϫⲓ
ϫⲱⲃ	N	ϫⲱⲃ
ϫⲱⲃ	VSTAT	ϫⲉⲃⲓⲱⲟⲩ
ϫⲱⲃⲓ	N	ϫⲱⲃⲓ
ϫⲱⲃⲓ	VSTAT	ϫⲉⲃⲓⲱⲟⲩ
ϫⲱⲃⲥ	V	ϫⲱⲃⲥ
ϫⲱⲓ	N	ϫⲱ
ϫⲱⲓ	N	ϫⲱⲓ
ϫⲱⲓⲗⲓ	V	ϫⲱⲓⲗⲓ
ϫⲱⲓⲧ	N	ϫⲱⲓⲧ
ϫⲱⲕ	N	ϫⲱⲕ
ϫⲱⲕ	V	ϫⲱⲕ
ϫⲱⲕϩ	V	ϫⲟⲩⲕϩ
ϫⲱⲕⲉⲙ	V	ϫⲱⲕⲉⲙ
ϫⲱⲗ	N	ϫⲟⲗ
ϫⲱⲗ	N	ϫⲱⲗ
ϫⲱⲗ	V	ϫⲱⲗ
ϫⲱⲗ	V	ϭⲱⲗ
ϫⲱⲗ	V	ⲕⲱⲗ
ϫⲱⲗϩ	V	ϫⲱⲗϩ
ϫⲱⲗϫ	V	ϫⲱⲗϫ
ϫⲱⲗⲕ	V	ϫⲱⲗⲕ
ϫⲱⲙ	N	ϫⲱⲙ
ϫⲱⲙ	N	ϭⲱⲙ
ϫⲱⲛϫ	N	ϫⲱⲛϫ
ϫⲱⲛⲧ	V	ϫⲱⲛⲧ
ϫⲱⲟⲩ	N	ϫⲱⲟⲩ
ϫⲱⲟⲩϫ	V	ϫⲱⲟⲩϫ
ϫⲱⲟⲩⲛ	V	ϫⲱⲟⲩⲛ
ϫⲱⲟⲩⲛⲓ	N	ϫⲱⲟⲩⲛⲓ
ϫⲱⲣ	V	ϫⲱⲣ
ϫⲱⲣϩ	N	ϫⲱⲣϩ
ϫⲱⲣϫ	V	ϫⲱⲣϫ
ϫⲱⲣⲓ	N	ϫⲱⲣⲓ
ϫⲱⲧ	N	ϫⲱⲧ
ϫⲱⲧϩ	V	ϭⲱⲧϩ
ϭϧⲉⲗⲧ	N	ϣϧⲉⲗⲧ
ϭⲁϥⲏ	N	ϭⲁϥⲏ
ϭⲁϧⲉⲙ	V	ϭⲱϧⲉⲙ
ϭⲁϧⲉⲙ	VSTAT	ϭⲱϧⲉⲙ
ϭⲁϧⲙ	V	ϭⲱϧⲉⲙ
ϭⲁϩⲥⲓ	N	ϭⲁϩⲥⲓ
ϭⲁϫ	N	ϭⲁϫ
ϭⲁϭⲉⲩ	N	ϫⲁϭⲉ
ϭⲁⲃⲱⲧ	N	ϭⲁⲃⲱⲧ
ϭⲁⲓ	VSTAT	ϭⲓ
ϭⲁⲕ	V	ϭⲁⲕ
ϭⲁⲗ	N	ϫⲟⲗ
ϭⲁⲗⲁⲩϫ	N	ϭⲁⲗⲟϫ
ϭⲁⲗⲉ	N	ϭⲁⲗⲉ
ϭⲁⲗⲉⲩ	N	ϭⲁⲗⲉ
ϭⲁⲗⲏⲟⲩⲧ	VSTAT	ϫⲱⲓⲗⲓ
ϭⲁⲗⲟϫ	N	ϭⲁⲗⲟϫ
ϭⲁⲗⲟⲩⲕⲥ	N	ϭⲁⲗⲟⲩⲕⲥ
ϭⲁⲗⲡ	N	ϭⲗⲁⲡ
ϭⲁⲗⲱⲟⲩϣ	N	ϭⲗⲱⲟⲩϣ
ϭⲁⲙⲁⲩⲗⲓ	N	ϭⲁⲙⲟⲩⲗ
ϭⲁⲙⲟⲩⲗ	N	ϭⲁⲙⲟⲩⲗ
ϭⲁⲡ	VSTAT	ϭⲱⲡⲓ
ϭⲁⲣⲱⲡ	N	ϭⲁⲣⲱⲡ
ϭⲁⲥ	V	ϭⲓⲥⲓ
ϭⲁⲥ	V	ϭⲱⲥ
ϭⲁⲥⲓ	VSTAT	ϭⲓⲥⲓ
ϭⲁⲧϥⲓ	N	ϭⲁⲧϥⲓ
ϭⲁⲩ	VSTAT	ϭⲓ
ϭⲁⲩⲙⲱⲓⲧ	V	ϭⲁⲩⲙⲱⲓⲧ
ϭⲉ	V	ϭⲟ
ϭⲉϩ	V	ϭⲉϩ
ϭⲉϩ	VSTAT	ϭⲉϩ
ϭⲉⲗ	V	ϭⲱⲗ
ϭⲉⲗⲓ	N	ϭⲉⲗⲓ
ϭⲉⲗⲕ	V	ϭⲱⲗⲕ
ϭⲉⲛⲏⲟⲩⲧ	VSTAT	ϭⲉⲛⲟ
ϭⲉⲛⲟ	V	ϭⲉⲛⲟ
ϭⲉⲛⲧⲱⲗⲓ	N	ϣⲉⲛⲧⲱⲗⲓ
ϭⲉⲡ	V	ϣⲱⲡ
ϭⲉⲡ	V	ϭⲱⲡⲓ
ϭⲉⲣⲉ	V	ϭⲉⲣⲟ
ϭⲉⲣⲏⲟⲩⲧ	VSTAT	ϭⲉⲣⲟ
ϭⲉⲣⲟ	V	ϭⲉⲣⲟ
ϭⲉⲣⲱ	V	ϭⲉⲣⲟ
ϭⲉⲥ	V	ϭⲓⲥⲓ
ϭⲉⲧϭⲱⲧ	V	ϭⲟⲧϭⲉⲧ
ϭⲏ	N	ϭⲏ
ϭⲏϫ	VSTAT	ϭⲱϫ
ϭⲏⲟⲩ	N	ϭⲏⲟⲩ
ϭⲏⲟⲩ	VSTAT	ϭⲓ
ϭⲏⲟⲩⲧ	VSTAT	ϭⲟ
ϭⲏⲡⲓ	N	ϭⲏⲡⲓ
ϭⲏⲥ	VSTAT	ϭⲱⲥ
ϭⲓ	V	ϭⲓ
ϭⲓⲏ	N	ϭⲓⲏ
ϭⲓⲓⲉ	N	ϭⲓⲓⲉ
ϭⲓⲕⲥ	N	ϭⲓⲕⲥ
ϭⲓⲙⲉ	V	ϭⲓⲙⲉ
ϭⲓⲙⲏ	V	ϭⲓⲙⲉ
ϭⲓⲙⲟⲩⲧ	N	ϭⲓⲙⲟⲩⲧ
ϭⲓⲟⲩⲓ	V	ϭⲓⲟⲩⲓ
ϭⲓⲡⲥ	N	ϭⲓⲡⲥ
ϭⲓⲥⲃⲱ	V	ϭⲓⲥⲃⲱ
ϭⲓⲥⲉⲩ	N	ϭⲓⲥⲉⲩ
ϭⲓⲥⲓ	N	ϭⲓⲥⲓ
ϭⲓⲥⲓ	V	ϭⲓⲥⲓ
ϭⲓⲧ	V	ϭⲓ
ϭⲓⲧⲥ	N	ϣⲓⲧⲥ
ϭⲓⲱϯ	N	ϭⲓⲱϯ
ϭⲓⲱⲙⲥ	V	ϭⲓⲱⲙⲥ
ϭⲗⲁ	N	ϭⲗⲁ
ϭⲗⲁϩ	N	ϭⲗⲁ
ϭⲗⲁⲙ	V	ϭⲗⲁⲙ
ϭⲗⲁⲡ	N	ϭⲗⲁⲡ
ϭⲗⲉϩ	N	ϭⲗⲉϩ
ϭⲗⲉⲙⲗⲱⲙ	V	ϭⲗⲟⲙⲗⲉⲙ
ϭⲗⲉⲙⲗⲱⲙ	VSTAT	ϭⲗⲟⲙⲗⲉⲙ
ϭⲗⲏ	N	ϭⲗⲏ
ϭⲗⲏⲓⲙⲓ	N	ϣⲗⲏⲓⲙⲓ
ϭⲗⲓⲗ	N	ϭⲗⲓⲗ
ϭⲗⲟ	V	ϭⲗⲟ
ϭⲗⲟϥ	N	ϣⲗⲟϥ
ϭⲗⲟϫ	N	ϭⲗⲟϫ
ϭⲗⲟⲓ	N	ϭⲗⲟⲓ
ϭⲗⲟⲙⲗⲉⲙ	V	ϭⲗⲟⲙⲗⲉⲙ
ϭⲗⲟⲧ	N	ϭⲗⲟϫ
ϭⲗⲱⲃⲓ	N	ϭⲗⲱⲃⲓ
ϭⲗⲱⲟⲩϣ	N	ϭⲗⲱⲟⲩϣ
ϭⲗⲱⲧ	N	ϭⲗⲱⲧ
ϭⲛⲁϩ	N	ϭⲛⲁϩ
ϭⲛⲁⲩ	V	ϭⲛⲁⲩ
ϭⲛⲁⲩϩ	N	ϭⲛⲁϩ
ϭⲛⲁⲩϩ	V	ϭⲛⲁⲩ
ϭⲛⲉ	V	ϭⲛⲟⲛ
ϭⲛⲏⲛ	V	ϣϭⲛⲏⲛ
ϭⲛⲏⲟⲩⲧ	VSTAT	ϭⲛⲟ
ϭⲛⲏⲟⲩⲧ	VSTAT	ϭⲛⲟⲛ
ϭⲛⲟ	V	ϭⲛⲟ
ϭⲛⲟ	V	ϭⲛⲟⲛ
ϭⲛⲟϥ	N	ϭⲛⲟϥ
ϭⲛⲟⲛ	V	ϭⲛⲟⲛ
ϭⲛⲟⲩ	V	ϭⲛⲟⲩ
ϭⲛⲟⲩϥ	N	ϭⲛⲟⲩϥ
ϭⲛⲱϥ	N	ϭⲛⲟⲩϥ
ϭⲛⲱⲟⲩ	N	ϭⲛⲱⲟⲩ
ϭⲟ	V	ϭⲟ
ϭⲟϥⲧⲉⲛ	N	ϭⲟϥⲧⲉⲛ
ϭⲟϩ	V	ϭⲟϩ
ϭⲟϫ	V	ϭⲱϫ
ϭⲟϫⲓ	V	ϭⲟϫⲓ
ϭⲟⲓⲥ	N	ϭⲟⲓⲥ
ϭⲟⲗ	V	ϭⲱⲗ
ϭⲟⲗ	VSTAT	ϭⲱⲗ
ϭⲟⲗϫ	VSTAT	ⲕⲱⲗϫ
ϭⲟⲗⲃⲓ	N	ϭⲟⲗⲃⲓ
ϭⲟⲗⲕ	V	ϭⲱⲗⲕ
ϭⲟⲗⲕ	VSTAT	ϭⲱⲗⲕ
ϭⲟⲗⲗⲉ	N	ϭⲟⲗⲗⲉ
ϭⲟⲗⲙⲉⲥ	N	ϣⲟⲗⲙⲉⲥ
ϭⲟⲗⲡ	V	ϭⲱⲗⲡ
ϭⲟⲙϥ	N	ϭⲟⲙϥ
ϭⲟⲛϥ	N	ϭⲟⲙϥ
ϭⲟⲛⲧ	V	ϫⲱⲛⲧ
ϭⲟⲛⲧ	VSTAT	ϫⲱⲛⲧ
ϭⲟⲡ	N	ϭⲟⲡ
ϭⲟⲡ	V	ϣⲱⲡ
ϭⲟⲡ	V	ϭⲱⲡⲓ
ϭⲟⲣⲡ	V	ϭⲱⲣⲡ
ϭⲟⲣⲡ	VSTAT	ϭⲱⲣⲡ
ϭⲟⲥϫⲉⲥ	V	ϭⲟⲥϫⲉⲥ
ϭⲟⲥⲓ	VSTAT	ϭⲓⲥⲓ
ϭⲟⲧϩ	VSTAT	ϭⲱⲧϩ
ϭⲟⲧϭⲉⲧ	V	ϭⲟⲧϭⲉⲧ
ϭⲟⲧⲡ	VSTAT	ϭⲱⲧⲡ
ϭⲟⲩ	N	ϭⲟⲩ
ϭⲟⲩⲓ	V	ϭⲟⲩⲓ
ϭⲟⲩⲣ	N	ϭⲱⲣ
ϭⲣⲉ	N	ϭⲣⲉ
ϭⲣⲉⲡⲣⲉⲡ	N	ϭⲣⲉⲡⲣⲉⲡ
ϭⲣⲏ	N	ϭⲣⲉ
ϭⲣⲏ	V	ϭⲣⲏ
ϭⲣⲏϩⲓ	N	ϭⲣⲏϩⲓ
ϭⲣⲏϫⲓ	N	ϭⲣⲏϫⲓ
ϭⲣⲏⲟⲩⲧ	VSTAT	ϭⲣⲟ
ϭⲣⲏⲡⲓ	N	ϭⲣⲏⲡⲓ
ϭⲣⲟ	V	ϭⲣⲟ
ϭⲣⲟϩ	V	ϭⲣⲟϩ
ϭⲣⲟⲙⲡⲓ	N	ϭⲣⲟⲙⲡⲓ
ϭⲣⲱ	N	ϭⲣⲱ
ϭⲣⲱⲡ	N	ϭⲣⲱⲡ
ϭⲱϣⲉⲛ	N	ϭⲱϣⲉⲛ
ϭⲱϥⲧ	V	ϭⲱⲧⲡ
ϭⲱϧⲉⲙ	V	ϭⲱϧⲉⲙ
ϭⲱϫ	V	ϭⲱϫ
ϭⲱⲗ	V	ϭⲱⲗ
ϭⲱⲗϩ	V	ϫⲱⲗϩ
ϭⲱⲗⲉⲙ	V	ϭⲱⲗⲉⲙ
ϭⲱⲗⲕ	V	ϫⲱⲗⲕ
ϭⲱⲗⲕ	V	ϭⲱⲗⲕ
ϭⲱⲗⲡ	N	ϭⲱⲗⲡ
ϭⲱⲗⲡ	V	ϭⲱⲗⲡ
ϭⲱⲙ	N	ϭⲱⲙ
ϭⲱⲛⲧ	V	ϫⲱⲛⲧ
ϭⲱⲡ	V	ϣⲱⲡ
ϭⲱⲡⲓ	V	ϭⲱⲡⲓ
ϭⲱⲣ	N	ϭⲱⲣ
ϭⲱⲣⲉⲙ	V	ϭⲱⲣⲉⲙ
ϭⲱⲣⲡ	V	ϭⲱⲣⲡ
ϭⲱⲥ	N	ϭⲱⲥ
ϭⲱⲥ	V	ϭⲱⲥ
ϭⲱⲧϥ	V	ϭⲱⲧⲡ
ϭⲱⲧϩ	V	ϭⲱⲧϩ
ϭⲱⲧⲡ	V	ϭⲱⲧⲡ
ϭⲱⲧⲥ	V	ϭⲱⲧⲥ
ϯ	ART	ⲡⲓ
ϯ	PPERS	ⲁⲛⲟⲕ
ϯ	V	ϯ
ϯⲁⲅⲁⲑⲟⲛ	N	ϯⲁⲅⲁⲑⲟⲛ
ϯϩⲁⲡ	V	ϯϩⲁⲡ
ϯϩⲟ	V	ϯϩⲟ
ϯϯ	V	ϯϯ
ϯⲁⲙⲁⲣⲧⲉⲣⲉ	V	ϯⲁⲙⲁⲣⲧⲉⲣⲉ
ϯⲕⲉϩ	V	ϯⲕⲉϩ
ϯⲕⲛⲉⲩⲉ	V	ϯⲕⲛⲉⲩⲉ
ϯⲙⲁϯ	V	ϯⲙⲁϯ
ϯⲙⲓ	N	ϯⲙⲓ
ϯⲟⲥⲓ	V	ϯⲟⲥⲓ
ϯⲟⲩⲧⲁϩ	V	ϯⲟⲩⲧⲁϩ
ϯⲟⲩⲱ	V	ϯⲟⲩⲱ
ϯⲡⲓ	N	ϯⲡⲓ
ϯⲥⲃⲱ	V	ϯⲥⲃⲱ
ϯⲱⲙⲥ	V	ϯⲱⲙⲥ
ϯⲱⲟⲩ	V	ϯⲱⲟⲩ
ⲁ	APST	ⲁ
ⲁ	CFOC	ⲁⲣⲉ
ⲁϣ	N	ⲁϣ
ⲁϣ	V	ⲓϣⲓ
ⲁϣ	V	ⲱϣ
ⲁϣⲁⲓ	V	ⲁϣⲁⲓ
ⲁϣⲉⲃⲉⲛ	N	ⲁϣⲉⲃⲉⲛ
ⲁϣⲉⲩ	N	ⲁϣⲉⲩ
ⲁϣⲓ	VSTAT	ⲓϣⲓ
ⲁϣⲓⲣⲁ	N	ⲁϣⲓⲣⲁ
ⲁϥ	N	ⲁϥ
ⲁϥϣⲁⲛ	ACOND_PPERS	ⲁⲣⲉϣⲁⲛ_ⲛⲑⲟϥ
ⲁϥϫⲓⲣ	N	ⲁϥϫⲓⲣ
ⲁϥⲗⲉⲗⲓ	N	ⲁϥⲗⲉⲗⲓ
ⲁϥⲟⲩⲓ	N	ⲁϥ
ⲁϧⲓ	N	ⲁϧⲓ
ⲁϧⲟ	N	ⲁϧⲟ
ⲁϧⲟ	VBD	ⲁϧⲟ
ⲁϧⲟⲣⲓ	N	ⲁϧⲱⲣⲓ
ⲁϧⲱ	VBD	ⲁϧⲟ
ⲁϧⲱⲓⲣⲓ	N	ⲁϧⲱⲣⲓ
ⲁϧⲱⲙ	N	ⲁϧⲱⲙ
ⲁϧⲱⲣⲓ	N	ⲁϧⲱⲣⲓ
ⲁϩⲓ	N	ⲁϩⲓ
ⲁϩⲟ	N	ⲁϩⲟ
ⲁϩⲟⲙ	N	ⲁϩⲟⲙ
ⲁϩⲟⲣ	N	ⲁϩⲟ
ⲁϩⲟⲣⲁⲧⲟⲛ	N	ⲁϩⲟⲣⲁⲧⲟⲛ
ⲁϩⲟⲣⲁⲧⲟⲥ	N	ⲁϩⲟⲣⲁⲧⲟⲥ
ⲁϩⲱⲣ	N	ⲁϩⲟ
ⲁϫⲉ	V	ϫⲱ
ⲁϫⲟ	N	ⲁϫⲱ
ⲁϫⲟ	V	ϫⲱ
ⲁϫⲟⲧ	V	ϫⲱ
ⲁϫⲟⲩ	N	ⲁϫⲱ
ⲁϫⲡ	N	ⲁϫⲡ
ⲁϫⲡⲓ	N	ⲁϫⲡ
ⲁϫⲱ	N	ϫⲟ
ⲁϫⲱ	N	ⲁϫⲱ
ⲁϭⲓⲛ	N	ⲁϭⲓⲛ
ⲁϭⲛⲓ	N	ⲁϭⲛⲓ
ⲁϭⲟ	N	ⲁϭⲟ
ⲁϭⲟⲗⲧⲉ	N	ⲁϭⲟⲗⲧⲉ
ⲁϭⲣⲏⲛ	N	ⲁϭⲣⲏⲛ
ⲁⲁϥ	N	ⲁϥ
ⲁⲁⲓ	V	ⲁⲓⲁⲓ
ⲁⲁⲣⲱⲛ	NPROP	ⲁⲁⲣⲱⲛ
ⲁⲃ	N	ⲁϥ
ⲁⲃⲁϫⲏⲓⲛⲓ	N	ⲁⲃⲁϫⲏⲓⲛⲓ
ⲁⲃⲁϫⲓⲛⲓ	N	ⲁⲃⲁϫⲏⲓⲛⲓ
ⲁⲃⲁⲅⲟⲩⲙ	NPROP	ⲁⲃⲁⲅⲟⲩⲙ
ⲁⲃⲁⲛ	N	ⲁⲟⲩⲁⲛ
ⲁⲃⲁⲥⲓⲗⲉⲩⲧⲟⲥ	N	ⲁⲃⲁⲥⲓⲗⲉⲩⲧⲟⲥ
ⲁⲃⲃⲁ	N	ⲁⲃⲃⲁ
ⲁⲃⲉⲗⲧⲓⲟⲛ	N	ⲁⲃⲉⲗⲧⲓⲟⲛ
ⲁⲃⲏⲛ	N	ⲁⲟⲩⲓⲛ
ⲁⲃⲏⲧ	N	ⲁⲃⲏⲧ
ⲁⲃⲏⲧ	N	ⲁⲃⲟⲧ
ⲁⲃⲓⲁⲑⲁⲣ	NPROP	ⲁⲃⲓⲁⲑⲁⲣ
ⲁⲃⲓⲙⲉⲗⲉⲭ	NPROP	ⲁⲃⲓⲙⲉⲗⲉⲭ
ⲁⲃⲓⲛ	N	ⲁⲟⲩⲓⲛ
ⲁⲃⲓⲣⲱⲛ	NPROP	ⲁⲃⲓⲣⲱⲛ
ⲁⲃⲓⲧ	N	ⲁⲃⲓⲧ
ⲁⲃⲟⲕ	N	ⲁⲃⲱⲕ
ⲁⲃⲟⲕⲓ	N	ⲁⲃⲱⲕ
ⲁⲃⲟⲧ	N	ⲁⲃⲟⲧ
ⲁⲃⲟⲩⲓ	N	ⲁϥ
ⲁⲃⲣⲁϩⲁⲙ	NPROP	ⲁⲃⲣⲁϩⲁⲙ
ⲁⲃⲥⲱⲛ	N	ⲁⲃⲥⲱⲛ
ⲁⲃⲱ	N	ⲁⲃⲱ
ⲁⲃⲱⲕ	N	ⲁⲃⲱⲕ
ⲁⲅⲁⲑⲁⲣⲥⲓ	N	ⲁⲅⲁⲑⲁⲣⲥⲓ
ⲁⲅⲁⲑⲟⲛ	N	ⲁⲅⲁⲑⲟⲛ
ⲁⲅⲁⲑⲟⲥ	N	ⲁⲅⲁⲑⲟⲥ
ⲁⲅⲁⲗⲗⲓⲱⲛ	V	ⲁⲅⲁⲗⲗⲓⲱⲛ
ⲁⲅⲁⲛⲁⲕⲧⲉⲓ	V	ⲁⲅⲁⲛⲁⲕⲧⲉⲓ
ⲁⲅⲁⲡⲁ	V	ⲁⲅⲁⲡⲁ
ⲁⲅⲁⲡⲏ	N	ⲁⲅⲁⲡⲏ
ⲁⲅⲁⲡⲏⲧⲟⲥ	N	ⲁⲅⲁⲡⲏⲧⲟⲥ
ⲁⲅⲁⲣⲓⲛⲛⲉⲟⲥ	N	ⲁⲅⲁⲣⲓⲛⲛⲉⲟⲥ
ⲁⲅⲅⲉⲗⲓⲕⲏ	N	ⲁⲅⲅⲉⲗⲓⲕⲏ
ⲁⲅⲅⲉⲗⲓⲕⲟⲛ	N	ⲁⲅⲅⲉⲗⲓⲕⲟⲛ
ⲁⲅⲅⲉⲗⲓⲕⲟⲥ	N	ⲁⲅⲅⲉⲗⲓⲕⲟⲥ
ⲁⲅⲅⲉⲗⲟⲥ	N	ⲁⲅⲅⲉⲗⲟⲥ
ⲁⲅⲅⲏⲛ	N	ⲁⲅⲅⲏⲛ
ⲁⲅⲅⲓⲟⲛ	N	ⲁⲅⲅⲓⲟⲛ
ⲁⲅⲉⲗⲏ	N	ⲁⲅⲉⲗⲏ
ⲁⲅⲉⲛⲛⲏⲧⲟⲛ	N	ⲁⲅⲉⲛⲛⲏⲧⲟⲛ
ⲁⲅⲉⲛⲛⲏⲧⲟⲥ	N	ⲁⲅⲉⲛⲛⲏⲧⲟⲥ
ⲁⲅⲓⲁ	N	ⲁⲅⲓⲁ
ⲁⲅⲓⲟⲛ	N	ⲁⲅⲓⲟⲛ
ⲁⲅⲓⲟⲥ	N	ϩⲁⲅⲓⲟⲥ
ⲁⲅⲛⲱⲙⲏⲥⲩⲛⲏ	N	ⲁⲅⲛⲱⲙⲏⲥⲩⲛⲏ
ⲁⲅⲛⲱⲙⲟⲛ	N	ⲁⲅⲛⲱⲙⲟⲛ
ⲁⲅⲛⲱⲥⲧⲟⲥ	N	ⲁⲅⲛⲱⲥⲧⲟⲥ
ⲁⲅⲟⲣⲁ	N	ⲁⲅⲟⲣⲁ
ⲁⲅⲟⲣⲁⲓⲟⲥ	N	ⲁⲅⲟⲣⲁⲓⲟⲥ
ⲁⲅⲟⲣⲁⲥⲓⲁ	N	ⲁⲅⲟⲣⲁⲥⲓⲁ
ⲁⲅⲟⲩⲥⲧⲟⲥ	NPROP	ⲁⲅⲟⲩⲥⲧⲟⲥ
ⲁⲅⲣⲁⲫⲟⲥ	ADV	ⲁⲅⲣⲁⲫⲟⲥ
ⲁⲅⲣⲓⲟⲛ	N	ⲁⲅⲣⲓⲟⲛ
ⲁⲅⲣⲓⲟⲥ	N	ⲁⲅⲣⲓⲟⲥ
ⲁⲅⲱ	N	ⲁⲕⲱ
ⲁⲅⲱⲅⲏ	N	ⲁⲅⲱⲅⲏ
ⲁⲅⲱⲛ	N	ⲁⲅⲱⲛ
ⲁⲅⲱⲛⲓⲁ	N	ⲁⲅⲱⲛⲓⲁ
ⲁⲅⲱⲛⲓⲍⲉ	V	ⲁⲅⲱⲛⲓⲍⲉ
ⲁⲅⲱⲛⲓⲍⲉⲥⲑⲉ	V	ⲁⲅⲱⲛⲓⲍⲉⲥⲑⲉ
ⲁⲅⲱⲛⲓⲥⲧⲏⲥ	N	ⲁⲅⲱⲛⲓⲥⲧⲏⲥ
ⲁⲅⲱⲛⲟⲑⲉⲧⲏⲥ	N	ⲁⲅⲱⲛⲟⲑⲉⲧⲏⲥ
ⲁⲅⲱⲣⲁ	N	ⲁⲅⲱⲣⲁ
ⲁⲇⲁⲙⲁⲛⲧⲓⲛⲏ	N	ⲁⲇⲁⲙⲁⲛⲧⲓⲛⲏ
ⲁⲇⲁⲙⲁⲛⲧⲟⲥ	N	ⲁⲇⲁⲙⲁⲛⲧⲟⲥ
ⲁⲇⲁⲙⲁⲥ	NPROP	ⲁⲇⲁⲙⲁⲥ
ⲁⲇⲏⲗⲟⲥ	N	ⲁⲇⲏⲗⲟⲥ
ⲁⲇⲓϭⲓ	V	ⲁⲇⲓϭⲓ
ⲁⲇⲓⲕⲁⲓⲟⲥ	N	ⲁⲇⲓⲕⲁⲓⲟⲥ
ⲁⲇⲓⲕⲓⲁ	N	ⲁⲇⲓⲕⲓⲁ
ⲁⲇⲓⲕⲟⲛ	N	ⲁⲇⲓⲕⲟⲛ
ⲁⲇⲓⲕⲟⲥ	N	ⲁⲇⲓⲕⲟⲥ
ⲁⲇⲓⲕⲱⲥ	ADV	ⲁⲇⲓⲕⲱⲥ
ⲁⲉⲣⲟⲇⲓⲟⲥ	N	ⲁⲉⲣⲟⲇⲓⲟⲥ
ⲁⲉⲧⲟⲥ	N	ⲁⲉⲧⲟⲥ
ⲁⲏⲣ	N	ⲁⲏⲣ
ⲁⲑⲁⲛⲁⲥⲓⲁ	N	ⲁⲑⲁⲛⲁⲥⲓⲁ
ⲁⲑⲁⲛⲁⲧⲟⲛ	N	ⲁⲑⲁⲛⲁⲧⲟⲛ
ⲁⲑⲁⲛⲁⲧⲟⲥ	N	ⲁⲑⲁⲛⲁⲧⲟⲥ
ⲁⲑⲉⲣⲙⲏⲛⲉⲩⲉ	V	ⲁⲑⲉⲣⲙⲏⲛⲉⲩⲉ
ⲁⲑⲉⲧⲉⲓ	V	ⲁⲑⲉⲧⲉⲓ
ⲁⲑⲏⲛⲁⲓⲟⲥ	N	ⲁⲑⲏⲛⲁⲓⲟⲥ
ⲁⲑⲏⲣ	N	ϩⲁⲑⲏⲣ
ⲁⲑⲗⲏⲥⲓⲥ	N	ⲁⲑⲗⲏⲥⲓⲥ
ⲁⲑⲗⲏⲧⲏⲥ	N	ⲁⲑⲗⲏⲧⲏⲥ
ⲁⲑⲗⲟⲛ	N	ⲁⲑⲗⲟⲛ
ⲁⲑⲗⲟⲫⲟⲣⲟⲥ	N	ⲁⲑⲗⲟⲫⲟⲣⲟⲥ
ⲁⲑⲩⲛⲁ	N	ⲁⲑⲩⲛⲁ
ⲁⲑⲩⲣⲁⲥ	N	ⲁⲑⲩⲣⲁⲥ
ⲁⲑⲱⲣ	N	ϩⲁⲑⲱⲣ
ⲁⲓ	V	ⲓⲣⲓ
ⲁⲓⲧ	V	ⲓⲣⲓ
ⲁⲓϣⲁⲛ	ACOND_PPERS	ⲁⲣⲉϣⲁⲛ_ⲁⲛⲟⲕ
ⲁⲓⲁⲓ	V	ⲁⲓⲁⲓ
ⲁⲓⲇⲓⲟⲥ	N	ⲁⲓⲇⲓⲟⲥ
ⲁⲓⲇⲟⲓⲟⲛ	N	ⲁⲓⲇⲟⲓⲟⲛ
ⲁⲓⲕ	N	ⲁⲓⲕ
ⲁⲓⲛⲓⲅⲙⲁ	N	ⲁⲓⲛⲓⲅⲙⲁ
ⲁⲓⲟⲩ	N	ⲁⲓⲟⲩ
ⲁⲓⲡⲉⲛⲟⲥ	N	ⲁⲓⲡⲉⲛⲟⲥ
ⲁⲓⲥⲑⲁⲛⲉ	V	ⲁⲓⲥⲑⲁⲛⲉ
ⲁⲓⲥⲑⲏⲥⲓⲥ	N	ⲁⲓⲥⲑⲏⲥⲓⲥ
ⲁⲓⲥⲑⲏⲧⲏⲣⲓⲟⲛ	N	ⲁⲓⲥⲑⲏⲧⲏⲣⲓⲟⲛ
ⲁⲓⲥⲑⲏⲧⲟⲛ	N	ⲁⲓⲥⲑⲏⲧⲟⲛ
ⲁⲓⲥⲑⲏⲧⲟⲥ	N	ⲁⲓⲥⲑⲏⲧⲟⲥ
ⲁⲓⲧⲉⲓ	N	ⲁⲓⲧⲉⲓ
ⲁⲓⲧⲉⲓ	V	ⲁⲓⲧⲉⲓ
ⲁⲓⲧⲏⲙⲁ	N	ⲁⲓⲧⲏⲙⲁ
ⲁⲓⲧⲏⲥⲓⲥ	N	ⲁⲓⲧⲏⲥⲓⲥ
ⲁⲓⲧⲓ	V	ⲁⲓⲧⲉⲓ
ⲁⲓⲧⲓⲁ	N	ⲁⲓⲧⲓⲁ
ⲁⲓⲧⲓⲟⲛ	N	ⲁⲓⲧⲓⲟⲛ
ⲁⲓⲭⲙⲁⲗⲱⲥⲓⲁ	N	ⲁⲓⲭⲙⲁⲗⲱⲥⲓⲁ
ⲁⲓⲭⲙⲁⲗⲱⲧⲉⲩⲉ	V	ⲁⲓⲭⲙⲁⲗⲱⲧⲉⲩⲉ
ⲁⲓⲭⲙⲁⲗⲱⲧⲓⲍⲉ	V	ⲁⲓⲭⲙⲁⲗⲱⲧⲓⲍⲉ
ⲁⲓⲭⲙⲁⲗⲱⲧⲟⲥ	N	ⲁⲓⲭⲙⲁⲗⲱⲧⲟⲥ
ⲁⲓⲱⲛ	N	ⲁⲓⲱⲛ
ⲁⲓⲱⲛⲓⲟⲛ	N	ⲁⲓⲱⲛⲓⲟⲛ
ⲁⲓⲱⲛⲓⲟⲥ	N	ⲁⲓⲱⲛⲓⲟⲥ
ⲁⲕϣⲁⲛ	ACOND_PPERS	ⲁⲣⲉϣⲁⲛ_ⲛⲑⲟⲕ
ⲁⲕⲁⲑⲁⲣⲥⲓⲁ	N	ⲁⲕⲁⲑⲁⲣⲥⲓⲁ
ⲁⲕⲁⲑⲁⲣⲧⲟⲛ	N	ⲁⲕⲁⲑⲁⲣⲧⲟⲛ
ⲁⲕⲁⲑⲁⲣⲧⲟⲥ	N	ⲁⲕⲁⲑⲁⲣⲧⲟⲥ
ⲁⲕⲁⲕⲓⲟⲥ	NPROP	ⲁⲕⲁⲕⲓⲟⲥ
ⲁⲕⲁⲕⲟⲥ	N	ⲁⲕⲁⲕⲟⲥ
ⲁⲕⲁⲛⲁⲕⲧⲉⲓ	V	ⲁⲕⲁⲛⲁⲕⲧⲉⲓ
ⲁⲕⲁⲧⲁⲅⲛⲱⲥⲧⲟⲥ	N	ⲁⲕⲁⲧⲁⲅⲛⲱⲥⲧⲟⲥ
ⲁⲕⲉⲣⲁⲓⲟⲛ	N	ⲁⲕⲉⲣⲁⲓⲟⲛ
ⲁⲕⲉⲣⲁⲓⲟⲥ	N	ⲁⲕⲉⲣⲁⲓⲟⲥ
ⲁⲕⲏⲥ	N	ⲁⲕⲏⲥ
ⲁⲕⲗⲏ	N	ⲁⲕⲗⲏ
ⲁⲕⲗⲓ	N	ⲁⲕⲗⲏ
ⲁⲕⲙⲏ	N	ⲁⲕⲙⲏ
ⲁⲕⲙⲏⲛ	ADV	ⲁⲕⲙⲏⲛ
ⲁⲕⲟⲗⲗⲟⲩⲑⲓⲁ	N	ⲁⲕⲟⲗⲗⲟⲩⲑⲓⲁ
ⲁⲕⲟⲗⲟⲩⲑⲓⲁ	N	ⲁⲕⲟⲗⲟⲩⲑⲓⲁ
ⲁⲕⲟⲗⲧⲉ	N	ⲁϭⲟⲗⲧⲉ
ⲁⲕⲣⲁⲧⲟⲛ	N	ⲁⲕⲣⲁⲧⲟⲛ
ⲁⲕⲣⲓⲃⲁⲍⲉ	V	ⲁⲕⲣⲓⲃⲁⲍⲉ
ⲁⲕⲣⲓⲃⲏⲥ	N	ⲁⲕⲣⲓⲃⲏⲥ
ⲁⲕⲣⲓⲃⲓⲁ	N	ⲁⲕⲣⲓⲃⲓⲁ
ⲁⲕⲣⲓⲃⲱⲥ	ADV	ⲁⲕⲣⲓⲃⲱⲥ
ⲁⲕⲣⲓⲥ	N	ⲁⲕⲣⲓⲥ
ⲁⲕⲣⲟⲁⲧⲏⲥ	N	ⲁⲕⲣⲟⲁⲧⲏⲥ
ⲁⲕⲣⲱⲁⲧⲏⲥ	N	ⲁⲕⲣⲱⲁⲧⲏⲥ
ⲁⲕⲧⲓⲛ	N	ⲁⲕⲧⲓⲛ
ⲁⲕⲩⲗⲁ	NPROP	ⲁⲕⲩⲗⲁ
ⲁⲕⲩⲣⲟⲛ	N	ⲁⲕⲩⲣⲟⲛ
ⲁⲕⲩⲣⲟⲩ	V	ⲁⲕⲩⲣⲟⲩ
ⲁⲕⲱ	N	ⲁⲕⲱ
ⲁⲗ	N	ⲁⲗ
ⲁⲗ	N	ⲁⲗⲟⲗⲓ
ⲁⲗϫⲁⲓ	N	ⲁⲗϫⲁⲓ
ⲁⲗⲁⲃⲁⲥⲧⲣⲟⲛ	N	ⲁⲗⲁⲃⲁⲥⲧⲣⲟⲛ
ⲁⲗⲁⲃⲗⲉⲃ	V	ⲗⲁⲡⲗⲉⲡ
ⲁⲗⲁⲕ	N	ϩⲁⲗⲁⲕ
ⲁⲗⲁⲗⲉⲓⲁ	N	ⲁⲗⲁⲗⲉⲓⲁ
ⲁⲗⲁⲗⲓⲁ	N	ⲁⲗⲁⲗⲓⲁ
ⲁⲗⲁⲡⲗⲉⲡ	V	ⲗⲁⲡⲗⲉⲡ
ⲁⲗⲁⲥⲱϯ	N	ⲁⲗⲁⲥⲱϯ
ⲁⲗⲁⲩ	N	ⲁⲗⲟⲩ
ⲁⲗⲉⲕⲧⲟⲥ	N	ⲁⲗⲉⲕⲧⲟⲥ
ⲁⲗⲉⲕⲧⲱⲣ	N	ⲁⲗⲉⲕⲧⲱⲣ
ⲁⲗⲉⲝⲁⲛⲇⲣⲉⲩⲥ	N	ⲁⲗⲉⲝⲁⲛⲇⲣⲉⲩⲥ
ⲁⲗⲉⲝⲁⲛⲇⲣⲟⲥ	NPROP	ⲁⲗⲉⲝⲁⲛⲇⲣⲟⲥ
ⲁⲗⲏⲑⲉⲓⲁ	N	ⲁⲗⲏⲑⲉⲓⲁ
ⲁⲗⲏⲑⲓⲛⲏ	N	ⲁⲗⲏⲑⲓⲛⲏ
ⲁⲗⲏⲑⲓⲛⲟⲛ	N	ⲁⲗⲏⲑⲓⲛⲟⲛ
ⲁⲗⲏⲑⲓⲛⲟⲥ	N	ⲁⲗⲏⲑⲓⲛⲟⲥ
ⲁⲗⲏⲑⲱⲥ	ADV	ⲁⲗⲏⲑⲱⲥ
ⲁⲗⲏⲓ	V	ⲁⲗⲏⲓ
ⲁⲗⲓ	N	ⲁⲗⲓ
ⲁⲗⲓ	V	ⲁⲗⲏⲓ
ⲁⲗⲓ	VSTAT	ⲱⲗⲓ
ⲁⲗⲓϫⲓ	N	ⲁⲗⲓϫⲓ
ⲁⲗⲓⲗ	N	ⲁⲗⲓⲗ
ⲁⲗⲓⲗⲓ	N	ⲁⲗⲓⲗ
ⲁⲗⲓⲟⲩⲓ	VSTAT	ⲱⲗⲓ
ⲁⲗⲓⲧ	VSTAT	ⲱⲗⲓ
ⲁⲗⲕⲉ	N	ⲁⲗⲕⲉ
ⲁⲗⲕⲏ	N	ⲁⲗⲕⲉ
ⲁⲗⲕⲓ	N	ⲁⲕⲗⲏ
ⲁⲗⲕⲟⲩ	N	ⲁⲗⲕⲟⲩ
ⲁⲗⲕⲟⲩ	N	ⲉⲗⲕⲟ
ⲁⲗⲗⲁ	CONJ	ⲁⲗⲗⲁ
ⲁⲗⲗⲁⲅⲏ	N	ⲁⲗⲗⲁⲅⲏ
ⲁⲗⲗⲁⲥⲥⲉ	V	ⲁⲗⲗⲁⲥⲥⲉ
ⲁⲗⲗⲏⲗⲟⲩⲓⲁ	FW	ⲁⲗⲗⲏⲗⲟⲩⲓⲁ
ⲁⲗⲗⲏⲗⲟⲩⲓⲓⲁ	PTC	ⲁⲗⲗⲏⲗⲟⲩⲓⲓⲁ
ⲁⲗⲗⲟⲅⲉⲛⲏⲥ	N	ⲁⲗⲗⲟⲅⲉⲛⲏⲥ
ⲁⲗⲗⲟⲅⲉⲛⲓⲟⲥ	N	ⲁⲗⲗⲟⲅⲉⲛⲓⲟⲥ
ⲁⲗⲗⲟⲕ	N	ⲁⲗⲗⲟⲕ
ⲁⲗⲗⲟⲕⲓ	N	ⲁⲗⲗⲱⲕⲓ
ⲁⲗⲗⲟⲧⲣⲓⲟⲛ	N	ⲁⲗⲗⲟⲧⲣⲓⲟⲛ
ⲁⲗⲗⲟⲧⲣⲓⲟⲥ	N	ⲁⲗⲗⲟⲧⲣⲓⲟⲥ
ⲁⲗⲗⲟⲩ	N	ⲁⲗⲗⲟⲩ
ⲁⲗⲗⲟⲫⲩⲗⲟⲥ	N	ⲁⲗⲗⲟⲫⲩⲗⲟⲥ
ⲁⲗⲗⲱⲏ	N	ⲁⲗⲗⲱⲏ
ⲁⲗⲗⲱⲕⲏ	N	ⲁⲗⲗⲱⲕⲓ
ⲁⲗⲗⲱⲕⲓ	N	ⲁⲗⲗⲱⲕⲓ
ⲁⲗⲟϫ	N	ⲁⲗⲟϫ
ⲁⲗⲟⲅⲟⲛ	N	ⲁⲗⲟⲅⲟⲛ
ⲁⲗⲟⲅⲟⲥ	N	ⲁⲗⲟⲅⲟⲥ
ⲁⲗⲟⲕ	N	ⲁⲗⲟⲕ
ⲁⲗⲟⲗⲓ	N	ⲁⲗⲟⲗⲓ
ⲁⲗⲟⲩ	N	ⲁⲗⲟⲩ
ⲁⲗⲟⲩⲃⲉϩ	N	ⲃⲁⲗⲙⲃⲉϩ
ⲁⲗⲥⲟⲥ	N	ⲁⲗⲥⲟⲥ
ⲁⲗⲫⲁ	N	ⲁⲗⲫⲁ
ⲁⲗⲫⲁⲃⲁⲧⲱⲛ	N	ⲁⲗⲫⲁⲃⲁⲧⲱⲛ
ⲁⲗⲫⲁⲓⲟⲥ	N	ⲁⲗⲫⲁⲓⲟⲥ
ⲁⲗⲫⲉⲟⲥ	NPROP	ⲁⲗⲫⲉⲟⲥ
ⲁⲗⲱϫ	N	ⲁⲗⲟϫ
ⲁⲗⲱⲙ	N	ϩⲁⲗⲱⲙ
ⲁⲗⲱⲟⲩⲓ	N	ⲁⲗⲟⲩ
ⲁⲙ	N	ϩⲁⲙ
ⲁⲙⲁϩⲓ	V	ⲁⲙⲁϩⲓ
ⲁⲙⲁⲓⲟⲩ	N	ⲓⲟⲙ
ⲁⲙⲁⲗⲉⲕ	NPROP	ⲁⲙⲁⲗⲉⲕ
ⲁⲙⲁⲗⲏϫ	V	ⲁⲙⲁⲗⲏϫ
ⲁⲙⲁⲣⲁⲛⲧⲟⲥ	N	ⲁⲙⲁⲣⲁⲛⲧⲟⲥ
ⲁⲙⲉ	N	ⲁⲙⲉ
ⲁⲙⲉⲗⲉⲓ	V	ⲁⲙⲉⲗⲉⲓ
ⲁⲙⲉⲗⲉⲓⲁ	N	ⲁⲙⲉⲗⲉⲓⲁ
ⲁⲙⲉⲗⲏⲥ	N	ⲁⲙⲉⲗⲏⲥ
ⲁⲙⲉⲛϯ	N	ⲁⲙⲉⲛϯ
ⲁⲙⲉⲣⲓ	N	ⲁⲙⲉⲣⲓ
ⲁⲙⲉⲣⲓⲙⲛⲟⲥ	N	ⲁⲙⲉⲣⲓⲙⲛⲟⲥ
ⲁⲙⲉⲧⲣⲏⲧⲟⲛ	N	ⲁⲙⲉⲧⲣⲏⲧⲟⲛ
ⲁⲙⲏ	N	ⲁⲙⲉ
ⲁⲙⲏϣ	N	ⲁⲙⲏϣ
ⲁⲙⲏⲑⲓⲥⲧⲱⲥ	N	ⲁⲙⲏⲑⲓⲥⲧⲱⲥ
ⲁⲙⲏⲓⲣⲓ	N	ⲁⲙⲏⲓⲣⲓ
ⲁⲙⲏⲛ	PTC	ⲁⲙⲏⲛ
ⲁⲙⲏⲣ	N	ⲁⲙⲏⲣ
ⲁⲙⲏⲧⲣⲓⲧⲟⲥ	N	ⲁⲙⲏⲧⲣⲓⲧⲟⲥ
ⲁⲙⲓⲁⲛⲧⲟⲥ	N	ⲁⲙⲓⲁⲛⲧⲟⲥ
ⲁⲙⲓⲛ	N	ⲁⲙⲓⲛ
ⲁⲙⲓⲛⲁⲇⲁⲃ	NPROP	ⲁⲙⲓⲛⲁⲇⲁⲃ
ⲁⲙⲓⲣⲁ	N	ⲁⲙⲓⲣⲁ
ⲁⲙⲓⲥⲓ	N	ⲁⲙⲓⲥⲓ
ⲁⲙⲙⲁ	N	ⲁⲙⲁ
ⲁⲙⲙⲟⲣⲁⲓⲟⲥ	N	ⲁⲙⲙⲟⲣⲁⲓⲟⲥ
ⲁⲙⲙⲱⲛⲓⲧⲏⲥ	N	ⲁⲙⲙⲱⲛⲓⲧⲏⲥ
ⲁⲙⲛⲁ	N	ⲁⲙⲛⲁ
ⲁⲙⲟⲛⲓ	V	ⲁⲙⲟⲛⲓ
ⲁⲙⲟⲛⲓ	V	ⲙⲟⲛⲓ
ⲁⲙⲟⲩ	V	ⲁⲙⲟⲩ
ⲁⲙⲟⲩ	VIMP	ⲓ
ⲁⲙⲡⲟⲩⲗⲉ	N	ⲁⲙⲡⲟⲩⲗⲉ
ⲁⲙⲣⲉ	N	ⲁⲙⲣⲉ
ⲁⲙⲣⲏⲟⲩ	N	ⲁⲙⲣⲉ
ⲁⲙⲩⲅⲇⲁⲗⲟⲛ	N	ⲁⲙⲩⲅⲇⲁⲗⲟⲛ
ⲁⲙⲫⲓⲃⲁⲗⲉ	V	ⲁⲙⲫⲓⲃⲁⲗⲉ
ⲁⲙⲫⲓⲃⲟⲗⲓⲁ	N	ⲁⲙⲫⲓⲃⲟⲗⲓⲁ
ⲁⲙⲫⲓⲧⲁⲡⲟⲥ	N	ⲁⲙⲫⲓⲧⲁⲡⲟⲥ
ⲁⲙⲱⲓⲛⲓ	VIMP	ⲓ
ⲁⲙⲱⲙⲟⲙ	N	ⲁⲙⲱⲙⲟⲙ
ⲁⲛ	N	ⲁⲛ
ⲁⲛ	NEG	ⲁⲛ
ⲁⲛ	PTC	ⲁⲛ
ⲁⲛϣⲁⲛ	ACOND_PPERS	ⲁⲣⲉϣⲁⲛ_ⲁⲛⲟⲛ
ⲁⲛϣⲓⲣⲓ	N	ⲁⲛϣⲓⲣⲓ
ⲁⲛϩⲁⲗⲓⲥⲕⲉ	V	ⲁⲛϩⲁⲗⲓⲥⲕⲉ
ⲁⲛϩⲁⲗⲱⲙⲁ	N	ⲁⲛϩⲁⲗⲱⲙⲁ
ⲁⲛϩⲉⲥⲓⲥ	N	ⲁⲛϩⲉⲥⲓⲥ
ⲁⲛϩⲏⲕⲉⲓⲥⲑⲁⲓ	V	ⲁⲛϩⲏⲕⲉⲓⲥⲑⲁⲓ
ⲁⲛϩⲟⲗⲟⲙⲁ	N	ⲁⲛϩⲟⲗⲟⲙⲁ
ⲁⲛϩⲟⲙⲟⲓⲟⲛ	N	ⲁⲛϩⲟⲙⲟⲓⲟⲛ
ⲁⲛϩⲟⲥⲓⲟⲥ	N	ⲁⲛϩⲟⲥⲓⲟⲥ
ⲁⲛϩⲱⲙⲁⲗⲓⲁ	N	ⲁⲛϩⲱⲙⲁⲗⲓⲁ
ⲁⲛϭⲓⲣⲓ	N	ⲁⲛϣⲓⲣⲓ
ⲁⲛϯⲛⲱⲟⲩ	NPROP	ⲁⲛϯⲛⲱⲟⲩ
ⲁⲛⲁ	N	ⲱⲛⲓ
ⲁⲛⲁϣ	N	ⲁⲛⲁϣ
ⲁⲛⲁⲃⲁⲑⲙⲟⲥ	N	ⲁⲛⲁⲃⲁⲑⲙⲟⲥ
ⲁⲛⲁⲃⲁⲥⲓⲥ	N	ⲁⲛⲁⲃⲁⲥⲓⲥ
ⲁⲛⲁⲅⲕⲁⲍⲉ	V	ⲁⲛⲁⲅⲕⲁⲍⲉ
ⲁⲛⲁⲅⲕⲁⲓⲟⲛ	N	ⲁⲛⲁⲅⲕⲁⲓⲟⲛ
ⲁⲛⲁⲅⲕⲁⲓⲟⲥ	N	ⲁⲛⲁⲅⲕⲁⲓⲟⲥ
ⲁⲛⲁⲅⲕⲏ	N	ⲁⲛⲁⲅⲕⲏ
ⲁⲛⲁⲅⲛⲱⲥⲧⲏⲥ	N	ⲁⲛⲁⲅⲛⲱⲥⲧⲏⲥ
ⲁⲛⲁⲇⲓⲇⲟⲩ	V	ⲁⲛⲁⲇⲓⲇⲟⲩ
ⲁⲛⲁⲑⲉⲙⲁ	N	ⲁⲛⲁⲑⲉⲙⲁ
ⲁⲛⲁⲑⲉⲙⲁⲧⲓⲍⲉ	V	ⲁⲛⲁⲑⲉⲙⲁⲧⲓⲍⲉ
ⲁⲛⲁⲓ	V	ⲁⲛⲁⲓ
ⲁⲛⲁⲓⲥⲑⲏⲧⲟⲛ	N	ⲁⲛⲁⲓⲥⲑⲏⲧⲟⲛ
ⲁⲛⲁⲓⲥⲑⲏⲧⲟⲥ	N	ⲁⲛⲁⲓⲥⲑⲏⲧⲟⲥ
ⲁⲛⲁⲓⲧⲓⲟⲥ	N	ⲁⲛⲁⲓⲧⲓⲟⲥ
ⲁⲛⲁⲓⲱ	N	ⲁⲛⲁⲓⲱ
ⲁⲛⲁⲕⲁⲗⲉⲓ	V	ⲁⲛⲁⲕⲁⲗⲉⲓ
ⲁⲛⲁⲕⲣⲓⲛⲉ	V	ⲁⲛⲁⲕⲣⲓⲛⲉ
ⲁⲛⲁⲗⲁⲙⲃⲁⲛⲉ	V	ⲁⲛⲁⲗⲁⲙⲃⲁⲛⲉ
ⲁⲛⲁⲗⲏⲙⲯⲓⲥ	N	ⲁⲛⲁⲗⲏⲙⲯⲓⲥ
ⲁⲛⲁⲗⲏⲯⲓⲥ	N	ⲁⲛⲁⲗⲏⲯⲓⲥ
ⲁⲛⲁⲗⲟⲅⲓⲁ	N	ⲁⲛⲁⲗⲟⲅⲓⲁ
ⲁⲛⲁⲗⲟⲅⲓⲟⲛ	N	ⲁⲛⲁⲗⲟⲅⲓⲟⲛ
ⲁⲛⲁⲙⲏⲓ	N	ⲁⲛⲁⲙⲏⲓ
ⲁⲛⲁⲛⲓⲁⲥ	NPROP	ⲁⲛⲁⲛⲓⲁⲥ
ⲁⲛⲁⲡⲁⲓ	N	ⲁⲛⲁⲡⲁⲓ
ⲁⲛⲁⲡⲁⲩⲉ	V	ⲁⲛⲁⲡⲁⲩⲉ
ⲁⲛⲁⲡⲁⲩⲥⲓⲥ	N	ⲁⲛⲁⲡⲁⲩⲥⲓⲥ
ⲁⲛⲁⲡⲗⲁⲥⲓⲥ	N	ⲁⲛⲁⲡⲗⲁⲥⲓⲥ
ⲁⲛⲁⲡⲛⲟⲏ	N	ⲁⲛⲁⲡⲛⲟⲏ
ⲁⲛⲁⲣⲭⲟⲥ	N	ⲁⲛⲁⲣⲭⲟⲥ
ⲁⲛⲁⲥⲕⲉⲡⲧⲉⲥⲑⲁⲓ	V	ⲁⲛⲁⲥⲕⲉⲡⲧⲉⲥⲑⲁⲓ
ⲁⲛⲁⲥⲧⲁⲥⲓ	V	ⲁⲛⲁⲥⲧⲁⲥⲓ
ⲁⲛⲁⲥⲧⲁⲥⲓⲙⲱⲛ	N	ⲁⲛⲁⲥⲧⲁⲥⲓⲙⲱⲛ
ⲁⲛⲁⲥⲧⲁⲥⲓⲥ	N	ⲁⲛⲁⲥⲧⲁⲥⲓⲥ
ⲁⲛⲁⲥⲧⲣⲉⲫⲉⲥⲑⲁⲓ	V	ⲁⲛⲁⲥⲧⲣⲉⲫⲉⲥⲑⲁⲓ
ⲁⲛⲁⲥⲧⲣⲟⲫⲏ	N	ⲁⲛⲁⲥⲧⲣⲟⲫⲏ
ⲁⲛⲁⲧⲟⲗⲏ	NPROP	ⲁⲛⲁⲧⲟⲗⲏ
ⲁⲛⲁⲧⲣⲉⲡⲉ	V	ⲁⲛⲁⲧⲣⲉⲡⲉ
ⲁⲛⲁⲩ	V	ⲛⲁⲩ
ⲁⲛⲁⲩ	VIMP	ⲛⲁⲩ
ⲁⲛⲁⲩϣ	N	ⲁⲛⲁϣ
ⲁⲛⲁⲫⲟⲣⲁ	N	ⲁⲛⲁⲫⲟⲣⲁ
ⲁⲛⲁⲭⲱⲣⲉⲓ	V	ⲁⲛⲁⲭⲱⲣⲉⲓ
ⲁⲛⲁⲭⲱⲣⲏⲧⲏⲥ	N	ⲁⲛⲁⲭⲱⲣⲏⲧⲏⲥ
ⲁⲛⲁⲭⲱⲣⲓⲛ	V	ⲁⲛⲁⲭⲱⲣⲓⲛ
ⲁⲛⲁⲭⲱⲣⲓⲧⲏⲥ	N	ⲁⲛⲁⲭⲱⲣⲓⲧⲏⲥ
ⲁⲛⲅⲱⲛ	N	ⲁⲛⲅⲱⲛ
ⲁⲛⲇⲓⲗⲟⲅⲓⲁ	N	ⲁⲛⲇⲓⲗⲟⲅⲓⲁ
ⲁⲛⲇⲣⲉⲁⲥ	NPROP	ⲁⲛⲇⲣⲉⲁⲥ
ⲁⲛⲇⲣⲉⲓⲁⲥ	N	ⲁⲛⲇⲣⲉⲓⲁⲥ
ⲁⲛⲉⲡⲓⲕⲱⲗⲩⲧⲏⲥ	ADV	ⲁⲛⲉⲡⲓⲕⲱⲗⲩⲧⲏⲥ
ⲁⲛⲉⲭⲉ	V	ⲁⲛⲉⲭⲉ
ⲁⲛⲉⲭⲉⲥⲑⲉ	V	ⲁⲛⲉⲭⲉⲥⲑⲉ
ⲁⲛⲍⲏⲃ	N	ⲁⲛⲍⲏⲃ
ⲁⲛⲍⲱⲛⲏ	N	ⲁⲛⲍⲱⲛⲏ
ⲁⲛⲑⲁϣ	N	ⲁⲛⲑⲁϣ
ⲁⲛⲑⲉⲙⲓⲟⲛ	N	ⲁⲛⲑⲉⲙⲓⲟⲛ
ⲁⲛⲑⲉⲣⲁ	N	ϩⲁⲑⲏⲣ
ⲁⲛⲑⲉⲱⲛⲟⲥ	N	ⲁⲛⲑⲉⲱⲛⲟⲥ
ⲁⲛⲑⲏⲣ	N	ϩⲁⲑⲏⲣ
ⲁⲛⲑⲟⲩⲥ	N	ⲁⲛⲑⲟⲩⲥ
ⲁⲛⲑⲣⲁⲝ	N	ⲁⲛⲑⲣⲁⲝ
ⲁⲛⲑⲩⲡⲁⲧⲟⲥ	N	ⲁⲛⲑⲩⲡⲁⲧⲟⲥ
ⲁⲛⲓ	VIMP	ⲓⲛⲓ
ⲁⲛⲓⲕⲁⲙ	N	ⲁⲛⲓⲕⲁⲙ
ⲁⲛⲓⲟⲩⲓ	V	ⲓⲛⲓ
ⲁⲛⲓⲧ	V	ⲓⲛⲓ
ⲁⲛⲕⲟⲕⲓ	N	ⲁⲛⲕⲟⲕⲓ
ⲁⲛⲕⲟⲩⲕⲓ	N	ⲁⲛⲕⲟⲕⲓ
ⲁⲛⲛⲁ	NPROP	ⲁⲛⲛⲁ
ⲁⲛⲛⲟϣⲉⲣ	N	ⲁⲛⲛⲟϣⲉⲣ
ⲁⲛⲟⲏⲧⲟⲛ	N	ⲁⲛⲟⲏⲧⲟⲛ
ⲁⲛⲟⲏⲧⲟⲥ	N	ⲁⲛⲟⲏⲧⲟⲥ
ⲁⲛⲟⲕ	N	ⲁⲛⲟⲕ
ⲁⲛⲟⲕ	PPERI	ⲁⲛⲟⲕ
ⲁⲛⲟⲙⲉⲓ	V	ⲁⲛⲟⲙⲉⲓ
ⲁⲛⲟⲙⲓⲁ	N	ⲁⲛⲟⲙⲓⲁ
ⲁⲛⲟⲙⲟⲛ	N	ⲁⲛⲟⲙⲟⲛ
ⲁⲛⲟⲙⲟⲥ	N	ⲁⲛⲟⲙⲟⲥ
ⲁⲛⲟⲛⲓ	V	ⲁⲛⲟⲛⲓ
ⲁⲛⲟⲩⲥⲓⲟⲥ	N	ⲁⲛⲟⲩⲥⲓⲟⲥ
ⲁⲛⲟⲭⲏ	N	ⲁⲛⲟⲭⲏ
ⲁⲛⲧⲓ	PREP	ⲁⲛⲧⲓ
ⲁⲛⲧⲓⲅⲣⲁⲫⲉ	V	ⲁⲛⲧⲓⲅⲣⲁⲫⲉ
ⲁⲛⲧⲓⲅⲣⲁⲫⲟⲛ	N	ⲁⲛⲧⲓⲅⲣⲁⲫⲟⲛ
ⲁⲛⲧⲓⲇⲓⲕⲟⲥ	N	ⲁⲛⲧⲓⲇⲓⲕⲟⲥ
ⲁⲛⲧⲓⲕⲉⲓⲙⲉⲛⲏ	N	ⲁⲛⲧⲓⲕⲉⲓⲙⲉⲛⲏ
ⲁⲛⲧⲓⲕⲉⲓⲙⲉⲛⲟⲛ	N	ⲁⲛⲧⲓⲕⲉⲓⲙⲉⲛⲟⲛ
ⲁⲛⲧⲓⲕⲉⲓⲙⲉⲛⲟⲥ	N	ⲁⲛⲧⲓⲕⲉⲓⲙⲉⲛⲟⲥ
ⲁⲛⲧⲓⲕⲓⲙⲉⲛⲟⲥ	N	ⲁⲛⲧⲓⲕⲓⲙⲉⲛⲟⲥ
ⲁⲛⲧⲓⲗⲉⲅⲉ	V	ⲁⲛⲧⲓⲗⲉⲅⲉ
ⲁⲛⲧⲓⲗⲟⲅⲓⲁ	N	ⲁⲛⲧⲓⲗⲟⲅⲓⲁ
ⲁⲛⲧⲓⲙⲓⲙⲟⲛ	N	ⲁⲛⲧⲓⲙⲓⲙⲟⲛ
ⲁⲛⲧⲓⲧⲩⲡⲟⲛ	N	ⲁⲛⲧⲓⲧⲩⲡⲟⲛ
ⲁⲛⲧⲓⲧⲩⲡⲟⲥ	N	ⲁⲛⲧⲓⲧⲩⲡⲟⲥ
ⲁⲛⲧⲓⲭⲣⲓⲥⲧⲟⲥ	N	ⲁⲛⲧⲓⲭⲣⲓⲥⲧⲟⲥ
ⲁⲛⲧⲟⲗⲓ	N	ⲁⲛⲧⲟⲗⲓ
ⲁⲛⲧⲱⲣⲓ	N	ⲁⲛⲧⲱⲣⲓ
ⲁⲛⲩⲥⲧⲏⲥ	N	ⲁⲛⲩⲥⲧⲏⲥ
ⲁⲝⲓⲟⲛ	N	ⲁⲝⲓⲟⲛ
ⲁⲝⲓⲟⲡⲓⲥⲧⲟⲥ	N	ⲁⲝⲓⲟⲡⲓⲥⲧⲟⲥ
ⲁⲝⲓⲟⲥ	N	ⲁⲝⲓⲟⲥ
ⲁⲝⲓⲟⲩ	V	ⲁⲝⲓⲟⲩ
ⲁⲝⲓⲱⲙⲁ	N	ⲁⲝⲓⲱⲙⲁ
ⲁⲝⲓⲱⲙⲁⲧⲓⲕⲟⲥ	N	ⲁⲝⲓⲱⲙⲁⲧⲓⲕⲟⲥ
ⲁⲟⲩⲁⲛ	N	ⲁⲟⲩⲁⲛ
ⲁⲟⲩⲃⲏⲧ	N	ⲁⲃⲏⲧ
ⲁⲟⲩⲏⲧ	N	ⲁⲃⲏⲧ
ⲁⲟⲩⲓⲛ	N	ⲁⲟⲩⲓⲛ
ⲁⲟⲩⲱ	N	ⲟⲩⲱ
ⲁⲟⲩⲱ	V	ⲟⲩⲱ
ⲁⲟⲩⲱⲛ	VIMP	ⲟⲩⲱⲛ
ⲁⲡϫⲱϫ	N	ϫⲱϫ
ⲁⲡⲁ	N	ⲁⲡⲁ
ⲁⲡⲁⲅⲅⲉⲓⲗⲉ	V	ⲁⲡⲁⲅⲅⲉⲓⲗⲉ
ⲁⲡⲁⲑⲏⲥ	N	ⲁⲡⲁⲑⲏⲥ
ⲁⲡⲁⲓⲇⲉ	V	ⲁⲡⲁⲓⲇⲉ
ⲁⲡⲁⲛⲑⲣⲟⲡⲓⲁ	N	ⲁⲡⲁⲛⲑⲣⲟⲡⲓⲁ
ⲁⲡⲁⲛⲧⲁ	V	ⲁⲡⲁⲛⲧⲁ
ⲁⲡⲁⲛⲧⲏ	N	ⲁⲡⲁⲛⲧⲏ
ⲁⲡⲁⲛⲧⲩⲙⲁ	N	ⲁⲡⲁⲛⲧⲩⲙⲁ
ⲁⲡⲁⲣⲛⲁ	V	ⲁⲡⲁⲣⲛⲁ
ⲁⲡⲁⲣⲭⲏ	N	ⲁⲡⲁⲣⲭⲏ
ⲁⲡⲁⲥ	N	ⲁⲡⲁⲥ
ⲁⲡⲁⲧⲁ	V	ⲁⲡⲁⲧⲁ
ⲁⲡⲁⲧⲏ	N	ⲁⲡⲁⲧⲏ
ⲁⲡⲁⲩⲥⲧⲱⲥ	ADV	ⲁⲡⲁⲩⲥⲧⲱⲥ
ⲁⲡⲉⲇⲉⲩⲧⲟⲥ	N	ⲁⲡⲉⲇⲉⲩⲧⲟⲥ
ⲁⲡⲉⲓⲗⲉ	V	ⲁⲡⲉⲓⲗⲉ
ⲁⲡⲉⲓⲗⲉⲓ	V	ⲁⲡⲉⲓⲗⲉⲓ
ⲁⲡⲉⲓⲗⲏ	N	ⲁⲡⲉⲓⲗⲏ
ⲁⲡⲉⲣⲁⲛⲧⲟⲛ	N	ⲁⲡⲉⲣⲁⲛⲧⲟⲛ
ⲁⲡⲉⲣⲁⲛⲧⲟⲥ	N	ⲁⲡⲉⲣⲁⲛⲧⲟⲥ
ⲁⲡⲉⲭⲉ	V	ⲁⲡⲉⲭⲉ
ⲁⲡⲓⲥⲧⲉⲓ	V	ⲁⲡⲓⲥⲧⲉⲓ
ⲁⲡⲓⲥⲧⲓⲁ	N	ⲁⲡⲓⲥⲧⲓⲁ
ⲁⲡⲓⲥⲧⲟⲛ	N	ⲁⲡⲓⲥⲧⲟⲛ
ⲁⲡⲓⲥⲧⲟⲥ	N	ⲁⲡⲓⲥⲧⲟⲥ
ⲁⲡⲟϩⲣⲏⲧⲟⲥ	N	ⲁⲡⲟϩⲣⲏⲧⲟⲥ
ⲁⲡⲟⲅⲣⲁⲫⲏ	N	ⲁⲡⲟⲅⲣⲁⲫⲏ
ⲁⲡⲟⲇⲉⲓⲝⲓⲥ	N	ⲁⲡⲟⲇⲉⲓⲝⲓⲥ
ⲁⲡⲟⲇⲏⲙⲉⲓ	V	ⲁⲡⲟⲇⲏⲙⲉⲓ
ⲁⲡⲟⲇⲏⲙⲓⲁ	N	ⲁⲡⲟⲇⲏⲙⲓⲁ
ⲁⲡⲟⲇⲓⲕⲛⲩⲉ	V	ⲁⲡⲟⲇⲓⲕⲛⲩⲉ
ⲁⲡⲟⲇⲓⲝⲓⲥ	N	ⲁⲡⲟⲇⲓⲝⲓⲥ
ⲁⲡⲟⲑⲏⲕⲏ	N	ⲁⲡⲟⲑⲏⲕⲏ
ⲁⲡⲟⲕⲁⲑⲓⲥⲧⲁ	V	ⲁⲡⲟⲕⲁⲑⲓⲥⲧⲁ
ⲁⲡⲟⲕⲁⲗⲩⲯⲓⲥ	N	ⲁⲡⲟⲕⲁⲗⲩⲯⲓⲥ
ⲁⲡⲟⲕⲁⲧⲁⲥⲧⲁⲥⲓⲥ	N	ⲁⲡⲟⲕⲁⲧⲁⲥⲧⲁⲥⲓⲥ
ⲁⲡⲟⲕⲗⲏⲣⲟⲥ	N	ⲁⲡⲟⲕⲗⲏⲣⲟⲥ
ⲁⲡⲟⲕⲣⲓⲥⲓⲥ	N	ⲁⲡⲟⲕⲣⲓⲥⲓⲥ
ⲁⲡⲟⲕⲣⲓⲧⲏⲥ	N	ⲁⲡⲟⲕⲣⲓⲧⲏⲥ
ⲁⲡⲟⲕⲣⲩⲫⲟⲛ	N	ⲁⲡⲟⲕⲣⲩⲫⲟⲛ
ⲁⲡⲟⲗⲁⲩⲉ	V	ⲁⲡⲟⲗⲁⲩⲉ
ⲁⲡⲟⲗⲁⲩⲥⲓⲥ	N	ⲁⲡⲟⲗⲁⲩⲥⲓⲥ
ⲁⲡⲟⲗⲗⲟⲛ	NPROP	ⲁⲡⲟⲗⲗⲟⲛ
ⲁⲡⲟⲗⲗⲱ	NPROP	ⲁⲡⲟⲗⲗⲱ
ⲁⲡⲟⲗⲗⲱⲛ	NPROP	ⲁⲡⲟⲗⲗⲱⲛ
ⲁⲡⲟⲗⲟⲅⲓⲁ	N	ⲁⲡⲟⲗⲟⲅⲓⲁ
ⲁⲡⲟⲗⲟⲅⲓⲍⲉ	V	ⲁⲡⲟⲗⲟⲅⲓⲍⲉ
ⲁⲡⲟⲗⲩ	V	ⲁⲡⲟⲗⲩ
ⲁⲡⲟⲛⲉⲁ	N	ⲁⲡⲟⲛⲉⲁ
ⲁⲡⲟⲛⲟⲓⲁ	N	ⲁⲡⲟⲛⲟⲓⲁ
ⲁⲡⲟⲣⲉⲓ	V	ⲁⲡⲟⲣⲉⲓ
ⲁⲡⲟⲣⲓ	V	ⲁⲡⲟⲣⲓ
ⲁⲡⲟⲣⲣⲟⲓⲁ	N	ⲁⲡⲟⲣⲣⲟⲓⲁ
ⲁⲡⲟⲥⲕⲉⲩⲏ	N	ⲁⲡⲟⲥⲕⲉⲩⲏ
ⲁⲡⲟⲥⲧⲁⲗⲙⲉⲛⲟⲥ	V	ⲁⲡⲟⲥⲧⲁⲗⲙⲉⲛⲟⲥ
ⲁⲡⲟⲥⲧⲁⲥⲥⲉ	V	ⲁⲡⲟⲥⲧⲁⲥⲥⲉ
ⲁⲡⲟⲥⲧⲁⲧⲏⲥ	N	ⲁⲡⲟⲥⲧⲁⲧⲏⲥ
ⲁⲡⲟⲥⲧⲉⲣⲓ	V	ⲁⲡⲟⲥⲧⲉⲣⲓ
ⲁⲡⲟⲥⲧⲏⲑⲓⲍⲉ	V	ⲁⲡⲟⲥⲧⲏⲑⲓⲍⲉ
ⲁⲡⲟⲥⲧⲟⲗⲏ	N	ⲁⲡⲟⲥⲧⲟⲗⲏ
ⲁⲡⲟⲥⲧⲟⲗⲓⲕⲏ	N	ⲁⲡⲟⲥⲧⲟⲗⲓⲕⲏ
ⲁⲡⲟⲥⲧⲟⲗⲓⲕⲟⲛ	N	ⲁⲡⲟⲥⲧⲟⲗⲓⲕⲟⲛ
ⲁⲡⲟⲥⲧⲟⲗⲟⲥ	N	ⲁⲡⲟⲥⲧⲟⲗⲟⲥ
ⲁⲡⲟⲥⲩⲛⲁⲅⲱⲅⲟⲥ	N	ⲁⲡⲟⲥⲩⲛⲁⲅⲱⲅⲟⲥ
ⲁⲡⲟⲧⲁⲅⲏ	N	ⲁⲡⲟⲧⲁⲅⲏ
ⲁⲡⲟⲧⲁⲥⲥⲉ	V	ⲁⲡⲟⲧⲁⲥⲥⲉ
ⲁⲡⲟⲧⲉⲗⲉⲥⲙⲁ	N	ⲁⲡⲟⲧⲉⲗⲉⲥⲙⲁ
ⲁⲡⲟⲩⲥ	N	ⲁⲡⲟⲩⲥ
ⲁⲡⲟⲫⲁⲛⲉ	V	ⲁⲡⲟⲫⲁⲛⲉ
ⲁⲡⲟⲫⲁⲥⲓⲥ	N	ⲁⲡⲟⲫⲁⲥⲓⲥ
ⲁⲡⲟⲭⲁⲣⲓⲍⲉ	V	ⲁⲡⲟⲭⲁⲣⲓⲍⲉ
ⲁⲡⲟⲭⲏ	N	ⲁⲡⲟⲭⲏ
ⲁⲡⲣⲁⲕⲧⲟⲥ	N	ⲁⲡⲣⲁⲕⲧⲟⲥ
ⲁⲣⲁ	N	ⲁⲣⲁ
ⲁⲣⲁⲃⲟⲥ	N	ⲁⲣⲁⲃⲟⲥ
ⲁⲣⲁⲙ	NPROP	ⲁⲣⲁⲙ
ⲁⲣⲁⲣⲓⲙ	N	ⲁⲣⲓⲙ
ⲁⲣⲁⲥⲑⲉ	V	ⲁⲣⲁⲥⲑⲉ
ⲁⲣⲃⲟⲧ	N	ⲁⲣⲃⲟⲧ
ⲁⲣⲃⲱⲧ	N	ⲁⲣⲃⲟⲧ
ⲁⲣⲅⲟⲛ	N	ⲁⲣⲅⲟⲛ
ⲁⲣⲅⲟⲥ	N	ⲁⲣⲅⲟⲥ
ⲁⲣⲉ	CFOC	ⲁⲣⲉ
ⲁⲣⲉϣⲁⲛ	ACOND	ⲁⲣⲉϣⲁⲛ
ⲁⲣⲉϩ	V	ⲁⲣⲉϩ
ⲁⲣⲉⲥⲕⲉ	V	ⲁⲣⲉⲥⲕⲉ
ⲁⲣⲉⲧⲉⲛϣⲁⲛ	ACOND_PPERS	ⲁⲣⲉϣⲁⲛ_ⲛⲑⲱⲧⲉⲛ
ⲁⲣⲉⲧⲏ	N	ⲁⲣⲉⲧⲏ
ⲁⲣⲏⲃ	N	ⲁⲣⲏⲃ
ⲁⲣⲏⲟⲩ	ADV	ⲁⲣⲏⲟⲩ
ⲁⲣⲏⲟⲩ	N	ⲉⲣⲏⲟⲩ
ⲁⲣⲓ	VIMP	ⲓⲣⲓ
ⲁⲣⲓⲏⲗ	NPROP	ⲁⲣⲓⲏⲗ
ⲁⲣⲓⲑⲙⲓⲁ	N	ⲁⲣⲓⲑⲙⲓⲁ
ⲁⲣⲓⲑⲙⲓⲟⲛ	N	ⲁⲣⲓⲑⲙⲓⲟⲛ
ⲁⲣⲓⲑⲙⲟⲥ	N	ⲁⲣⲓⲑⲙⲟⲥ
ⲁⲣⲓⲕⲓ	N	ⲁⲣⲓⲕⲓ
ⲁⲣⲓⲙ	N	ⲁⲣⲓⲙ
ⲁⲣⲓⲙⲁⲑⲁⲓⲟⲥ	NPROP	ⲁⲣⲓⲙⲁⲑⲁⲓⲟⲥ
ⲁⲣⲓⲟⲩⲓ	VSTAT	ⲓⲣⲓ
ⲁⲣⲓⲥⲧⲁ	V	ⲁⲣⲓⲥⲧⲁ
ⲁⲣⲓⲥⲧⲟⲛ	N	ⲁⲣⲓⲥⲧⲟⲛ
ⲁⲣⲕⲁⲇⲓⲟⲥ	NPROP	ⲁⲣⲕⲁⲇⲓⲟⲥ
ⲁⲣⲕⲉⲩⲑⲟⲥ	N	ⲁⲣⲕⲉⲩⲑⲟⲥ
ⲁⲣⲕⲟⲥ	N	ⲁⲣⲕⲟⲥ
ⲁⲣⲕⲧⲟⲥ	N	ⲁⲣⲕⲧⲟⲥ
ⲁⲣⲛⲁ	V	ⲁⲣⲛⲁ
ⲁⲣⲛⲏⲥⲓⲥ	N	ⲁⲣⲛⲏⲥⲓⲥ
ⲁⲣⲛⲓⲥⲑⲉ	V	ⲁⲣⲛⲓⲥⲑⲉ
ⲁⲣⲝ	N	ⲁⲣⲝ
ⲁⲣⲣⲏⲧⲟⲛ	N	ⲁⲣⲣⲏⲧⲟⲛ
ⲁⲣⲣⲏⲧⲟⲥ	N	ⲁⲣⲣⲏⲧⲟⲥ
ⲁⲣⲥⲉⲛⲓⲟⲥ	NPROP	ⲁⲣⲥⲉⲛⲓⲟⲥ
ⲁⲣⲥⲉⲛⲟⲅⲉⲛⲓⲁ	N	ⲁⲣⲥⲉⲛⲟⲅⲉⲛⲓⲁ
ⲁⲣⲥⲓⲛⲓⲕⲟⲛ	N	ⲁⲣⲥⲓⲛⲓⲕⲟⲛ
ⲁⲣⲧⲉⲙⲓⲥ	NPROP	ⲁⲣⲧⲉⲙⲓⲥ
ⲁⲣⲧⲏⲣⲓⲁ	N	ⲁⲣⲧⲏⲣⲓⲁ
ⲁⲣⲧⲩⲙⲓⲥ	N	ⲁⲣⲧⲩⲙⲓⲥ
ⲁⲣⲭⲁⲅⲅⲉⲗⲓⲕⲏ	N	ⲁⲣⲭⲁⲅⲅⲉⲗⲓⲕⲏ
ⲁⲣⲭⲁⲅⲅⲉⲗⲟⲥ	N	ⲁⲣⲭⲁⲅⲅⲉⲗⲟⲥ
ⲁⲣⲭⲁⲓⲟⲛ	N	ⲁⲣⲭⲁⲓⲟⲛ
ⲁⲣⲭⲁⲓⲟⲥ	N	ⲁⲣⲭⲁⲓⲟⲥ
ⲁⲣⲭⲉⲓ	V	ⲁⲣⲭⲉⲓ
ⲁⲣⲭⲉⲟⲥ	N	ⲁⲣⲭⲉⲟⲥ
ⲁⲣⲭⲉⲥⲑⲁⲓ	V	ⲁⲣⲭⲉⲥⲑⲁⲓ
ⲁⲣⲭⲏ	N	ⲁⲣⲭⲏ
ⲁⲣⲭⲏⲅⲟⲥ	N	ⲁⲣⲭⲏⲅⲟⲥ
ⲁⲣⲭⲏⲇⲓⲁⲕⲟⲛⲟⲥ	N	ⲁⲣⲭⲏⲇⲓⲁⲕⲟⲛⲟⲥ
ⲁⲣⲭⲏⲇⲓⲁⲕⲱⲛ	N	ⲁⲣⲭⲏⲇⲓⲁⲕⲱⲛ
ⲁⲣⲭⲏⲉⲡⲓⲥⲕⲟⲡⲟⲥ	N	ⲁⲣⲭⲏⲉⲡⲓⲥⲕⲟⲡⲟⲥ
ⲁⲣⲭⲏⲑⲗⲓⲧⲏⲥ	N	ⲁⲣⲭⲏⲑⲗⲓⲧⲏⲥ
ⲁⲣⲭⲏⲕⲣⲓⲧⲏⲥ	N	ⲁⲣⲭⲏⲕⲣⲓⲧⲏⲥ
ⲁⲣⲭⲏⲗⲏⲥⲧⲏⲥ	N	ⲁⲣⲭⲏⲗⲏⲥⲧⲏⲥ
ⲁⲣⲭⲏⲡⲗⲁⲥⲙⲁ	N	ⲁⲣⲭⲏⲡⲗⲁⲥⲙⲁ
ⲁⲣⲭⲏⲡⲣⲉⲥⲃⲩⲧⲉⲣⲟⲥ	N	ⲁⲣⲭⲏⲡⲣⲉⲥⲃⲩⲧⲉⲣⲟⲥ
ⲁⲣⲭⲏⲡⲣⲟⲫⲏⲧⲏⲥ	N	ⲁⲣⲭⲏⲡⲣⲟⲫⲏⲧⲏⲥ
ⲁⲣⲭⲏⲥⲧⲣⲁⲧⲩⲗⲁⲧⲏⲥ	N	ⲁⲣⲭⲏⲥⲧⲣⲁⲧⲩⲗⲁⲧⲏⲥ
ⲁⲣⲭⲏⲥⲩⲛⲁⲅⲱⲅⲟⲥ	N	ⲁⲣⲭⲏⲥⲩⲛⲁⲅⲱⲅⲟⲥ
ⲁⲣⲭⲓ	V	ⲁⲣⲭⲉⲓ
ⲁⲣⲭⲓⲅⲉⲛⲉⲧⲱⲣ	N	ⲁⲣⲭⲓⲅⲉⲛⲉⲧⲱⲣ
ⲁⲣⲭⲓⲅⲉⲛⲛⲏⲧⲱⲣ	N	ⲁⲣⲭⲓⲅⲉⲛⲛⲏⲧⲱⲣ
ⲁⲣⲭⲓⲇⲓⲁⲕⲟⲛⲟⲥ	N	ⲁⲣⲭⲓⲇⲓⲁⲕⲟⲛⲟⲥ
ⲁⲣⲭⲓⲉⲡⲓⲥⲕⲟⲡⲟⲥ	N	ⲁⲣⲭⲓⲉⲡⲓⲥⲕⲟⲡⲟⲥ
ⲁⲣⲭⲓⲉⲣⲉⲩⲥ	N	ⲁⲣⲭⲓⲉⲣⲉⲩⲥ
ⲁⲣⲭⲓⲙⲁⲅⲉⲣⲟⲥ	N	ⲁⲣⲭⲓⲙⲁⲅⲉⲣⲟⲥ
ⲁⲣⲭⲓⲙⲁⲛⲇⲣⲓⲧⲏⲥ	N	ⲁⲣⲭⲓⲙⲁⲛⲇⲣⲓⲧⲏⲥ
ⲁⲣⲭⲓⲥⲑⲁⲓ	V	ⲁⲣⲭⲓⲥⲑⲁⲓ
ⲁⲣⲭⲓⲥⲧⲣⲁⲧⲉⲩⲙⲁ	N	ⲁⲣⲭⲓⲥⲧⲣⲁⲧⲉⲩⲙⲁ
ⲁⲣⲭⲓⲥⲧⲣⲁⲧⲏⲅⲟⲥ	N	ⲁⲣⲭⲓⲥⲧⲣⲁⲧⲏⲅⲟⲥ
ⲁⲣⲭⲓⲥⲩⲛⲁⲅⲱⲅⲟⲥ	N	ⲁⲣⲭⲓⲥⲩⲛⲁⲅⲱⲅⲟⲥ
ⲁⲣⲭⲓⲧⲉⲕⲧⲱⲛ	N	ⲁⲣⲭⲓⲧⲉⲕⲧⲱⲛ
ⲁⲣⲭⲓⲧⲗⲕ	V	ⲁⲣⲭⲓⲧⲗⲕ
ⲁⲣⲭⲟⲛⲧⲓⲕⲏ	N	ⲁⲣⲭⲟⲛⲧⲓⲕⲏ
ⲁⲣⲭⲟⲛⲧⲓⲕⲟⲛ	N	ⲁⲣⲭⲟⲛⲧⲓⲕⲟⲛ
ⲁⲣⲭⲱⲛ	N	ⲁⲣⲭⲱⲛ
ⲁⲣⲱⲙⲁⲧⲁ	N	ⲁⲣⲱⲙⲁⲧⲁ
ⲁⲣⲱⲟⲩⲓ	N	ⲣⲱⲟⲩⲓ
ⲁⲥϣⲁⲛ	ACOND_PPERS	ⲁⲣⲉϣⲁⲛ_ⲛⲑⲟⲥ
ⲁⲥⲁϥ	N	ⲁⲥⲁϥ
ⲁⲥⲁⲗⲉⲩⲧⲟⲥ	N	ⲁⲥⲁⲗⲉⲩⲧⲟⲥ
ⲁⲥⲉⲃⲏⲥ	N	ⲁⲥⲉⲃⲏⲥ
ⲁⲥⲏⲙⲁⲛⲧⲟⲥ	N	ⲁⲥⲏⲙⲁⲛⲧⲟⲥ
ⲁⲥⲏⲙⲓⲟⲥ	N	ⲁⲥⲏⲙⲓⲟⲥ
ⲁⲥⲑⲉⲛⲉⲓⲁ	N	ⲁⲥⲑⲉⲛⲉⲓⲁ
ⲁⲥⲑⲉⲛⲏⲥ	N	ⲁⲥⲑⲉⲛⲏⲥ
ⲁⲥⲓⲁ	NPROP	ⲁⲥⲓⲁ
ⲁⲥⲓⲁⲓ	V	ⲁⲥⲓⲁⲓ
ⲁⲥⲓⲱⲟⲩ	VSTAT	ⲁⲥⲓⲁⲓ
ⲁⲥⲕⲉⲓ	V	ⲁⲥⲕⲉⲓ
ⲁⲥⲕⲏⲥⲓⲥ	N	ⲁⲥⲕⲏⲥⲓⲥ
ⲁⲥⲕⲏⲧⲏⲥ	N	ⲁⲥⲕⲏⲧⲏⲥ
ⲁⲥⲕⲏⲧⲓⲕⲟⲛ	N	ⲁⲥⲕⲏⲧⲓⲕⲟⲛ
ⲁⲥⲕⲟⲥ	N	ⲁⲥⲕⲟⲥ
ⲁⲥⲟ	N	ⲁⲥⲟ
ⲁⲥⲟϥⲡⲉⲣ	N	ⲁⲥⲟϥⲡⲉⲣ
ⲁⲥⲟⲩⲓ	N	ⲁⲥⲟⲩⲓ
ⲁⲥⲟⲩⲗⲓ	N	ⲁⲥⲟⲩⲗⲓ
ⲁⲥⲡⲁⲍⲉ	V	ⲁⲥⲡⲁⲍⲉ
ⲁⲥⲡⲁⲗⲁⲑⲟⲥ	N	ⲁⲥⲡⲁⲗⲁⲑⲟⲥ
ⲁⲥⲡⲁⲥⲙⲟⲥ	N	ⲁⲥⲡⲁⲥⲙⲟⲥ
ⲁⲥⲡⲓ	N	ⲁⲥⲡⲓ
ⲁⲥⲥⲁⲣⲓⲟⲛ	N	ⲁⲥⲥⲁⲣⲓⲟⲛ
ⲁⲥⲥⲩⲣⲓⲟⲥ	N	ⲁⲥⲥⲩⲣⲓⲟⲥ
ⲁⲥⲧⲏⲣ	N	ⲁⲥⲧⲏⲣ
ⲁⲥⲧⲓⲟⲥ	N	ⲁⲥⲧⲓⲟⲥ
ⲁⲥⲩⲛⲑⲉⲧⲟⲛ	N	ⲁⲥⲩⲛⲑⲉⲧⲟⲛ
ⲁⲥⲫⲁⲗⲏⲥ	N	ⲁⲥⲫⲁⲗⲏⲥ
ⲁⲥⲫⲁⲗⲓⲁ	N	ⲁⲥⲫⲁⲗⲓⲁ
ⲁⲥⲫⲁⲗⲓⲍⲉ	V	ⲁⲥⲫⲁⲗⲓⲍⲉ
ⲁⲥⲫⲁⲗⲱⲥ	ADV	ⲁⲥⲫⲁⲗⲱⲥ
ⲁⲥⲫⲟⲩⲓ	N	ⲁⲥⲫⲟⲩⲓ
ⲁⲥⲭⲏⲙⲟⲛⲉⲓ	V	ⲁⲥⲭⲏⲙⲟⲛⲉⲓ
ⲁⲥⲭⲏⲙⲟⲥⲩⲛⲏ	N	ⲁⲥⲭⲏⲙⲟⲥⲩⲛⲏ
ⲁⲥⲱⲙⲁⲧⲟⲛ	N	ⲁⲥⲱⲙⲁⲧⲟⲛ
ⲁⲥⲱⲙⲁⲧⲟⲥ	N	ⲁⲥⲱⲙⲁⲧⲟⲥ
ⲁⲧϭⲛⲟⲩ	PREP	ⲁⲧϭⲛⲉ
ⲁⲧϭⲣⲏⲛ	N	ⲁϭⲣⲏⲛ
ⲁⲧⲁⲕⲧⲱⲥ	N	ⲁⲧⲁⲕⲧⲱⲥ
ⲁⲧⲁⲙⲁⲛⲇⲓⲛⲟⲛ	N	ⲁⲧⲁⲙⲁⲛⲇⲓⲛⲟⲛ
ⲁⲧⲁⲝⲓⲁ	N	ⲁⲧⲁⲝⲓⲁ
ⲁⲧⲉⲗⲏⲥ	N	ⲁⲧⲉⲗⲏⲥ
ⲁⲧⲓⲙⲓⲁ	N	ⲁⲧⲓⲙⲓⲁ
ⲁⲧⲓⲙⲟⲥ	N	ⲁⲧⲓⲙⲟⲥ
ⲁⲧⲕⲁⲥ	N	ⲁⲧⲕⲁⲥ
ⲁⲧⲣⲉⲡⲧⲟⲥ	N	ⲁⲧⲣⲉⲡⲧⲟⲥ
ⲁⲩϣⲁⲛ	ACOND_PPERS	ⲁⲣⲉϣⲁⲛ_ⲛⲑⲱⲟⲩ
ⲁⲩϫⲁⲗ	N	ⲁⲩϫⲁⲗ
ⲁⲩϫⲱⲗ	V	ϫⲱⲗ
ⲁⲩⲑⲁⲇⲏⲥ	N	ⲁⲩⲑⲁⲇⲏⲥ
ⲁⲩⲑⲁⲧⲏⲥ	N	ⲁⲩⲑⲁⲇⲏⲥ
ⲁⲩⲑⲁⲧⲏⲥ	N	ⲁⲩⲑⲁⲧⲏⲥ
ⲁⲩⲑⲉⲛⲧⲉⲓⲁ	N	ⲁⲩⲑⲉⲛⲧⲉⲓⲁ
ⲁⲩⲑⲉⲛⲧⲏⲥ	N	ⲁⲩⲑⲉⲛⲧⲏⲥ
ⲁⲩⲑⲉⲛⲧⲓⲕⲏ	N	ⲁⲩⲑⲉⲛⲧⲓⲕⲏ
ⲁⲩⲓⲥ	V	ⲁⲩⲓⲥ
ⲁⲩⲗⲏ	N	ⲁⲩⲗⲏ
ⲁⲩⲗⲏⲟⲩ	N	ⲁⲩⲗⲏⲟⲩ
ⲁⲩⲝⲁⲛⲉ	V	ⲁⲩⲝⲁⲛⲉ
ⲁⲩⲝⲓⲥⲓⲥ	N	ⲁⲩⲝⲓⲥⲓⲥ
ⲁⲩⲣⲏϫ	N	ⲁⲩⲣⲏϫ
ⲁⲩⲥⲟⲛ	N	ⲁⲃⲥⲱⲛ
ⲁⲩⲧⲟⲅⲉⲛⲏⲥ	N	ⲁⲩⲧⲟⲅⲉⲛⲏⲥ
ⲁⲩⲧⲟⲅⲉⲛⲏⲧⲟⲥ	N	ⲁⲩⲧⲟⲅⲉⲛⲏⲧⲟⲥ
ⲁⲩⲧⲟⲅⲉⲛⲛⲓⲟⲥ	N	ⲁⲩⲧⲟⲅⲉⲛⲛⲓⲟⲥ
ⲁⲩⲧⲟⲇⲟⲝⲁⲥⲧⲟⲥ	N	ⲁⲩⲧⲟⲇⲟⲝⲁⲥⲧⲟⲥ
ⲁⲩⲧⲟⲑⲉⲗⲏⲧⲟⲥ	N	ⲁⲩⲧⲟⲑⲉⲗⲏⲧⲟⲥ
ⲁⲩⲧⲟⲕⲣⲁⲧⲱⲣ	N	ⲁⲩⲧⲟⲕⲣⲁⲧⲱⲣ
ⲁⲩⲧⲟⲡⲁⲧⲱⲣ	N	ⲁⲩⲧⲟⲡⲁⲧⲱⲣ
ⲁⲩⲧⲟⲧⲉⲗⲏⲥ	N	ⲁⲩⲧⲟⲧⲉⲗⲏⲥ
ⲁⲩⲧⲟⲩ	N	ⲁⲩⲧⲟⲩ
ⲁⲩⲧⲟⲫⲩⲏⲥ	N	ⲁⲩⲧⲟⲫⲩⲏⲥ
ⲁⲩⲱⲛ	V	ⲟⲩⲱⲛ
ⲁⲫⲉ	N	ⲁⲫⲉ
ⲁⲫⲉⲇⲣⲱⲛ	N	ⲁⲫⲉⲇⲣⲱⲛ
ⲁⲫⲉⲗⲡⲓⲍⲉ	V	ⲁⲫⲉⲗⲡⲓⲍⲉ
ⲁⲫⲏⲟⲩⲓ	N	ⲁⲫⲉ
ⲁⲫⲏⲧ	N	ⲁⲫⲟⲧ
ⲁⲫⲑⲁⲣⲥⲓⲁ	N	ⲁⲫⲑⲁⲣⲥⲓⲁ
ⲁⲫⲑⲁⲣⲧⲟⲛ	N	ⲁⲫⲑⲁⲣⲧⲟⲛ
ⲁⲫⲑⲁⲣⲧⲟⲥ	N	ⲁⲫⲑⲁⲣⲧⲟⲥ
ⲁⲫⲑⲟⲛⲓⲁ	NPROP	ⲁⲫⲑⲟⲛⲓⲁ
ⲁⲫⲑⲟⲣⲟⲥ	N	ⲁⲫⲑⲟⲣⲟⲥ
ⲁⲫⲟⲣⲓⲥⲙⲟⲥ	N	ⲁⲫⲟⲣⲓⲥⲙⲟⲥ
ⲁⲫⲟⲣⲙⲏ	N	ⲁⲫⲟⲣⲙⲏ
ⲁⲫⲟⲧ	N	ⲁⲫⲟⲧ
ⲁⲫⲟⲩⲓ	N	ⲁϥ
ⲁⲫⲣⲏⲇⲱⲛⲓⲁ	N	ⲁⲫⲣⲏⲇⲱⲛⲓⲁ
ⲁⲫⲱⲣⲓⲥⲉ	V	ⲁⲫⲱⲣⲓⲥⲉ
ⲁⲫⲱⲧ	N	ⲉⲫⲱⲧ
ⲁⲫⲱⲫ	N	ⲁⲫⲱⲫ
ⲁⲭⲁⲁⲃ	NPROP	ⲁⲭⲁⲁⲃ
ⲁⲭⲁⲃ	NPROP	ⲁⲭⲁⲃ
ⲁⲭⲁⲓⲁ	NPROP	ⲁⲭⲁⲓⲁ
ⲁⲭⲁⲓⲕⲟⲥ	NPROP	ⲁⲭⲁⲓⲕⲟⲥ
ⲁⲭⲁⲧⲏⲥ	N	ⲁⲭⲁⲧⲏⲥ
ⲁⲭⲓ	N	ⲁϧⲓ
ⲁⲭⲓⲗⲗⲓⲟⲛ	N	ⲁⲭⲓⲗⲗⲓⲟⲛ
ⲁⲭⲱ	N	ⲁⲭⲱ
ⲁⲭⲱⲟⲩⲓ	N	ⲁⲭⲱ
ⲁⲭⲱⲣⲏⲧⲟⲥ	N	ⲁⲭⲱⲣⲏⲧⲟⲥ
ⲁⲯⲩⲭⲟⲛ	N	ⲁⲯⲩⲭⲟⲛ
ⲃⲁϣ	V	ⲃⲱϣ
ⲃⲁϣⲓ	N	ⲃⲁϣⲓ
ⲃⲁϣⲟⲣ	N	ⲃⲁϣⲟⲣ
ⲃⲁϣⲟⲩϣ	N	ⲃⲁϣⲟⲩϣ
ⲃⲁϣⲟⲩⲣ	N	ⲃⲁϣⲟⲩⲣ
ⲃⲁϩ	N	ⲟⲩⲁϩ
ⲃⲁϩ	V	ⲟⲩⲱϩ
ⲃⲁϩⲥⲓ	N	ⲃⲁϩⲥⲓ
ⲃⲁϫⲏⲛⲓ	N	ⲁⲃⲁϫⲏⲓⲛⲓ
ⲃⲁϫⲓ	V	ⲃⲁϫⲓ
ⲃⲁϫⲓⲏⲛⲓ	N	ⲁⲃⲁϫⲏⲓⲛⲓ
ⲃⲁϫⲓⲛⲓ	N	ⲁⲃⲁϫⲏⲓⲛⲓ
ⲃⲁⲉⲙⲡⲓ	N	ⲃⲁⲉⲙⲡⲓ
ⲃⲁⲑⲙⲟⲥ	N	ⲃⲁⲑⲙⲟⲥ
ⲃⲁⲑⲟⲛ	N	ⲃⲁⲑⲟⲛ
ⲃⲁⲑⲟⲥ	N	ⲃⲁⲑⲟⲥ
ⲃⲁⲓ	N	ⲃⲁⲓ
ⲃⲁⲕ	V	ⲃⲁⲕ
ⲃⲁⲕ	V	ⲃⲱⲕ
ⲃⲁⲕ	VSTAT	ⲃⲱⲕ
ⲃⲁⲕⲓ	N	ⲃⲁⲕⲓ
ⲃⲁⲕⲓ	V	ⲃⲁⲕⲓ
ⲃⲁⲕⲧⲏⲣⲓⲁ	N	ⲃⲁⲕⲧⲏⲣⲓⲁ
ⲃⲁⲗ	N	ⲃⲁⲗ
ⲃⲁⲗ	VSTAT	ⲃⲱⲗ
ⲃⲁⲗϩⲙⲱⲟⲩ	N	ⲃⲁⲗϩⲙⲱⲟⲩ
ⲃⲁⲗⲁⲧ	N	ⲃⲁⲗⲁⲧ
ⲃⲁⲗⲕⲟⲩ	N	ⲃⲁⲗⲕⲟⲩ
ⲃⲁⲗⲗⲁ	NPROP	ⲃⲁⲗⲗⲁ
ⲃⲁⲗⲗⲁⲧⲓⲟⲛ	N	ⲃⲁⲗⲗⲁⲧⲓⲟⲛ
ⲃⲁⲗⲙⲃⲁϩ	N	ⲃⲁⲗⲙⲃⲉϩ
ⲃⲁⲗⲙⲃⲉϩ	N	ⲃⲁⲗⲙⲃⲉϩ
ⲃⲁⲗⲡⲉⲙⲱⲟⲩⲓ	N	ⲃⲁⲗϩⲙⲱⲟⲩ
ⲃⲁⲡⲧⲓⲍⲉ	V	ⲃⲁⲡⲧⲓⲍⲉ
ⲃⲁⲡⲧⲓⲥⲙⲁ	N	ⲃⲁⲡⲧⲓⲥⲙⲁ
ⲃⲁⲡⲧⲓⲥⲙⲟⲥ	N	ⲃⲁⲡⲧⲓⲥⲙⲟⲥ
ⲃⲁⲡⲧⲓⲥⲧⲏⲥ	N	ⲃⲁⲡⲧⲓⲥⲧⲏⲥ
ⲃⲁⲣϣⲓⲛ	N	ⲃⲁⲣϣⲓⲛ
ⲃⲁⲣⲁⲃⲃⲁⲥ	NPROP	ⲃⲁⲣⲁⲃⲃⲁⲥ
ⲃⲁⲣⲁⲭⲓⲁⲥ	NPROP	ⲃⲁⲣⲁⲭⲓⲁⲥ
ⲃⲁⲣⲃⲁⲣⲟⲥ	N	ⲃⲁⲣⲃⲁⲣⲟⲥ
ⲃⲁⲣⲉⲓ	V	ⲃⲁⲣⲉⲓ
ⲃⲁⲣⲉⲓⲥⲑⲁⲓ	V	ⲃⲁⲣⲉⲓⲥⲑⲁⲓ
ⲃⲁⲣⲏⲓⲧ	N	ⲃⲁⲣⲏⲓⲧ
ⲃⲁⲣⲑⲟⲗⲟⲙⲁⲓⲟⲥ	NPROP	ⲃⲁⲣⲑⲟⲗⲟⲙⲁⲓⲟⲥ
ⲃⲁⲣⲑⲟⲗⲟⲙⲉⲟⲥ	NPROP	ⲃⲁⲣⲑⲟⲗⲟⲙⲉⲟⲥ
ⲃⲁⲣⲟϩ	N	ⲃⲁⲣⲟϩ
ⲃⲁⲣⲟⲥ	N	ⲃⲁⲣⲟⲥ
ⲃⲁⲣⲟⲧ	N	ⲃⲁⲣⲱⲧ
ⲃⲁⲣⲧⲓⲙⲁⲓⲟⲥ	NPROP	ⲃⲁⲣⲧⲓⲙⲁⲓⲟⲥ
ⲃⲁⲣⲱⲧ	N	ⲃⲁⲣⲱⲧ
ⲃⲁⲥ	V	ⲟⲩⲓⲥⲓ
ⲃⲁⲥⲁⲛⲓⲍⲉ	V	ⲃⲁⲥⲁⲛⲓⲍⲉ
ⲃⲁⲥⲁⲛⲓⲥⲧⲏⲣⲓⲟⲛ	N	ⲃⲁⲥⲁⲛⲓⲥⲧⲏⲣⲓⲟⲛ
ⲃⲁⲥⲁⲛⲓⲥⲧⲏⲥ	N	ⲃⲁⲥⲁⲛⲓⲥⲧⲏⲥ
ⲃⲁⲥⲁⲛⲟⲥ	N	ⲃⲁⲥⲁⲛⲟⲥ
ⲃⲁⲥⲓⲗⲉⲓⲧⲏⲥ	NPROP	ⲃⲁⲥⲓⲗⲉⲓⲧⲏⲥ
ⲃⲁⲥⲓⲗⲓⲕⲟⲛ	N	ⲃⲁⲥⲓⲗⲓⲕⲟⲛ
ⲃⲁⲥⲓⲗⲓⲕⲟⲥ	N	ⲃⲁⲥⲓⲗⲓⲕⲟⲥ
ⲃⲁⲥⲓⲙⲟⲥ	NPROP	ⲃⲁⲥⲓⲙⲟⲥ
ⲃⲁⲥⲓⲥ	N	ⲃⲁⲥⲓⲥ
ⲃⲁⲥⲕⲁⲛⲟⲥ	N	ⲃⲁⲥⲕⲁⲛⲟⲥ
ⲃⲁⲥⲛⲏⲧ	N	ⲃⲉⲥⲛⲏⲧ
ⲃⲁⲥⲟⲩⲣ	N	ⲃⲁⲥⲟⲩⲣ
ⲃⲁⲥⲧ	V	ⲃⲱⲥⲧ
ⲃⲁⲥⲧⲉⲣⲛⲁ	N	ⲃⲁⲥⲧⲉⲣⲛⲁ
ⲃⲁⲧⲁⲛⲉ	N	ⲃⲁⲧⲁⲛⲉ
ⲃⲁⲧⲟⲥ	N	ⲃⲁⲧⲟⲥ
ⲃⲁⲧⲧⲁⲗⲟⲅⲓ	V	ⲃⲁⲧⲧⲁⲗⲟⲅⲓ
ⲃⲁⲧⲧⲟⲗⲟⲅⲓⲁ	N	ⲃⲁⲧⲧⲟⲗⲟⲅⲓⲁ
ⲃⲁⲩ	N	ⲃⲁⲓ
ⲃⲁⲩⲕⲁⲗⲓⲟⲛ	N	ⲃⲁⲩⲕⲁⲗⲓⲟⲛ
ⲃⲇⲉⲗⲗⲏ	N	ⲃⲇⲉⲗⲗⲏ
ⲃⲉϣ	N	ⲃⲉϣ
ⲃⲉϩⲃⲉϩ	N	ⲃⲉϩⲃⲉϩ
ⲃⲉϩⲓ	N	ⲃⲉϩⲓ
ⲃⲉϫⲃⲱϫ	V	ⲟⲩⲟϫⲟⲩⲉϫ
ⲃⲉϫⲏⲛ	N	ⲃⲉϭⲏⲛ
ⲃⲉϫⲓ	N	ⲃⲏϫ
ⲃⲉϭⲏⲛ	N	ⲃⲉϭⲏⲛ
ⲃⲉⲃⲁⲓⲟⲩ	V	ⲃⲉⲃⲁⲓⲟⲩ
ⲃⲉⲃⲓ	V	ⲃⲉⲃⲓ
ⲃⲉⲉⲗⲍⲉⲃⲟⲩⲗ	N	ⲃⲉⲉⲗⲍⲉⲃⲟⲩⲗ
ⲃⲉⲗ	V	ⲃⲱⲗ
ⲃⲉⲗϩⲱⲗ	N	ⲃⲉⲗϩⲱⲗ
ⲃⲉⲗϫ	N	ⲃⲉⲗϫ
ⲃⲉⲗⲍⲉⲃⲟⲩⲗ	NPROP	ⲃⲉⲗⲍⲉⲃⲟⲩⲗ
ⲃⲉⲗⲑⲱⲛ	N	ⲃⲉⲗⲑⲱⲛ
ⲃⲉⲗⲗⲉ	N	ⲃⲉⲗⲗⲉ
ⲃⲉⲗⲗⲉⲩ	N	ⲃⲉⲗⲗⲉ
ⲃⲉⲗⲗⲏ	N	ⲃⲉⲗⲗⲉ
ⲃⲉⲛϫⲓ	N	ⲃⲉⲛϫⲓ
ⲃⲉⲛⲓ	N	ⲃⲉⲛⲓ
ⲃⲉⲛⲓ	N	ⲃⲏⲛⲓ
ⲃⲉⲛⲓⲁⲙⲓⲛ	NPROP	ⲃⲉⲛⲓⲁⲙⲓⲛ
ⲃⲉⲛⲓⲡⲓ	N	ⲃⲉⲛⲓⲡⲓ
ⲃⲉⲛⲛⲏ	N	ⲃⲉⲛⲛⲏ
ⲃⲉⲣϣⲏⲟⲩ	N	ⲃⲉⲣϣⲏⲟⲩ
ⲃⲉⲣϣⲟ	N	ⲃⲉⲣϣⲟ
ⲃⲉⲣⲃⲉⲣ	V	ⲃⲉⲣⲃⲉⲣ
ⲃⲉⲣⲃⲉⲣ	V	ⲃⲟⲣⲃⲉⲣ
ⲃⲉⲣⲃⲓⲣ	N	ⲃⲉⲣⲃⲓⲣ
ⲃⲉⲣⲃⲱⲣ	V	ⲃⲟⲣⲃⲉⲣ
ⲃⲉⲣⲉϭⲱⲟⲩⲧⲥ	N	ⲃⲉⲣⲉϭⲱⲟⲩⲧⲥ
ⲃⲉⲣⲉⲧⲁⲣⲓⲟⲥ	N	ⲃⲉⲣⲉⲧⲁⲣⲓⲟⲥ
ⲃⲉⲣⲓ	N	ⲃⲉⲣⲓ
ⲃⲉⲣⲥⲓ	N	ⲃⲉⲣⲥⲓ
ⲃⲉⲣⲥⲓϯ	N	ⲃⲉⲣⲥⲓϯ
ⲃⲉⲣⲧ	N	ⲟⲩⲉⲣⲧ
ⲃⲉⲥⲉ	N	ⲃⲉⲥⲉ
ⲃⲉⲥⲛⲏⲧ	N	ⲃⲉⲥⲛⲏⲧ
ⲃⲉⲧ	V	ⲃⲟϯ
ⲃⲉⲧⲃⲉⲧ	N	ⲃⲉⲧⲃⲉⲧ
ⲃⲉⲭⲉ	N	ⲃⲉⲭⲉ
ⲃⲉⲭⲏⲟⲩⲓ	N	ⲃⲉⲭⲉ
ⲃⲏ	N	ⲃⲏ
ⲃⲏϣ	N	ⲃⲉϣ
ⲃⲏϣ	VSTAT	ⲃⲱϣ
ⲃⲏϫ	N	ⲃⲏϫ
ⲃⲏⲃ	N	ⲃⲏⲃ
ⲃⲏⲇⲥⲁⲓⲇⲁⲛ	N	ⲃⲏⲇⲥⲁⲓⲇⲁⲛ
ⲃⲏⲇⲥⲁⲓⲇⲁⲛ	NPROP	ⲃⲏⲇⲥⲁⲓⲇⲁⲛ
ⲃⲏⲑⲥⲁⲓⲇⲁ	NPROP	ⲃⲏⲑⲥⲁⲓⲇⲁ
ⲃⲏⲕ	VSTAT	ⲃⲱⲕ
ⲃⲏⲗ	VSTAT	ⲃⲱⲗ
ⲃⲏⲙⲁ	N	ⲃⲏⲙⲁ
ⲃⲏⲛⲓ	N	ⲃⲏⲛⲓ
ⲃⲏⲣ	PINT	ⲟⲩⲏⲣ
ⲃⲏⲧ	N	ⲃⲏⲧ
ⲃⲏⲧ	VSTAT	ⲃⲟϯ
ⲃⲏⲧⲫⲁⲅⲏ	NPROP	ⲃⲏⲧⲫⲁⲅⲏ
ⲃⲓϫ	N	ⲃⲓϫ
ⲃⲓϫⲓ	V	ⲃⲓϫⲓ
ⲃⲓϯ	V	ⲃⲓϯ
ⲃⲓⲁ	N	ⲃⲓⲁ
ⲃⲓⲁⲍⲉ	V	ⲃⲓⲁⲍⲉ
ⲃⲓⲃⲗⲓⲟⲑⲩⲕⲏ	N	ⲃⲓⲃⲗⲓⲟⲑⲩⲕⲏ
ⲃⲓⲃⲗⲟⲥ	N	ⲃⲓⲃⲗⲟⲥ
ⲃⲓⲏⲭⲓ	N	ⲃⲓⲏⲭⲓ
ⲃⲓⲕⲁⲣⲓⲟⲥ	N	ⲃⲓⲕⲁⲣⲓⲟⲥ
ⲃⲓⲕⲓ	N	ⲃⲓⲕⲓ
ⲃⲓⲕⲧⲱⲣ	NPROP	ⲃⲓⲕⲧⲱⲣ
ⲃⲓⲛⲁϫ	N	ⲃⲓⲛⲁϫ
ⲃⲓⲛⲓ	N	ⲃⲓⲛⲓ
ⲃⲓⲟⲥ	N	ⲃⲓⲟⲥ
ⲃⲓⲣ	N	ⲃⲓⲣ
ⲃⲓⲥⲓ	V	ⲟⲩⲓⲥⲓ
ⲃⲓⲱⲧⲓⲕⲟⲛ	N	ⲃⲓⲱⲧⲓⲕⲟⲛ
ⲃⲓⲱⲧⲓⲕⲟⲥ	N	ⲃⲓⲱⲧⲓⲕⲟⲥ
ⲃⲗⲁ	N	ⲃⲗⲁ
ⲃⲗⲁⲃⲏ	N	ⲃⲗⲁⲃⲏ
ⲃⲗⲁⲡⲧⲉⲓ	V	ⲃⲗⲁⲡⲧⲉⲓ
ⲃⲗⲁⲥⲫⲏⲙⲓⲁ	N	ⲃⲗⲁⲥⲫⲏⲙⲓⲁ
ⲃⲟϣⲃⲉϣ	V	ⲟⲩⲟϣⲟⲩⲉϣ
ⲃⲟϥ	N	ⲃⲟϥ
ⲃⲟϩ	N	ⲃⲱⲱϩ
ⲃⲟϩⲓ	N	ⲃⲟϩⲓ
ⲃⲟϩⲓ	N	ⲟⲩⲟϩⲓ
ⲃⲟϯ	N	ⲃⲱϯ
ⲃⲟϯ	V	ⲃⲟϯ
ⲃⲟⲁⲛⲏⲣⲅⲉⲥ	N	ⲃⲟⲁⲛⲏⲣⲅⲉⲥ
ⲃⲟⲁⲛⲏⲣⲅⲉⲥ	NPROP	ⲃⲟⲁⲛⲏⲣⲅⲉⲥ
ⲃⲟⲉⲥ	NPROP	ⲃⲟⲉⲥ
ⲃⲟⲏⲑⲉⲓ	N	ⲃⲟⲏⲑⲉⲓ
ⲃⲟⲏⲑⲉⲓ	V	ⲃⲟⲏⲑⲉⲓ
ⲃⲟⲏⲑⲉⲓⲁ	N	ⲃⲟⲏⲑⲉⲓⲁ
ⲃⲟⲏⲑⲓⲁ	N	ⲃⲟⲏⲑⲓⲁ
ⲃⲟⲏⲑⲟⲥ	N	ⲃⲟⲏⲑⲟⲥ
ⲃⲟⲓϣⲓ	N	ⲃⲟⲓϣⲓ
ⲃⲟⲕⲓ	V	ⲃⲟⲕⲓ
ⲃⲟⲗ	N	ⲃⲟⲗ
ⲃⲟⲗ	V	ⲃⲱⲗ
ⲃⲟⲗⲥ	VSTAT	ⲟⲩⲱⲗⲥ
ⲃⲟⲙⲱⲥ	N	ⲃⲟⲙⲱⲥ
ⲃⲟⲛϯ	N	ⲃⲟⲛϯ
ⲃⲟⲣⲃⲉⲣ	V	ⲃⲟⲣⲃⲉⲣ
ⲃⲟⲣⲃⲟⲣⲟⲥ	N	ⲃⲟⲣⲃⲟⲣⲟⲥ
ⲃⲟⲥⲉⲣ	N	ⲟⲩⲟⲥⲉⲣ
ⲃⲟⲧ	V	ⲃⲟϯ
ⲃⲟⲧ	V	ⲟⲩⲱϯ
ⲃⲟⲧⲁⲛⲏ	N	ⲃⲟⲧⲁⲛⲏ
ⲃⲟⲩϩⲓ	N	ⲃⲟⲩϩⲓ
ⲃⲟⲩⲗⲉⲩⲧⲏⲥ	N	ⲃⲟⲩⲗⲉⲩⲧⲏⲥ
ⲃⲟⲩⲗⲏⲥⲓⲥ	N	ⲃⲟⲩⲗⲏⲥⲓⲥ
ⲃⲟⲩⲛⲉⲩⲣⲟⲛ	N	ⲃⲟⲩⲛⲉⲩⲣⲟⲛ
ⲃⲟⲩⲛⲟⲥ	N	ⲃⲟⲩⲛⲟⲥ
ⲃⲣⲁⲃⲓⲟⲛ	N	ⲃⲣⲁⲃⲓⲟⲛ
ⲃⲣⲁⲓ	N	ⲃⲣⲁⲓ
ⲃⲣⲁⲭⲙⲁⲛⲏⲥ	N	ⲃⲣⲁⲭⲙⲁⲛⲏⲥ
ⲃⲣⲉϩⲓ	N	ⲉⲙⲣⲉϩⲓ
ⲃⲣⲉϩⲓ	N	ⲙⲃⲣⲉϩⲓ
ⲃⲣⲟⲛⲧⲏ	N	ⲃⲣⲟⲛⲧⲏ
ⲃⲣⲟⲩⲭⲟⲥ	N	ⲃⲣⲟⲩⲭⲟⲥ
ⲃⲩⲃⲓⲟⲛ	N	ⲃⲩⲃⲓⲟⲛ
ⲃⲩⲏⲕⲓ	N	ⲃⲓⲏⲭⲓ
ⲃⲩⲏⲭⲓ	N	ⲃⲓⲏⲭⲓ
ⲃⲩⲣⲣⲩⲗⲗⲟⲥ	N	ⲃⲩⲣⲣⲩⲗⲗⲟⲥ
ⲃⲭⲏⲓ	N	ⲃⲓⲏⲭⲓ
ⲃⲱ	N	ⲃⲱ
ⲃⲱϣ	N	ⲟⲩⲱϣ
ⲃⲱϣ	V	ⲃⲱϣ
ⲃⲱϩⲉⲙ	V	ⲟⲩⲱϩⲉⲙ
ⲃⲱϩⲛ	V	ⲃⲱϩⲛ
ⲃⲱϫ	V	ⲟⲩⲱϫ
ⲃⲱϯ	N	ⲃⲱϯ
ⲃⲱⲕ	N	ⲃⲱⲕ
ⲃⲱⲕ	V	ⲃⲱⲕ
ⲃⲱⲕⲓ	N	ⲃⲱⲕⲓ
ⲃⲱⲗ	V	ⲃⲱⲗ
ⲃⲱⲗⲟⲥ	N	ⲃⲱⲗⲟⲥ
ⲃⲱⲙⲟⲥ	N	ⲃⲱⲙⲟⲥ
ⲃⲱⲟⲩ	N	ⲃⲱⲟⲩ
ⲃⲱⲣⲡ	V	ⲟⲩⲱⲣⲡ
ⲃⲱⲥⲧ	V	ⲃⲱⲥⲧ
ⲃⲱⲱϩ	N	ⲃⲱⲱϩ
ⲅⲁⲃⲣⲓⲏⲗ	NPROP	ⲅⲁⲃⲣⲓⲏⲗ
ⲅⲁⲍⲁ	N	ⲅⲁⲍⲁ
ⲅⲁⲍⲟⲫⲩⲗⲁⲕⲓⲟⲛ	N	ⲅⲁⲍⲟⲫⲩⲗⲁⲕⲓⲟⲛ
ⲅⲁⲓⲟⲥ	NPROP	ⲅⲁⲓⲟⲥ
ⲅⲁⲗⲁⲕⲧⲓⲧⲏⲥ	N	ⲅⲁⲗⲁⲕⲧⲓⲧⲏⲥ
ⲅⲁⲗⲁⲧⲓⲁ	NPROP	ⲅⲁⲗⲁⲧⲓⲁ
ⲅⲁⲗⲓⲗⲁⲓⲁ	NPROP	ⲅⲁⲗⲓⲗⲁⲓⲁ
ⲅⲁⲗⲓⲗⲁⲓⲟⲥ	N	ⲅⲁⲗⲓⲗⲁⲓⲟⲥ
ⲅⲁⲗⲓⲗⲉⲁ	NPROP	ⲅⲁⲗⲓⲗⲉⲁ
ⲅⲁⲗⲗⲓⲕⲟⲥ	N	ⲅⲁⲗⲗⲓⲕⲟⲥ
ⲅⲁⲙⲟⲥ	N	ⲅⲁⲙⲟⲥ
ⲅⲁⲡⲁⲣⲓ	N	ⲅⲁⲡⲁⲣⲓ
ⲅⲁⲣ	PTC	ⲅⲁⲣ
ⲅⲉ	FM	ⲅⲉ
ⲅⲉ	PTC	ⲅⲉ
ⲅⲉϩⲉⲛⲛⲁ	N	ⲅⲉϩⲉⲛⲛⲁ
ⲅⲉϩⲉⲛⲛⲁ	NPROP	ⲅⲉϩⲉⲛⲛⲁ
ⲅⲉⲑⲑⲁⲓⲟⲥ	N	ⲅⲉⲑⲑⲁⲓⲟⲥ
ⲅⲉⲑⲥⲏⲙⲁⲛⲉⲓ	N	ⲅⲉⲑⲥⲏⲙⲁⲛⲉⲓ
ⲅⲉⲛⲉⲁ	N	ⲅⲉⲛⲉⲁ
ⲅⲉⲛⲉⲥⲓⲥ	N	ⲅⲉⲛⲉⲥⲓⲥ
ⲅⲉⲛⲏⲙⲁ	N	ⲅⲉⲛⲏⲙⲁ
ⲅⲉⲛⲏⲧⲟⲛ	N	ⲅⲉⲛⲏⲧⲟⲛ
ⲅⲉⲛⲓⲕⲟⲥ	N	ⲅⲉⲛⲓⲕⲟⲥ
ⲅⲉⲛⲛⲁⲓⲟⲥ	N	ⲅⲉⲛⲛⲁⲓⲟⲥ
ⲅⲉⲛⲛⲉⲁ	N	ⲅⲉⲛⲛⲉⲁ
ⲅⲉⲛⲛⲉⲟⲥ	N	ⲅⲉⲛⲛⲉⲟⲥ
ⲅⲉⲛⲛⲏⲥⲁⲣⲉⲧ	N	ⲅⲉⲛⲛⲏⲥⲁⲣⲉⲧ
ⲅⲉⲛⲟⲓⲧⲟ	V	ⲅⲉⲛⲟⲓⲧⲟ
ⲅⲉⲛⲟⲥ	N	ⲅⲉⲛⲟⲥ
ⲅⲉⲣⲁⲍⲏⲛⲟⲥ	N	ⲅⲉⲣⲁⲍⲏⲛⲟⲥ
ⲅⲉⲣⲁⲥⲏⲛⲟⲥ	N	ⲅⲉⲣⲁⲥⲏⲛⲟⲥ
ⲅⲉⲣⲅⲉⲥⲁⲓⲟⲥ	N	ⲅⲉⲣⲅⲉⲥⲁⲓⲟⲥ
ⲅⲉⲱⲙⲓⲧⲣⲏⲥ	N	ⲅⲉⲱⲙⲓⲧⲣⲏⲥ
ⲅⲉⲱⲣⲅⲟⲥ	N	ⲅⲉⲱⲣⲅⲟⲥ
ⲅⲓⲅⲁⲥ	N	ⲅⲓⲅⲁⲥ
ⲅⲗⲩⲡⲧⲟⲛ	N	ⲅⲗⲩⲡⲧⲟⲛ
ⲅⲗⲱⲥⲥⲟⲕⲟⲙⲟⲛ	N	ⲅⲗⲱⲥⲥⲟⲕⲟⲙⲟⲛ
ⲅⲛⲏⲥⲓⲟⲥ	N	ⲅⲛⲏⲥⲓⲟⲥ
ⲅⲛⲟⲫⲟⲥ	N	ⲅⲛⲟⲫⲟⲥ
ⲅⲛⲱⲙⲏ	N	ⲅⲛⲱⲙⲏ
ⲅⲛⲱⲥⲉⲱⲥ	N	ⲅⲛⲱⲥⲉⲱⲥ
ⲅⲛⲱⲥⲓⲥ	N	ⲅⲛⲱⲥⲓⲥ
ⲅⲟⲗⲅⲟⲑⲁ	NPROP	ⲅⲟⲗⲅⲟⲑⲁ
ⲅⲣⲁⲙⲙⲁ	N	ⲅⲣⲁⲙⲙⲁ
ⲅⲣⲁⲙⲙⲁⲧⲉⲩⲥ	N	ⲅⲣⲁⲙⲙⲁⲧⲉⲩⲥ
ⲅⲣⲁⲙⲙⲁⲧⲏⲫⲟⲣⲟⲥ	N	ⲅⲣⲁⲙⲙⲁⲧⲏⲫⲟⲣⲟⲥ
ⲅⲣⲁⲙⲙⲁⲧⲓⲕⲟⲥ	N	ⲅⲣⲁⲙⲙⲁⲧⲓⲕⲟⲥ
ⲅⲣⲁⲙⲡⲉ	N	ⲅⲣⲁⲙⲡⲉ
ⲅⲣⲁⲫⲉⲩⲥ	N	ⲅⲣⲁⲫⲉⲩⲥ
ⲅⲣⲁⲫⲏ	N	ⲅⲣⲁⲫⲏ
ⲅⲣⲁⲫⲟⲟⲩⲉ	N	ⲅⲣⲁⲫⲟⲟⲩⲉ
ⲅⲣⲏⲅⲟⲣⲓⲟⲥ	NPROP	ⲅⲣⲏⲅⲟⲣⲓⲟⲥ
ⲅⲣⲩⲡⲁⲍⲉ	V	ⲅⲣⲩⲡⲁⲍⲉ
ⲅⲩⲙⲛⲁⲍⲉ	V	ⲅⲩⲙⲛⲁⲍⲉ
ⲅⲩⲙⲛⲁⲥⲓⲁ	N	ⲅⲩⲙⲛⲁⲥⲓⲁ
ⲅⲱ	N	ⲁⲕⲱ
ⲇ	NUM	ⲇ
ⲇⲁⲑⲁⲛ	NPROP	ⲇⲁⲑⲁⲛ
ⲇⲁⲓⲙⲟⲛⲓⲍⲉ	V	ⲇⲁⲓⲙⲟⲛⲓⲍⲉ
ⲇⲁⲓⲙⲟⲛⲓⲟⲛ	N	ⲇⲁⲓⲙⲟⲛⲓⲟⲛ
ⲇⲁⲓⲙⲱⲛ	N	ⲇⲁⲓⲙⲱⲛ
ⲇⲁⲓⲙⲱⲛⲓⲟⲛ	N	ⲇⲁⲓⲙⲱⲛⲓⲟⲛ
ⲇⲁⲗⲙⲁⲛⲟⲩⲑⲁ	NPROP	ⲇⲁⲗⲙⲁⲛⲟⲩⲑⲁ
ⲇⲁⲛⲓⲏⲗ	NPROP	ⲇⲁⲛⲓⲏⲗ
ⲇⲁⲛⲓⲥⲧⲏⲥ	N	ⲇⲁⲛⲓⲥⲧⲏⲥ
ⲇⲁⲡⲁⲛⲏ	N	ⲇⲁⲡⲁⲛⲏ
ⲇⲁⲩⲉⲓⲇ	NPROP	ⲇⲁⲩⲉⲓⲇ
ⲇⲁⲩⲓⲇ	NPROP	ⲇⲁⲩⲓⲇ
ⲇⲉ	PTC	ⲇⲉ
ⲇⲉⲃⲃⲱⲣⲁ	NPROP	ⲇⲉⲃⲃⲱⲣⲁ
ⲇⲉⲓⲡⲛⲟⲛ	N	ⲇⲉⲓⲡⲛⲟⲛ
ⲇⲉⲓⲡⲛⲟⲛ	V	ⲇⲉⲓⲡⲛⲟⲛ
ⲇⲉⲕⲁⲛⲟⲥ	N	ⲇⲉⲕⲁⲛⲟⲥ
ⲇⲉⲕⲁⲡⲟⲗⲓⲥ	N	ⲇⲉⲕⲁⲡⲟⲗⲓⲥ
ⲇⲉⲕⲁⲥ	N	ⲇⲉⲕⲁⲥ
ⲇⲉⲙⲱⲛ	N	ⲇⲉⲙⲱⲛ
ⲇⲉⲥⲡⲟⲧⲉⲓⲁ	N	ⲇⲉⲥⲡⲟⲧⲉⲓⲁ
ⲇⲉⲥⲡⲟⲧⲏⲥ	N	ⲇⲉⲥⲡⲟⲧⲏⲥ
ⲇⲉⲥⲡⲱⲧⲁ	N	ⲇⲉⲥⲡⲱⲧⲁ
ⲇⲉⲩⲧⲉⲣⲁ	N	ⲇⲉⲩⲧⲉⲣⲁ
ⲇⲉⲩⲧⲉⲣⲁⲥ	FM	ⲇⲉⲩⲧⲉⲣⲁⲥ
ⲇⲉⲩⲧⲉⲣⲟⲛ	ADV	ⲇⲉⲩⲧⲉⲣⲟⲛ
ⲇⲏ	PTC	ⲇⲏ
ⲇⲏⲗⲟⲩ	V	ⲇⲏⲗⲟⲩ
ⲇⲏⲙⲏⲧⲣⲓⲟⲥ	NPROP	ⲇⲏⲙⲏⲧⲣⲓⲟⲥ
ⲇⲏⲙⲓⲟⲥ	N	ⲇⲏⲙⲓⲟⲥ
ⲇⲏⲙⲓⲟⲩⲣⲅⲟⲥ	N	ⲇⲏⲙⲓⲟⲩⲣⲅⲟⲥ
ⲇⲏⲙⲟⲥ	N	ⲇⲏⲙⲟⲥ
ⲇⲏⲙⲟⲥⲓⲁ	N	ⲇⲏⲙⲟⲥⲓⲁ
ⲇⲏⲙⲟⲥⲓⲟⲛ	N	ⲇⲏⲙⲟⲥⲓⲟⲛ
ⲇⲏⲛⲁⲣⲓⲟⲛ	N	ⲇⲏⲛⲁⲣⲓⲟⲛ
ⲇⲓⲁⲃⲁⲗⲗⲉ	V	ⲇⲓⲁⲃⲁⲗⲗⲉ
ⲇⲓⲁⲃⲟⲗⲏ	N	ⲇⲓⲁⲃⲟⲗⲏ
ⲇⲓⲁⲃⲟⲗⲓⲕⲟⲛ	N	ⲇⲓⲁⲃⲟⲗⲓⲕⲟⲛ
ⲇⲓⲁⲃⲟⲗⲟⲥ	N	ⲇⲓⲁⲃⲟⲗⲟⲥ
ⲇⲓⲁⲃⲟⲗⲟⲥ	NPROP	ⲇⲓⲁⲃⲟⲗⲟⲥ
ⲇⲓⲁⲅⲣⲁⲫⲟⲛ	N	ⲇⲓⲁⲅⲣⲁⲫⲟⲛ
ⲇⲓⲁⲅⲱⲅⲏ	N	ⲇⲓⲁⲅⲱⲅⲏ
ⲇⲓⲁⲑⲉⲥⲓⲥ	N	ⲇⲓⲁⲑⲉⲥⲓⲥ
ⲇⲓⲁⲑⲏⲕⲏ	N	ⲇⲓⲁⲑⲏⲕⲏ
ⲇⲓⲁⲓⲣⲉⲥⲓⲥ	N	ⲇⲓⲁⲓⲣⲉⲥⲓⲥ
ⲇⲓⲁⲕⲟⲛⲉⲓ	V	ⲇⲓⲁⲕⲟⲛⲉⲓ
ⲇⲓⲁⲕⲟⲛⲓ	V	ⲇⲓⲁⲕⲟⲛⲉⲓ
ⲇⲓⲁⲕⲟⲛⲓⲁ	N	ⲇⲓⲁⲕⲟⲛⲓⲁ
ⲇⲓⲁⲕⲟⲛⲟⲥ	N	ⲇⲓⲁⲕⲟⲛⲟⲥ
ⲇⲓⲁⲕⲣⲓⲛⲉ	V	ⲇⲓⲁⲕⲣⲓⲛⲉ
ⲇⲓⲁⲕⲣⲓⲥⲓⲥ	N	ⲇⲓⲁⲕⲣⲓⲥⲓⲥ
ⲇⲓⲁⲕⲱⲛ	N	ⲇⲓⲁⲕⲱⲛ
ⲇⲓⲁⲗⲟⲅⲟⲥ	N	ⲇⲓⲁⲗⲟⲅⲟⲥ
ⲇⲓⲁⲙⲟⲛⲏ	N	ⲇⲓⲁⲙⲟⲛⲏ
ⲇⲓⲁⲛⲟⲓⲁ	N	ⲇⲓⲁⲛⲟⲓⲁ
ⲇⲓⲁⲛⲟⲓⲥⲓⲥ	N	ⲇⲓⲁⲛⲟⲓⲥⲓⲥ
ⲇⲓⲁⲡⲉⲣⲁ	V	ⲇⲓⲁⲡⲉⲣⲁ
ⲇⲓⲁⲥⲡⲟⲣⲁ	N	ⲇⲓⲁⲥⲡⲟⲣⲁ
ⲇⲓⲁⲥⲧⲁⲗⲙⲟⲥ	N	ⲇⲓⲁⲥⲧⲁⲗⲙⲟⲥ
ⲇⲓⲁⲥⲧⲣⲟⲫⲏ	N	ⲇⲓⲁⲥⲧⲣⲟⲫⲏ
ⲇⲓⲁⲥⲱⲥⲟⲩ	V	ⲇⲓⲁⲥⲱⲥⲟⲩ
ⲇⲓⲁⲧⲁⲅⲏ	N	ⲇⲓⲁⲧⲁⲅⲏ
ⲇⲓⲁⲧⲁⲅⲙⲁ	N	ⲇⲓⲁⲧⲁⲅⲙⲁ
ⲇⲓⲁⲧⲁⲥⲥⲉ	V	ⲇⲓⲁⲧⲁⲥⲥⲉ
ⲇⲓⲁⲧⲉⲗⲉⲓ	V	ⲇⲓⲁⲧⲉⲗⲉⲓ
ⲇⲓⲁⲧⲟⲭⲟⲥ	N	ⲇⲓⲁⲧⲟⲭⲟⲥ
ⲇⲓⲁⲧⲣⲓⲃⲉ	V	ⲇⲓⲁⲧⲣⲓⲃⲉ
ⲇⲓⲁⲫⲟⲣⲁ	N	ⲇⲓⲁⲫⲟⲣⲁ
ⲇⲓⲁⲯⲁⲗⲙⲁ	N	ⲇⲓⲁⲯⲁⲗⲙⲁ
ⲇⲓⲇⲁⲥⲕⲁⲗⲓⲁ	N	ⲇⲓⲇⲁⲥⲕⲁⲗⲓⲁ
ⲇⲓⲇⲓⲡⲗⲁ	N	ⲇⲓⲇⲓⲡⲗⲁ
ⲇⲓⲇⲣⲁⲭⲙⲟⲛ	N	ⲇⲓⲇⲣⲁⲭⲙⲟⲛ
ⲇⲓⲏⲅⲏⲙⲁ	N	ⲇⲓⲏⲅⲏⲙⲁ
ⲇⲓⲏⲕⲏⲥⲓⲥ	N	ⲇⲓⲏⲕⲏⲥⲓⲥ
ⲇⲓⲕⲁⲍⲉ	V	ⲇⲓⲕⲁⲍⲉ
ⲇⲓⲕⲁⲓⲟⲗⲟⲅⲓⲁ	N	ⲇⲓⲕⲁⲓⲟⲗⲟⲅⲓⲁ
ⲇⲓⲕⲁⲓⲟⲛ	N	ⲇⲓⲕⲁⲓⲟⲛ
ⲇⲓⲕⲁⲓⲟⲥ	N	ⲇⲓⲕⲁⲓⲟⲥ
ⲇⲓⲕⲁⲓⲟⲥⲩⲛⲏ	N	ⲇⲓⲕⲁⲓⲟⲥⲩⲛⲏ
ⲇⲓⲕⲁⲓⲱⲙⲁ	N	ⲇⲓⲕⲁⲓⲱⲙⲁ
ⲇⲓⲕⲁⲓⲱⲥ	ADV	ⲇⲓⲕⲁⲓⲱⲥ
ⲇⲓⲕⲁⲥⲧⲏⲣⲓⲟⲛ	N	ⲇⲓⲕⲁⲥⲧⲏⲣⲓⲟⲛ
ⲇⲓⲕⲁⲥⲧⲏⲥ	N	ⲇⲓⲕⲁⲥⲧⲏⲥ
ⲇⲓⲕⲏ	N	ⲇⲓⲕⲏ
ⲇⲓⲙⲓⲟⲩⲣⲅⲓⲁ	N	ⲇⲓⲙⲓⲟⲩⲣⲅⲓⲁ
ⲇⲓⲙⲱⲣⲓⲧⲏⲥ	N	ⲇⲓⲙⲱⲣⲓⲧⲏⲥ
ⲇⲓⲛⲁ	N	ⲇⲓⲛⲁ
ⲇⲓⲟⲓⲕⲉⲓ	V	ⲇⲓⲟⲓⲕⲉⲓ
ⲇⲓⲟⲓⲕⲏ	V	ⲇⲓⲟⲓⲕⲏ
ⲇⲓⲟⲓⲕⲏⲥⲓⲥ	N	ⲇⲓⲟⲓⲕⲏⲥⲓⲥ
ⲇⲓⲟⲓⲕⲏⲧⲏⲥ	N	ⲇⲓⲟⲓⲕⲏⲧⲏⲥ
ⲇⲓⲟⲕⲗⲏϯⲁⲛⲟⲥ	NPROP	ⲇⲓⲟⲕⲗⲏϯⲁⲛⲟⲥ
ⲇⲓⲟⲕⲗⲏⲧⲓⲁⲛⲟⲥ	NPROP	ⲇⲓⲟⲕⲗⲏⲧⲓⲁⲛⲟⲥ
ⲇⲓⲟⲥⲙⲏ	N	ⲇⲓⲟⲥⲙⲏ
ⲇⲓⲡⲗⲁ	N	ⲇⲓⲡⲗⲁ
ⲇⲓⲡⲛⲟⲛ	N	ⲇⲓⲡⲛⲟⲛ
ⲇⲓⲥⲧⲁⲍⲉ	V	ⲇⲓⲥⲧⲁⲍⲉ
ⲇⲓⲥⲧⲓⲭⲟⲛ	N	ⲇⲓⲥⲧⲓⲭⲟⲛ
ⲇⲓⲧⲁⲥⲅⲁⲗⲟⲥ	N	ⲇⲓⲧⲁⲥⲅⲁⲗⲟⲥ
ⲇⲓⲱⲅⲙⲟⲥ	N	ⲇⲓⲱⲅⲙⲟⲥ
ⲇⲓⲱⲕⲉ	V	ⲇⲓⲱⲕⲉ
ⲇⲓⲱⲕⲉⲓ	V	ⲇⲓⲱⲕⲉⲓ
ⲇⲓⲱⲕⲧⲏⲥ	N	ⲇⲓⲱⲕⲧⲏⲥ
ⲇⲟϭⲓ	V	ⲇⲟϭⲓ
ⲇⲟϭⲓⲙⲁⲥⲧⲏⲥ	N	ⲇⲟϭⲓⲙⲁⲥⲧⲏⲥ
ⲇⲟⲅⲙⲁ	N	ⲇⲟⲅⲙⲁ
ⲇⲟⲅⲙⲁⲧⲓⲍⲉ	V	ⲇⲟⲅⲙⲁⲧⲓⲍⲉ
ⲇⲟⲕⲉⲓ	V	ⲇⲟⲕⲉⲓ
ⲇⲟⲕⲓⲙⲁⲍⲉ	V	ⲇⲟⲕⲓⲙⲁⲍⲉ
ⲇⲟⲕⲓⲙⲏ	N	ⲇⲟⲕⲓⲙⲏ
ⲇⲟⲕⲓⲙⲟⲛ	N	ⲇⲟⲕⲓⲙⲟⲛ
ⲇⲟⲕⲓⲙⲟⲥ	N	ⲇⲟⲕⲓⲙⲟⲥ
ⲇⲟⲗⲟⲥ	N	ⲇⲟⲗⲟⲥ
ⲇⲟⲝⲟⲅⲉⲛⲏⲥ	N	ⲇⲟⲝⲟⲅⲉⲛⲏⲥ
ⲇⲟⲝⲟⲅⲉⲛⲓⲁ	N	ⲇⲟⲝⲟⲅⲉⲛⲓⲁ
ⲇⲟⲝⲟⲕⲣⲁⲧⲓⲁ	N	ⲇⲟⲝⲟⲕⲣⲁⲧⲓⲁ
ⲇⲟⲝⲟⲕⲣⲁⲧⲱⲣ	N	ⲇⲟⲝⲟⲕⲣⲁⲧⲱⲣ
ⲇⲟⲝⲟⲗⲟⲅⲓⲁ	N	ⲇⲟⲝⲟⲗⲟⲅⲓⲁ
ⲇⲟⲝⲟⲛ	N	ⲇⲟⲝⲟⲛ
ⲇⲟⲝⲟⲫⲁⲛⲏⲥ	N	ⲇⲟⲝⲟⲫⲁⲛⲏⲥ
ⲇⲟⲝⲟⲫⲁⲛⲓⲁ	N	ⲇⲟⲝⲟⲫⲁⲛⲓⲁ
ⲇⲟⲣⲕⲁⲥ	N	ⲇⲟⲣⲕⲁⲥ
ⲇⲟⲩⲗⲟⲥ	NPROP	ⲇⲟⲩⲗⲟⲥ
ⲇⲟⲩⲝ	N	ⲇⲟⲩⲝ
ⲇⲣⲁⲕⲱⲛ	N	ⲇⲣⲁⲕⲱⲛ
ⲇⲣⲓⲙⲙⲁ	N	ⲇⲣⲓⲙⲙⲁ
ⲇⲣⲟⲙⲉⲩⲥ	N	ⲇⲣⲟⲙⲉⲩⲥ
ⲇⲣⲟⲙⲟⲥ	N	ⲇⲣⲟⲙⲟⲥ
ⲇⲣⲩⲙⲟⲥ	N	ⲇⲣⲩⲙⲟⲥ
ⲇⲩⲁⲥ	N	ⲇⲩⲁⲥ
ⲇⲩⲙⲟⲧⲏⲥ	N	ⲇⲩⲙⲟⲧⲏⲥ
ⲇⲩⲛⲁⲙⲓⲥ	N	ⲇⲩⲛⲁⲙⲓⲥ
ⲇⲩⲛⲁⲥⲧⲏⲥ	N	ⲇⲩⲛⲁⲥⲧⲏⲥ
ⲇⲩⲛⲁⲧⲟⲥ	N	ⲇⲩⲛⲁⲧⲟⲥ
ⲇⲩⲣⲁⲛⲛⲉⲩⲉ	V	ⲇⲩⲣⲁⲛⲛⲉⲩⲉ
ⲇⲩⲣⲁⲛⲛⲟⲥ	N	ⲇⲩⲣⲁⲛⲛⲟⲥ
ⲇⲩⲥⲕⲟⲗⲟⲛ	N	ⲇⲩⲥⲕⲟⲗⲟⲛ
ⲇⲱⲇⲉⲕⲁⲥ	N	ⲇⲱⲇⲉⲕⲁⲥ
ⲇⲱⲣⲉⲁ	N	ⲇⲱⲣⲉⲁ
ⲇⲱⲣⲉⲁⲥϯⲕⲟⲛ	N	ⲇⲱⲣⲉⲁⲥϯⲕⲟⲛ
ⲇⲱⲣⲓⲁ	N	ⲇⲱⲣⲓⲁ
ⲇⲱⲣⲓⲍⲉ	V	ⲇⲱⲣⲓⲍⲉ
ⲇⲱⲣⲟⲛ	N	ⲇⲱⲣⲟⲛ
ⲉ	CCIRC	ⲉⲣⲉ
ⲉ	PREP	ⲉ
ⲉ	PPERO	ⲛⲑⲟ
#ⲉϣ	V	ⲓϣⲓ
ⲉϣ	V	ⲱϣ
ⲉϣⲁⲩ	N	ⲉϣⲱ
ⲉϣⲟ	N	ⲉϣⲟ
ⲉϣⲟϯ	N	ϣⲱⲧ
ⲉϣⲟⲩ	N	ⲉϭⲟⲩ
ⲉϣⲱ	N	ⲉϣⲱ
ⲉϣⲱⲡ	CONJ	ⲉϣⲱⲡ
ⲉϣⲱⲧ	N	ϣⲱⲧ
ⲉϥ	V	ⲱϥⲓ
ⲉϥⲣⲁⲥⲟⲩ	N	ⲉϥⲣⲁⲥⲟⲩ
ⲉϧⲟⲩⲛ	ADV	ⲉϧⲟⲩⲛ
ⲉϧⲟⲩⲛ	N	ⲉϧⲟⲩⲛ
ⲉϧⲣⲏⲓ	ADV	ⲉϧⲣⲏⲓ
ⲉϩⲃⲏⲟⲩⲓ	N	ϩⲱⲃ
ⲉϩⲉ	N	ⲉϩⲉ
ⲉϩⲉⲟⲩ	N	ⲉϩⲉ
ⲉϩⲉⲩ	N	ⲉϩⲉ
ⲉϩⲉⲩ	N	ⲓⲱ
ⲉϩⲕⲟ	V	ϩⲕⲟ
ⲉϩⲗⲓ	N	ϩⲗⲓ
ⲉϩⲗⲟⲗ	N	ϩⲗⲟⲗ
ⲉϩⲙⲟⲧ	N	ϩⲙⲟⲧ
ⲉϩⲛⲁ	N	ⲉϩⲛⲉ
ⲉϩⲛⲉ	N	ⲉϩⲛⲉ
ⲉϩⲛⲉ	V	ⲉϩⲛⲉ
ⲉϩⲟⲟⲩ	N	ⲉϩⲟⲟⲩ
ⲉϩⲟⲧⲉ	PREP	ⲉϩⲟⲧⲉ
ⲉϩⲟⲧⲉⲣⲟ	PREP	ⲉϩⲟⲧⲉ
ⲉϩⲣⲁ	PREP	ⲉϩⲣⲉⲛ
ⲉϩⲣⲏⲓ	ADV	ⲉϩⲣⲏⲓ
ⲉϩⲣⲏⲣⲓ	N	ϩⲣⲏⲣⲓ
ⲉϩⲣⲟϣ	V	ϩⲣⲟϣ
ⲉϩⲣⲱ	N	ϩⲣⲱ
ⲉϩⲣⲱⲧ	N	ϩⲣⲱⲧ
ⲉϩⲧⲏ	N	ϩⲏⲧ
ⲉϩⲱⲟⲩ	N	ⲉϩⲉ
ⲉϫⲉⲛ	PREP	ⲉϫⲉⲛ
ⲉϫⲏⲟⲩ	N	ϫⲟⲓ
ⲉϫⲗⲟϫ	N	ϭⲗⲟϫ
ⲉϫⲟⲩ	N	ⲁϫⲱ
ⲉϫⲱ	N	ⲁϫⲱ
ⲉϫⲱ	PREP	ⲉϫⲉⲛ
ⲉϫⲱⲣϩ	N	ϫⲱⲣϩ
ⲉϭⲗⲟϫ	N	ϭⲗⲟϫ
ⲉϭⲟⲩ	N	ⲉϭⲟⲩ
ⲉⲁⲧ	N	ⲉⲁⲧ
ⲉⲃⲇⲟⲙⲏ	N	ⲉⲃⲇⲟⲙⲏ
ⲉⲃⲏⲗ	ADV	ⲉⲃⲏⲗ
ⲉⲃⲏⲧ	N	ⲁⲃⲟⲧ
ⲉⲃⲓ	N	ⲉⲃⲓ
ⲉⲃⲓⲁⲓⲕ	N	ⲃⲱⲕ
ⲉⲃⲓⲏⲛ	N	ⲉⲃⲓⲏⲛ
ⲉⲃⲓⲱ	N	ⲉⲃⲓⲱ
ⲉⲃⲟⲗ	ADV	ⲉⲃⲟⲗ
ⲉⲃⲣⲉϩⲓ	N	ⲙⲃⲣⲉϩⲓ
ⲉⲃⲣⲏϫ	N	ⲉⲃⲣⲏϫ
ⲉⲅⲅⲕⲗⲩⲙⲁⲥ	N	ⲉⲅⲅⲕⲗⲩⲙⲁⲥ
ⲉⲅⲅⲣⲁⲫⲟⲛ	N	ⲉⲅⲅⲣⲁⲫⲟⲛ
ⲉⲅⲅⲣⲁⲫⲱⲥ	ADV	ⲉⲅⲅⲣⲁⲫⲱⲥ
ⲉⲅⲅⲩⲁ	N	ⲉⲅⲅⲩⲁ
ⲉⲅⲅⲩⲏ	N	ⲉⲅⲅⲩⲏ
ⲉⲅⲅⲩⲏ	V	ⲉⲅⲅⲩⲏ
ⲉⲅⲉⲧⲉ	PTC	ⲉⲅⲉⲧⲉ
ⲉⲅⲕⲁⲕⲉⲓ	V	ⲉⲅⲕⲁⲕⲉⲓ
ⲉⲅⲕⲁⲗⲉⲓ	V	ⲉⲅⲕⲁⲗⲉⲓ
ⲉⲅⲕⲉⲫⲁⲗⲟⲥ	N	ⲉⲅⲕⲉⲫⲁⲗⲟⲥ
ⲉⲅⲕⲣⲁⲧⲉⲓⲁ	N	ⲉⲅⲕⲣⲁⲧⲉⲓⲁ
ⲉⲅⲕⲣⲁⲧⲉⲩⲉ	V	ⲉⲅⲕⲣⲁⲧⲉⲩⲉ
ⲉⲅⲕⲣⲁⲧⲏⲥ	N	ⲉⲅⲕⲣⲁⲧⲏⲥ
ⲉⲅⲕⲣⲩⲫⲓⲟⲛ	N	ⲉⲅⲕⲣⲩⲫⲓⲟⲛ
ⲉⲅⲕⲱⲙⲓⲁⲍⲉ	V	ⲉⲅⲕⲱⲙⲓⲁⲍⲉ
ⲉⲅⲕⲱⲙⲓⲟⲛ	N	ⲉⲅⲕⲱⲙⲓⲟⲛ
ⲉⲉⲩ	N	ⲓⲱ
ⲉⲍⲉⲭⲓⲁ	N	ϩⲏⲥⲩⲭⲓⲁ
ⲉⲑ	CREL	ⲉⲧⲉ
ⲉⲑⲁⲩϣ	N	ⲉⲑⲱϣ
ⲉⲑⲃⲉ	PREP	ⲉⲑⲃⲉ
ⲉⲑⲃⲏ	PREP	ⲉⲑⲃⲉ
ⲉⲑⲏⲣ	N	ⲉⲑⲏⲣ
ⲉⲑⲛⲟⲥ	N	ϩⲉⲑⲛⲟⲥ
ⲉⲑⲟϣⲓ	N	ⲉⲑⲱϣ
ⲉⲑⲟⲥ	N	ⲉⲑⲟⲥ
ⲉⲑⲱϣ	N	ⲉⲑⲱϣ
ⲉⲓ	PPERS	ⲁⲛⲟⲕ
ⲉⲓ	V	ⲓ
ⲉⲓⲇⲉⲁ	N	ⲉⲓⲇⲉⲁ
ⲉⲓⲇⲟⲥ	N	ⲉⲓⲇⲟⲥ
ⲉⲓⲇⲱⲗⲟⲛ	N	ⲉⲓⲇⲱⲗⲟⲛ
ⲉⲓⲉⲃⲧ	N	ⲉⲓⲉⲃⲧ
ⲉⲓⲕⲏ	ADV	ⲉⲓⲕⲏ
ⲉⲓⲙⲏⲧⲓ	CONJ	ⲉⲓⲙⲏⲧⲓ
ⲉⲓⲟⲩⲗ	N	ⲉⲓⲟⲩⲗ
ⲉⲓⲣⲏⲛⲏ	N	ⲉⲓⲣⲏⲛⲏ
ⲉⲓⲣⲏⲛⲓⲕⲏ	N	ⲉⲓⲣⲏⲛⲓⲕⲏ
ⲉⲓⲣⲏⲛⲓⲕⲟⲛ	N	ⲉⲓⲣⲏⲛⲓⲕⲟⲛ
ⲉⲓⲣⲏⲛⲓⲕⲟⲥ	N	ⲉⲓⲣⲏⲛⲓⲕⲟⲥ
ⲉⲓⲧⲁ	CONJ	ⲉⲓⲧⲁ
ⲉⲓⲧⲉ	CONJ	ⲉⲓⲧⲉ
ⲉⲓⲱⲧ	N	ⲉⲓⲱⲧ
ⲉⲕⲇⲓⲕⲏⲥⲓⲥ	N	ⲉⲕⲇⲓⲕⲏⲥⲓⲥ
ⲉⲕⲕⲗⲏⲥⲓⲁ	N	ⲉⲕⲕⲗⲏⲥⲓⲁ
ⲉⲕⲕⲗⲏⲥⲓⲁⲥⲧⲏⲥ	N	ⲉⲕⲕⲗⲏⲥⲓⲁⲥⲧⲏⲥ
ⲉⲕⲕⲗⲏⲥⲓⲁⲥⲧⲓⲕⲟⲛ	N	ⲉⲕⲕⲗⲏⲥⲓⲁⲥⲧⲓⲕⲟⲛ
ⲉⲕⲗⲉⲕⲧⲏ	N	ⲉⲕⲗⲉⲕⲧⲏ
ⲉⲕⲗⲉⲕⲧⲟⲥ	N	ⲉⲕⲗⲉⲕⲧⲟⲥ
ⲉⲕⲗⲟⲅⲏ	N	ⲉⲕⲗⲟⲅⲏ
ⲉⲕⲗⲟⲗⲓ	N	ⲕⲉⲗⲱⲗ
ⲉⲕⲡⲗⲏⲝⲓⲥ	N	ⲉⲕⲡⲗⲏⲝⲓⲥ
ⲉⲕⲥⲁⲕⲧⲱⲣ	N	ⲉⲕⲥⲁⲕⲧⲱⲣ
ⲉⲕⲥⲧⲁⲥⲓⲥ	N	ⲉⲕⲥⲧⲁⲥⲓⲥ
ⲉⲕⲧⲏ	N	ⲉⲕⲧⲏ
ⲉⲗ	N	ⲁⲗⲟⲗⲓ
ⲉⲗ	V	ⲱⲗⲓ
ⲉⲗϩⲱⲃ	N	ⲉⲗϩⲱⲃ
ⲉⲗϩⲱⲡ	N	ⲉⲗϩⲱⲃ
ⲉⲗϫⲱⲃ	N	ⲉⲗϫⲱⲃ
ⲉⲗⲁⲙⲓⲧⲏⲥ	N	ⲉⲗⲁⲙⲓⲧⲏⲥ
ⲉⲗⲁⲥⲥⲟⲙⲁ	N	ⲉⲗⲁⲥⲥⲟⲙⲁ
ⲉⲗⲁⲭⲓⲥⲧⲟⲛ	N	ⲉⲗⲁⲭⲓⲥⲧⲟⲛ
ⲉⲗⲁⲭⲓⲥⲧⲟⲥ	N	ⲉⲗⲁⲭⲓⲥⲧⲟⲥ
ⲉⲗⲃⲓϫⲓ	N	ⲉⲗⲃⲓϫⲓ
ⲉⲗⲉⲅⲭⲉ	V	ⲉⲗⲉⲅⲭⲉ
ⲉⲗⲉⲏⲙⲟⲥⲩⲛⲏ	N	ⲉⲗⲉⲏⲙⲟⲥⲩⲛⲏ
ⲉⲗⲉⲩⲑⲉⲣⲁ	N	ⲉⲗⲉⲩⲑⲉⲣⲁ
ⲉⲗⲉⲩⲑⲉⲣⲓⲁ	N	ⲉⲗⲉⲩⲑⲉⲣⲓⲁ
ⲉⲗⲉⲩⲑⲉⲣⲟⲥ	N	ⲉⲗⲉⲩⲑⲉⲣⲟⲥ
ⲉⲗⲉⲩⲑⲉⲣⲟⲩ	V	ⲉⲗⲉⲩⲑⲉⲣⲟⲩ
ⲉⲗⲉⲫⲁⲛⲧⲓⲛⲟⲛ	N	ⲉⲗⲉⲫⲁⲛⲧⲓⲛⲟⲛ
ⲉⲗⲓⲥⲥⲁⲓⲟⲥ	NPROP	ⲉⲗⲓⲥⲥⲁⲓⲟⲥ
ⲉⲗⲕⲉⲙⲏ	N	ⲉⲗⲕⲉⲙⲏ
ⲉⲗⲕⲟ	N	ⲉⲗⲕⲟ
ⲉⲗⲕⲟⲩ	N	ⲉⲗⲕⲟ
ⲉⲗⲗⲉⲃⲟⲣⲟⲛ	N	ⲉⲗⲗⲉⲃⲟⲣⲟⲛ
ⲉⲗⲱⲉⲓ	N	ⲉⲗⲱⲉⲓ
ⲉⲙϣⲓϣ	N	ⲙϣⲓϣ
ⲉⲙϣⲓⲣ	N	ⲙϣⲓⲣ
ⲉⲙϩⲁⲩ	N	ⲙϩⲁⲩ
ⲉⲙϩⲓⲧ	N	ⲉⲙϩⲓⲧ
ⲉⲙϫⲱⲗ	N	ⲙϫⲱⲗ
ⲉⲙⲁϣⲱ	ADV	ⲉⲙⲁϣⲱ
ⲉⲙⲃⲟⲛ	V	ⲙⲃⲟⲛ
ⲉⲙⲃⲣⲉϩⲓ	N	ⲙⲃⲣⲉϩⲓ
ⲉⲙⲃⲣⲓⲥ	N	ⲉⲙⲃⲣⲓⲥ
ⲉⲙⲃⲣⲱ	N	ⲉⲙⲃⲣⲱ
ⲉⲙⲉⲛⲧ	N	ⲉⲙⲉⲛⲧ
ⲉⲙⲑⲟ	N	ⲙⲑⲟ
ⲉⲙⲑⲱ	N	ⲉⲙⲑⲱ
ⲉⲙⲓ	V	ⲉⲙⲓ
ⲉⲙⲓⲧ	N	ⲙⲓⲧ
ⲉⲙⲕ	V	ⲱⲙⲕ
ⲉⲙⲕⲁϩ	V	ⲙⲕⲁϩ
ⲉⲙⲗⲁϧ	V	ⲙⲗⲁϧ
ⲉⲙⲙⲁⲛⲟⲩⲏⲗ	V	ⲉⲙⲙⲁⲛⲟⲩⲏⲗ
ⲉⲙⲛⲟϯ	N	ⲙⲛⲟⲧ
ⲉⲙⲛⲟⲧⲉ	N	ⲙⲛⲟⲩⲧ
ⲉⲙⲛⲟⲩⲧ	N	ⲙⲛⲟⲩⲧ
ⲉⲙⲟⲩ	N	ⲉⲙⲟⲩ
ⲉⲙⲡϣⲁ	V	ⲙⲡϣⲁ
ⲉⲙⲡⲉⲣⲟⲥ	N	ⲉⲙⲡⲉⲣⲟⲥ
ⲉⲙⲡⲟⲣⲟⲥ	N	ⲉⲙⲡⲟⲣⲟⲥ
ⲉⲙⲣⲁⲓ	N	ⲃⲣⲁⲓ
ⲉⲙⲣⲉϩⲓ	N	ⲉⲙⲣⲉϩⲓ
ⲉⲙⲣⲱⲙ	N	ⲙⲣⲱⲙ
ⲉⲙⲥ	V	ⲉⲙⲥ
ⲉⲙⲥ	V	ⲱⲙⲥ
ⲉⲙⲥⲁϩ	N	ⲙⲥⲁϩ
ⲉⲙⲥⲟⲃⲓ	N	ⲉⲙⲥⲟⲃⲓ
ⲉⲙⲧⲟⲛ	V	ⲙⲧⲟⲛ
ⲉⲙⲫⲁⲛⲓⲍⲉ	V	ⲉⲙⲫⲁⲛⲓⲍⲉ
ⲉⲙⲫⲁⲛⲓⲥⲑⲁⲓ	V	ⲉⲙⲫⲁⲛⲓⲥⲑⲁⲓ
ⲉⲙⲯⲩⲭⲟⲛ	N	ⲉⲙⲯⲩⲭⲟⲛ
ⲉⲙⲱⲟⲩⲓ	N	ⲉⲙⲟⲩ
ⲉⲛ	V	ⲓⲛⲓ
ⲉⲛϣⲟⲧ	V	ⲛϣⲟⲧ
ⲉⲛϩⲟⲧ	VSTAT	ⲛⲁϩϯ
ⲉⲛϩⲟⲩⲣ	V	ⲛϩⲟⲩⲣ
ⲉⲛⲁⲅⲉ	V	ⲉⲛⲁⲅⲉ
ⲉⲛⲇⲁⲓⲙⲱⲛⲓⲟⲛ	N	ⲉⲛⲇⲁⲓⲙⲱⲛⲓⲟⲛ
ⲉⲛⲇⲏⲙⲁ	N	ⲉⲛⲇⲏⲙⲁ
ⲉⲛⲇⲟⲝ⸌ⲧ⸍	N	ⲉⲛⲇⲟⲝ⸌ⲧ⸍
ⲉⲛⲇⲩⲙⲁ	N	ⲉⲛⲇⲩⲙⲁ
ⲉⲛⲉϩ	ADV	ⲉⲛⲉϩ
ⲉⲛⲉϩ	N	ⲉⲛⲉϩ
ⲉⲛⲉⲣⲅⲉⲓ	V	ⲉⲛⲉⲣⲅⲉⲓ
ⲉⲛⲉⲣⲅⲉⲓⲁ	N	ⲉⲛⲉⲣⲅⲉⲓⲁ
ⲉⲛⲉⲣⲅⲏⲙⲁ	N	ⲉⲛⲉⲣⲅⲏⲙⲁ
ⲉⲛⲉⲭⲉⲣⲟⲛ	N	ⲉⲛⲉⲭⲉⲣⲟⲛ
ⲉⲛⲑⲩⲙⲏⲥⲓⲥ	N	ⲉⲛⲑⲩⲙⲏⲥⲓⲥ
ⲉⲛⲕⲟⲕⲓ	N	ⲁⲛⲕⲟⲕⲓ
ⲉⲛⲕⲟⲧ	V	ⲉⲛⲕⲟⲧ
ⲉⲛⲛⲁⲥ	N	ⲉⲛⲛⲁⲥ
ⲉⲛⲛⲁⲧⲏ	N	ⲉⲛⲛⲁⲧⲏ
ⲉⲛⲛⲟⲓⲁ	N	ⲉⲛⲛⲟⲓⲁ
ⲉⲛⲟⲩⲕ	N	ⲉⲛⲟⲩⲕ
ⲉⲛⲟⲭⲗⲉⲓ	V	ⲉⲛⲟⲭⲗⲉⲓ
ⲉⲛⲟⲭⲟⲥ	N	ⲉⲛⲟⲭⲟⲥ
ⲉⲛⲟⲭⲟⲥ	NPROP	ⲉⲛⲟⲭⲟⲥ
ⲉⲛⲧⲁⲅⲓⲟⲛ	N	ⲉⲛⲧⲁⲅⲓⲟⲛ
ⲉⲛⲧⲏϫ	N	ⲉⲛⲧⲏϫ
ⲉⲛⲧⲓⲛⲁⲥⲥⲉ	V	ⲉⲛⲧⲓⲛⲁⲥⲥⲉ
ⲉⲛⲧⲟⲗⲏ	N	ⲉⲛⲧⲟⲗⲏ
ⲉⲛⲭⲁⲓ	N	ⲛⲭⲁⲓ
ⲉⲛⲱⲭ	NPROP	ⲉⲛⲱⲭ
ⲉⲛⲱⲭⲗⲉⲓ	V	ⲉⲛⲱⲭⲗⲉⲓ
ⲉⲝϩⲟⲙⲟⲗⲟⲅⲏⲥⲓⲥ	N	ⲉⲝϩⲟⲙⲟⲗⲟⲅⲏⲥⲓⲥ
ⲉⲝⲁⲅⲉ	V	ⲉⲝⲁⲅⲉ
ⲉⲝⲁⲡⲁⲧⲁ	V	ⲉⲝⲁⲡⲁⲧⲁ
ⲉⲝⲁⲡⲓⲛⲁ	ADV	ⲉⲝⲁⲡⲓⲛⲁ
ⲉⲝⲁⲥ	N	ⲉⲝⲁⲥ
ⲉⲝⲉⲇⲣⲁ	N	ⲉⲝⲉⲇⲣⲁ
ⲉⲝⲉⲥⲧⲉⲓ	V	ⲉⲝⲉⲥⲧⲉⲓ
ⲉⲝⲉⲥⲧⲉⲓ	V	ⲉⲝⲉⲥⲧⲓ
ⲉⲝⲉⲥⲧⲓ	V	ⲉⲝⲉⲥⲧⲓ
ⲉⲝⲉⲧⲁⲍⲉ	V	ⲉⲝⲉⲧⲁⲍⲉ
ⲉⲝⲉⲧⲁⲥⲓⲥ	N	ⲉⲝⲉⲧⲁⲥⲓⲥ
ⲉⲝⲏⲅⲉⲓⲥⲓⲥ	N	ⲉⲝⲏⲅⲉⲓⲥⲓⲥ
ⲉⲝⲏⲅⲉⲥⲓⲥ	N	ⲉⲝⲏⲅⲉⲥⲓⲥ
ⲉⲝⲏⲅⲏⲥⲓⲥ	N	ⲉⲝⲏⲅⲏⲥⲓⲥ
ⲉⲝⲏⲅⲏⲧⲏⲥ	N	ⲉⲝⲏⲅⲏⲧⲏⲥ
ⲉⲝⲏⲕⲏⲥⲓⲥ	N	ⲉⲝⲏⲕⲏⲥⲓⲥ
ⲉⲝⲓⲗⲉ̄	N	ⲉⲝⲓⲗⲉ̄
ⲉⲝⲟⲇⲟⲥ	N	ⲉⲝⲟⲇⲟⲥ
ⲉⲝⲟⲙⲟⲗⲟⲅⲉⲓ	V	ⲉⲝⲟⲙⲟⲗⲟⲅⲉⲓ
ⲉⲝⲟⲙⲟⲗⲟⲅⲓ	V	ⲉⲝⲟⲙⲟⲗⲟⲅⲉⲓ
ⲉⲝⲟⲣⲅⲓⲥⲧⲏⲥ	N	ⲉⲝⲟⲣⲅⲓⲥⲧⲏⲥ
ⲉⲝⲟⲣⲓⲍⲉ	V	ⲉⲝⲟⲣⲓⲍⲉ
ⲉⲝⲟⲩⲑⲉⲛⲓ	V	ⲉⲝⲟⲩⲑⲉⲛⲓ
ⲉⲝⲟⲩⲥⲓⲁ	N	ⲉⲝⲟⲩⲥⲓⲁ
ⲉⲝⲟⲩⲥⲓⲁⲍⲓⲛ	V	ⲉⲝⲟⲩⲥⲓⲁⲍⲓⲛ
ⲉⲝⲟⲩⲥⲓⲁⲥⲧⲏⲥ	N	ⲉⲝⲟⲩⲥⲓⲁⲥⲧⲏⲥ
ⲉⲝⲱⲇⲓⲕⲟⲥ	N	ⲉⲝⲱⲇⲓⲕⲟⲥ
ⲉⲝⲱⲣⲉⲓⲥⲧⲓⲁ	N	ⲉⲝⲱⲣⲉⲓⲥⲧⲓⲁ
ⲉⲝⲱⲣⲓⲍⲓⲛ	V	ⲉⲝⲱⲣⲓⲍⲓⲛ
ⲉⲝⲱⲣⲓⲥⲧⲓⲁ	N	ⲉⲝⲱⲣⲓⲥⲧⲓⲁ
ⲉⲟⲩⲗ	N	ⲉⲓⲟⲩⲗ
ⲉⲡ	V	ⲱⲡ
ⲉⲡⲁⲓⲛⲟⲩ	V	ⲉⲡⲁⲓⲛⲟⲩ
ⲉⲡⲁⲣⲭⲓⲁ	N	ⲉⲡⲁⲣⲭⲓⲁ
ⲉⲡⲁⲣⲭⲟⲥ	N	ⲉⲡⲁⲣⲭⲟⲥ
ⲉⲡⲉⲓ	CONJ	ⲉⲡⲉⲓ
ⲉⲡⲉⲓⲇⲏ	CONJ	ⲉⲡⲉⲓⲇⲏ
ⲉⲡⲉⲓⲑⲩⲙⲓⲁ	N	ⲉⲡⲉⲓⲑⲩⲙⲓⲁ
ⲉⲡⲉⲓⲧⲁ	ADV	ⲉⲡⲉⲓⲧⲁ
ⲉⲡⲉⲛⲇⲩⲧⲏⲥ	N	ⲉⲡⲉⲛⲇⲩⲧⲏⲥ
ⲉⲡⲉⲭⲏⲣⲓ	V	ⲉⲡⲉⲭⲏⲣⲓ
ⲉⲡⲏⲡ	N	ⲉⲡⲏⲡ
ⲉⲡⲏⲣⲉⲁⲍⲉ	V	ⲉⲡⲏⲣⲉⲁⲍⲉ
ⲉⲡⲏⲣⲓⲁ	N	ⲉⲡⲏⲣⲓⲁ
ⲉⲡⲓⲃⲟⲗⲏ	N	ⲉⲡⲓⲃⲟⲗⲏ
ⲉⲡⲓⲃⲟⲩⲗⲉⲩⲉ	V	ⲉⲡⲓⲃⲟⲩⲗⲉⲩⲉ
ⲉⲡⲓⲃⲟⲩⲗⲏ	N	ⲉⲡⲓⲃⲟⲩⲗⲏ
ⲉⲡⲓⲅⲉⲁⲉⲓ	V	ⲉⲡⲓⲅⲉⲁⲉⲓ
ⲉⲡⲓⲅⲉⲛⲛⲓⲟⲥ	N	ⲉⲡⲓⲅⲉⲛⲛⲓⲟⲥ
ⲉⲡⲓⲅⲣⲁⲫⲏ	N	ⲉⲡⲓⲅⲣⲁⲫⲏ
ⲉⲡⲓⲉⲓⲕⲏⲥ	N	ⲉⲡⲓⲉⲓⲕⲏⲥ
ⲉⲡⲓⲑⲁⲛⲁⲧⲏⲥ	N	ⲉⲡⲓⲑⲁⲛⲁⲧⲏⲥ
ⲉⲡⲓⲑⲁⲛⲁⲧⲓⲟⲥ	N	ⲉⲡⲓⲑⲁⲛⲁⲧⲓⲟⲥ
ⲉⲡⲓⲑⲩⲙⲉⲓ	V	ⲉⲡⲓⲑⲩⲙⲉⲓ
ⲉⲡⲓⲑⲩⲙⲓⲁ	N	ⲉⲡⲓⲑⲩⲙⲓⲁ
ⲉⲡⲓⲕⲁⲑⲉⲣⲙⲁ	N	ⲉⲡⲓⲕⲁⲑⲉⲣⲙⲁ
ⲉⲡⲓⲕⲁⲗⲉⲓ	V	ⲉⲡⲓⲕⲁⲗⲉⲓ
ⲉⲡⲓⲛⲟⲓⲁ	N	ⲉⲡⲓⲛⲟⲓⲁ
ⲉⲡⲓⲥⲏⲙⲟⲥ	N	ⲉⲡⲓⲥⲏⲙⲟⲥ
ⲉⲡⲓⲥⲕⲟⲡⲏ	N	ⲉⲡⲓⲥⲕⲟⲡⲏ
ⲉⲡⲓⲥⲕⲟⲡⲓⲟⲛ	N	ⲉⲡⲓⲥⲕⲟⲡⲓⲟⲛ
ⲉⲡⲓⲥⲕⲟⲡⲟⲥ	N	ⲉⲡⲓⲥⲕⲟⲡⲟⲥ
ⲉⲡⲓⲥⲧⲏⲙⲏ	N	ⲉⲡⲓⲥⲧⲏⲙⲏ
ⲉⲡⲓⲥⲧⲟⲗⲏ	N	ⲉⲡⲓⲥⲧⲟⲗⲏ
ⲉⲡⲓⲧⲁⲕⲏ	N	ⲉⲡⲓⲧⲁⲕⲏ
ⲉⲡⲓⲧⲁⲥⲥⲉ	V	ⲉⲡⲓⲧⲁⲥⲥⲉ
ⲉⲡⲓⲧⲉⲗⲉⲓ	V	ⲉⲡⲓⲧⲉⲗⲉⲓ
ⲉⲡⲓⲧⲉⲗⲓⲛ	V	ⲉⲡⲓⲧⲉⲗⲓⲛ
ⲉⲡⲓⲧⲓⲙⲁ	V	ⲉⲡⲓⲧⲓⲙⲁ
ⲉⲡⲓⲧⲓⲙⲓⲁ	N	ⲉⲡⲓⲧⲓⲙⲓⲁ
ⲉⲡⲓⲧⲣⲉⲡⲉ	V	ⲉⲡⲓⲧⲣⲉⲡⲉ
ⲉⲡⲓⲧⲣⲟⲡⲏ	N	ⲉⲡⲓⲧⲣⲟⲡⲏ
ⲉⲡⲓⲧⲣⲟⲡⲟⲥ	N	ⲉⲡⲓⲧⲣⲟⲡⲟⲥ
ⲉⲡⲟⲓⲕⲓⲟⲛ	N	ⲉⲡⲟⲓⲕⲓⲟⲛ
ⲉⲡⲟⲩⲣⲁⲛⲓⲟⲛ	N	ⲉⲡⲟⲩⲣⲁⲛⲓⲟⲛ
ⲉⲡⲥ	N	ⲏⲡⲥ
ⲉⲡⲫⲁⲑⲁ	FM	ⲉⲡⲫⲁⲑⲁ
ⲉⲡⲫⲁⲑⲁ	NPROP	ⲉⲡⲫⲁⲑⲁ
ⲉⲣ	V	ⲓⲣⲓ
ⲉⲣϣⲃⲉ	V	ⲉⲣϣⲃⲉ
ⲉⲣϣⲓϣ	N	ⲉⲣϣⲓϣ
ⲉⲣϣⲓϣⲓ	N	ⲉⲣϣⲓϣⲓ
ⲉⲣϣⲓϣⲓ	V	ⲉⲣϣⲓϣⲓ
ⲉⲣϣⲫⲏⲣ	V	ⲉⲣϣⲫⲏⲣ
ⲉⲣϣⲫⲏⲣⲓ	V	ⲉⲣϣⲫⲏⲣⲓ
ⲉⲣϣⲱⲛ	N	ⲉⲣϣⲱⲛ
ⲉⲣϥ	V	ⲱⲣϥ
ⲉⲣϩⲏⲧ	V	ⲉⲣϩⲏⲧ
ⲉⲣϩⲟϯ	V	ⲉⲣϩⲟϯ
ⲉⲣϩⲱⲃ	V	ⲉⲣϩⲱⲃ
ⲉⲣϫ	N	ⲉⲣϫ
ⲉⲣⲁⲛⲁⲭⲱⲣⲓⲛ	V	ⲉⲣⲁⲛⲁⲭⲱⲣⲓⲛ
ⲉⲣⲁⲧ	PREP	ⲉⲣⲁⲧ
ⲉⲣⲁⲧⲟⲩⲧⲁϩ	V	ⲉⲣⲁⲧⲟⲩⲧⲁϩ
ⲉⲣⲃⲓⲛ	N	ⲉⲣⲃⲓⲛ
ⲉⲣⲃⲓⲥⲓ	N	ⲉⲣⲃⲓⲥⲓ
ⲉⲣⲃⲓⲧ	N	ⲉⲣⲃⲓⲧ
ⲉⲣⲃⲱⲥ	N	ⲉⲣⲃⲱⲥ
ⲉⲣⲅⲁⲥⲓⲁ	N	ⲉⲣⲅⲁⲥⲓⲁ
ⲉⲣⲅⲁⲥⲧⲏⲣⲓⲟⲛ	N	ⲉⲣⲅⲁⲥⲧⲏⲣⲓⲟⲛ
ⲉⲣⲅⲁⲧⲏⲥ	N	ⲉⲣⲅⲁⲧⲏⲥ
ⲉⲣⲅⲟⲇⲓⲱⲕⲧⲏⲥ	N	ⲉⲣⲅⲟⲇⲓⲱⲕⲧⲏⲥ
ⲉⲣⲅⲟⲗⲁⲃⲓⲁ	N	ⲉⲣⲅⲟⲗⲁⲃⲓⲁ
ⲉⲣⲅⲟⲛ	N	ⲉⲣⲅⲟⲛ
ⲉⲣⲇⲓⲁⲕⲣⲓⲛⲓⲛ	V	ⲉⲣⲇⲓⲁⲕⲣⲓⲛⲓⲛ
ⲉⲣⲇⲟⲕⲓⲙⲁⲍⲓⲛ	V	ⲉⲣⲇⲟⲕⲓⲙⲁⲍⲓⲛ
ⲉⲣⲉ	AOPT	ⲉⲣⲉ
ⲉⲣⲉ	AOPT_PPERS	ⲉⲣⲉ_ⲛⲑⲟ
ⲉⲣⲉ	CCIRC	ⲉⲣⲉ
ⲉⲣⲉ	CFOC	ⲁⲣⲉ
ⲉⲣⲉⲡⲓⲧⲓⲙⲁⲛ	V	ⲉⲣⲉⲡⲓⲧⲓⲙⲁⲛ
ⲉⲣⲉⲩⲑⲏⲛⲓⲛ	V	ⲉⲣⲉⲩⲑⲏⲛⲓⲛ
ⲉⲣⲏⲃ	N	ⲁⲣⲏⲃ
ⲉⲣⲏⲙⲓⲁ	N	ⲉⲣⲏⲙⲓⲁ
ⲉⲣⲏⲙⲟⲥ	N	ⲉⲣⲏⲙⲟⲥ
ⲉⲣⲏⲟⲩ	N	ⲉⲣⲏⲟⲩ
ⲉⲣⲏⲧ	V	ⲉⲣⲏⲧ
ⲉⲣⲏⲩ	N	ⲉⲣⲏⲩ
ⲉⲣⲑⲉⲁⲧⲣⲟⲛ	V	ⲉⲣⲑⲉⲁⲧⲣⲟⲛ
ⲉⲣⲓⲍⲉ	V	ⲉⲣⲓⲍⲉ
ⲉⲣⲕⲁⲧⲏⲅⲟⲣⲓⲛ	V	ⲉⲣⲕⲁⲧⲏⲅⲟⲣⲓⲛ
ⲉⲣⲕⲁⲩⲙⲁ	V	ⲉⲣⲕⲁⲩⲙⲁ
ⲉⲣⲕⲗⲏⲣⲟⲛⲟⲙⲓⲛ	V	ⲉⲣⲕⲗⲏⲣⲟⲛⲟⲙⲓⲛ
ⲉⲣⲙⲁⲛ	N	ϩⲣⲙⲁⲛ
ⲉⲣⲙⲏⲧⲁⲣⲓⲟⲛ	N	ⲉⲣⲙⲏⲧⲁⲣⲓⲟⲛ
ⲉⲣⲛⲏⲥⲧⲉⲩⲓⲛ	V	ⲉⲣⲛⲏⲥⲧⲉⲩⲓⲛ
ⲉⲣⲟ	PREP	ⲉ
ⲉⲣⲟⲩⲣⲟ	V	ⲉⲣⲟⲩⲣⲟ
ⲉⲣⲟⲩⲟⲧ	V	ⲉⲣⲟⲩⲟⲧ
ⲉⲣⲟⲩⲱ	V	ⲉⲣⲟⲩⲱ
ⲉⲣⲡⲓⲣⲁⲍⲓⲛ	V	ⲉⲣⲡⲓⲣⲁⲍⲓⲛ
ⲉⲣⲡⲣⲉϩⲓ	N	ⲉⲙⲣⲉϩⲓ
ⲉⲣⲡⲣⲟⲥⲉⲩⲭⲉⲥⲑⲉ	V	ⲉⲣⲡⲣⲟⲥⲉⲩⲭⲉⲥⲑⲉ
ⲉⲣⲥⲁⲃⲉ	V	ⲉⲣⲥⲁⲃⲉ
ⲉⲣⲥⲕⲁⲛⲇⲁⲗⲓⲍⲉⲥⲑⲉ	V	ⲉⲣⲥⲕⲁⲛⲇⲁⲗⲓⲍⲉⲥⲑⲉ
ⲉⲣⲥⲟϫ	V	ⲉⲣⲥⲟϫ
ⲉⲣⲥⲱⲟⲩ	N	ⲉⲣⲥⲱⲟⲩ
ⲉⲣⲧⲟⲃ	N	ⲉⲣⲧⲟⲃ
ⲉⲣⲧⲟⲡ	N	ⲉⲣⲧⲟⲃ
ⲉⲣⲧⲱ	N	ⲉⲣⲧⲱ
ⲉⲣⲧⲱⲃ	N	ⲉⲣⲧⲟⲃ
ⲉⲣⲩⲑⲣⲁ	N	ⲉⲣⲩⲑⲣⲁ
ⲉⲣⲫⲁϧⲣⲓ	V	ⲉⲣⲫⲁϧⲣⲓ
ⲉⲣⲫⲉⲓ	N	ⲉⲣⲫⲉⲓ
ⲉⲣⲫⲏⲟⲩⲓ	N	ⲉⲣⲫⲉⲓ
ⲉⲣⲭⲣⲉⲓⲁ	V	ⲉⲣⲭⲣⲉⲓⲁ
ⲉⲣⲭⲣⲓⲁ	V	ⲉⲣⲭⲣⲉⲓⲁ
ⲉⲣⲱ	PREP	ⲉ
ⲉⲣⲱϯ	N	ⲉⲣⲱϯ
ⲉⲣⲱⲥ	N	ⲉⲣⲱⲥ
ⲉⲥⲏⲧ	N	ⲉⲥⲏⲧ
ⲉⲥⲑⲁⲛⲉ	V	ⲉⲥⲑⲁⲛⲉ
ⲉⲥⲑⲏⲥⲓⲥ	N	ⲉⲥⲑⲏⲥⲓⲥ
ⲉⲥⲑⲏⲧⲏⲣⲓⲟⲛ	N	ⲉⲥⲑⲏⲧⲏⲣⲓⲟⲛ
ⲉⲥⲓⲇⲟⲣⲟⲥ	NPROP	ⲉⲥⲓⲇⲟⲣⲟⲥ
ⲉⲥⲓⲉ	N	ⲉⲥⲓⲉ
ⲉⲥⲕⲉⲛ	PREP	ⲉⲥⲕⲉⲛ
ⲉⲥⲣⲱⲙ	NPROP	ⲉⲥⲣⲱⲙ
ⲉⲥⲧⲱ	V	ⲉⲥⲧⲱ
ⲉⲥⲩⲭⲁⲍⲉ	V	ⲉⲥⲩⲭⲁⲍⲉ
ⲉⲥⲭⲁⲣⲁ	N	ⲉⲥⲭⲁⲣⲁ
ⲉⲥⲱⲟⲩ	N	ⲉⲥⲱⲟⲩ
ⲉⲧ	APREC	ⲉⲧ
ⲉⲧ	CFOC	ⲁⲣⲉ
ⲉⲧ	CREL	ⲉⲧⲉ
ⲉⲧⲉ	CFOC	ⲁⲣⲉ
ⲉⲧⲉ	CREL	ⲉⲧⲉ
ⲉⲧⲉ	APREC	ⲉⲧ
ⲉⲧⲉϣⲓ	N	ⲉⲧⲏϣⲓ
ⲉⲧⲏϣⲓ	N	ⲉⲧⲏϣⲓ
ⲉⲧⲓ	ADV	ⲉⲧⲓ
ⲉⲧⲟⲧ	PREP	ⲉⲧⲉⲛ
ⲉⲩϩⲁ	NPROP	ⲉⲩϩⲁ
ⲉⲩϩⲁⲓⲟⲥ	N	ⲉⲩϩⲁⲓⲟⲥ
ⲉⲩϩⲁⲓⲟⲥ	NPROP	ⲉⲩϩⲁⲓⲟⲥ
ⲉⲩⲁⲅⲅⲉⲗⲓⲍⲉ	V	ⲉⲩⲁⲅⲅⲉⲗⲓⲍⲉ
ⲉⲩⲁⲅⲅⲉⲗⲓⲟⲛ	N	ⲉⲩⲁⲅⲅⲉⲗⲓⲟⲛ
ⲉⲩⲁⲅⲅⲉⲗⲓⲥⲧⲏⲥ	N	ⲉⲩⲁⲅⲅⲉⲗⲓⲥⲧⲏⲥ
ⲉⲩⲁⲅⲣⲓⲟⲥ	NPROP	ⲉⲩⲁⲅⲣⲓⲟⲥ
ⲉⲩⲅⲉ	ADV	ⲉⲩⲅⲉ
ⲉⲩⲅⲉⲛⲏⲥ	N	ⲉⲩⲅⲉⲛⲏⲥ
ⲉⲩⲇⲁⲓⲙⲟⲛⲓⲁ	N	ⲉⲩⲇⲁⲓⲙⲟⲛⲓⲁ
ⲉⲩⲇⲟⲕⲉⲓ	V	ⲉⲩⲇⲟⲕⲉⲓ
ⲉⲩⲉ	AOPT_PPERS	ⲉⲣⲉ_ⲛⲑⲱⲟⲩ
ⲉⲩⲉⲣⲅⲉⲥⲓⲁ	N	ⲉⲩⲉⲣⲅⲉⲥⲓⲁ
ⲉⲩⲉⲣⲅⲉⲧⲏⲥ	N	ⲉⲩⲉⲣⲅⲉⲧⲏⲥ
ⲉⲩⲑⲉⲱⲥ	ADV	ⲉⲩⲑⲉⲱⲥ
ⲉⲩⲑⲩⲥ	ADV	ⲉⲩⲑⲩⲥ
ⲉⲩⲕⲉⲣⲓ	V	ⲉⲩⲕⲉⲣⲓ
ⲉⲩⲕⲉⲣⲓⲁ	N	ⲉⲩⲕⲉⲣⲓⲁ
ⲉⲩⲕⲗⲉⲉⲥⲧⲁⲧⲟⲥ	N	ⲉⲩⲕⲗⲉⲉⲥⲧⲁⲧⲟⲥ
ⲉⲩⲕⲟⲡⲟⲛ	N	ⲉⲩⲕⲟⲡⲟⲛ
ⲉⲩⲕⲣⲁⲥⲓⲁ	N	ⲉⲩⲕⲣⲁⲥⲓⲁ
ⲉⲩⲗⲁⲃⲉⲥⲧⲁⲧⲟⲥ	N	ⲉⲩⲗⲁⲃⲉⲥⲧⲁⲧⲟⲥ
ⲉⲩⲗⲁⲃⲓⲁ	N	ⲉⲩⲗⲁⲃⲓⲁ
ⲉⲩⲗⲟⲅⲓⲁ	N	ⲉⲩⲗⲟⲅⲓⲁ
ⲉⲩⲗⲟⲅⲟⲛ	N	ⲉⲩⲗⲟⲅⲟⲛ
ⲉⲩⲛⲓ	N	ⲉⲩⲛⲓ
ⲉⲩⲛⲟⲓⲁ	N	ⲉⲩⲛⲟⲓⲁ
ⲉⲩⲡⲟⲣⲉⲓ	V	ⲉⲩⲡⲟⲣⲉⲓ
ⲉⲩⲡⲟⲣⲓ	V	ⲉⲩⲡⲟⲣⲓ
ⲉⲩⲡⲟⲣⲓⲁ	N	ⲉⲩⲡⲟⲣⲓⲁ
ⲉⲩⲡⲟⲣⲟⲥ	N	ⲉⲩⲡⲟⲣⲟⲥ
ⲉⲩⲡⲣⲉⲡⲉⲓⲁ	N	ⲉⲩⲡⲣⲉⲡⲉⲓⲁ
ⲉⲩⲣⲓⲡⲟⲥ	N	ⲉⲩⲣⲓⲡⲟⲥ
ⲉⲩⲥⲉⲃⲉⲓⲁ	N	ⲉⲩⲥⲉⲃⲉⲓⲁ
ⲉⲩⲥⲉⲃⲏⲥ	N	ⲉⲩⲥⲉⲃⲏⲥ
ⲉⲩⲥⲧⲁⲑⲓⲟⲥ	NPROP	ⲉⲩⲥⲧⲁⲑⲓⲟⲥ
ⲉⲩⲥⲭⲏⲙⲱⲛ	N	ⲉⲩⲥⲭⲏⲙⲱⲛ
ⲉⲩⲥⲭⲩⲙⲟⲥⲩⲛⲏ	N	ⲉⲩⲥⲭⲩⲙⲟⲥⲩⲛⲏ
ⲉⲩⲧⲉⲗⲉⲓⲁ	N	ⲉⲩⲧⲉⲗⲉⲓⲁ
ⲉⲩⲧⲣⲟⲡⲓⲟⲥ	NPROP	ⲉⲩⲧⲣⲟⲡⲓⲟⲥ
ⲉⲩⲫⲣⲁⲛⲉ	V	ⲉⲩⲫⲣⲁⲛⲉ
ⲉⲩⲫⲣⲟⲥⲩⲛⲏ	N	ⲉⲩⲫⲣⲟⲥⲩⲛⲏ
ⲉⲩⲫⲩⲏⲥ	N	ⲉⲩⲫⲩⲏⲥ
ⲉⲩⲭⲁⲣⲓⲥⲧⲉⲓ	V	ⲉⲩⲭⲁⲣⲓⲥⲧⲉⲓ
ⲉⲩⲭⲁⲣⲓⲥⲧⲓⲁ	N	ⲉⲩⲭⲁⲣⲓⲥⲧⲓⲁ
ⲉⲩⲭⲁⲣⲓⲥⲧⲟⲩ	V	ⲉⲩⲭⲁⲣⲓⲥⲧⲟⲩ
ⲉⲩⲭⲏ	N	ⲉⲩⲭⲏ
ⲉⲫⲉⲥⲟⲥ	NPROP	ⲉⲫⲉⲥⲟⲥ
ⲉⲫⲗⲏⲟⲩ	N	ⲉⲫⲗⲏⲟⲩ
ⲉⲫⲟⲇⲓⲟⲛ	N	ⲉⲫⲟⲇⲓⲟⲛ
ⲉⲫⲣⲁⲓ	N	ⲃⲣⲁⲓ
ⲉⲫⲣⲉⲙ	NPROP	ⲉⲫⲣⲉⲙ
ⲉⲫⲱⲧ	N	ⲉⲫⲱⲧ
ⲉⲱ	N	ⲓⲱ
ⲉⲱⲛ	N	ⲉⲱⲛ
ⲉⲱⲥ	CONJ	ⲉⲱⲥ
ⲍⲁⲍ	N	ⲍⲁⲍ
ⲍⲁⲭⲁⲣⲓⲁⲥ	NPROP	ⲍⲁⲭⲁⲣⲓⲁⲥ
ⲍⲉⲃⲉⲇⲁⲓⲟⲥ	NPROP	ⲍⲉⲃⲉⲇⲁⲓⲟⲥ
ⲍⲉⲃⲉⲇⲉⲟⲥ	N	ⲍⲉⲃⲉⲇⲉⲟⲥ
ⲍⲉⲃⲉⲇⲉⲟⲥ	NPROP	ⲍⲉⲃⲉⲇⲉⲟⲥ
ⲍⲉⲗⲫⲁ	NPROP	ⲍⲉⲗⲫⲁ
ⲍⲉⲛⲍⲉⲛ	N	ⲍⲉⲛⲍⲉⲛ
ⲍⲉⲩⲥ	NPROP	ⲍⲉⲩⲥ
ⲍⲏⲛⲱⲛ	NPROP	ⲍⲏⲛⲱⲛ
ⲍⲏⲧⲏⲙⲁ	N	ⲍⲏⲧⲏⲙⲁ
ⲍⲏⲧⲏⲥⲓⲥ	N	ⲍⲏⲧⲏⲥⲓⲥ
ⲍⲓⲍⲁⲛⲓⲟⲛ	N	ⲍⲓⲍⲁⲛⲓⲟⲛ
ⲍⲟⲣⲟⲃⲁⲃⲉⲗ	NPROP	ⲍⲟⲣⲟⲃⲁⲃⲉⲗ
ⲍⲩⲅⲓⲥⲕⲟⲛ	N	ⲍⲩⲅⲓⲥⲕⲟⲛ
ⲍⲱⲅⲣⲁⲫⲉⲓ	V	ⲍⲱⲅⲣⲁⲫⲉⲓ
ⲍⲱⲅⲣⲁⲫⲉⲓⲁ	N	ⲍⲱⲅⲣⲁⲫⲉⲓⲁ
ⲍⲱⲏ	N	ⲍⲱⲏ
ⲍⲱⲛⲏ	N	ⲍⲱⲛⲏ
ⲍⲱⲛⲧ	N	ⲍⲱⲛⲧ
ⲍⲱⲟⲛ	N	ⲍⲱⲟⲛ
ⲏ	CONJ	ⲏ
ⲏ	UNKOWN	ⲏ
ⲏϫⲓ	N	ⲏϫⲓ
ⲏⲇⲏ	ADV	ⲏⲇⲏ
ⲏⲓ	N	ⲏⲓ
ⲏⲛⲓⲟⲭⲟⲥ	N	ⲏⲛⲓⲟⲭⲟⲥ
ⲏⲝⲧⲁⲥⲓⲥ	N	ⲏⲝⲧⲁⲥⲓⲥ
ⲏⲟⲩ	N	ⲏⲓ
ⲏⲡ	VSTAT	ⲱⲡ
ⲏⲡⲥ	N	ⲏⲡⲥ
ⲏⲣⲉⲙⲓⲟⲥ	N	ⲏⲣⲉⲙⲓⲟⲥ
ⲏⲣⲉⲙⲟⲥ	N	ⲏⲣⲉⲙⲟⲥ
ⲏⲣⲡ	N	ⲏⲣⲡ
ⲏⲣⲱⲇⲓⲁⲛⲟⲥ	NPROP	ⲏⲣⲱⲇⲓⲁⲛⲟⲥ
ⲏⲥⲁⲓⲁⲥ	NPROP	ⲏⲥⲁⲓⲁⲥ
ⲏⲥⲁⲩ	NPROP	ⲏⲥⲁⲩ
ⲏⲥⲓⲭⲓⲁ	N	ⲏⲥⲓⲭⲓⲁ
ⲑϧⲙⲟ	V	ⲧϧⲙⲟ
ⲑⲁϣ	V	ⲑⲱϣ
ⲑⲁϥ	N	ⲑⲁϥ
ⲑⲁϥ	V	ⲑⲁϥ
ⲑⲁϧ	V	ⲧⲱϧ
ⲑⲁϧⲓ	VSTAT	ⲑⲓϧⲓ
ⲑⲁϩⲉⲙ	V	ⲑⲱϩⲉⲙ
ⲑⲁϩⲉⲙ	VSTAT	ⲑⲱϩⲉⲙ
ⲑⲁϩⲙ	V	ⲑⲱϩⲉⲙ
ⲑⲁϩⲙⲉ	V	ⲑⲱϩⲉⲙ
ⲑⲁϩⲥ	V	ⲑⲱϩⲥ
ⲑⲁϩⲥ	VSTAT	ⲑⲱϩⲥ
ⲑⲁⲇⲇⲁⲓⲟⲥ	N	ⲑⲁⲇⲇⲁⲓⲟⲥ
ⲑⲁⲇⲇⲉⲟⲥ	NPROP	ⲑⲁⲇⲇⲉⲟⲥ
ⲑⲁⲗⲁⲥⲥⲁ	N	ⲑⲁⲗⲁⲥⲥⲁ
ⲑⲁⲗⲓϩⲓ	N	ⲑⲁⲗⲓϩⲓ
ⲑⲁⲗⲗⲓⲥ	N	ⲑⲁⲗⲗⲓⲥ
ⲑⲁⲗⲡⲉⲓ	V	ⲑⲁⲗⲡⲉⲓ
ⲑⲁⲙ	VSTAT	ⲑⲱⲙ
ⲑⲁⲙⲓⲉ	V	ⲑⲁⲙⲓⲉ
ⲑⲁⲙⲓⲉ	V	ⲑⲁⲙⲓⲟ
ⲑⲁⲙⲓⲏⲟⲩⲧ	VSTAT	ⲑⲁⲙⲓⲟ
ⲑⲁⲙⲓⲟ	V	ⲑⲁⲙⲓⲟ
ⲑⲁⲛⲛⲟ	V	ⲑⲁⲛⲛⲟ
ⲑⲁⲡⲉⲛ	N	ⲑⲁⲡⲉⲛ
ⲑⲁⲣⲓ	V	ⲑⲁⲣⲓ
ⲑⲁⲣⲙⲓ	N	ⲑⲁⲣⲙⲓ
ⲑⲁⲧ	VSTAT	ⲑⲱⲧ
ⲑⲁⲩⲙⲁ	N	ⲑⲁⲩⲙⲁ
ⲑⲁⲩⲙⲁⲍⲉ	V	ⲑⲁⲩⲙⲁⲍⲉ
ⲑⲁⲩⲙⲁⲥⲓⲱⲧⲁⲧⲟⲥ	N	ⲑⲁⲩⲙⲁⲥⲓⲱⲧⲁⲧⲟⲥ
ⲑⲁⲩⲙⲁⲥⲧⲟⲛ	N	ⲑⲁⲩⲙⲁⲥⲧⲟⲛ
ⲑⲃⲁ	NUM	ⲑⲃⲁ
ⲑⲃⲁⲓ	N	ⲑⲟⲩⲁⲓ
ⲑⲃⲏⲗ	N	ⲑⲃⲏⲗ
ⲑⲉϣ	V	ⲑⲱϣ
ⲑⲉϧ	V	ⲧⲱϧ
ⲑⲉϧⲑⲱϧ	V	ⲑⲟϧⲧⲉϧ
ⲑⲉϩ	V	ⲧⲱϧ
ⲑⲉⲁⲧⲣⲟⲛ	N	ⲑⲉⲁⲧⲣⲟⲛ
ⲑⲉⲃⲇⲟⲙⲁⲥ	N	ⲑⲉⲃⲇⲟⲙⲁⲥ
ⲑⲉⲃⲓ	N	ⲧⲁⲓⲃⲓ
ⲑⲉⲃⲓⲏⲟⲩⲧ	VSTAT	ⲑⲉⲃⲓⲟ
ⲑⲉⲃⲓⲟ	V	ⲑⲉⲃⲓⲟ
ⲑⲉⲃⲟⲃⲟⲗⲏ	N	ⲑⲉⲃⲟⲃⲟⲗⲏ
ⲑⲉⲃⲥ	N	ⲑⲓⲃⲥ
ⲑⲉⲓⲟⲛ	N	ⲑⲉⲓⲟⲛ
ⲑⲉⲓⲟⲥ	N	ⲑⲉⲓⲟⲥ
ⲑⲉⲕⲉⲙ	V	ⲑⲱⲕⲉⲙ
ⲑⲉⲗⲏⲗ	V	ⲑⲉⲗⲏⲗ
ⲑⲉⲗⲏⲙⲁ	N	ⲑⲉⲗⲏⲙⲁ
ⲑⲉⲙ	V	ⲑⲱⲙ
ⲑⲉⲙⲙⲟ	V	ⲧϧⲙⲟ
ⲑⲉⲙⲥ	V	ⲑⲱⲙⲥ
ⲑⲉⲛⲓ	V	ⲑⲏⲛⲓ
ⲑⲉⲟⲇⲟⲕⲟⲥ	N	ⲑⲉⲟⲇⲟⲕⲟⲥ
ⲑⲉⲟⲇⲱⲣ	NPROP	ⲑⲉⲟⲇⲱⲣ
ⲑⲉⲟⲇⲱⲣⲟⲥ	NPROP	ⲑⲉⲟⲇⲱⲣⲟⲥ
ⲑⲉⲟⲇⲱⲥⲓⲟⲥ	NPROP	ⲑⲉⲟⲇⲱⲥⲓⲟⲥ
ⲑⲉⲟⲗⲟⲅⲓⲁ	N	ⲑⲉⲟⲗⲟⲅⲓⲁ
ⲑⲉⲟⲗⲟⲅⲟⲥ	N	ⲑⲉⲟⲗⲟⲅⲟⲥ
ⲑⲉⲟⲥⲉⲃⲉⲓⲁ	N	ⲑⲉⲟⲥⲉⲃⲉⲓⲁ
ⲑⲉⲟⲥⲉⲃⲉⲥⲧⲁⲧⲟⲥ	N	ⲑⲉⲟⲥⲉⲃⲉⲥⲧⲁⲧⲟⲥ
ⲑⲉⲟⲥⲥⲉⲃⲏⲥ	N	ⲑⲉⲟⲥⲥⲉⲃⲏⲥ
ⲑⲉⲟⲧⲟⲕⲟⲥ	N	ⲑⲉⲟⲧⲟⲕⲟⲥ
ⲑⲉⲟⲧⲟⲕⲟⲥ	NPROP	ⲑⲉⲟⲧⲟⲕⲟⲥ
ⲑⲉⲟⲫⲓⲗⲉⲥⲧⲁⲧⲟⲥ	N	ⲑⲉⲟⲫⲓⲗⲉⲥⲧⲁⲧⲟⲥ
ⲑⲉⲟⲫⲓⲗⲓⲁ	N	ⲑⲉⲟⲫⲓⲗⲓⲁ
ⲑⲉⲟⲫⲓⲗⲟⲥ	NPROP	ⲑⲉⲟⲫⲓⲗⲟⲥ
ⲑⲉⲟⲫⲟⲣⲟⲥ	N	ⲑⲉⲟⲫⲟⲣⲟⲥ
ⲑⲉⲣϣ	N	ⲑⲉⲣϣ
ⲑⲉⲣϣⲟ	V	ⲑⲉⲣϣⲟ
ⲑⲉⲣⲁⲡⲉⲩⲉ	V	ⲑⲉⲣⲁⲡⲉⲩⲉ
ⲑⲉⲣⲁⲡⲓⲁ	N	ⲑⲉⲣⲁⲡⲓⲁ
ⲑⲉⲣⲁⲡⲟⲩ	V	ⲑⲉⲣⲁⲡⲟⲩ
ⲑⲉⲣⲙⲟⲫⲩⲗⲁⲕⲉ	N	ⲑⲉⲣⲙⲟⲫⲩⲗⲁⲕⲉ
ⲑⲉⲣⲡ	V	ⲑⲱⲣⲡ
ⲑⲉⲥⲃⲓⲧⲏⲥ	N	ⲑⲉⲥⲃⲓⲧⲏⲥ
ⲑⲉⲥⲓⲥ	N	ⲑⲉⲥⲓⲥ
ⲑⲉⲧ	V	ⲑⲱⲧ
ⲑⲉⲱⲇⲱⲣⲟⲥ	NPROP	ⲑⲉⲱⲇⲱⲣⲟⲥ
ⲑⲉⲱⲣⲉⲓ	V	ⲑⲉⲱⲣⲉⲓ
ⲑⲉⲱⲣⲓⲁ	N	ⲑⲉⲱⲣⲓⲁ
ⲑⲉⲱⲫⲓⲗⲟⲥ	NPROP	ⲑⲉⲱⲫⲓⲗⲟⲥ
ⲑⲏ	PDEM	ⲫⲏ
ⲑⲏϣ	VSTAT	ⲑⲱϣ
ⲑⲏϥ	N	ⲑⲁϥ
ⲑⲏⲃⲁⲉⲓⲥ	NPROP	ⲑⲏⲃⲁⲉⲓⲥ
ⲑⲏⲃⲓ	N	ⲧⲁⲓⲃⲓ
ⲑⲏⲕ	VSTAT	ⲑⲏⲕ
ⲑⲏⲗⲩⲕⲟⲛ	N	ⲑⲏⲗⲩⲕⲟⲛ
ⲑⲏⲙ	VSTAT	ⲑⲱⲙ
ⲑⲏⲙ	VSTAT	ⲧⲏⲙ
ⲑⲏⲛ	N	ⲑⲏⲛ
ⲑⲏⲛⲓ	V	ⲑⲏⲛⲓ
ⲑⲏⲛⲟⲩ	PPERO	ⲛⲑⲱⲧⲉⲛ
ⲑⲏⲟⲩ	N	ⲑⲏⲟⲩ
ⲑⲏⲣϣ	N	ⲑⲉⲣϣ
ⲑⲏⲣⲓⲟⲛ	N	ⲑⲏⲣⲓⲟⲛ
ⲑⲏⲥⲁⲩⲣⲟⲥ	N	ⲑⲏⲥⲁⲩⲣⲟⲥ
ⲑⲏⲥⲅⲉ	N	ⲑⲏⲥⲅⲉ
ⲑⲏⲧ	VSTAT	ⲑⲱⲧ
ⲑⲓϥⲓ	N	ⲑⲓϥⲓ
ⲑⲓϧⲓ	V	ⲑⲓϧⲓ
ⲑⲓⲃⲥ	N	ⲑⲓⲃⲥ
ⲑⲗⲏ	V	ⲑⲗⲏ
ⲑⲗⲓⲃⲉ	V	ⲑⲗⲓⲃⲉ
ⲑⲗⲓⲑⲗⲓⲯⲓⲥ	N	ⲑⲗⲓⲑⲗⲓⲯⲓⲥ
ⲑⲗⲓⲯⲓⲥ	N	ⲑⲗⲓⲯⲓⲥ
ⲑⲗⲟⲙ	N	ⲑⲗⲟⲙ
ⲑⲗⲱⲙ	N	ⲑⲗⲟⲙ
ⲑⲙⲁⲓⲉ	V	ⲑⲙⲁⲓⲟ
ⲑⲙⲁⲓⲏⲟⲩⲧ	VSTAT	ⲑⲙⲁⲓⲟ
ⲑⲙⲁⲓⲟ	V	ⲑⲙⲁⲓⲟ
ⲑⲙⲏ	N	ⲑⲙⲏ
ⲑⲙⲏⲓ	N	ⲑⲙⲏⲓ
ⲑⲙⲓⲥ	N	ⲑⲙⲓⲥ
ⲑⲛⲏⲧⲟⲛ	N	ⲑⲛⲏⲧⲟⲛ
ⲑⲟ	N	ⲑⲟ
ⲑⲟϥⲧⲉϥ	V	ⲑⲟϥⲧⲉϥ
ⲑⲟϧⲧⲉϧ	V	ⲑⲟϧⲧⲉϧ
ⲑⲟϩ	N	ⲧⲟϩ
ⲑⲟϩ	V	ⲑⲟϩ
ⲑⲟϩ	V	ⲧϩⲟ
ⲑⲟϩ	V	ⲧⲱϧ
ⲑⲟⲓ	N	ⲑⲟⲓ
ⲑⲟⲕ	N	ⲑⲟⲕ
ⲑⲟⲕ	N	ⲑⲱⲕ
ⲑⲟⲕⲉⲙ	VSTAT	ⲑⲱⲕⲉⲙ
ⲑⲟⲕⲥ	V	ⲧⲱⲧⲥ
ⲑⲟⲕⲥ	VSTAT	ⲧⲱⲧⲥ
ⲑⲟⲗ	N	ⲑⲟⲗ
ⲑⲟⲗⲃ	V	ⲑⲱⲗⲉⲃ
ⲑⲟⲗⲉⲃ	VSTAT	ⲑⲱⲗⲉⲃ
ⲑⲟⲗⲙ	V	ⲑⲱⲗⲉⲃ
ⲑⲟⲗⲟⲥ	N	ⲑⲟⲗⲟⲥ
ⲑⲟⲗⲥ	V	ⲑⲱⲗⲥ
ⲑⲟⲙ	N	ⲑⲟⲙ
ⲑⲟⲙ	V	ⲑⲱⲙ
ⲑⲟⲙⲥ	V	ⲑⲱⲙⲥ
ⲑⲟⲙⲥ	VSTAT	ⲑⲱⲙⲥ
ⲑⲟⲙⲧⲉⲙ	V	ⲑⲟⲙⲧⲉⲙ
ⲑⲟⲛⲧⲉⲛ	V	ⲑⲟⲛⲧⲉⲛ
ⲑⲟⲧⲥ	VSTAT	ⲧⲱⲧⲥ
ⲑⲟⲩ	N	ⲑⲏⲟⲩ
ⲑⲟⲩⲁⲓ	N	ⲑⲟⲩⲁⲓ
ⲑⲟⲩⲉⲗⲟ	V	ⲑⲟⲩⲉⲗⲟ
ⲑⲟⲩⲉⲧ	V	ⲑⲱⲟⲩϯ
ⲑⲟⲩⲏⲧ	VSTAT	ⲑⲱⲟⲩϯ
ⲑⲟⲩⲑⲟⲩ	V	ⲑⲟⲩⲑⲟⲩ
ⲑⲟⲩⲕⲥ	V	ⲧⲱⲧⲥ
ⲑⲟⲩⲙⲉ	N	ⲑⲟⲩⲙⲉ
ⲑⲟⲩⲝ	V	ⲧⲱⲧⲥ
ⲑⲟⲩⲟϯ	N	ⲑⲟⲩⲱⲧ
ⲑⲟⲩⲣⲁϫⲓ	N	ⲑⲟⲩⲣⲁϫⲓ
ⲑⲟⲩⲣⲁⲕⲓⲟⲛ	N	ⲑⲟⲩⲣⲁⲕⲓⲟⲛ
ⲑⲟⲩⲥ	N	ⲑⲟⲩⲥ
ⲑⲟⲩⲱ	N	ⲑⲟⲩⲱ
ⲑⲟⲩⲱⲧ	N	ⲑⲟⲩⲱⲧ
ⲑⲟⲩⲱⲧ	V	ⲑⲱⲟⲩϯ
ⲑⲣ	ACAUS	ⲑⲣⲉ
ⲑⲣⲁⲛ	N	ⲑⲣⲁⲛ
ⲑⲣⲉ	ACAUS	ⲑⲣⲉ
ⲑⲣⲏⲃ	N	ⲑⲣⲏⲃ
ⲑⲣⲓⲙ	N	ⲑⲣⲓⲙ
ⲑⲣⲓⲣ	N	ⲑⲣⲓⲣ
ⲑⲣⲓⲥⲕⲓⲁ	N	ⲑⲣⲓⲥⲕⲓⲁ
ⲑⲣⲟ	ACAUS	ⲑⲣⲉ
ⲑⲣⲟ	V	ⲑⲣⲟ
ⲑⲣⲟⲛⲟⲥ	N	ⲑⲣⲟⲛⲟⲥ
ⲑⲩⲕⲏ	N	ⲑⲩⲕⲏ
ⲑⲩⲗⲓⲕⲓⲁ	N	ⲑⲩⲗⲓⲕⲓⲁ
ⲑⲩⲙⲓⲁⲧⲏⲣⲓⲟⲛ	N	ⲑⲩⲙⲓⲁⲧⲏⲣⲓⲟⲛ
ⲑⲩⲙⲟⲥ	N	ⲑⲩⲙⲟⲥ
ⲑⲩⲡⲟⲩⲣⲅⲓⲁ	N	ⲑⲩⲡⲟⲩⲣⲅⲓⲁ
ⲑⲩⲣⲟⲣⲟⲥ	N	ⲑⲩⲣⲟⲣⲟⲥ
ⲑⲩⲥⲁⲩⲣⲟⲥ	N	ⲑⲩⲥⲁⲩⲣⲟⲥ
ⲑⲩⲥⲓⲁ	N	ⲑⲩⲥⲓⲁ
ⲑⲩⲥⲓⲁⲍⲉ	V	ⲑⲩⲥⲓⲁⲍⲉ
ⲑⲩⲥⲓⲁⲥⲧⲏⲣⲓⲟⲛ	N	ⲑⲩⲥⲓⲁⲥⲧⲏⲣⲓⲟⲛ
ⲑⲱ	N	ⲫⲱ
ⲑⲱϣ	V	ⲑⲱϣ
ⲑⲱϣⲡ	V	ⲑⲱⲃϣ
ⲑⲱϥ	PPOS	ⲫⲱϥ
ⲑⲱϩⲉⲙ	V	ⲑⲱϩⲉⲙ
ⲑⲱϩⲥ	V	ⲑⲱϩⲥ
ⲑⲱϯ	N	ⲑⲱϯ
ⲑⲱⲃϣ	V	ⲑⲱⲃϣ
ⲑⲱⲃⲓ	N	ⲑⲱⲃⲓ
ⲑⲱⲓ	PPOS	ⲫⲱⲓ
ⲑⲱⲕ	N	ⲑⲟⲕ
ⲑⲱⲕ	N	ⲑⲱⲕ
ⲑⲱⲕ	PPOS	ⲫⲱⲕ
ⲑⲱⲕ	V	ⲑⲱⲕ
ⲑⲱⲕⲉⲙ	V	ⲑⲱⲕⲉⲙ
ⲑⲱⲗⲉⲃ	V	ⲑⲱⲗⲉⲃ
ⲑⲱⲗⲥ	V	ⲑⲱⲗⲥ
ⲑⲱⲙ	N	ⲑⲱⲙ
ⲑⲱⲙ	V	ⲑⲱⲙ
ⲑⲱⲙⲁⲥ	NPROP	ⲑⲱⲙⲁⲥ
ⲑⲱⲙⲥ	V	ⲑⲱⲙⲥ
ⲑⲱⲛ	PINT	ⲑⲱⲛ
ⲑⲱⲛ	PPOS	ⲫⲱⲛ
ⲑⲱⲟⲩϯ	V	ⲑⲱⲟⲩϯ
ⲑⲱⲟⲩⲓ	N	ⲑⲱⲟⲩⲓ
ⲑⲱⲟⲩⲧ	N	ⲑⲱⲟⲩⲧ
ⲑⲱⲣϣ	V	ⲑⲱⲣϣ
ⲑⲱⲣⲓ	N	ⲑⲱⲣⲓ
ⲑⲱⲣⲡ	V	ⲑⲱⲣⲡ
ⲑⲱⲥ	PPOS	ⲫⲱⲥ
ⲑⲱⲧ	V	ⲑⲱⲧ
ⲓ	PPERO	ⲁⲛⲟⲕ
ⲓ	PPERS	ⲁⲛⲟⲕ
ⲓ	V	ⲓ
ⲓϣ	N	ⲓϣ
ⲓϣⲓ	V	ⲓϣⲓ
ⲓϧ	N	ⲓϧ
ⲓⲁ	N	ⲓⲁ
ⲓⲁ	N	ⲓⲱ
ⲓⲁ	V	ⲓⲱⲓ
ⲓⲁϩ	N	ⲓⲟϩⲓ
ⲓⲁⲃⲓ	N	ⲓⲁⲃⲓ
ⲓⲁⲉⲓⲣⲟⲥ	N	ⲓⲁⲉⲓⲣⲟⲥ
ⲓⲁⲕⲱⲃⲟⲥ	NPROP	ⲓⲁⲕⲱⲃⲟⲥ
ⲓⲁⲗ	N	ⲓⲁⲗ
ⲓⲁⲣⲟ	N	ⲓⲁⲣⲟ
ⲓⲁⲥⲡⲓⲥ	N	ⲓⲁⲥⲡⲓⲥ
ⲓⲁⲧ	N	ⲓⲉⲣ
ⲓⲁⲩ	N	ⲓⲁⲩ
ⲓⲁⲱ	N	ⲓⲱ
ⲓⲃ	NUM	ⲓⲃ
ⲓⲃⲉⲣⲟⲥ	N	ⲓⲃⲉⲣⲟⲥ
ⲓⲃⲓ	V	ⲓⲃⲓ
ⲓⲇⲟⲩⲙⲁⲓⲁ	N	ⲓⲇⲟⲩⲙⲁⲓⲁ
ⲓⲇⲟⲩⲙⲁⲓⲟⲥ	N	ⲓⲇⲟⲩⲙⲁⲓⲟⲥ
ⲓⲉ	ADV	ⲓⲉ
ⲓⲉ	CONJ	ⲓⲉ
ⲓⲉⲃ	N	ⲓⲉⲃ
ⲓⲉⲃ	N	ⲓⲟⲡⲏ
ⲓⲉⲃⲧ	N	ⲉⲓⲉⲃⲧ
ⲓⲉⲡ	N	ⲓⲟⲡⲏ
ⲓⲉⲣ	N	ⲓⲉⲣ
ⲓⲉⲣⲟⲥⲁⲗⲏⲙ	NPROP	ⲓⲉⲣⲟⲥⲁⲗⲏⲙ
ⲓⲉⲣⲟⲯⲁⲗⲧⲏⲥ	N	ⲓⲉⲣⲟⲯⲁⲗⲧⲏⲥ
ⲓⲉⲥⲥⲁⲓ	NPROP	ⲓⲉⲥⲥⲁⲓ
ⲓⲉⲫ	N	ⲓⲟⲡⲏ
ⲓⲉⲫⲟⲩⲱⲓ	N	ⲓⲉⲫⲟⲩⲱⲓ
ⲓⲏⲃ	N	ⲓⲉⲃ
ⲓⲏⲃ	N	ⲓⲟⲡⲏ
ⲓⲏⲥ	VSTAT	ⲓⲱⲥ
ⲓⲏⲥⲟⲩⲥ	NPROP	ⲓⲏⲥⲟⲩⲥ
ⲓⲕⲧⲉⲣⲟⲥ	N	ⲓⲕⲧⲉⲣⲟⲥ
ⲓⲛⲁ	ADV	ⲓⲛⲁ
ⲓⲛⲓ	N	ⲓⲛⲓ
ⲓⲛⲓ	V	ⲓⲛⲓ
ⲓⲟϩ	N	ⲓⲟϩ
ⲓⲟϩⲓ	N	ⲓⲟϩⲓ
ⲓⲟϩⲓ	N	ⲟϩⲓ
ⲓⲟϯ	N	ⲓⲱⲧ
ⲓⲟⲙ	N	ⲓⲟⲙ
ⲓⲟⲡⲏ	N	ⲓⲟⲡⲏ
ⲓⲟⲡⲓ	N	ⲓⲟⲡⲏ
ⲓⲟⲣ	N	ⲓⲟⲣ
ⲓⲟⲣⲇⲁⲛⲏ	N	ⲓⲟⲣⲇⲁⲛⲏ
ⲓⲟⲣⲇⲁⲛⲏⲥ	NPROP	ⲓⲟⲣⲇⲁⲛⲏⲥ
ⲓⲟⲣⲉⲙ	VSTAT	ⲓⲱⲣⲉⲙ
ⲓⲟⲩⲇⲁ	NPROP	ⲓⲟⲩⲇⲁ
ⲓⲟⲩⲇⲁⲓ	N	ⲓⲟⲩⲇⲁⲓ
ⲓⲟⲩⲇⲁⲓ	NPROP	ⲓⲟⲩⲇⲁⲓ
ⲓⲟⲩⲇⲁⲓⲁ	N	ⲓⲟⲩⲇⲁⲓⲁ
ⲓⲟⲩⲇⲁⲓⲁ	NPROP	ⲓⲟⲩⲇⲁⲓⲁ
ⲓⲟⲩⲇⲁⲓⲟⲥ	N	ⲓⲟⲩⲇⲁⲓⲟⲥ
ⲓⲟⲩⲇⲁⲥ	NPROP	ⲓⲟⲩⲇⲁⲥ
ⲓⲟⲩⲇⲉⲁ	NPROP	ⲓⲟⲩⲇⲉⲁ
ⲓⲟⲩⲗⲓⲁⲛⲟⲥ	NPROP	ⲓⲟⲩⲗⲓⲁⲛⲟⲥ
ⲓⲟⲩⲗⲓⲟⲥ	NPROP	ⲓⲟⲩⲗⲓⲟⲥ
ⲓⲣⲏⲛⲏ	N	ⲓⲣⲏⲛⲏ
ⲓⲣⲓ	V	ⲓⲣⲓ
ⲓⲥ	PTC	ⲓⲥ
ⲓⲥϫⲉⲛ	PREP	ⲓⲥϫⲉⲛ
ⲓⲥⲁⲁⲕ	NPROP	ⲓⲥⲁⲁⲕ
ⲓⲥⲕⲁⲣⲓⲱⲧⲏⲥ	NPROP	ⲓⲥⲕⲁⲣⲓⲱⲧⲏⲥ
ⲓⲥⲙⲁⲏⲗ	NPROP	ⲓⲥⲙⲁⲏⲗ
ⲓⲥⲙⲁⲏⲗⲓⲧⲏⲥ	N	ⲓⲥⲙⲁⲏⲗⲓⲧⲏⲥ
ⲓⲥⲟⲯⲩⲭⲟⲛ	N	ⲓⲥⲟⲯⲩⲭⲟⲛ
ⲓⲥⲣⲁⲏⲗ	NPROP	ⲓⲥⲣⲁⲏⲗ
ⲓⲥⲣⲁⲏⲗⲓⲧⲏⲥ	N	ⲓⲥⲣⲁⲏⲗⲓⲧⲏⲥ
ⲓⲥⲧⲟⲣⲓⲁ	N	ⲓⲥⲧⲟⲣⲓⲁ
ⲓⲧⲁ	ADV	ⲓⲧⲁ
ⲓⲧⲉⲛ	N	ⲓⲧⲉⲛ
ⲓⲭⲛⲟⲥ	N	ⲓⲭⲛⲟⲥ
ⲓⲱ	N	ⲓⲱ
ⲓⲱ	V	ⲓⲱⲓ
ⲓⲱϩⲁⲛⲏⲥ	NPROP	ⲓⲱϩⲁⲛⲏⲥ
ⲓⲱϩⲁⲛⲛⲏⲥ	N	ⲓⲱϩⲁⲛⲛⲏⲥ
ⲓⲱϩⲁⲛⲛⲏⲥ	NPROP	ⲓⲱϩⲁⲛⲛⲏⲥ
ⲓⲱϯ	N	ⲓⲱϯ
ⲓⲱⲁⲛⲛⲏⲥ	NPROP	ⲓⲱⲁⲛⲛⲏⲥ
ⲓⲱⲃ	NPROP	ⲓⲱⲃ
ⲓⲱⲃⲏⲇ	NPROP	ⲓⲱⲃⲏⲇ
ⲓⲱⲓ	V	ⲓⲱⲓ
ⲓⲱⲟⲩ	VSTAT	ⲓⲱⲓ
ⲓⲱⲣϩ	V	ⲓⲱⲣϩ
ⲓⲱⲣⲉⲙ	V	ⲓⲱⲣⲉⲙ
ⲓⲱⲥ	V	ⲓⲱⲥ
ⲓⲱⲥⲏ	N	ⲓⲱⲥⲏ
ⲓⲱⲥⲏ	NPROP	ⲓⲱⲥⲏ
ⲓⲱⲥⲏⲫ	NPROP	ⲓⲱⲥⲏⲫ
ⲓⲱⲥⲓⲁⲥ	NPROP	ⲓⲱⲥⲓⲁⲥ
ⲓⲱⲧ	N	ⲓⲱⲧ
ⲕ	PPERO	ⲛⲑⲟⲕ
ⲕ	PPERS	ⲛⲑⲟⲕ
ⲕⲁϣ	N	ⲕⲁϣ
ⲕⲁϣ	V	ⲕⲱϣ
ⲕⲁϣⲟⲩ	N	ⲕⲁϣⲟⲩ
ⲕⲁϣⲟⲩⲗⲓ	N	ⲕⲁϣⲟⲩⲗⲓ
ⲕⲁϩ	N	ⲕⲉϩ
ⲕⲁϩ	V	ⲕⲁϩ
ⲕⲁϩⲓ	N	ⲕⲁϩⲓ
ⲕⲁϫⲓ	N	ⲕⲁϫⲓ
ⲕⲁϯ	V	ⲕⲁϯ
ⲕⲁⲃⲁⲓ	N	ⲕⲁⲃⲁⲓ
ⲕⲁⲃⲓ	N	ⲕⲏⲃⲓ
ⲕⲁⲃⲓⲧⲁⲣⲉ	N	ⲕⲁⲃⲓⲧⲁⲣⲉ
ⲕⲁⲇⲁⲝⲓⲁⲣⲭⲏⲥ	N	ⲕⲁⲇⲁⲝⲓⲁⲣⲭⲏⲥ
ⲕⲁⲍⲟⲫⲩⲗⲁⲅⲓⲟⲛ	N	ⲕⲁⲍⲟⲫⲩⲗⲁⲅⲓⲟⲛ
ⲕⲁⲑⲁⲓⲣⲉⲥⲓⲥ	N	ⲕⲁⲑⲁⲓⲣⲉⲥⲓⲥ
ⲕⲁⲑⲁⲓⲣⲟⲩ	V	ⲕⲁⲑⲁⲓⲣⲟⲩ
ⲕⲁⲑⲁⲣⲓⲍⲉ	V	ⲕⲁⲑⲁⲣⲓⲍⲉ
ⲕⲁⲑⲁⲣⲓⲥⲙⲟⲥ	N	ⲕⲁⲑⲁⲣⲓⲥⲙⲟⲥ
ⲕⲁⲑⲁⲣⲓⲱⲧⲏⲥ	N	ⲕⲁⲑⲁⲣⲓⲱⲧⲏⲥ
ⲕⲁⲑⲁⲣⲟⲛ	N	ⲕⲁⲑⲁⲣⲟⲛ
ⲕⲁⲑⲁⲣⲟⲥ	N	ⲕⲁⲑⲁⲣⲟⲥ
ⲕⲁⲑⲉⲇⲣⲁ	N	ⲕⲁⲑⲉⲇⲣⲁ
ⲕⲁⲑⲉⲇⲣⲟⲥ	N	ⲕⲁⲑⲉⲇⲣⲟⲥ
ⲕⲁⲑⲏⲅⲓ	V	ⲕⲁⲑⲏⲅⲓ
ⲕⲁⲑⲏⲕⲏⲥⲓⲥ	N	ⲕⲁⲑⲏⲕⲏⲥⲓⲥ
ⲕⲁⲑⲏⲕⲟⲩⲙⲉⲛⲓⲧⲏⲥ	N	ⲕⲁⲑⲏⲕⲟⲩⲙⲉⲛⲓⲧⲏⲥ
ⲕⲁⲑⲏⲕⲟⲩⲙⲉⲛⲟⲥ	N	ⲕⲁⲑⲏⲕⲟⲩⲙⲉⲛⲟⲥ
ⲕⲁⲑⲓⲥⲧⲁ	V	ⲕⲁⲑⲓⲥⲧⲁ
ⲕⲁⲑⲟⲗⲓⲕⲏ	N	ⲕⲁⲑⲟⲗⲓⲕⲏ
ⲕⲁⲑⲟⲗⲓⲕⲟⲛ	N	ⲕⲁⲑⲟⲗⲓⲕⲟⲛ
ⲕⲁⲑⲟⲧⲓ	ADV	ⲕⲁⲑⲟⲧⲓ
ⲕⲁⲓ	CONJ	ⲕⲁⲓ
ⲕⲁⲓⲅⲁⲣ	CONJ	ⲕⲁⲓⲅⲁⲣ
ⲕⲁⲓⲕⲟⲛ	N	ⲕⲁⲓⲕⲟⲛ
ⲕⲁⲓⲛⲏ	N	ⲕⲁⲓⲛⲏ
ⲕⲁⲓⲡⲉⲣ	CONJ	ⲕⲁⲓⲡⲉⲣ
ⲕⲁⲓⲣⲟⲥ	N	ⲕⲁⲓⲣⲟⲥ
ⲕⲁⲓⲥⲁⲣ	N	ⲕⲁⲓⲥⲁⲣ
ⲕⲁⲓⲧⲟⲓ	CONJ	ⲕⲁⲓⲧⲟⲓ
ⲕⲁⲕ	VSTAT	ⲕⲱⲕ
ⲕⲁⲕⲑⲓ	N	ⲕⲁⲕⲑⲓ
ⲕⲁⲕⲓⲁ	N	ⲕⲁⲕⲓⲁ
ⲕⲁⲕⲓⲛⲕⲁⲕⲱⲥ	ADV	ⲕⲁⲕⲓⲛⲕⲁⲕⲱⲥ
ⲕⲁⲕⲕⲁⲙⲁⲩ	N	ⲭⲁⲕⲕⲁⲙⲁⲩ
ⲕⲁⲕⲟⲅⲏⲣⲟⲥ	N	ⲕⲁⲕⲟⲅⲏⲣⲟⲥ
ⲕⲁⲕⲟⲏⲑⲉⲓⲁ	N	ⲕⲁⲕⲟⲏⲑⲉⲓⲁ
ⲕⲁⲕⲟⲓ	N	ⲕⲁⲕⲟⲓ
ⲕⲁⲕⲟⲛ	N	ⲕⲁⲕⲟⲛ
ⲕⲁⲕⲟⲛⲟⲓⲁ	N	ⲕⲁⲕⲟⲛⲟⲓⲁ
ⲕⲁⲕⲟⲥ	N	ⲕⲁⲕⲟⲥ
ⲕⲁⲕⲟⲩ	V	ⲕⲁⲕⲟⲩ
ⲕⲁⲕⲟⲩⲣⲅⲓⲁ	N	ⲕⲁⲕⲟⲩⲣⲅⲓⲁ
ⲕⲁⲕⲟⲩⲣⲅⲟⲥ	N	ⲕⲁⲕⲟⲩⲣⲅⲟⲥ
ⲕⲁⲕⲥⲉϩⲧ	N	ⲕⲁⲕⲥⲉϩⲧ
ⲕⲁⲕⲧⲓ	N	ⲕⲁⲕⲑⲓ
ⲕⲁⲕⲱⲓ	N	ⲕⲁⲕⲟⲓ
ⲕⲁⲕⲱⲥ	ADV	ⲕⲁⲕⲱⲥ
ⲕⲁⲕⲱⲥⲓⲥ	N	ⲕⲁⲕⲱⲥⲓⲥ
ⲕⲁⲗ	N	ⲕⲉⲗⲓ
ⲕⲁⲗⲁⲉⲓⲛⲟⲥ	N	ⲕⲁⲗⲁⲉⲓⲛⲟⲥ
ⲕⲁⲗⲁⲕⲓⲁ	N	ⲕⲁⲗⲁⲕⲓⲁ
ⲕⲁⲗⲁⲙⲁⲣⲓⲟⲛ	N	ⲕⲁⲗⲁⲙⲁⲣⲓⲟⲛ
ⲕⲁⲗⲁⲙⲫⲟ	N	ⲕⲁⲗⲁⲙⲫⲟ
ⲕⲁⲗⲁⲙⲫⲱⲟⲩ	N	ⲕⲁⲗⲁⲙⲫⲟ
ⲕⲁⲗⲉⲓ	V	ⲕⲁⲗⲉⲓ
ⲕⲁⲗⲏ	N	ⲁⲕⲗⲏ
ⲕⲁⲗⲕ	N	ⲁⲕⲗⲏ
ⲕⲁⲗⲗⲁⲉⲓⲛⲏ	N	ⲕⲁⲗⲗⲁⲉⲓⲛⲏ
ⲕⲁⲗⲗⲓⲅⲣⲁⲫⲟⲥ	N	ⲕⲁⲗⲗⲓⲅⲣⲁⲫⲟⲥ
ⲕⲁⲗⲗⲓⲛⲓⲕⲟⲥ	N	ⲕⲁⲗⲗⲓⲛⲓⲕⲟⲥ
ⲕⲁⲗⲗⲟⲥ	N	ⲕⲁⲗⲗⲟⲥ
ⲕⲁⲗⲟⲥ	ADV	ⲕⲁⲗⲟⲥ
ⲕⲁⲗⲟⲩⲕⲓ	N	ⲕⲁⲗⲟⲩⲕⲓ
ⲕⲁⲗⲡ	VSTAT	ⲕⲱⲗⲡ
ⲕⲁⲗⲧ	V	ⲕⲁⲗⲧ
ⲕⲁⲗⲩⲙⲙⲁ	N	ⲕⲁⲗⲩⲙⲙⲁ
ⲕⲁⲗⲩⲡⲧⲟⲥ	N	ⲕⲁⲗⲩⲡⲧⲟⲥ
ⲕⲁⲗⲱⲥ	ADV	ⲕⲁⲗⲱⲥ
ⲕⲁⲙ	N	ⲕⲁⲙ
ⲕⲁⲙⲁⲇⲓⲟⲛ	N	ⲕⲁⲙⲁⲇⲓⲟⲛ
ⲕⲁⲙⲁⲣⲉ	N	ⲕⲁⲙⲁⲣⲉ
ⲕⲁⲙⲃⲏ	N	ⲕⲁⲙⲃⲏ
ⲕⲁⲙⲓⲛⲟⲥ	N	ⲕⲁⲙⲓⲛⲟⲥ
ⲕⲁⲙⲓⲥⲓⲟⲛ	N	ⲕⲁⲙⲓⲥⲓⲟⲛ
ⲕⲁⲙⲡⲓ	N	ⲕⲁⲙⲡⲓ
ⲕⲁⲛ	CONJ	ⲕⲁⲛ
ⲕⲁⲛⲁⲛⲁⲓⲟⲥ	N	ⲕⲁⲛⲁⲛⲁⲓⲟⲥ
ⲕⲁⲛⲁⲛⲉⲟⲥ	NPROP	ⲕⲁⲛⲁⲛⲉⲟⲥ
ⲕⲁⲛⲁⲛⲓⲧⲏⲥ	N	ⲕⲁⲛⲁⲛⲓⲧⲏⲥ
ⲕⲁⲛⲟⲩϥⲓ	N	ⲕⲁⲛⲟⲩϥⲓ
ⲕⲁⲛⲱⲛ	N	ⲕⲁⲛⲱⲛ
ⲕⲁⲛⲱⲛⲓⲍⲉ	V	ⲕⲁⲛⲱⲛⲓⲍⲉ
ⲕⲁⲟⲩⲣⲓ	N	ⲕⲟⲩⲣ
ⲕⲁⲡ	N	ⲕⲁⲡ
ⲕⲁⲡϣⲟ	N	ⲕⲁⲡϣⲱ
ⲕⲁⲡϣⲱ	N	ⲕⲁⲡϣⲱ
ⲕⲁⲡⲁⲣⲛⲁⲟⲩⲙ	NPROP	ⲕⲁⲡⲁⲣⲛⲁⲟⲩⲙ
ⲕⲁⲡⲏⲗⲟⲥ	N	ⲕⲁⲡⲏⲗⲟⲥ
ⲕⲁⲡⲛⲓⲍⲉ	V	ⲕⲁⲡⲛⲓⲍⲉ
ⲕⲁⲡⲛⲟⲥ	N	ⲕⲁⲡⲛⲟⲥ
ⲕⲁⲣϫ	V	ⲕⲱⲣϫ
ⲕⲁⲣⲁⲡⲏⲡ	N	ⲕⲁⲣⲁⲡⲏⲡ
ⲕⲁⲣⲁⲡⲓⲡ	N	ⲕⲁⲣⲁⲡⲏⲡ
ⲕⲁⲣⲓ	N	ⲕⲁⲣⲓ
ⲕⲁⲣⲟⲓⲁ	N	ⲕⲁⲣⲟⲓⲁ
ⲕⲁⲣⲟⲩⲥ	N	ⲕⲁⲣⲟⲩⲥ
ⲕⲁⲣⲡⲟⲥ	N	ⲕⲁⲣⲡⲟⲥ
ⲕⲁⲣⲡⲟⲥ	NPROP	ⲕⲁⲣⲡⲟⲥ
ⲕⲁⲣⲡⲟⲫⲟⲣⲓ̄ⲁ	N	ⲕⲁⲣⲡⲟⲫⲟⲣⲓ̄ⲁ
ⲕⲁⲥ	N	ⲕⲁⲥ
ⲕⲁⲥ	N	ⲧⲕⲁⲥ
ⲕⲁⲥⲓⲁ	N	ⲕⲁⲥⲓⲁ
ⲕⲁⲥⲓⲁⲛⲟⲥ	NPROP	ⲕⲁⲥⲓⲁⲛⲟⲥ
ⲕⲁⲥⲓⲥ	N	ⲕⲁⲥⲓⲥ
ⲕⲁⲥⲧⲣⲟⲛ	N	ⲕⲁⲥⲧⲣⲟⲛ
ⲕⲁⲧ	V	ⲕⲁϯ
ⲕⲁⲧⲁ	PREP	ⲕⲁⲧⲁ
ⲕⲁⲧⲁϩⲣⲁⲕⲧⲏⲥ	N	ⲕⲁⲧⲁϩⲣⲁⲕⲧⲏⲥ
ⲕⲁⲧⲁⲃⲁⲥⲓⲥ	N	ⲕⲁⲧⲁⲃⲁⲥⲓⲥ
ⲕⲁⲧⲁⲃⲟⲗⲏ	N	ⲕⲁⲧⲁⲃⲟⲗⲏ
ⲕⲁⲧⲁⲅⲓⲛⲱⲥⲕⲉ	V	ⲕⲁⲧⲁⲅⲓⲛⲱⲥⲕⲉ
ⲕⲁⲧⲁⲅⲛⲱⲥⲓⲥ	N	ⲕⲁⲧⲁⲅⲛⲱⲥⲓⲥ
ⲕⲁⲧⲁⲇⲓⲕⲏ	N	ⲕⲁⲧⲁⲇⲓⲕⲏ
ⲕⲁⲧⲁⲇⲓⲕⲟⲥ	N	ⲕⲁⲧⲁⲇⲓⲕⲟⲥ
ⲕⲁⲧⲁⲇⲓⲕⲱⲥ	N	ⲕⲁⲧⲁⲇⲓⲕⲱⲥ
ⲕⲁⲧⲁⲕⲉⲛⲉ	V	ⲕⲁⲧⲁⲕⲉⲛⲉ
ⲕⲁⲧⲁⲕⲓⲟⲛ	N	ⲕⲁⲧⲁⲕⲓⲟⲛ
ⲕⲁⲧⲁⲕⲗⲩⲥⲙⲟⲥ	N	ⲕⲁⲧⲁⲕⲗⲩⲥⲙⲟⲥ
ⲕⲁⲧⲁⲕⲣⲓⲙⲁ	N	ⲕⲁⲧⲁⲕⲣⲓⲙⲁ
ⲕⲁⲧⲁⲕⲣⲓⲛⲉ	V	ⲕⲁⲧⲁⲕⲣⲓⲛⲉ
ⲕⲁⲧⲁⲕⲣⲓⲥⲓⲥ	N	ⲕⲁⲧⲁⲕⲣⲓⲥⲓⲥ
ⲕⲁⲧⲁⲗⲁⲗⲉⲓ	V	ⲕⲁⲧⲁⲗⲁⲗⲉⲓ
ⲕⲁⲧⲁⲗⲁⲗⲓⲁ	N	ⲕⲁⲧⲁⲗⲁⲗⲓⲁ
ⲕⲁⲧⲁⲗⲁⲙⲃⲁⲛⲉ	V	ⲕⲁⲧⲁⲗⲁⲙⲃⲁⲛⲉ
ⲕⲁⲧⲁⲗⲁⲥⲉ	V	ⲕⲁⲧⲁⲗⲁⲥⲉ
ⲕⲁⲧⲁⲗⲗⲁⲅⲏ	N	ⲕⲁⲧⲁⲗⲗⲁⲅⲏ
ⲕⲁⲧⲁⲗⲩ	V	ⲕⲁⲧⲁⲗⲩ
ⲕⲁⲧⲁⲗⲩⲉ	V	ⲕⲁⲧⲁⲗⲩⲉ
ⲕⲁⲧⲁⲛⲟⲓ	V	ⲕⲁⲧⲁⲛⲟⲓ
ⲕⲁⲧⲁⲛⲧⲁ	ADV	ⲕⲁⲧⲁⲛⲧⲁ
ⲕⲁⲧⲁⲛⲧⲁ	V	ⲕⲁⲧⲁⲛⲧⲁ
ⲕⲁⲧⲁⲝⲓⲟⲩ	V	ⲕⲁⲧⲁⲝⲓⲟⲩ
ⲕⲁⲧⲁⲡⲁⲧⲓ	V	ⲕⲁⲧⲁⲡⲁⲧⲓ
ⲕⲁⲧⲁⲡⲉⲧⲁⲥⲙⲁ	N	ⲕⲁⲧⲁⲡⲉⲧⲁⲥⲙⲁ
ⲕⲁⲧⲁⲡⲟⲛϯⲍⲉ	V	ⲕⲁⲧⲁⲡⲟⲛϯⲍⲉ
ⲕⲁⲧⲁⲣⲅⲉⲓ	V	ⲕⲁⲧⲁⲣⲅⲉⲓ
ⲕⲁⲧⲁⲥⲕⲟⲡⲟⲥ	N	ⲕⲁⲧⲁⲥⲕⲟⲡⲟⲥ
ⲕⲁⲧⲁⲥⲧⲁⲥⲓⲥ	N	ⲕⲁⲧⲁⲥⲧⲁⲥⲓⲥ
ⲕⲁⲧⲁⲧⲁⲝⲓⲥ	N	ⲕⲁⲧⲁⲧⲁⲝⲓⲥ
ⲕⲁⲧⲁⲫⲣⲟⲛⲉⲓ	V	ⲕⲁⲧⲁⲫⲣⲟⲛⲉⲓ
ⲕⲁⲧⲁⲫⲣⲟⲛⲏⲥⲓⲥ	N	ⲕⲁⲧⲁⲫⲣⲟⲛⲏⲥⲓⲥ
ⲕⲁⲧⲁⲫⲣⲟⲛⲏⲧⲏⲥ	N	ⲕⲁⲧⲁⲫⲣⲟⲛⲏⲧⲏⲥ
ⲕⲁⲧⲁⲫⲣⲟⲛⲓⲛ	V	ⲕⲁⲧⲁⲫⲣⲟⲛⲓⲛ
ⲕⲁⲧⲉⲭⲉ	V	ⲕⲁⲧⲉⲭⲉ
ⲕⲁⲧⲏⲅⲟⲣⲉⲓ	V	ⲕⲁⲧⲏⲅⲟⲣⲉⲓ
ⲕⲁⲧⲏⲅⲟⲣⲓ	V	ⲕⲁⲧⲏⲅⲟⲣⲓ
ⲕⲁⲧⲏⲅⲟⲣⲓⲁ	N	ⲕⲁⲧⲏⲅⲟⲣⲓⲁ
ⲕⲁⲧⲏⲅⲟⲣⲟⲥ	N	ⲕⲁⲧⲏⲅⲟⲣⲟⲥ
ⲕⲁⲧⲏⲭⲏ	V	ⲕⲁⲧⲏⲭⲏ
ⲕⲁⲧⲓⲗⲁ	N	ⲕⲁⲧⲓⲗⲁ
ⲕⲁⲧⲙⲓⲥ	N	ⲕⲁⲧⲙⲓⲥ
ⲕⲁⲧⲟⲁ	N	ⲕⲁⲧⲱ
ⲕⲁⲧⲟⲣⲑⲟⲩ	V	ⲕⲁⲧⲟⲣⲑⲟⲩ
ⲕⲁⲧⲟⲣⲑⲱⲙⲁ	N	ⲕⲁⲧⲟⲣⲑⲱⲙⲁ
ⲕⲁⲧⲟⲥ	N	ⲕⲁⲧⲟⲥ
ⲕⲁⲧⲟⲩⲗⲓ	N	ⲕⲁⲧⲟⲩⲗⲓ
ⲕⲁⲧⲟⲭⲏ	N	ⲕⲁⲧⲟⲭⲏ
ⲕⲁⲧⲱ	N	ⲕⲁⲧⲱ
ⲕⲁⲩⲙⲁ	N	ⲕⲁⲩⲙⲁ
ⲕⲁⲩⲥⲱⲛ	N	ⲕⲁⲩⲥⲱⲛ
ⲕⲁⲩⲧⲏⲣⲓⲍⲉ	V	ⲕⲁⲩⲧⲏⲣⲓⲍⲉ
ⲕⲁⲫⲁϫⲓ	N	ⲕⲁⲫⲁϫⲓ
ⲕⲁⲫⲁⲓ	N	ⲕⲁⲫⲁⲓ
ⲕⲁⲫⲁⲣⲛⲁⲟⲩⲙ	NPROP	ⲕⲁⲫⲁⲣⲛⲁⲟⲩⲙ
ⲕⲁⲯⲁ	N	ⲕⲁⲯⲁ
ⲕⲇⲏⲥⲓⲥ	N	ⲕⲇⲏⲥⲓⲥ
ⲕⲉ	ART	ⲕⲉ
ⲕⲉ	N	ⲕⲉ
ⲕⲉϣ	N	ⲕⲁϣ
ⲕⲉϩ	N	ⲕⲉϩ
ⲕⲉϩ	VSTAT	ⲕⲁϩ
ⲕⲉϩⲛⲓ	N	ⲕⲉϩⲛⲓ
ⲕⲉⲃⲉⲣⲛⲓⲧⲏⲥ	N	ⲕⲉⲃⲉⲣⲛⲓⲧⲏⲥ
ⲕⲉⲃⲓ	N	ⲕⲏⲃⲓ
ⲕⲉⲃⲓⲱⲛ	N	ⲕⲉⲃⲓⲱⲛ
ⲕⲉⲇⲣⲟⲥ	N	ⲕⲉⲇⲣⲟⲥ
ⲕⲉⲕ	V	ⲕⲱⲕ
ⲕⲉⲕⲗⲉⲩⲧⲏⲥ	N	ⲕⲉⲕⲗⲉⲩⲧⲏⲥ
ⲕⲉⲗ	N	ⲕⲉⲗ
ⲕⲉⲗ	N	ⲕⲉⲗⲓ
ⲕⲉⲗ	V	ⲕⲱⲗ
ⲕⲉⲗϥⲁϫ	N	ⲕⲉⲗϥⲁϫ
ⲕⲉⲗϥⲓ	N	ⲕⲉⲗϥⲓ
ⲕⲉⲗϫ	V	ⲕⲱⲗϫ
ⲕⲉⲗⲉⲃⲓⲛ	N	ⲕⲉⲗⲉⲃⲓⲛ
ⲕⲉⲗⲉⲗⲓ	N	ⲕⲉⲗⲉⲗⲓ
ⲕⲉⲗⲉⲩⲉ	V	ⲕⲉⲗⲉⲩⲉ
ⲕⲉⲗⲉⲩⲉⲥⲑⲁⲓ	V	ⲕⲉⲗⲉⲩⲉⲥⲑⲁⲓ
ⲕⲉⲗⲉⲩⲥⲓⲥ	N	ⲕⲉⲗⲉⲩⲥⲓⲥ
ⲕⲉⲗⲓ	N	ⲕⲉⲗⲓ
ⲕⲉⲗⲕⲁ	N	ⲕⲉⲗⲕⲁ
ⲕⲉⲗⲗⲟϫ	N	ⲕⲉⲗⲗⲟϫ
ⲕⲉⲗⲟⲗ	N	ⲕⲉⲗⲱⲗ
ⲕⲉⲗⲟⲗⲓ	N	ⲕⲉⲗⲱⲗ
ⲕⲉⲗⲟⲩ	V	ⲕⲉⲗⲟⲩ
ⲕⲉⲗⲡ	V	ⲕⲱⲗⲡ
ⲕⲉⲗⲱⲗ	N	ⲕⲉⲗⲱⲗ
ⲕⲉⲙⲕⲉⲙ	V	ⲕⲉⲙⲕⲉⲙ
ⲕⲉⲛ	N	ⲕⲉⲛ
ⲕⲉⲛⲉⲅⲓⲟⲥ	N	ⲕⲉⲛⲉⲅⲓⲟⲥ
ⲕⲉⲛⲉⲫⲓⲧⲉⲛ	N	ⲕⲉⲛⲉⲫⲓⲧⲉⲛ
ⲕⲉⲛⲓ	V	ⲕⲉⲛⲓ
ⲕⲉⲛⲓⲱⲟⲩⲧ	VSTAT	ⲕⲉⲛⲓ
ⲕⲉⲛⲟⲇⲟⲝⲟⲥ	N	ⲕⲉⲛⲟⲇⲟⲝⲟⲥ
ⲕⲉⲛⲧⲉ	N	ⲕⲉⲛⲧⲉ
ⲕⲉⲛⲧⲉⲣⲓⲟⲛ	N	ⲕⲉⲛⲧⲉⲣⲓⲟⲛ
ⲕⲉⲛⲧⲏⲛⲁⲣⲓⲟⲛ	N	ⲕⲉⲛⲧⲏⲛⲁⲣⲓⲟⲛ
ⲕⲉⲛⲧⲩⲣⲓⲱⲛ	N	ⲕⲉⲛⲧⲩⲣⲓⲱⲛ
ⲕⲉⲟⲩⲟⲩ	N	ⲕⲉⲟⲩⲟⲩ
ⲕⲉⲣϥ	V	ⲕⲱⲣϥ
ⲕⲉⲣϩⲉ	N	ⲕⲉⲣϩⲉ
ⲕⲉⲣϫ	V	ⲕⲱⲣϫ
ⲕⲉⲣⲁ	V	ⲕⲉⲣⲁ
ⲕⲉⲣⲁⲍⲉ	V	ⲕⲉⲣⲁⲍⲉ
ⲕⲉⲣⲁⲓⲁ	N	ⲕⲉⲣⲁⲓⲁ
ⲕⲉⲣⲁⲙⲉⲩⲥ	N	ⲕⲉⲣⲁⲙⲉⲩⲥ
ⲕⲉⲣⲁⲡⲧⲉⲥ	N	ⲕⲉⲣⲁⲡⲧⲉⲥ
ⲕⲉⲣⲁⲥⲙⲁ	N	ⲕⲉⲣⲁⲥⲙⲁ
ⲕⲉⲣⲁⲧⲥⲉ	N	ⲕⲉⲣⲁⲧⲥⲉ
ⲕⲉⲣⲃⲟⲩ	N	ⲕⲉⲣⲃⲟⲩ
ⲕⲉⲣⲉⲁ	N	ⲕⲉⲣⲉⲁ
ⲕⲉⲣⲉⲓⲁ	N	ⲕⲉⲣⲉⲓⲁ
ⲕⲉⲣⲙⲁ	N	ⲕⲉⲣⲙⲁ
ⲕⲉⲣⲙⲓ	N	ⲕⲉⲣⲙⲓ
ⲕⲉⲣⲥ	N	ⲕⲉⲣⲥ
ⲕⲉⲣⲱⲛ	N	ⲕⲉⲣⲱⲛ
ⲕⲉⲥ	V	ⲕⲱⲥ
ⲕⲉⲥⲁⲣⲓⲁ	NPROP	ⲕⲉⲥⲁⲣⲓⲁ
ⲕⲉⲥⲕⲱⲥ	V	ⲕⲟⲥⲕⲉⲥ
ⲕⲉⲥⲧⲱⲛⲁⲣⲓⲟⲥ	N	ⲕⲉⲥⲧⲱⲛⲁⲣⲓⲟⲥ
ⲕⲉⲧ	V	ⲕⲱϯ
ⲕⲉⲧ	V	ⲕⲱⲧ
ⲕⲉⲧⲱⲛ	N	ⲕⲉⲧⲱⲛ
ⲕⲉⲫⲁⲗⲁⲓⲟⲛ	N	ⲕⲉⲫⲁⲗⲁⲓⲟⲛ
ⲕⲉⲫⲁⲗⲁⲓⲱⲧⲏⲥ	N	ⲕⲉⲫⲁⲗⲁⲓⲱⲧⲏⲥ
ⲕⲉⲫⲁⲗⲏ	N	ⲕⲉⲫⲁⲗⲏ
ⲕⲉⲫⲁⲗⲓⲥ	N	ⲕⲉⲫⲁⲗⲓⲥ
ⲕⲏ	N	ⲕⲏ
ⲕⲏⲃ	VSTAT	ⲕⲱⲃ
ⲕⲏⲃ	VSTAT	ⲭⲃⲟⲃ
ⲕⲏⲃⲓ	N	ⲕⲏⲃⲓ
ⲕⲏⲕ	VSTAT	ⲕⲱⲕ
ⲕⲏⲗ	N	ⲕⲉⲗ
ⲕⲏⲙⲏⲧⲉⲣⲓⲟⲛ	N	ⲕⲏⲙⲏⲧⲉⲣⲓⲟⲛ
ⲕⲏⲛ	V	ⲕⲏⲛ
ⲕⲏⲛⲥⲟⲥ	N	ⲕⲏⲛⲥⲟⲥ
ⲕⲏⲛⲱⲧⲏⲥ	N	ⲕⲏⲛⲱⲧⲏⲥ
ⲕⲏⲡⲟⲥ	N	ⲕⲏⲡⲟⲥ
ⲕⲏⲡⲟⲩⲣⲟⲥ	N	ⲕⲏⲡⲟⲩⲣⲟⲥ
ⲕⲏⲣⲩⲅⲙⲁ	N	ⲕⲏⲣⲩⲅⲙⲁ
ⲕⲏⲣⲩⲝ	N	ⲕⲏⲣⲩⲝ
ⲕⲏⲣⲩⲥⲥⲉ	V	ⲕⲏⲣⲩⲥⲥⲉ
ⲕⲏⲥ	VSTAT	ⲕⲱⲥ
ⲕⲏⲧ	VSTAT	ⲕⲱⲧ
ⲕⲏⲧⲟⲥ	N	ⲕⲏⲧⲟⲥ
ⲕⲏⲫⲁ	N	ⲕⲏⲫⲁ
ⲕⲓϥⲓ	N	ⲕⲓϥⲓ
ⲕⲓϯ	N	ⲕⲓϯ
ⲕⲓⲃⲱⲧⲟⲥ	N	ⲕⲓⲃⲱⲧⲟⲥ
ⲕⲓⲇⲁⲣⲓⲥ	N	ⲕⲓⲇⲁⲣⲓⲥ
ⲕⲓⲇⲣⲓⲟⲛ	N	ⲕⲓⲇⲣⲓⲟⲛ
ⲕⲓⲏ	N	ϭⲓⲓⲉ
ⲕⲓⲑⲁⲣⲁ	N	ⲕⲓⲑⲁⲣⲁ
ⲕⲓⲑⲁⲣⲓⲍⲉ	V	ⲕⲓⲑⲁⲣⲓⲍⲉ
ⲕⲓⲙ	V	ⲕⲓⲙ
ⲕⲓⲛⲇⲩⲛⲉⲩⲉ	V	ⲕⲓⲛⲇⲩⲛⲉⲩⲉ
ⲕⲓⲛⲇⲩⲛⲟⲥ	N	ⲕⲓⲛⲇⲩⲛⲟⲥ
ⲕⲓⲛⲏⲥⲓⲥ	N	ⲕⲓⲛⲏⲥⲓⲥ
ⲕⲓⲛⲛⲁⲙⲱⲙⲟⲛ	N	ⲕⲓⲛⲛⲁⲙⲱⲙⲟⲛ
ⲕⲓⲧⲣⲁ	N	ⲕⲓⲧⲣⲁ
ⲕⲓⲩⲏ	N	ⲕⲓⲩⲏ
ⲕⲗⲁϥⲧ	N	ⲕⲗⲁϥⲧ
ⲕⲗⲁⲃⲉⲕⲟⲗⲗⲁⲣⲓⲟⲥ	N	ⲕⲗⲁⲃⲉⲕⲟⲗⲗⲁⲣⲓⲟⲥ
ⲕⲗⲁⲇⲟⲥ	N	ⲕⲗⲁⲇⲟⲥ
ⲕⲗⲁⲥⲙⲁ	N	ⲕⲗⲁⲥⲙⲁ
ⲕⲗⲁⲥⲙⲁⲧⲓⲍⲉ	V	ⲕⲗⲁⲥⲙⲁⲧⲓⲍⲉ
ⲕⲗⲏ	N	ⲕⲗⲏ
ⲕⲗⲏⲙⲁ	N	ⲕⲗⲏⲙⲁ
ⲕⲗⲏⲣⲓⲕⲟⲥ	N	ⲕⲗⲏⲣⲓⲕⲟⲥ
ⲕⲗⲏⲣⲟⲛⲟⲙⲉⲓ	V	ⲕⲗⲏⲣⲟⲛⲟⲙⲉⲓ
ⲕⲗⲏⲣⲟⲛⲟⲙⲓⲁ	N	ⲕⲗⲏⲣⲟⲛⲟⲙⲓⲁ
ⲕⲗⲏⲣⲟⲛⲟⲙⲟⲥ	N	ⲕⲗⲏⲣⲟⲛⲟⲙⲟⲥ
ⲕⲗⲏⲣⲟⲥ	N	ⲕⲗⲏⲣⲟⲥ
ⲕⲗⲏⲣⲟⲩ	V	ⲕⲗⲏⲣⲟⲩ
ⲕⲗⲓϫⲓ	N	ⲕⲗⲓϫⲓ
ⲕⲗⲓⲙⲁ	N	ⲕⲗⲓⲙⲁ
ⲕⲗⲟⲙⲗⲉⲙ	V	ϭⲗⲟⲙⲗⲉⲙ
ⲕⲗⲱⲓⲗⲓ	N	ⲕⲗⲱⲓⲗⲓ
ⲕⲛⲓⲕⲓϫⲓ	N	ⲕⲛⲓⲕⲓϫⲓ
ⲕⲟⲃ	V	ⲕⲱⲃ
ⲕⲟⲃϩ	N	ⲕⲟⲃϩ
ⲕⲟⲇⲣⲁⲛⲧⲏⲥ	N	ⲕⲟⲇⲣⲁⲛⲧⲏⲥ
ⲕⲟⲓ	N	ⲕⲟⲓ
ⲕⲟⲓϩⲓ	N	ⲕⲟⲓϩⲓ
ⲕⲟⲓⲗⲁⲥ	N	ⲕⲟⲓⲗⲁⲥ
ⲕⲟⲓⲗⲓⲁ	N	ⲕⲟⲓⲗⲓⲁ
ⲕⲟⲓⲛⲟⲃⲓⲟⲥ	N	ⲕⲟⲓⲛⲟⲃⲓⲟⲥ
ⲕⲟⲓⲛⲟⲛ	N	ⲕⲟⲓⲛⲟⲛ
ⲕⲟⲓⲛⲟⲛⲟⲥ	N	ⲕⲟⲓⲛⲟⲛⲟⲥ
ⲕⲟⲓⲛⲟⲥ	N	ⲕⲟⲓⲛⲟⲥ
ⲕⲟⲓⲛⲱⲛⲉⲓ	V	ⲕⲟⲓⲛⲱⲛⲉⲓ
ⲕⲟⲓⲛⲱⲛⲓ	V	ⲕⲟⲓⲛⲱⲛⲓ
ⲕⲟⲓⲛⲱⲛⲓⲁ	N	ⲕⲟⲓⲛⲱⲛⲓⲁ
ⲕⲟⲓⲛⲱⲛⲟⲥ	N	ⲕⲟⲓⲛⲱⲛⲟⲥ
ⲕⲟⲓⲧⲱⲛ	N	ⲕⲟⲓⲧⲱⲛ
ⲕⲟⲕ	V	ⲕⲱⲕ
ⲕⲟⲕⲕⲓⲛⲟⲥ	N	ⲕⲟⲕⲕⲓⲛⲟⲥ
ⲕⲟⲕⲕⲟⲥ	N	ⲕⲟⲕⲕⲟⲥ
ⲕⲟⲗ	V	ⲕⲱⲗ
ⲕⲟⲗϩⲟⲧ	N	ⲕⲟⲩⲗϩⲟⲧ
ⲕⲟⲗϩⲧ	N	ⲕⲟⲩⲗϩⲟⲧ
ⲕⲟⲗϫ	V	ⲕⲱⲗϫ
ⲕⲟⲗϫ	VSTAT	ⲕⲱⲗϫ
ⲕⲟⲗⲁⲍⲉ	V	ⲕⲟⲗⲁⲍⲉ
ⲕⲟⲗⲁⲕⲉⲩⲉ	V	ⲕⲟⲗⲁⲕⲉⲩⲉ
ⲕⲟⲗⲁⲥⲓⲥ	N	ⲕⲟⲗⲁⲥⲓⲥ
ⲕⲟⲗⲁⲥⲧⲏⲣⲓⲟⲛ	N	ⲕⲟⲗⲁⲥⲧⲏⲣⲓⲟⲛ
ⲕⲟⲗⲕⲉⲗ	N	ⲕⲟⲗⲕⲉⲗ
ⲕⲟⲗⲗⲁ	V	ⲕⲟⲗⲗⲁ
ⲕⲟⲗⲗⲁⲣⲓⲟⲛ	N	ⲕⲟⲗⲗⲁⲣⲓⲟⲛ
ⲕⲟⲗⲗⲏⲅⲓⲟⲛ	N	ⲕⲟⲗⲗⲏⲅⲓⲟⲛ
ⲕⲟⲗⲗⲏⲕⲟⲛ	N	ⲕⲟⲗⲗⲏⲕⲟⲛ
ⲕⲟⲗⲗⲩⲃⲓⲥⲧⲏⲥ	N	ⲕⲟⲗⲗⲩⲃⲓⲥⲧⲏⲥ
ⲕⲟⲗⲗⲩⲕⲓⲟⲛ	N	ⲕⲟⲗⲗⲏⲅⲓⲟⲛ
ⲕⲟⲗⲟⲃⲟⲥ	N	ⲕⲟⲗⲟⲃⲟⲥ
ⲕⲟⲗⲡ	V	ⲕⲱⲗⲡ
ⲕⲟⲗⲡ	VSTAT	ⲕⲱⲗⲡ
ⲕⲟⲗⲡⲟⲥ	N	ⲕⲟⲗⲡⲟⲥ
ⲕⲟⲗⲧⲁϧ	N	ⲕⲟⲗⲧⲁϧ
ⲕⲟⲗⲩⲙⲃⲏⲑⲣⲁ	N	ⲕⲟⲗⲩⲙⲃⲏⲑⲣⲁ
ⲕⲟⲙⲁⲣⲓⲧⲏⲥ	N	ⲕⲟⲙⲁⲣⲓⲧⲏⲥ
ⲕⲟⲙⲉⲥ	N	ⲕⲟⲙⲉⲥ
ⲕⲟⲙⲏ	N	ⲕⲟⲙⲏ
ⲕⲟⲙⲏⲛⲧⲁⲣⲓⲥⲓⲟⲥ	N	ⲕⲟⲙⲏⲛⲧⲁⲣⲓⲥⲓⲟⲥ
ⲕⲟⲙⲏⲥ	N	ⲕⲟⲙⲏⲥ
ⲕⲟⲙⲏⲧⲁⲧⲟⲛ	N	ⲕⲟⲙⲏⲧⲁⲧⲟⲛ
ⲕⲟⲙⲓ	N	ⲕⲟⲙⲏ
ⲕⲟⲙⲡⲗⲉⲩⲥⲓⲥ	N	ⲕⲟⲙⲡⲗⲉⲩⲥⲓⲥ
ⲕⲟⲛϯⲧⲟⲛ	N	ⲕⲟⲛϯⲧⲟⲛ
ⲕⲟⲛⲇⲣⲁⲛⲧⲏⲥ	N	ⲕⲟⲛⲇⲣⲁⲛⲧⲏⲥ
ⲕⲟⲛⲓⲁ	V	ⲕⲟⲛⲓⲁ
ⲕⲟⲛⲧⲁⲣⲓⲟⲛ	N	ⲕⲟⲛⲧⲁⲣⲓⲟⲛ
ⲕⲟⲡϣ	VSTAT	ⲕⲱⲡϣ
ⲕⲟⲡⲣⲓⲁ	N	ⲕⲟⲡⲣⲓⲁ
ⲕⲟⲣϥ	V	ⲕⲱⲣϥ
ⲕⲟⲣϥ	VSTAT	ⲕⲱⲣϥ
ⲕⲟⲣϫ	V	ⲕⲱⲣϫ
ⲕⲟⲣⲃⲁⲛ	N	ⲕⲟⲣⲃⲁⲛ
ⲕⲟⲣⲉ	NPROP	ⲕⲟⲣⲉ
ⲕⲟⲣⲏ	N	ⲕⲟⲣⲏ
ⲕⲟⲣⲓ	N	ⲕⲟⲣⲓ
ⲕⲟⲣⲓⲛⲑⲟⲥ	N	ⲕⲟⲣⲓⲛⲑⲟⲥ
ⲕⲟⲣⲕⲥ	N	ⲕⲟⲣⲕⲥ
ⲕⲟⲣⲝ	N	ⲕⲟⲣⲝ
ⲕⲟⲣⲟⲩ	N	ⲕⲟⲣⲟⲩ
ⲕⲟⲣⲧⲉⲛ	N	ⲕⲟⲣⲧⲉⲛ
ⲕⲟⲥ	V	ⲕⲱⲥ
ⲕⲟⲥⲕⲉⲥ	V	ⲕⲟⲥⲕⲉⲥ
ⲕⲟⲥⲙⲉⲓ	V	ⲕⲟⲥⲙⲉⲓ
ⲕⲟⲥⲙⲉⲓⲥⲑⲁⲓ	V	ⲕⲟⲥⲙⲉⲓⲥⲑⲁⲓ
ⲕⲟⲥⲙⲏⲥⲓⲥ	N	ⲕⲟⲥⲙⲏⲥⲓⲥ
ⲕⲟⲥⲙⲓⲕⲟⲛ	N	ⲕⲟⲥⲙⲓⲕⲟⲛ
ⲕⲟⲥⲙⲓⲕⲟⲥ	N	ⲕⲟⲥⲙⲓⲕⲟⲥ
ⲕⲟⲥⲙⲟⲕⲣⲁⲧⲱⲣ	N	ⲕⲟⲥⲙⲟⲕⲣⲁⲧⲱⲣ
ⲕⲟⲥⲙⲟⲥ	N	ⲕⲟⲥⲙⲟⲥ
ⲕⲟⲧ	N	ⲕⲟⲧ
ⲕⲟⲧ	V	ⲕⲱϯ
ⲕⲟⲧ	V	ⲕⲱⲧ
ⲕⲟⲩϫⲓ	N	ⲕⲟⲩϫⲓ
ⲕⲟⲩⲕⲗⲓⲟⲛ	N	ⲕⲟⲩⲕⲗⲓⲟⲛ
ⲕⲟⲩⲕⲟⲩⲙⲓⲟⲛ	N	ⲕⲟⲩⲕⲟⲩⲙⲓⲟⲛ
ⲕⲟⲩⲕⲟⲩⲫⲁⲧ	N	ⲕⲟⲩⲕⲟⲩⲫⲁⲧ
ⲕⲟⲩⲗϩⲟⲧ	N	ⲕⲟⲩⲗϩⲟⲧ
ⲕⲟⲩⲗⲁϫⲓ	N	ⲕⲟⲩⲗⲁϫⲓ
ⲕⲟⲩⲗⲁⲑⲉ	N	ⲕⲟⲩⲗⲁⲑⲉ
ⲕⲟⲩⲗⲗⲁ	N	ⲕⲟⲩⲗⲗⲁ
ⲕⲟⲩⲗⲱⲗ	N	ⲕⲉⲗⲱⲗ
ⲕⲟⲩⲗⲱⲗ	V	ⲕⲟⲩⲗⲱⲗ
ⲕⲟⲩⲗⲱⲗ	VSTAT	ⲕⲟⲩⲗⲱⲗ
ⲕⲟⲩⲙ	FM	ⲕⲟⲩⲙ
ⲕⲟⲩⲙ	V	ⲕⲟⲩⲙ
ⲕⲟⲩⲙⲫⲟⲥ	N	ⲕⲟⲩⲙⲫⲟⲥ
ⲕⲟⲩⲝ	N	ⲕⲟⲩⲝ
ⲕⲟⲩⲡⲉⲣ	N	ⲕⲟⲩⲡⲉⲣ
ⲕⲟⲩⲣ	N	ⲕⲟⲩⲣ
ⲕⲟⲩⲫⲁⲧ	N	ⲕⲟⲩⲫⲁⲧ
ⲕⲟⲩⲫⲓⲍⲉ	V	ⲕⲟⲩⲫⲓⲍⲉ
ⲕⲟⲩⲫⲟⲛ	N	ⲕⲟⲩⲫⲟⲛ
ⲕⲟⲭⲗⲓⲁⲣⲓⲛ	N	ⲕⲟⲭⲗⲓⲁⲣⲓⲛ
ⲕⲣⲁⲙ	N	ⲕⲣⲁⲙ
ⲕⲣⲁⲛⲓⲟⲛ	V	ⲕⲣⲁⲛⲓⲟⲛ
ⲕⲣⲁⲥⲓⲥ	N	ⲕⲣⲁⲥⲓⲥ
ⲕⲣⲁⲧⲏⲣ	N	ⲕⲣⲁⲧⲏⲣ
ⲕⲣⲁⲧⲟⲥ	N	ⲕⲣⲁⲧⲟⲥ
ⲕⲣⲁⲩⲅⲏ	N	ⲕⲣⲁⲩⲅⲏ
ⲕⲣⲏⲧⲉⲥ	N	ⲕⲣⲏⲧⲉⲥ
ⲕⲣⲓⲕⲟⲥ	N	ⲕⲣⲓⲕⲟⲥ
ⲕⲣⲓⲙⲁ	N	ⲕⲣⲓⲙⲁ
ⲕⲣⲓⲛⲉ	V	ⲕⲣⲓⲛⲉ
ⲕⲣⲓⲛⲟⲛ	N	ⲕⲣⲓⲛⲟⲛ
ⲕⲣⲓⲥⲓⲥ	N	ⲕⲣⲓⲥⲓⲥ
ⲕⲣⲓⲥⲡⲟⲥ	NPROP	ⲕⲣⲓⲥⲡⲟⲥ
ⲕⲣⲓⲧⲏⲣⲓⲟⲛ	N	ⲕⲣⲓⲧⲏⲣⲓⲟⲛ
ⲕⲣⲓⲧⲏⲥ	N	ⲕⲣⲓⲧⲏⲥ
ⲕⲣⲟⲕⲟⲥ	N	ⲕⲣⲟⲕⲟⲥ
ⲕⲣⲟⲙ	N	ⲕⲣⲁⲙ
ⲕⲣⲟⲛⲟⲥ	N	ⲕⲣⲟⲛⲟⲥ
ⲕⲣⲟⲛⲟⲥ	NPROP	ⲕⲣⲟⲛⲟⲥ
ⲕⲣⲩⲥⲧⲁⲗⲗⲟⲛ	N	ⲕⲣⲩⲥⲧⲁⲗⲗⲟⲛ
ⲕⲣⲩⲥⲧⲁⲗⲗⲟⲥ	N	ⲕⲣⲩⲥⲧⲁⲗⲗⲟⲥ
ⲕⲣⲱⲙ	N	ⲕⲣⲁⲙ
ⲕⲧⲉ	V	ⲕⲧⲟ
ⲕⲧⲏⲙⲁ	N	ⲕⲧⲏⲙⲁ
ⲕⲧⲏⲟⲩⲧ	VSTAT	ⲕⲧⲟ
ⲕⲧⲏⲥⲓⲥ	N	ⲕⲧⲏⲥⲓⲥ
ⲕⲧⲓⲥⲓⲥ	N	ⲕⲧⲓⲥⲓⲥ
ⲕⲧⲓⲥⲙⲁ	N	ⲕⲧⲓⲥⲙⲁ
ⲕⲧⲟ	V	ⲕⲧⲟ
ⲕⲩⲇⲁⲣⲓⲧⲏⲥ	N	ⲕⲩⲇⲁⲣⲓⲧⲏⲥ
ⲕⲩⲕⲗⲟⲥ	N	ⲕⲩⲕⲗⲟⲥ
ⲕⲩⲗⲗⲟⲥ	N	ⲕⲩⲗⲗⲟⲥ
ⲕⲩⲙⲃⲁⲗⲟⲛ	N	ⲕⲩⲙⲃⲁⲗⲟⲛ
ⲕⲩⲙⲏⲗⲓⲟⲛ	N	ⲕⲩⲙⲏⲗⲓⲟⲛ
ⲕⲩⲛⲇⲓⲛⲁⲣⲓⲟⲛ	N	ⲕⲩⲛⲇⲓⲛⲁⲣⲓⲟⲛ
ⲕⲩⲛⲇⲩⲛⲟⲥ	N	ⲕⲩⲛⲇⲩⲛⲟⲥ
ⲕⲩⲡⲁⲣⲓⲥⲥⲟⲥ	N	ⲕⲩⲡⲁⲣⲓⲥⲥⲟⲥ
ⲕⲩⲡⲏ	N	ⲕⲩⲡⲏ
ⲕⲩⲡⲣⲓⲟⲥ	N	ⲕⲩⲡⲣⲓⲟⲥ
ⲕⲩⲡⲣⲟⲥ	N	ⲕⲩⲡⲣⲟⲥ
ⲕⲩⲣⲏⲛⲁⲓⲟⲥ	N	ⲕⲩⲣⲏⲛⲁⲓⲟⲥ
ⲕⲩⲣⲏⲥⲥⲉ	V	ⲕⲩⲣⲏⲥⲥⲉ
ⲕⲩⲣⲓ	N	ⲕⲩⲣⲓ
ⲕⲩⲣⲓⲁⲕⲏ	NPROP	ⲕⲩⲣⲓⲁⲕⲏ
ⲕⲩⲣⲓⲁⲕⲟⲛ	N	ⲕⲩⲣⲓⲁⲕⲟⲛ
ⲕⲩⲣⲓⲉⲩⲉⲥⲑⲁⲓ	V	ⲕⲩⲣⲓⲉⲩⲉⲥⲑⲁⲓ
ⲕⲩⲣⲓⲝ	N	ⲕⲩⲣⲓⲝ
ⲕⲩⲣⲓⲱⲥ	ADV	ⲕⲩⲣⲓⲱⲥ
ⲕⲩⲣⲟⲥ	N	ⲕⲩⲣⲟⲥ
ⲕⲱϣ	V	ⲕⲱϣ
ⲕⲱϯ	N	ⲕⲱϯ
ⲕⲱϯ	V	ⲕⲱϯ
ⲕⲱⲃ	N	ⲕⲱⲃ
ⲕⲱⲃ	V	ⲕⲱⲃ
ⲕⲱⲓ	N	ⲕⲱⲓ
ⲕⲱⲓϩ	N	ⲕⲱⲓϩ
ⲕⲱⲕ	V	ⲕⲱⲕ
ⲕⲱⲗ	V	ⲕⲱⲗ
ⲕⲱⲗϩ	V	ⲕⲱⲗϩ
ⲕⲱⲗϫ	V	ϫⲱⲗϫ
ⲕⲱⲗϫ	V	ⲕⲱⲗϫ
ⲕⲱⲗⲡ	V	ⲕⲱⲗⲡ
ⲕⲱⲗⲩ	V	ⲕⲱⲗⲩ
ⲕⲱⲗⲩⲉ	V	ⲕⲱⲗⲩⲉ
ⲕⲱⲙⲉⲥ	N	ⲕⲱⲙⲉⲥ
ⲕⲱⲙⲏ	N	ⲕⲱⲙⲏ
ⲕⲱⲙⲓⲧⲁⲧⲱⲛ	N	ⲕⲱⲙⲓⲧⲁⲧⲱⲛ
ⲕⲱⲙⲟⲡⲟⲗⲓⲥ	N	ⲕⲱⲙⲟⲡⲟⲗⲓⲥ
ⲕⲱⲛⲓⲁ	N	ⲕⲱⲛⲓⲁ
ⲕⲱⲛⲓⲁⲍⲉ	V	ⲕⲱⲛⲓⲁⲍⲉ
ⲕⲱⲡ	V	ⲕⲱⲃ
ⲕⲱⲡϣ	V	ⲕⲱⲡϣ
ⲕⲱⲡⲓⲥ	N	ⲕⲱⲡⲓⲥ
ⲕⲱⲣϣ	V	ⲕⲱⲣϣ
ⲕⲱⲣϥ	V	ⲕⲱⲣϥ
ⲕⲱⲣϫ	V	ⲕⲱⲣϫ
ⲕⲱⲣⲉⲝ	N	ⲕⲱⲣⲉⲝ
ⲕⲱⲥ	V	ⲕⲱⲥ
ⲕⲱⲥⲙⲓⲕⲟⲛ	N	ⲕⲱⲥⲙⲓⲕⲟⲛ
ⲕⲱⲥⲧⲁⲛⲧⲓⲛⲟⲥ	NPROP	ⲕⲱⲥⲧⲁⲛⲧⲓⲛⲟⲥ
ⲕⲱⲥⲧⲱϯⲁ	N	ⲕⲱⲥⲧⲱϯⲁ
ⲕⲱⲧ	N	ⲕⲱⲧ
ⲕⲱⲧ	V	ⲕⲱⲧ
ⲕⲱⲧⲱⲛ	N	ⲕⲱⲧⲱⲛ
ⲕⲱⲫⲟⲛ	N	ⲕⲱⲫⲟⲛ
ⲗⲁ	N	ⲗⲁ
ⲗⲁ	V	ⲗⲁ
ⲗⲁ	VSTAT	ⲗⲓⲃⲓ
ⲗⲁϧⲉⲙ	N	ⲗⲁϧⲉⲙ
ⲗⲁϧⲉⲙ	VSTAT	ⲗⲱϧⲉⲙ
ⲗⲁϩⲱϫ	N	ⲗⲁϩⲱϫ
ⲗⲁϫⲁⲡⲧ	N	ⲗⲁⲙϫⲁⲧⲡ
ⲗⲁϫⲓ	N	ⲗⲁϫⲓ
ⲗⲁϫⲗⲉϫ	N	ⲗⲁϫⲗⲉϫ
ⲗⲁϭⲟⲩ	N	ⲗⲁϭⲟⲩ
ⲗⲁⲃ	VSTAT	ⲗⲓⲃⲓ
ⲗⲁⲃⲁⲛ	NPROP	ⲗⲁⲃⲁⲛ
ⲗⲁⲃⲁⲥ	N	ⲗⲁⲃⲁⲥ
ⲗⲁⲃⲟ	N	ⲗⲁⲟⲩⲟ
ⲗⲁⲃⲟⲓ	N	ⲗⲁⲃⲟⲓ
ⲗⲁⲃⲟⲥ	N	ⲗⲁⲃⲁⲥ
ⲗⲁⲃⲱ	N	ⲗⲉⲃⲁⲛ
ⲗⲁⲓⲕⲟⲥ	N	ⲗⲁⲓⲕⲟⲥ
ⲗⲁⲕϩ	N	ⲗⲁⲕϩ
ⲗⲁⲕⲁⲙⲟⲩ	N	ⲗⲁⲕⲁⲙⲟⲩ
ⲗⲁⲕⲁⲛⲏ	N	ⲗⲁⲕⲁⲛⲏ
ⲗⲁⲕⲉⲛⲧ	N	ⲗⲁⲕⲉⲛⲧ
ⲗⲁⲕⲕⲟⲥ	N	ⲗⲁⲕⲕⲟⲥ
ⲗⲁⲕⲙⲏ	N	ⲗⲁⲕⲙⲏ
ⲗⲁⲕⲟⲛ	N	ⲗⲁⲕⲟⲛ
ⲗⲁⲕⲥⲓ	N	ⲗⲁⲕⲥⲓ
ⲗⲁⲕⲧⲓⲍⲉ	V	ⲗⲁⲕⲧⲓⲍⲉ
ⲗⲁⲗⲉ	V	ⲗⲁⲗⲱ
ⲗⲁⲗⲏⲟⲩⲧ	VSTAT	ⲗⲁⲗⲱ
ⲗⲁⲗⲓⲁ	N	ⲗⲁⲗⲓⲁ
ⲗⲁⲗⲟ	V	ⲗⲁⲗⲱ
ⲗⲁⲗⲟⲩⲕⲏⲛ	N	ⲗⲁⲗⲟⲩⲕⲓⲛ
ⲗⲁⲗⲟⲩⲕⲓⲛ	N	ⲗⲁⲗⲟⲩⲕⲓⲛ
ⲗⲁⲗⲱ	V	ⲗⲁⲗⲱ
ⲗⲁⲗⲱⲱ	V	ⲗⲁⲗⲱ
ⲗⲁⲙ	N	ⲗⲁⲙ
ⲗⲁⲙ	VSTAT	ⲗⲱⲙ
ⲗⲁⲙϫⲁⲧⲡ	N	ⲗⲁⲙϫⲁⲧⲡ
ⲗⲁⲙⲁ	FW	ⲗⲁⲙⲁ
ⲗⲁⲙⲁ	PINT	ⲗⲁⲙⲁ
ⲗⲁⲙⲡⲁⲥ	N	ⲗⲁⲙⲡⲁⲥ
ⲗⲁⲙⲡⲣⲟⲧⲁⲧⲟⲥ	N	ⲗⲁⲙⲡⲣⲟⲧⲁⲧⲟⲥ
ⲗⲁⲙⲡⲣⲟⲧⲏⲥ	N	ⲗⲁⲙⲡⲣⲟⲧⲏⲥ
ⲗⲁⲙⲣⲏⲧ	N	ⲗⲁⲙⲣⲏⲧ
ⲗⲁⲙⲯⲁⲛⲉ	N	ⲗⲁⲙⲯⲁⲛⲉ
ⲗⲁⲙⲱⲟⲩ	N	ⲗⲁⲙⲱⲟⲩ
ⲗⲁⲛⲑⲁⲛⲉ	V	ⲗⲁⲛⲑⲁⲛⲉ
ⲗⲁⲟⲥ	N	ⲗⲁⲟⲥ
ⲗⲁⲟⲩⲟ	N	ⲗⲁⲟⲩⲟ
ⲗⲁⲡⲗⲉⲡ	V	ⲗⲁⲡⲗⲉⲡ
ⲗⲁⲡⲥⲓ	N	ⲗⲁⲡⲥⲓ
ⲗⲁⲡⲥⲓ	V	ⲗⲁⲡⲥⲓ
ⲗⲁⲡⲧ	N	ⲗⲁⲡⲧ
ⲗⲁⲥ	N	ⲗⲁⲥ
ⲗⲁⲥ	V	ⲗⲱⲥ
ⲗⲁⲥ	VSTAT	ⲗⲱⲥ
ⲗⲁⲩ	N	ⲗⲱⲟⲩ
ⲗⲁⲩⲣⲁ	N	ⲗⲁⲩⲣⲁ
ⲗⲁⲭⲙⲏ	N	ⲗⲁⲕⲙⲏ
ⲗⲉϣϫ	V	ⲗⲱϣϫ
ⲗⲉϥⲗⲱϥ	V	ⲗⲟϥⲗⲉϥ
ⲗⲉϥⲗⲱϥ	VSTAT	ⲗⲟϥⲗⲉϥ
ⲗⲉϥⲗⲱϥⲧ	VSTAT	ⲗⲟϥⲗⲉϥ
ⲗⲉϩⲗⲉⲙ	N	ⲗⲉϩⲗⲏⲙ
ⲗⲉϩⲗⲏⲙ	N	ⲗⲉϩⲗⲏⲙ
ⲗⲉϫ	V	ⲗⲱϫ
ⲗⲉϫϩ	V	ⲗⲱϫϩ
ⲗⲉⲃⲁⲛ	N	ⲗⲉⲃⲁⲛ
ⲗⲉⲃⲏⲥ	N	ⲗⲉⲃⲏⲥ
ⲗⲉⲃⲧ	N	ⲗⲁⲡⲧ
ⲗⲉⲅⲅⲉⲓⲣⲓⲟⲛ	N	ⲗⲉⲅⲅⲉⲓⲣⲓⲟⲛ
ⲗⲉⲅⲉⲱⲛ	NPROP	ⲗⲉⲅⲉⲱⲛ
ⲗⲉⲓϥⲓ	N	ⲗⲉⲓϥⲓ
ⲗⲉⲓⲧⲟⲩⲣⲅⲓⲁ	N	ⲗⲉⲓⲧⲟⲩⲣⲅⲓⲁ
ⲗⲉⲓⲧⲟⲩⲣⲅⲟⲥ	N	ⲗⲉⲓⲧⲟⲩⲣⲅⲟⲥ
ⲗⲉⲕⲧⲟⲩⲙⲉⲛⲟⲥ	N	ⲗⲉⲕⲧⲟⲩⲙⲉⲛⲟⲥ
ⲗⲉⲗⲉ	N	ⲁⲗⲟⲗⲓ
ⲗⲉⲗⲉ	V	ⲗⲉⲗⲉ
ⲗⲉⲗⲏⲙ	N	ⲗⲉϩⲗⲏⲙ
ⲗⲉⲙⲗⲏⲙ	VSTAT	ϭⲗⲟⲙⲗⲉⲙ
ⲗⲉⲛϫⲓ	N	ⲗⲉⲛϫⲓ
ⲗⲉⲛⲧⲓⲟⲛ	N	ⲗⲉⲛⲧⲓⲟⲛ
ⲗⲉⲝⲓⲥ	N	ⲗⲉⲝⲓⲥ
ⲗⲉⲟⲛ	N	ⲗⲉⲟⲛ
ⲗⲉⲟⲡⲁⲣⲇⲁⲗⲓⲥ	N	ⲗⲉⲟⲡⲁⲣⲇⲁⲗⲓⲥ
ⲗⲉⲟⲩⲉⲓ	V	ⲗⲉⲟⲩⲉⲓ
ⲗⲉⲡⲁϣⲓ	N	ⲗⲉⲡⲁϣⲓ
ⲗⲉⲡⲧⲟⲛ	N	ⲗⲉⲡⲧⲟⲛ
ⲗⲉⲥⲭⲏ	N	ⲗⲉⲥⲭⲏ
ⲗⲉⲩⲓ	NPROP	ⲗⲉⲩⲓ
ⲗⲉⲩⲓⲧⲏⲥ	N	ⲗⲉⲩⲓⲧⲏⲥ
ⲗⲉⲩⲕⲏ	V	ⲗⲉⲩⲕⲏ
ⲗⲉⲩⲕⲱⲙⲁ	N	ⲗⲉⲩⲕⲱⲙⲁ
ⲗⲏⲕ	VSTAT	ⲗⲱⲕ
ⲗⲏⲗ	N	ⲗⲏⲗ
ⲗⲏⲗⲟⲩⲓ	N	ⲗⲏⲗⲟⲩⲓ
ⲗⲏⲙⲙⲁ	N	ⲗⲏⲙⲙⲁ
ⲗⲏⲟⲩ	N	ⲗⲏⲟⲩ
ⲗⲏⲥ	N	ⲗⲏⲥ
ⲗⲏⲥⲧⲏⲥ	N	ⲗⲏⲥⲧⲏⲥ
ⲗⲓⲁ	NPROP	ⲗⲓⲁ
ⲗⲓⲃⲁⲛⲟⲥ	N	ⲗⲓⲃⲁⲛⲟⲥ
ⲗⲓⲃⲉⲣⲧⲓⲛⲟⲥ	N	ⲗⲓⲃⲉⲣⲧⲓⲛⲟⲥ
ⲗⲓⲃⲓ	V	ⲗⲓⲃⲓ
ⲗⲓⲃⲓⲧⲟⲛ	N	ⲗⲓⲃⲓⲧⲟⲛ
ⲗⲓⲃⲟⲥ	N	ⲗⲓⲃⲟⲥ
ⲗⲓⲃⲱⲥ	N	ⲗⲓⲃⲟⲥ
ⲗⲓⲇⲣⲁ	N	ⲗⲓⲇⲣⲁ
ⲗⲓⲕ	N	ⲗⲓⲕ
ⲗⲓⲕⲛⲟⲛ	N	ⲗⲓⲕⲛⲟⲛ
ⲗⲓⲙⲏⲛ	N	ⲗⲓⲙⲏⲛ
ⲗⲓⲙⲛ	N	ⲗⲓⲙⲏⲛ
ⲗⲓⲙⲛⲏ	N	ⲗⲓⲙⲛⲏ
ⲗⲓⲝ	N	ⲗⲓⲝ
ⲗⲓⲧⲟⲩⲣⲅⲓⲁ	N	ⲗⲓⲧⲟⲩⲣⲅⲓⲁ
ⲗⲓⲧⲟⲩⲣⲅⲟⲥ	N	ⲗⲓⲧⲟⲩⲣⲅⲟⲥ
ⲗⲓⲧⲣⲁ	N	ⲗⲓⲧⲣⲁ
ⲗⲕ	V	ⲱⲗⲕ
ⲗⲟϥ	VSTAT	ⲗⲱϥ
ⲗⲟϥⲗⲉϥ	V	ⲗⲟϥⲗⲉϥ
ⲗⲟϫ	V	ⲗⲟϫ
ⲗⲟϫ	V	ⲗⲱϫ
ⲗⲟϫ	V	ⲗⲱϫⲓ
ⲗⲟϫϩ	V	ⲗⲱϫϩ
ⲗⲟϫⲗⲉϫ	V	ⲗⲟϫⲗⲉϫ
ⲗⲟⲃϣ	V	ⲗⲱⲃϣ
ⲗⲟⲃϣ	VSTAT	ⲗⲱⲃϣ
ⲗⲟⲃⲓ	VSTAT	ⲗⲓⲃⲓ
ⲗⲟⲃⲗⲉⲃ	V	ⲗⲟⲃⲗⲉⲃ
ⲗⲟⲅⲓⲍⲉ	V	ⲗⲟⲅⲓⲍⲉ
ⲗⲟⲅⲓⲕⲏ	N	ⲗⲟⲅⲓⲕⲏ
ⲗⲟⲅⲓⲕⲟⲛ	N	ⲗⲟⲅⲓⲕⲟⲛ
ⲗⲟⲅⲓⲕⲟⲥ	N	ⲗⲟⲅⲓⲕⲟⲥ
ⲗⲟⲅⲓⲥⲙⲟⲥ	N	ⲗⲟⲅⲓⲥⲙⲟⲥ
ⲗⲟⲅⲟⲅⲉⲛⲏⲥ	N	ⲗⲟⲅⲟⲅⲉⲛⲏⲥ
ⲗⲟⲅⲟⲅⲣⲁⲫⲟⲥ	N	ⲗⲟⲅⲟⲅⲣⲁⲫⲟⲥ
ⲗⲟⲅⲟⲥ	N	ⲗⲟⲅⲟⲥ
ⲗⲟⲅⲭⲏ	N	ⲗⲟⲅⲭⲏ
ⲗⲟⲅⲭⲓⲍⲉ	V	ⲗⲟⲅⲭⲓⲍⲉ
ⲗⲟⲓⲙⲟⲥ	N	ⲗⲟⲓⲙⲟⲥ
ⲗⲟⲓⲡⲁⲥ	N	ⲗⲟⲓⲡⲁⲥ
ⲗⲟⲓⲡⲟⲛ	CONJ	ⲗⲟⲓⲡⲟⲛ
ⲗⲟⲕ	N	ⲗⲟⲕ
ⲗⲟⲕⲉⲙ	VSTAT	ⲗⲟⲕⲉⲙ
ⲗⲟⲗ	N	ⲗⲟⲗ
ⲗⲟⲙ	N	ⲗⲟⲙ
ⲗⲟⲙⲥ	VSTAT	ⲗⲟⲙⲥ
ⲗⲟⲝ	V	ⲗⲟⲩⲝ
ⲗⲟⲝ	VSTAT	ⲗⲟⲩⲝ
ⲗⲟⲡϣ	VSTAT	ⲗⲱⲃϣ
ⲗⲟⲣⲟⲥ	N	ⲗⲟⲣⲟⲥ
ⲗⲟⲩⲕ	N	ⲗⲟⲩⲕ
ⲗⲟⲩⲕⲓⲁⲛⲟⲥ	NPROP	ⲗⲟⲩⲕⲓⲁⲛⲟⲥ
ⲗⲟⲩⲕⲟϫⲓ	N	ⲗⲟⲩⲕⲟϫⲓ
ⲗⲟⲩⲗⲁⲓ	V	ⲗⲟⲩⲗⲁⲓ
ⲗⲟⲩⲗⲱⲟⲩ	VSTAT	ϩⲗⲟⲩⲗⲱⲟⲩ
ⲗⲟⲩⲝ	V	ⲗⲟⲩⲝ
ⲗⲟⲩⲡⲁⲥ	N	ⲗⲟⲩⲡⲁⲥ
ⲗⲟⲩⲥⲓⲙⲟⲛ	N	ⲗⲟⲩⲥⲓⲙⲟⲛ
ⲗⲩⲕⲁⲟⲛⲓⲥⲧⲓ	ADV	ⲗⲩⲕⲁⲟⲛⲓⲥⲧⲓ
ⲗⲩⲙⲏⲛ	N	ⲗⲩⲙⲏⲛ
ⲗⲩⲡⲉⲓ	N	ⲗⲩⲡⲉⲓ
ⲗⲩⲡⲉⲓ	V	ⲗⲩⲡⲉⲓ
ⲗⲩⲡⲏ	N	ⲗⲩⲡⲏ
ⲗⲩⲡⲏ	V	ⲗⲩⲡⲏ
ⲗⲩⲥⲧⲏⲥ	N	ⲗⲏⲥⲧⲏⲥ
ⲗⲩⲭⲛⲉⲓⲁ	N	ⲗⲩⲭⲛⲉⲓⲁ
ⲗⲩⲭⲛⲓⲁ	N	ⲗⲩⲭⲛⲓⲁ
ⲗⲭⲩⲛⲓⲕⲟⲛ	N	ⲗⲭⲩⲛⲓⲕⲟⲛ
ⲗⲱϣϫ	V	ⲗⲱϣϫ
ⲗⲱϥ	V	ⲗⲱϥ
ⲗⲱϧⲉⲙ	V	ⲗⲱϧⲉⲙ
ⲗⲱϫ	V	ⲗⲱϫ
ⲗⲱϫϩ	V	ⲗⲱϫϩ
ⲗⲱϫⲓ	V	ⲗⲱϫⲓ
ⲗⲱⲃϣ	N	ⲗⲱⲃϣ
ⲗⲱⲃϣ	V	ⲗⲱⲃϣ
ⲗⲱⲓϩⲓ	N	ⲗⲱⲓϩⲓ
ⲗⲱⲓϫⲓ	N	ⲗⲱⲓϫⲓ
ⲗⲱⲓⲗⲓ	V	ϩⲗⲱⲓⲗⲓ
ⲗⲱⲓⲙⲓ	N	ⲗⲟⲙ
ⲗⲱⲕ	V	ⲗⲱⲕ
ⲗⲱⲙ	N	ⲗⲟⲙ
ⲗⲱⲙ	V	ⲗⲱⲙ
ⲗⲱⲙⲓ	N	ⲗⲟⲙ
ⲗⲱⲟⲩ	N	ⲗⲱⲟⲩ
ⲗⲱⲥ	V	ⲗⲱⲥ
ⲗⲱⲧ	NPROP	ⲗⲱⲧ
ⲗⲱⲧⲉⲝ	N	ⲗⲱⲧⲉⲝ
ⲙ	NUM	ⲙ
ⲙ	PREP	ⲛ
ⲙϣⲁ	V	ⲙⲡϣⲁ
ⲙϣⲓϣ	N	ⲙϣⲓϣ
ⲙϣⲓⲣ	N	ⲙϣⲓⲣ
ⲙϩⲁⲩ	N	ⲙϩⲁⲩ
ⲙϩⲟⲧ	N	ⲙϩⲟⲧ
ⲙϫⲁϩⲧ	N	ⲙϫⲁϩⲧ
ⲙϫⲁⲧϩ	N	ⲙϫⲁϩⲧ
ⲙϫⲟⲩⲗ	N	ⲙϫⲱⲗ
ⲙϫⲱⲗ	N	ⲙϫⲱⲗ
ⲙⲁ	N	ⲙⲁ
ⲙⲁ	VIMP	ϯ
ⲙⲁϣ	V	ⲙⲓϣⲓ
ⲙⲁϣϫ	N	ⲙⲁϣϫ
ⲙⲁϣⲉ	V	ϣⲉ
ⲙⲁϣⲉ	VIMP	ϣⲉ
ⲙⲁϣⲉⲣⲧ	N	ⲙⲁϣⲉⲣⲧ
ⲙⲁϣⲑⲱϯ	N	ⲙⲁϣⲑⲱϯ
ⲙⲁϣⲓ	N	ⲙⲁϣⲓ
ⲙⲁϣⲓ	N	ⲙⲁϫⲓ
ⲙⲁϣⲓ	VSTAT	ⲙⲓϣⲓ
ⲙⲁϣⲧ	V	ⲙⲟⲩϣⲧ
ⲙⲁϣⲱ	ADV	ⲙⲁϣⲱ
ⲙⲁϧⲓ	V	ⲙⲁϧⲓ
ⲙⲁϧⲟⲩⲗ	N	ⲙⲁϧⲟⲩⲗ
ⲙⲁϧⲧ	N	ⲙⲁϧⲧ
ⲙⲁϩ	V	ⲙⲟϩ
ⲙⲁϩⲓ	N	ⲙⲁϩⲓ
ⲙⲁϩⲣⲟ	N	ⲙⲁϩⲣⲟ
ⲙⲁϩⲥⲟⲗ	N	ⲙⲁϩⲥⲟⲗ
ⲙⲁϩⲥⲱⲗ	N	ⲙⲁϩⲥⲟⲗ
ⲙⲁϫⲓ	N	ⲙⲁϫⲓ
ⲙⲁϯ	N	ⲙⲁϯ
ⲙⲁϯ	V	ⲙⲁϯ
ⲙⲁⲅⲁⲛⲟⲛ	N	ⲙⲁⲅⲁⲛⲟⲛ
ⲙⲁⲅⲇⲁⲗⲏⲛⲏ	NPROP	ⲙⲁⲅⲇⲁⲗⲏⲛⲏ
ⲙⲁⲅⲉⲓⲁ	N	ⲙⲁⲅⲉⲓⲁ
ⲙⲁⲅⲉⲓⲣⲟⲥ	N	ⲙⲁⲅⲉⲓⲣⲟⲥ
ⲙⲁⲅⲓⲣⲟⲥ	N	ⲙⲁⲅⲓⲣⲟⲥ
ⲙⲁⲅⲟⲥ	N	ⲙⲁⲅⲟⲥ
ⲙⲁⲅⲟⲩⲥⲁⲓⲟⲥ	N	ⲙⲁⲅⲟⲩⲥⲁⲓⲟⲥ
ⲙⲁⲏ	N	ⲙⲁⲓⲏ
ⲙⲁⲑⲁⲓⲟⲥ	N	ⲙⲁⲑⲁⲓⲟⲥ
ⲙⲁⲑⲏⲧⲉⲩⲉ	V	ⲙⲁⲑⲏⲧⲉⲩⲉ
ⲙⲁⲑⲏⲧⲏⲥ	N	ⲙⲁⲑⲏⲧⲏⲥ
ⲙⲁⲑⲟⲩⲓ	N	ⲙⲁⲑⲟⲩⲓ
ⲙⲁⲓ	N	ⲙⲁ
ⲙⲁⲓ	V	ⲑⲙⲁⲓⲟ
ⲙⲁⲓ	V	ⲙⲉⲓ
ⲙⲁⲓⲏ	N	ⲙⲁⲓⲏ
ⲙⲁⲓⲟ	V	ⲑⲙⲁⲓⲟ
ⲙⲁⲕⲁⲣⲓⲁ	N	ⲙⲁⲕⲁⲣⲓⲁ
ⲙⲁⲕⲁⲣⲓⲍⲉ	V	ⲙⲁⲕⲁⲣⲓⲍⲉ
ⲙⲁⲕⲁⲣⲓⲟⲛ	N	ⲙⲁⲕⲁⲣⲓⲟⲛ
ⲙⲁⲕⲁⲣⲓⲟⲥ	N	ⲙⲁⲕⲁⲣⲓⲟⲥ
ⲙⲁⲕⲁⲣⲓⲟⲧⲏⲥ	N	ⲙⲁⲕⲁⲣⲓⲟⲧⲏⲥ
ⲙⲁⲕⲁⲣⲓⲥⲙⲟⲥ	N	ⲙⲁⲕⲁⲣⲓⲥⲙⲟⲥ
ⲙⲁⲕⲉⲇⲟⲛⲓⲁ	NPROP	ⲙⲁⲕⲉⲇⲟⲛⲓⲁ
ⲙⲁⲕⲉⲗⲗⲟⲥ	N	ⲙⲁⲕⲉⲗⲗⲟⲥ
ⲙⲁⲕⲓⲥ	N	ⲙⲁⲕⲓⲥ
ⲙⲁⲕⲣⲟ	N	ⲙⲁⲕⲣⲟ
ⲙⲁⲗⲁⲕⲟⲥ	N	ⲙⲁⲗⲁⲕⲟⲥ
ⲙⲁⲗⲓⲥⲧⲁ	ADV	ⲙⲁⲗⲓⲥⲧⲁ
ⲙⲁⲗⲗⲟⲛ	ADV	ⲙⲁⲗⲗⲟⲛ
ⲙⲁⲙⲣⲉϩ	N	ⲙⲁⲙⲣⲉϩ
ⲙⲁⲙⲱⲛⲁⲥ	N	ⲙⲁⲙⲱⲛⲁⲥ
ⲙⲁⲛ	N	ⲙⲁⲛ
ⲙⲁⲛϭⲁⲗⲉ	N	ⲙⲁⲛϭⲁⲗⲉ
ⲙⲁⲛⲅⲁⲛⲟⲛ	N	ⲙⲁⲛⲅⲁⲛⲟⲛ
ⲙⲁⲛⲓⲁ	N	ⲙⲁⲛⲓⲁ
ⲙⲁⲛⲓⲁⲕⲏⲥ	N	ⲙⲁⲛⲓⲁⲕⲏⲥ
ⲙⲁⲛⲕ	VSTAT	ⲙⲟⲩⲛⲕ
ⲙⲁⲛⲕⲟⲩ	N	ⲙⲁⲛⲕⲟⲩ
ⲙⲁⲛⲙⲟⲛ	N	ⲙⲁⲛⲙⲟⲛ
ⲙⲁⲛⲟⲩ	V	ⲙⲟⲛⲓ
ⲙⲁⲛⲟⲩⲟⲩ	V	ⲙⲟⲛⲓ
ⲙⲁⲛⲧⲁⲕⲏ	N	ⲙⲁⲛⲧⲁⲕⲏ
ⲙⲁⲡⲡⲁ	N	ⲙⲁⲡⲡⲁ
ⲙⲁⲣⲅⲁⲣⲓⲧⲏⲥ	N	ⲙⲁⲣⲅⲁⲣⲓⲧⲏⲥ
ⲙⲁⲣⲉ	AJUS	ⲙⲁⲣⲉ
ⲙⲁⲣⲑⲁ	NPROP	ⲙⲁⲣⲑⲁ
ⲙⲁⲣⲓϩⲁⲙ	NPROP	ⲙⲁⲣⲓϩⲁⲙ
ⲙⲁⲣⲓⲁ	NPROP	ⲙⲁⲣⲓⲁ
ⲙⲁⲣⲓⲥ	N	ⲙⲁⲩⲣⲉⲥ
ⲙⲁⲣⲟ	VBD	ⲙⲁⲣⲟ
ⲙⲁⲣⲧⲉⲣⲓⲍⲉ	V	ⲙⲁⲣⲧⲉⲣⲓⲍⲉ
ⲙⲁⲣⲧⲩⲣⲓⲁ	N	ⲙⲁⲣⲧⲩⲣⲓⲁ
ⲙⲁⲣⲧⲩⲣⲓⲕⲟⲛ	N	ⲙⲁⲣⲧⲩⲣⲓⲕⲟⲛ
ⲙⲁⲣⲧⲩⲣⲓⲛ	V	ⲙⲁⲣⲧⲩⲣⲓⲛ
ⲙⲁⲣⲧⲩⲣⲓⲟⲛ	N	ⲙⲁⲣⲧⲩⲣⲓⲟⲛ
ⲙⲁⲣⲧⲩⲣⲟⲗⲟⲅⲓⲟⲛ	N	ⲙⲁⲣⲧⲩⲣⲟⲗⲟⲅⲓⲟⲛ
ⲙⲁⲣⲧⲩⲣⲟⲥ	N	ⲙⲁⲣⲧⲩⲣⲟⲥ
ⲙⲁⲣⲧⲩⲥ	N	ⲙⲁⲣⲧⲩⲥ
ⲙⲁⲥ	N	ⲙⲁⲥ
ⲙⲁⲥ	V	ⲙⲓⲥⲓ
ⲙⲁⲥ	VSTAT	ⲙⲓⲥⲓ
ⲙⲁⲥϯⲭⲉ	N	ⲙⲁⲥϯⲭⲉ
ⲙⲁⲥⲟⲩⲣ	N	ⲙⲁⲥⲟⲩⲣ
ⲙⲁⲥⲧⲉ	V	ⲙⲟⲥϯ
ⲙⲁⲥⲧⲏⲝ	N	ⲙⲁⲥⲧⲏⲝ
ⲙⲁⲥⲧⲓⲅⲝ	N	ⲙⲁⲥⲧⲓⲅⲝ
ⲙⲁⲥⲧⲓⲅⲟⲩ	N	ⲙⲁⲥⲧⲓⲅⲟⲩ
ⲙⲁⲥⲧⲓⲅⲟⲩ	V	ⲙⲁⲥⲧⲓⲅⲟⲩ
ⲙⲁⲥⲧⲓⲕⲟⲥ	N	ⲙⲁⲥⲧⲓⲕⲟⲥ
ⲙⲁⲧⲁⲙⲉ	VIMP	ⲙⲁⲧⲁⲙⲟ
ⲙⲁⲧⲉⲣ	N	ⲙⲁⲧⲉⲣ
ⲙⲁⲧⲑⲉⲟⲥ	NPROP	ⲙⲁⲧⲑⲉⲟⲥ
ⲙⲁⲧⲟⲓ	N	ⲙⲁⲧⲟⲓ
ⲙⲁⲧⲟⲩⲃⲟ	VIMP	ⲙⲁⲧⲟⲩⲃⲟ
ⲙⲁⲧⲣⲱⲛⲁ	N	ⲙⲁⲧⲣⲱⲛⲁ
ⲙⲁⲩ	N	ⲙⲁⲩ
ⲙⲁⲩⲗⲓⲍⲉ	V	ⲙⲁⲩⲗⲓⲍⲉ
ⲙⲁⲩⲣⲉⲥ	N	ⲙⲁⲩⲣⲉⲥ
ⲙⲁⲩⲣⲏⲥ	N	ⲙⲁⲩⲣⲉⲥ
ⲙⲃⲁⲓ	N	ⲙⲃⲁⲓ
ⲙⲃⲟⲛ	N	ⲙⲃⲟⲛ
ⲙⲃⲟⲛ	V	ⲙⲃⲟⲛ
ⲙⲃⲣⲁⲓ	N	ⲃⲣⲁⲓ
ⲙⲃⲣⲉϩⲓ	N	ⲉⲙⲣⲉϩⲓ
ⲙⲃⲣⲉϩⲓ	N	ⲙⲃⲣⲉϩⲓ
ⲙⲉϣϣⲱⲧ	N	ⲙⲉϣϣⲱⲧ
ⲙⲉϣⲑⲓⲃⲥ	N	ⲙⲉϣⲑⲓⲃⲥ
ⲙⲉϣⲧ	V	ⲙⲟⲩϣⲧ
ⲙⲉϣⲫⲱⲛⲓ	N	ⲙⲉϣⲫⲱⲛⲓ
ⲙⲉϩ	VSTAT	ⲙⲟϩ
ⲙⲉϩⲓ	N	ⲙⲉϩⲓ
ⲙⲉϩⲙⲟⲩϩⲉ	N	ⲙⲉϩⲙⲟⲩϩⲉ
ⲙⲉϩⲙⲟⲩϩⲓ	N	ⲙⲉϩⲙⲟⲩϩⲉ
ⲙⲉϭⲧⲱⲗ	N	ⲙⲉϭⲧⲱⲗ
ⲙⲉⲅⲉⲑⲟⲥ	N	ⲙⲉⲅⲉⲑⲟⲥ
ⲙⲉⲅⲓⲥⲧⲁⲛⲟⲥ	N	ⲙⲉⲅⲓⲥⲧⲁⲛⲟⲥ
ⲙⲉⲑⲁⲓⲟ	N	ⲙⲉⲑⲁⲓⲟ
ⲙⲉⲑⲣⲉ	N	ⲙⲉⲑⲣⲉ
ⲙⲉⲑⲣⲉⲩ	N	ⲙⲉⲑⲣⲉ
ⲙⲉⲓ	N	ⲙⲉⲓ
ⲙⲉⲓ	V	ⲙⲉⲓ
ⲙⲉⲓϣ	V	ⲙⲓϣⲓ
ⲙⲉⲓⲗⲓⲟⲛ	N	ⲙⲓⲗⲓⲟⲛ
ⲙⲉⲕⲙⲉⲕ	V	ⲙⲟⲕⲙⲉⲕ
ⲙⲉⲕⲙⲟⲩⲕ	V	ⲙⲟⲕⲙⲉⲕ
ⲙⲉⲗⲁⲛ	N	ⲙⲉⲗⲁⲛ
ⲙⲉⲗⲉⲓ	V	ⲙⲉⲗⲉⲓ
ⲙⲉⲗⲉⲧⲁ	V	ⲙⲉⲗⲉⲧⲁ
ⲙⲉⲗⲉⲧⲏ	N	ⲙⲉⲗⲉⲧⲏ
ⲙⲉⲗⲉⲧⲏⲥⲓⲥ	N	ⲙⲉⲗⲉⲧⲏⲥⲓⲥ
ⲙⲉⲗⲓ	V	ⲙⲉⲗⲓ
ⲙⲉⲗⲟⲅⲣⲁⲫⲟⲥ	N	ⲙⲉⲗⲟⲅⲣⲁⲫⲟⲥ
ⲙⲉⲗⲟⲥ	N	ⲙⲉⲗⲟⲥ
ⲙⲉⲗⲱⲧ	N	ⲙⲉⲗⲱⲧ
ⲙⲉⲙⲫⲓ	V	ⲙⲉⲙⲫⲓ
ⲙⲉⲛ	PTC	ⲙⲉⲛ
ⲙⲉⲛⲉⲛⲥⲁ	PREP	ⲙⲉⲛⲉⲛⲥⲁ
ⲙⲉⲛⲉⲛⲥⲱ	PREP	ⲙⲉⲛⲉⲛⲥⲁ
ⲙⲉⲛⲉⲩⲉ	V	ⲙⲉⲛⲉⲩⲉ
ⲙⲉⲛⲕ	V	ⲙⲟⲩⲛⲕ
ⲙⲉⲛⲛⲏⲧ	V	ⲙⲟⲛⲓ
ⲙⲉⲛⲣⲉ	V	ⲙⲉⲓ
ⲙⲉⲛⲣⲓⲧ	N	ⲙⲉⲛⲣⲓⲧ
ⲙⲉⲛⲣⲓⲧ	V	ⲙⲉⲓ
ⲙⲉⲛⲧ	N	ⲙⲉⲛⲧ
ⲙⲉⲛⲧ-ϩⲏⲙⲉⲣⲟⲥ	N	ⲙⲉⲛⲧ-ϩⲏⲙⲉⲣⲟⲥ
ⲙⲉⲛⲧⲟⲓ	PTC	ⲙⲉⲛⲧⲟⲓ
ⲙⲉⲛⲧⲟⲓⲅⲉ	CONJ	ⲙⲉⲛⲧⲟⲓⲅⲉ
ⲙⲉⲣ	V	ⲙⲟⲩⲣ
ⲙⲉⲣ	VSTAT	ⲙⲟⲩⲣ
ⲙⲉⲣⲁⲛ	N	ⲙⲉⲣⲁⲛ
ⲙⲉⲣⲉϩ	N	ⲙⲉⲣⲉϩ
ⲙⲉⲣⲓ	N	ⲙⲉⲣⲓ
ⲙⲉⲣⲓⲍⲉ	V	ⲙⲉⲣⲓⲍⲉ
ⲙⲉⲣⲓⲕⲟⲥ	N	ⲙⲉⲣⲓⲕⲟⲥ
ⲙⲉⲣⲓⲥ	N	ⲙⲉⲣⲓⲥ
ⲙⲉⲣⲓⲥⲙⲟⲥ	N	ⲙⲉⲣⲓⲥⲙⲟⲥ
ⲙⲉⲣⲟⲥ	N	ⲙⲉⲣⲟⲥ
ⲙⲉⲣⲟⲩⲥ	FM	ⲙⲉⲣⲟⲩⲥ
ⲙⲉⲣⲣⲉ	N	ⲙⲉⲣⲣⲉ
ⲙⲉⲣⲱϥ	N	ⲙⲉⲣⲱϥ
ⲙⲉⲥ	V	ⲙⲓⲥⲓ
ⲙⲉⲥⲏⲙⲃⲣⲓⲁ	N	ⲙⲉⲥⲏⲙⲃⲣⲓⲁ
ⲙⲉⲥⲓⲧⲏⲥ	N	ⲙⲉⲥⲓⲧⲏⲥ
ⲙⲉⲥⲟⲧⲏⲥ	N	ⲙⲉⲥⲟⲧⲏⲥ
ⲙⲉⲥⲟⲩⲁⲫⲓ	N	ⲙⲉⲥⲟⲩⲁⲫⲓ
ⲙⲉⲥⲧⲉ	V	ⲙⲟⲥϯ
ⲙⲉⲥⲧⲉⲛϩⲏⲧ	N	ⲙⲉⲥⲧⲉⲛϩⲏⲧ
ⲙⲉⲥⲧⲱ	V	ⲙⲟⲥϯ
ⲙⲉⲧϣⲫⲱⲛⲓ	N	ⲙⲉϣⲫⲱⲛⲓ
ⲙⲉⲧⲁ	PREP	ⲙⲉⲧⲁ
ⲙⲉⲧⲁⲃⲟⲗⲏ	N	ⲙⲉⲧⲁⲃⲟⲗⲏ
ⲙⲉⲧⲁⲅⲅⲓⲥⲙⲟⲥ	N	ⲙⲉⲧⲁⲅⲅⲓⲥⲙⲟⲥ
ⲙⲉⲧⲁⲓⲱ	N	ⲙⲉⲑⲁⲓⲟ
ⲙⲉⲧⲁⲗⲗⲟⲛ	N	ⲙⲉⲧⲁⲗⲗⲟⲛ
ⲙⲉⲧⲁⲛⲟⲉⲓ	V	ⲙⲉⲧⲁⲛⲟⲉⲓ
ⲙⲉⲧⲁⲛⲟⲉⲓⲛ	N	ⲙⲉⲧⲁⲛⲟⲉⲓⲛ
ⲙⲉⲧⲁⲛⲟⲓ	V	ⲙⲉⲧⲁⲛⲟⲉⲓ
ⲙⲉⲧⲁⲛⲟⲓⲁ	N	ⲙⲉⲧⲁⲛⲟⲓⲁ
ⲙⲉⲧⲉⲭⲉ	V	ⲙⲉⲧⲉⲭⲉ
ⲙⲉⲧⲕⲟⲩϫⲓ	N	ⲙⲉⲧⲕⲟⲩϫⲓ
ⲙⲉⲧⲙⲉⲑⲣⲉ	V	ⲙⲉⲧⲙⲉⲑⲣⲉ
ⲙⲉⲧⲟⲩⲣⲟ	N	ⲙⲉⲧⲟⲩⲣⲟ
ⲙⲉⲧⲟⲭⲟⲥ	N	ⲙⲉⲧⲟⲭⲟⲥ
ⲙⲉⲧⲣⲁⲙⲁⲟ	N	ⲙⲉⲧⲣⲁⲙⲁⲟ
ⲙⲉⲧⲣⲉⲙⲣⲁⲩϣ	N	ⲙⲉⲧⲣⲉⲙⲣⲁⲩϣ
ⲙⲉⲧⲣⲏⲧⲏⲥ	N	ⲙⲉⲧⲣⲏⲧⲏⲥ
ⲙⲉⲧⲣⲟⲛ	N	ⲙⲉⲧⲣⲟⲛ
ⲙⲉⲧⲣⲱⲙⲓ	N	ⲙⲉⲧⲣⲱⲙⲓ
ⲙⲉⲧⲥⲟⲃⲓ	N	ⲉⲙⲥⲟⲃⲓ
ⲙⲉⲩⲓ	V	ⲙⲉⲩⲓ
ⲙⲉⲭⲓⲣ	N	ⲙϣⲓⲣ
ⲙⲉⲭⲣⲓ	PREP	ⲙⲉⲭⲣⲓ
ⲙⲏ	N	ⲙⲏ
ⲙⲏϣ	N	ⲙⲏϣ
ⲙⲏϯ	N	ⲙⲏϯ
ⲙⲏⲃⲣⲁⲛⲟⲛ	N	ⲙⲏⲃⲣⲁⲛⲟⲛ
ⲙⲏⲇⲟⲥ	N	ⲙⲏⲇⲟⲥ
ⲙⲏⲓ	N	ⲙⲉⲓ
ⲙⲏⲓ	V	ⲙⲉⲓ
ⲙⲏⲓ	VIMP	ϯ
ⲙⲏⲓⲛⲓ	N	ⲙⲏⲓⲛⲓ
ⲙⲏⲓⲧ	VIMP	ϯ
ⲙⲏⲛ	VSTAT	ⲙⲟⲩⲛ
ⲙⲏⲛⲓ	ADV	ⲙⲏⲛⲓ
ⲙⲏⲟⲗⲟⲛ	N	ⲙⲓⲟⲗⲱⲛ
ⲙⲏⲡⲟⲧⲉ	CONJ	ⲙⲏⲡⲟⲧⲉ
ⲙⲏⲡⲱⲥ	ADV	ⲙⲏⲡⲱⲥ
ⲙⲏⲡⲱⲥ	CONJ	ⲙⲏⲡⲱⲥ
ⲙⲏⲡⲱⲥ	N	ⲙⲏⲡⲱⲥ
ⲙⲏⲣ	N	ⲙⲏⲣ
ⲙⲏⲣ	VSTAT	ⲙⲟⲩⲣ
ⲙⲏⲣⲁⲛ	N	ⲙⲉⲣⲁⲛ
ⲙⲏⲣⲟⲥ	N	ⲙⲏⲣⲟⲥ
ⲙⲏⲥⲧⲏⲣⲓⲟⲛ	N	ⲙⲏⲥⲧⲏⲣⲓⲟⲛ
ⲙⲏⲧⲓ	CONJ	ⲙⲏⲧⲓ
ⲙⲏⲧⲣⲁ	N	ⲙⲏⲧⲣⲁ
ⲙⲏⲧⲣⲟⲡⲁⲧⲱⲣ	N	ⲙⲏⲧⲣⲟⲡⲁⲧⲱⲣ
ⲙⲏⲧⲣⲟⲡⲟⲗⲓⲥ	N	ⲙⲏⲧⲣⲟⲡⲟⲗⲓⲥ
ⲙⲏⲭⲁⲛⲏ	N	ⲙⲏⲭⲁⲛⲏ
ⲙⲑⲟ	N	ⲙⲑⲟ
ⲙⲓϣⲓ	V	ⲙⲓϣⲓ
ⲙⲓⲁⲕⲏⲥ	N	ⲙⲓⲁⲕⲏⲥ
ⲙⲓⲗⲓⲟⲛ	N	ⲙⲓⲗⲓⲟⲛ
ⲙⲓⲛⲓ	N	ⲙⲓⲛⲓ
ⲙⲓⲟ	V	ⲙⲓⲟ
ⲙⲓⲟⲕ	V	ⲙⲓⲟ
ⲙⲓⲟⲗⲟⲛ	N	ⲙⲓⲟⲗⲱⲛ
ⲙⲓⲟⲗⲱⲛ	N	ⲙⲓⲟⲗⲱⲛ
ⲙⲓⲥⲑⲱⲥⲓⲥ	N	ⲙⲓⲥⲑⲱⲥⲓⲥ
ⲙⲓⲥⲑⲱⲧⲏⲥ	N	ⲙⲓⲥⲑⲱⲧⲏⲥ
ⲙⲓⲥⲓ	V	ⲙⲓⲥⲓ
ⲙⲓⲧ	N	ⲙⲓⲧ
ⲙⲓⲧⲁⲧⲱⲣ	N	ⲙⲓⲧⲁⲧⲱⲣ
ⲙⲓⲧⲣⲁ	N	ⲙⲓⲧⲣⲁ
ⲙⲓⲧⲱⲟⲩⲓ	N	ⲙⲱⲓⲧ
ⲙⲓⲭⲁⲏⲗ	NPROP	ⲙⲓⲭⲁⲏⲗ
ⲙⲓⲱⲟⲩ	V	ⲙⲓⲟ
ⲙⲓⲱⲧⲉⲛ	V	ⲙⲓⲟ
ⲙⲕⲁϩ	N	ⲙⲕⲁϩ
ⲙⲕⲁϩ	V	ⲙⲕⲁϩ
ⲙⲗⲁϧ	V	ⲙⲗⲁϧ
ⲙⲙⲁⲩ	ADV	ⲙⲙⲁⲩ
ⲙⲙⲁⲩⲁ	IMOD	ⲙⲙⲁⲩⲁ
ⲙⲙⲓⲛⲙⲙⲟ	IMOD	ⲙⲙⲓⲛⲙⲙⲟ
ⲙⲙⲟ	PREP	ⲛ
ⲙⲙⲟⲛ	EXIST	ⲙⲙⲟⲛ
ⲙⲙⲟⲛ	NEG	ⲙⲙⲟⲛ
ⲙⲙⲟⲛ	PTC	ⲙⲙⲟⲛ
ⲙⲙⲟⲛ	V	ⲙⲙⲟⲛ
ⲙⲙⲟⲛⲧ	V	ⲙⲙⲟⲛ
ⲙⲙⲟⲛⲧⲁ	V	ⲙⲙⲟⲛ
ⲙⲙⲟⲛⲧⲉ	EXIST	ⲙⲙⲟⲛⲧⲉ
ⲙⲙⲱ	PREP	ⲛ
ⲙⲛⲁ	V	ⲙⲛⲁⲣⲉ
ⲙⲛⲁⲓ	ADV	ⲙⲛⲁⲓ
ⲙⲛⲁⲣⲉ	V	ⲙⲛⲁⲣⲉ
ⲙⲛⲏ	ADV	ⲙⲛⲏ
ⲙⲛⲏⲙⲏ	N	ⲙⲛⲏⲙⲏ
ⲙⲛⲟϯ	N	ⲙⲛⲟⲧ
ⲙⲛⲟⲧ	N	ⲙⲛⲟⲧ
ⲙⲛⲟⲧ	N	ⲙⲛⲟⲩⲧ
ⲙⲛⲟⲩⲧ	N	ⲙⲛⲟⲩⲧ
ⲙⲛⲧϩⲁⲡⲗⲟⲩⲥ	N	ⲙⲛⲧϩⲁⲡⲗⲟⲩⲥ
ⲙⲛⲧϩⲉⲃⲣⲁⲓⲟⲥ	N	ⲙⲛⲧϩⲉⲃⲣⲁⲓⲟⲥ
ⲙⲛⲧⲁⲅⲁⲑⲟⲥ	N	ⲙⲛⲧⲁⲅⲁⲑⲟⲥ
ⲙⲛⲧⲡⲣⲟⲇⲟⲧⲏⲥ	N	ⲙⲛⲧⲡⲣⲟⲇⲟⲧⲏⲥ
ⲙⲛⲧⲣⲉϥϩⲉⲧⲃⲯⲩⲭⲏ	N	ⲙⲛⲧⲣⲉϥϩⲉⲧⲃⲯⲩⲭⲏ
ⲙⲛⲧⲣⲉⲩⲉ	V	ⲙⲛⲧⲣⲉⲩⲉ
ⲙⲛⲧⲧⲉⲗⲓⲟⲥ	N	ⲙⲛⲧⲧⲉⲗⲓⲟⲥ
ⲙⲟϣⲓ	N	ⲙⲟϣⲓ
ⲙⲟϣⲓ	V	ⲙⲟϣⲓ
ⲙⲟϣⲧ	V	ⲙⲟⲩϣⲧ
ⲙⲟϧϫ	N	ⲙⲟϫϧ
ⲙⲟϩ	N	ⲙⲟϩ
ⲙⲟϩ	V	ⲙⲟϩ
ⲙⲟϫϧ	N	ⲙⲟϫϧ
ⲙⲟϫⲧ	V	ⲙⲟⲩϫⲧ
ⲙⲟϫⲧ	VSTAT	ⲙⲟⲩϫⲧ
ⲙⲟⲅⲓⲥ	ADV	ⲙⲟⲅⲓⲥ
ⲙⲟⲇⲓⲟⲛ	N	ⲙⲟⲇⲓⲟⲛ
ⲙⲟⲓ	VIMP	ϯ
ⲙⲟⲓⲣⲁ	N	ⲙⲟⲓⲣⲁ
ⲙⲟⲓⲧ	VSTAT	ϯ
ⲙⲟⲓⲭⲉⲓⲁ	N	ⲙⲟⲓⲭⲉⲓⲁ
ⲙⲟⲕϩ	VSTAT	ⲙⲕⲁϩ
ⲙⲟⲕⲓ	N	ⲙⲟⲕⲓ
ⲙⲟⲕⲙⲉⲕ	N	ⲙⲟⲕⲙⲉⲕ
ⲙⲟⲕⲙⲉⲕ	V	ⲙⲟⲕⲙⲉⲕ
ⲙⲟⲗϧ	V	ⲙⲟⲗϧ
ⲙⲟⲗϩ	N	ⲙⲟⲩⲗϩ
ⲙⲟⲗϩ	V	ⲙⲟⲩⲗϩ
ⲙⲟⲗϩ	VSTAT	ⲙⲟⲩⲗϩ
ⲙⲟⲗϫ	V	ⲙⲟⲩⲗϫ
ⲙⲟⲗϫ	VSTAT	ⲙⲟⲩⲗϫ
ⲙⲟⲗⲟⲭ	N	ⲙⲟⲗⲟⲭ
ⲙⲟⲛⲁⲍⲉⲓ	V	ⲙⲟⲛⲁⲍⲉⲓ
ⲙⲟⲛⲁⲣⲭⲏⲥ	N	ⲙⲟⲛⲁⲣⲭⲏⲥ
ⲙⲟⲛⲁⲣⲭⲓⲁ	N	ⲙⲟⲛⲁⲣⲭⲓⲁ
ⲙⲟⲛⲁⲥ	N	ⲙⲟⲛⲁⲥ
ⲙⲟⲛⲁⲥⲧⲏⲣⲓⲟⲛ	N	ⲙⲟⲛⲁⲥⲧⲏⲣⲓⲟⲛ
ⲙⲟⲛⲁⲭⲏ	N	ⲙⲟⲛⲁⲭⲏ
ⲙⲟⲛⲁⲭⲟⲥ	N	ⲙⲟⲛⲁⲭⲟⲥ
ⲙⲟⲛⲏ	N	ⲙⲟⲛⲏ
ⲙⲟⲛⲑⲩⲗⲟⲥ	N	ⲙⲟⲛⲑⲩⲗⲟⲥ
ⲙⲟⲛⲓ	N	ⲙⲟⲛⲓ
ⲙⲟⲛⲓ	V	ⲙⲟⲛⲓ
ⲙⲟⲛⲕ	V	ⲙⲟⲩⲛⲕ
ⲙⲟⲛⲕ	VSTAT	ⲙⲟⲩⲛⲕ
ⲙⲟⲛⲙⲉⲛ	V	ⲙⲟⲛⲙⲉⲛ
ⲙⲟⲛⲟⲅⲉⲛⲏⲥ	N	ⲙⲟⲛⲟⲅⲉⲛⲏⲥ
ⲙⲟⲛⲟⲛ	ADV	ⲙⲟⲛⲟⲛ
ⲙⲟⲛⲟⲛ	FM	ⲙⲟⲛⲟⲛ
ⲙⲟⲛⲟⲭⲟⲥ	N	ⲙⲟⲛⲟⲭⲟⲥ
ⲙⲟⲛⲱⲟⲩⲓ	N	ⲙⲟⲛⲱⲟⲩⲓ
ⲙⲟⲣ	V	ⲙⲟⲩⲣ
ⲙⲟⲣ	VSTAT	ⲙⲟⲩⲣ
ⲙⲟⲣⲧ	N	ⲙⲟⲣⲧ
ⲙⲟⲣⲫⲏ	N	ⲙⲟⲣⲫⲏ
ⲙⲟⲥϯ	V	ⲙⲟⲥϯ
ⲙⲟⲥⲓ	VSTAT	ⲙⲓⲥⲓ
ⲙⲟⲥⲕ	VSTAT	ⲙⲟⲥⲕ
ⲙⲟⲧⲉⲛ	V	ⲙⲟⲧⲉⲛ
ⲙⲟⲧⲉⲛ	VSTAT	ⲙⲧⲟⲛ
ⲙⲟⲩ	N	ⲙⲟⲩ
ⲙⲟⲩ	V	ⲙⲟⲩ
ⲙⲟⲩϣⲧ	V	ⲙⲟⲩϣⲧ
ⲙⲟⲩϫϧ	N	ⲙⲟϫϧ
ⲙⲟⲩϫⲧ	V	ⲙⲟⲩϫⲧ
ⲙⲟⲩϯ	V	ⲙⲟⲩϯ
ⲙⲟⲩⲉ	N	ⲙⲟⲩⲉ
ⲙⲟⲩⲓ	N	ⲙⲟⲩⲓ
ⲙⲟⲩⲕⲓ	N	ⲙⲟⲩⲕⲓ
ⲙⲟⲩⲗϩ	N	ⲙⲟⲩⲗϩ
ⲙⲟⲩⲗϩ	V	ⲙⲟⲩⲗϩ
ⲙⲟⲩⲗϫ	N	ⲙⲟⲩⲗϫ
ⲙⲟⲩⲗϫ	V	ⲙⲟⲩⲗϫ
ⲙⲟⲩⲗⲁϫ	N	ⲙⲟⲩⲗⲁϫ
ⲙⲟⲩⲗⲕ	V	ⲙⲟⲩⲗⲕ
ⲙⲟⲩⲗⲗⲁ	N	ⲙⲟⲩⲗⲗⲁ
ⲙⲟⲩⲛ	V	ⲙⲟⲩⲛ
ⲙⲟⲩⲛⲓ	V	ⲙⲟⲩⲛ
ⲙⲟⲩⲛⲕ	V	ⲙⲟⲩⲛⲕ
ⲙⲟⲩⲣ	V	ⲙⲟⲩⲣ
ⲙⲟⲩⲥⲉⲣ	N	ⲙⲟⲩⲥⲉⲣ
ⲙⲟⲩⲥⲏⲣ	N	ⲙⲟⲩⲥⲉⲣ
ⲙⲟⲩⲥⲓⲕⲉ	N	ⲙⲟⲩⲥⲓⲕⲉ
ⲙⲟⲩⲥⲓⲕⲟⲛ	N	ⲙⲟⲩⲥⲓⲕⲟⲛ
ⲙⲟⲩⲥⲭⲁⲧⲱⲛ	N	ⲙⲟⲩⲥⲭⲁⲧⲱⲛ
ⲙⲟⲩⲧ	N	ⲙⲟⲩⲧ
ⲙⲟⲭⲗⲟⲥ	N	ⲙⲟⲭⲗⲟⲥ
ⲙⲡ	ANEGPST	ⲙⲡⲉ
ⲙⲡϣⲁ	V	ⲙⲡϣⲁ
ⲙⲡϣⲓϣ	N	ⲙϣⲓϣ
ⲙⲡⲁ	ANEGAOR	ⲙⲡⲁⲣⲉ
ⲙⲡⲁⲡⲧⲉ	ANY	ⲙⲡⲁⲧⲉ
ⲙⲡⲁⲣⲉ	ANEGAOR	ⲙⲡⲁⲣⲉ
ⲙⲡⲁⲧⲉ	ANY	ⲙⲡⲁⲧⲉ
ⲙⲡⲉ	ANEGPST	ⲙⲡⲉ
ⲙⲡⲉⲛⲑⲣ	ANEGJUS	ⲙⲡⲉⲛⲑⲣⲉ
ⲙⲡⲉⲛⲑⲣⲉ	ANEGJUS	ⲙⲡⲉⲛⲑⲣⲉ
ⲙⲡⲉⲣ	NEG	ⲙⲡⲉⲣ
ⲙⲡⲟⲇⲓⲍⲉ	V	ⲙⲡⲟⲇⲓⲍⲉ
ⲙⲡⲣ	NEG	ⲙⲡⲉⲣ
ⲙⲣⲉϩ	N	ⲙⲣⲉϩ
ⲙⲣⲉϩⲓ	N	ⲉⲙⲣⲉϩⲓ
ⲙⲣⲟϣⲧ	VSTAT	ⲙⲣⲟϣⲧ
ⲙⲣⲟϧⲧ	N	ⲙⲣⲟϧⲧ
ⲙⲣⲟⲙ	N	ⲙⲣⲱⲙ
ⲙⲣⲱⲙ	N	ⲙⲣⲱⲙ
ⲙⲥⲁϩ	N	ⲙⲥⲁϩ
ⲙⲧⲁⲧ	N	ⲙⲧⲁⲧ
ⲙⲧⲁⲧϩ	N	ⲙⲧⲁⲧϩ
ⲙⲧⲁⲩ	N	ⲙⲧⲁⲩ
ⲙⲧⲟⲛ	V	ⲙⲧⲟⲛ
ⲙⲧⲟⲧϥ	N	ⲙⲧⲟⲧϥ
ⲙⲩⲣⲓⲁⲣⲭⲟⲥ	N	ⲙⲩⲣⲓⲁⲣⲭⲟⲥ
ⲙⲩⲥⲧⲏⲣⲓⲟⲛ	N	ⲙⲩⲥⲧⲏⲣⲓⲟⲛ
ⲙⲱϫⲉ	N	ⲙⲱϫⲉ
ⲙⲱⲁⲃⲓⲧⲏⲥ	N	ⲙⲱⲁⲃⲓⲧⲏⲥ
ⲙⲱⲅⲓⲥ	ADV	ⲙⲱⲅⲓⲥ
ⲙⲱⲓⲧ	N	ⲙⲱⲓⲧ
ⲙⲱⲛⲁⲭⲏ	N	ⲙⲱⲛⲁⲭⲏ
ⲙⲱⲛⲟⲛ	ADV	ⲙⲱⲛⲟⲛ
ⲙⲱⲟⲩ	N	ⲙⲱⲟⲩ
ⲙⲱⲟⲩⲓ	N	ⲙⲟⲩⲉ
ⲙⲱⲟⲩⲓ	N	ⲙⲟⲩⲓ
ⲙⲱⲟⲩⲧ	V	ⲙⲱⲟⲩⲧ
ⲙⲱⲟⲩⲧ	VSTAT	ⲙⲟⲩ
ⲙⲱⲩⲥⲏⲥ	NPROP	ⲙⲱⲩⲥⲏⲥ
ⲛ	ACONJ	ⲛⲧⲉ
ⲛ	ART	ⲡ
ⲛ	NEG	ⲛ
ⲛ	PPERO	ⲁⲛⲟⲛ
ⲛ	PPERS	ⲁⲛⲟⲛ
ⲛ	PREP	ⲛ
ⲛϣⲁϣⲓ	VSTAT	ϣⲁϣⲓ
ⲛϣⲟⲧ	V	ⲛϣⲟⲧ
ⲛϧⲏⲧ	PREP	ϧⲉⲛ
ⲛϧⲏⲧ	PREP_PPERO	ϧⲉⲛ_ⲁⲛⲟⲕ
ⲛϧⲟⲩⲛ	ADV	ⲛϧⲟⲩⲛ
ⲛϧⲣⲏⲓ	ADV	ⲛϧⲣⲏⲓ
ⲛϩⲟⲩⲣ	V	ⲛϩⲟⲩⲣ
ⲛϫⲉ	PTC	ⲛϫⲉ
ⲛⲁ	CPRET	ⲛⲁⲣⲉ
ⲛⲁ	FUT	ⲛⲁ
ⲛⲁ	PPOS	ⲡⲁ
ⲛⲁ	PPOS	ⲫⲁ
ⲛⲁ	PREP	ⲛⲁ
ⲛⲁ	V	ⲛⲁ
ⲛⲁ	V	ⲛⲁⲓ
ⲛⲁϣⲉ	V	ⲛⲁϣⲉ
ⲛⲁϣⲡ	VSTAT	ⲛⲟⲩϣⲡ
ⲛⲁϣⲧ	VSTAT	ⲛϣⲟⲧ
ⲛⲁϣⲱ	V	ⲛⲁϣⲉ
ⲛⲁϩ	V	ⲛⲟⲩϩ
ⲛⲁϩϫⲓ	N	ⲛⲁϩϫⲓ
ⲛⲁϩϯ	N	ⲛⲁϩϯ
ⲛⲁϩϯ	V	ⲛⲁϩϯ
ⲛⲁϩⲃⲓ	N	ⲛⲁⲩⲓ
ⲛⲁϩⲉⲙ	V	ⲛⲟϩⲉⲙ
ⲛⲁϩⲙ	V	ⲛⲟϩⲉⲙ
ⲛⲁϩⲙⲉ	V	ⲛⲟϩⲉⲙ
ⲛⲁϩⲣⲁ	PREP	ⲛⲁϩⲣⲛ
ⲛⲁϫⲡ	N	ⲛⲁϫⲡ
ⲛⲁⲁ	V	ⲛⲁⲁ
ⲛⲁⲁⲥⲥⲱⲛ	NPROP	ⲛⲁⲁⲥⲥⲱⲛ
ⲛⲁⲃⲓ	N	ⲛⲁⲩⲓ
ⲛⲁⲃⲟⲩⲭⲟⲇⲟⲛⲟⲥⲟⲣ	NPROP	ⲛⲁⲃⲟⲩⲭⲟⲇⲟⲛⲟⲥⲟⲣ
ⲛⲁⲍⲁⲣⲁⲓⲟⲥ	N	ⲛⲁⲍⲁⲣⲁⲓⲟⲥ
ⲛⲁⲍⲁⲣⲉⲑ	NPROP	ⲛⲁⲍⲁⲣⲉⲑ
ⲛⲁⲍⲁⲣⲏⲛⲟⲥ	NPROP	ⲛⲁⲍⲁⲣⲏⲛⲟⲥ
ⲛⲁⲍⲱⲣⲁⲓⲟⲥ	N	ⲛⲁⲍⲱⲣⲁⲓⲟⲥ
ⲛⲁⲓ	PDEM	ⲡⲁⲓ
ⲛⲁⲓ	PDEM	ⲫⲁⲓ
ⲛⲁⲓ	V	ⲛⲁⲓ
ⲛⲁⲕϩⲓ	N	ⲛⲁⲕϩⲓ
ⲛⲁⲙ	N	ⲛⲟⲙ
ⲛⲁⲛⲉ	VBD	ⲛⲁⲛⲉ
ⲛⲁⲟⲥ	N	ⲛⲁⲟⲥ
ⲛⲁⲣⲇⲓⲝ	N	ⲛⲁⲣⲇⲓⲝ
ⲛⲁⲣⲇⲟⲥ	N	ⲛⲁⲣⲇⲟⲥ
ⲛⲁⲣⲉ	CPRET	ⲛⲁⲣⲉ
ⲛⲁⲣⲉ	PREP	ⲛⲁⲣⲉ
ⲛⲁⲣⲧⲟⲥ	N	ⲛⲁⲣⲧⲟⲥ
ⲛⲁⲧ	N	ⲛⲁⲧ
ⲛⲁⲩ	N	ⲛⲁⲩ
ⲛⲁⲩ	V	ⲛⲁⲩ
ⲛⲁⲩⲃⲉⲛ	N	ⲛⲁⲩⲃⲉⲛ
ⲛⲁⲩⲓ	N	ⲛⲁⲩⲓ
ⲛⲁⲩⲕⲗⲏⲣⲟⲥ	N	ⲛⲁⲩⲕⲗⲏⲣⲟⲥ
ⲛⲁⲫⲁⲓ	N	ⲛⲁⲫⲁⲓ
ⲛⲁⲫⲣⲓ	N	ⲛⲁⲫⲣⲓ
ⲛⲉ	ART	ⲡ
ⲛⲉ	COP	ⲡⲉ
ⲛⲉ	CPRET	ⲛⲁⲣⲉ
ⲛⲉ	PPOS	ⲡⲉ
ⲛⲉϣⲡ	V	ⲛⲟⲩϣⲡ
ⲛⲉϥ	N	ⲛⲉϥ
ⲛⲉϥ	PPOS	ⲡⲉϥ
ⲛⲉϥⲓ	V	ⲛⲏⲃⲓ
ⲛⲉϩ	N	ⲛⲉϩ
ⲛⲉϩ	V	ⲛⲟⲩϩ
ⲛⲉϩ	VSTAT	ⲛⲟⲩϩ
ⲛⲉϩⲃⲁⲗ	N	ⲛⲉϩⲃⲏⲗ
ⲛⲉϩⲃⲉⲗ	N	ⲛⲉϩⲃⲏⲗ
ⲛⲉϩⲃⲏⲗ	N	ⲛⲉϩⲃⲏⲗ
ⲛⲉϩⲛⲓ	V	ⲛⲉϩⲛⲓ
ⲛⲉϩⲡ	V	ⲛⲟϩⲉⲃ
ⲛⲉϩⲥⲓ	V	ⲛⲉϩⲥⲓ
ⲛⲉϫ	V	ⲛⲟⲩϫ
ⲛⲉϫⲓ	N	ⲛⲉϫⲓ
ⲛⲉⲁⲛⲓⲥⲕⲟⲥ	N	ⲛⲉⲁⲛⲓⲥⲕⲟⲥ
ⲛⲉⲃ	N	ⲛⲏⲃ
ⲛⲉⲃⲓ	V	ⲛⲏⲃⲓ
ⲛⲉⲓ	N	ⲛⲉⲓ
ⲛⲉⲕ	PPOS	ⲡⲉⲕ
ⲛⲉⲙ	PPOS	ⲛⲉⲙ
ⲛⲉⲙ	PREP	ⲛⲉⲙ
ⲛⲉⲙⲁ	PREP	ⲛⲉⲙ
ⲛⲉⲙⲏ	PREP	ⲛⲉⲙ
ⲛⲉⲙⲫⲏ	N	ⲛⲉⲙⲫⲏ
ⲛⲉⲙⲱ	PREP	ⲛⲉⲙ
ⲛⲉⲙⲱ	PREP	ⲛⲉⲙⲱ
ⲛⲉⲙⲱ	V	ⲛⲉⲙⲱ
ⲛⲉⲛ	PPOS	ⲡⲉⲛ
ⲛⲉⲥⲉ	V	ⲛⲉⲥⲉ
ⲛⲉⲥⲧⲟⲣⲓⲟⲥ	NPROP	ⲛⲉⲥⲧⲟⲣⲓⲟⲥ
ⲛⲉⲥⲱ	V	ⲛⲉⲥⲉ
ⲛⲉⲧϥ	V	ⲛⲟⲩⲧϥ
ⲛⲉⲧⲃ	V	ⲛⲟⲩⲧϥ
ⲛⲉⲧⲛ	PPOS	ⲡⲉⲧⲛ
ⲛⲉⲩⲣⲟⲛ	N	ⲛⲉⲩⲣⲟⲛ
ⲛⲏ	PDEM	ⲫⲏ
ⲛⲏϩ	VSTAT	ⲛⲟⲩϩ
ⲛⲏϫ	VSTAT	ⲛⲟⲩϫ
ⲛⲏⲃ	N	ⲛⲏⲃ
ⲛⲏⲃⲓ	V	ⲛⲏⲃⲓ
ⲛⲏⲓ	N	ⲛⲉⲓ
ⲛⲏⲛⲓ	N	ⲛⲏⲛⲓ
ⲛⲏⲟⲩ	VSTAT	ⲓ
ⲛⲏⲥⲟⲥ	N	ⲛⲏⲥⲟⲥ
ⲛⲏⲥⲧⲉⲓⲁ	N	ⲛⲏⲥⲧⲉⲓⲁ
ⲛⲏⲥⲧⲉⲩⲉ	V	ⲛⲏⲥⲧⲉⲩⲉ
ⲛⲏⲥⲧⲓⲁ	N	ⲛⲏⲥⲧⲓⲁ
ⲛⲏⲫⲉ	V	ⲛⲏⲫⲉ
ⲛⲑⲟ	PPERI	ⲛⲑⲟ
ⲛⲑⲟϥ	N	ⲛⲑⲟϥ
ⲛⲑⲟϥ	PPERI	ⲛⲑⲟϥ
ⲛⲑⲟⲕ	PPERI	ⲛⲑⲟⲕ
ⲛⲑⲱⲟⲩ	PPERI	ⲛⲑⲱⲟⲩ
ⲛⲑⲱⲧⲉⲛ	PPERI	ⲛⲑⲱⲧⲉⲛ
ⲛⲓ	ART	ⲡⲓ
ⲛⲓϣϯ	N	ⲛⲓϣϯ
ⲛⲓϥⲓ	V	ⲛⲓϥⲓ
ⲛⲓⲃⲉⲛ	PINT	ⲛⲓⲃⲉⲛ
ⲛⲓⲃⲓ	V	ⲛⲏⲃⲓ
ⲛⲓⲕⲟⲫⲟⲣⲟⲥ	N	ⲛⲓⲕⲟⲫⲟⲣⲟⲥ
ⲛⲓⲙ	N	ⲛⲓⲙ
ⲛⲓⲙ	PINT	ⲛⲓⲙ
ⲛⲓⲛⲉⲩⲏⲓⲧⲏⲥ	N	ⲛⲓⲛⲉⲩⲏⲓⲧⲏⲥ
ⲛⲓⲛⲓ	V	ⲛⲏⲃⲓ
ⲛⲕⲟⲧ	N	ⲛⲕⲟⲧ
ⲛⲕⲟⲧ	V	ⲉⲛⲕⲟⲧ
ⲛⲛ	ANEGOPT	ⲛⲛⲉ
ⲛⲛⲉ	ANEGOPT	ⲛⲛⲉ
ⲛⲛⲉ	ANEGOPT_PPERS	ⲛⲛⲉ_ⲛⲑⲟ
ⲛⲛⲉ	V	ⲛⲛⲉ
ⲛⲟϣⲉⲣ	N	ⲛⲟϣⲉⲣ
ⲛⲟϣⲡ	V	ⲛⲟⲩϣⲡ
ⲛⲟϣⲡ	VSTAT	ⲛⲟⲩϣⲡ
ⲛⲟϥⲉⲣ	VSTAT	ⲛⲟϥⲉⲣ
ⲛⲟϥⲧ	V	ⲛⲟⲩⲧϥ
ⲛⲟϧϫ	V	ⲛⲟⲩϫϧ
ⲛⲟϩ	N	ⲛⲟϩ
ⲛⲟϩ	V	ⲛⲟⲩϩ
ⲛⲟϩⲉⲃ	V	ⲛⲟϩⲉⲃ
ⲛⲟϩⲉⲙ	V	ⲛⲟϩⲉⲙ
ⲛⲟϩⲉⲙ	VSTAT	ⲛⲟϩⲉⲙ
ⲛⲟϫ	V	ⲛⲟⲩϫ
ⲛⲟϫϧ	V	ⲛⲟⲩϫϧ
ⲛⲟϫϧ	VSTAT	ⲛⲟⲩϫϧ
ⲛⲟϫⲛⲉϫ	V	ⲛⲟϫⲛⲉϫ
ⲛⲟⲃⲓ	N	ⲛⲟⲃⲓ
ⲛⲟⲉⲓ	V	ⲛⲟⲉⲓ
ⲛⲟⲉⲣⲁ	N	ⲛⲟⲉⲣⲁ
ⲛⲟⲉⲣⲟⲛ	N	ⲛⲟⲉⲣⲟⲛ
ⲛⲟⲉⲣⲟⲥ	N	ⲛⲟⲉⲣⲟⲥ
ⲛⲟⲏⲙⲁ	N	ⲛⲟⲏⲙⲁ
ⲛⲟⲏⲥⲓⲥ	N	ⲛⲟⲏⲥⲓⲥ
ⲛⲟⲏⲧⲟⲛ	N	ⲛⲟⲏⲧⲟⲛ
ⲛⲟⲏⲧⲟⲥ	N	ⲛⲟⲏⲧⲟⲥ
ⲛⲟⲓ	UNKNOWN	UNKNOWN
ⲛⲟⲓ	V	ⲛⲟⲓ
ⲛⲟⲓⲛⲓ	V	ⲛⲟⲓⲛⲓ
ⲛⲟⲙ	N	ⲛⲟⲙ
ⲛⲟⲙϯ	N	ⲛⲟⲙϯ
ⲛⲟⲙⲏ	N	ⲛⲟⲙⲏ
ⲛⲟⲙⲓⲕⲟⲛ	N	ⲛⲟⲙⲓⲕⲟⲛ
ⲛⲟⲙⲓⲕⲟⲥ	N	ⲛⲟⲙⲓⲕⲟⲥ
ⲛⲟⲙⲓⲙⲟⲛ	N	ⲛⲟⲙⲓⲙⲟⲛ
ⲛⲟⲙⲓⲥⲙⲁ	N	ⲛⲟⲙⲓⲥⲙⲁ
ⲛⲟⲙⲟⲇⲓⲇⲁⲥⲕⲁⲗⲟⲥ	N	ⲛⲟⲙⲟⲇⲓⲇⲁⲥⲕⲁⲗⲟⲥ
ⲛⲟⲙⲟⲑⲉⲧⲏⲥ	N	ⲛⲟⲙⲟⲑⲉⲧⲏⲥ
ⲛⲟⲙⲟⲑⲉⲧⲓ	V	ⲛⲟⲙⲟⲑⲉⲧⲓ
ⲛⲟⲙⲟⲥ	N	ⲛⲟⲙⲟⲥ
ⲛⲟⲛⲓ	V	ⲛⲟⲛⲓ
ⲛⲟⲧ	V	ⲛⲟⲩⲧ
ⲛⲟⲧⲁⲣⲓⲟⲥ	N	ⲛⲟⲧⲁⲣⲓⲟⲥ
ⲛⲟⲧⲉⲙ	VSTAT	ⲛⲟⲩⲧⲉⲙ
ⲛⲟⲩ	PPOS	ⲡⲟⲩ
ⲛⲟⲩϣⲡ	V	ⲛⲟⲩϣⲡ
ⲛⲟⲩϥ	PPOS	ⲫⲱϥ
ⲛⲟⲩϥⲧ	V	ⲛⲟⲩϥⲧ
ⲛⲟⲩϥⲧ	V	ⲛⲟⲩⲧϥ
ⲛⲟⲩϧϫ	V	ⲛⲟⲩϫϧ
ⲛⲟⲩϩ	V	ⲛⲟⲩϩ
ⲛⲟⲩϩⲓ	N	ⲛⲟⲩϩⲓ
ⲛⲟⲩϫ	V	ⲛⲟⲩϫ
ⲛⲟⲩϫϧ	V	ⲛⲟⲩϫϧ
ⲛⲟⲩϯ	N	ⲛⲟⲩϯ
ⲛⲟⲩⲃ	N	ⲛⲟⲩⲃ
ⲛⲟⲩⲃⲧ	V	ⲛⲟⲩⲃⲧ
ⲛⲟⲩⲉϣⲉⲛ	PREP	ⲛⲟⲩⲉϣⲉⲛ
ⲛⲟⲩⲑⲉⲧⲉⲓ	V	ⲛⲟⲩⲑⲉⲧⲉⲓ
ⲛⲟⲩⲓ	PPOS	ⲫⲱⲓ
ⲛⲟⲩⲓ	V	ⲛⲟⲩⲓ
ⲛⲟⲩⲕ	PPOS	ⲫⲱⲕ
ⲛⲟⲩⲕⲉⲣ	V	ⲛⲟⲩⲕⲉⲣ
ⲛⲟⲩⲙⲉⲣⲟⲛ	N	ⲛⲟⲩⲙⲉⲣⲟⲛ
ⲛⲟⲩⲙⲟⲥ	N	ⲛⲟⲩⲙⲟⲥ
ⲛⲟⲩⲛ	N	ⲛⲟⲩⲛ
ⲛⲟⲩⲛ	PPOS	ⲫⲱⲛ
ⲛⲟⲩⲛⲓ	N	ⲛⲟⲩⲛⲓ
ⲛⲟⲩⲣⲓ	N	ⲛⲟⲩⲣⲓ
ⲛⲟⲩⲥ	N	ⲛⲟⲩⲥ
ⲛⲟⲩⲥ	PPOS	ⲡⲱⲥ
ⲛⲟⲩⲥ	PPOS	ⲫⲱⲥ
ⲛⲟⲩⲧ	V	ⲛⲟⲩⲧ
ⲛⲟⲩⲧϥ	V	ⲛⲟⲩⲧϥ
ⲛⲟⲩⲧⲃ	V	ⲛⲟⲩⲃⲧ
ⲛⲟⲩⲧⲉⲙ	V	ⲛⲟⲩⲧⲉⲙ
ⲛⲟⲩⲧⲛ	V	ⲛⲟⲩⲃⲧ
ⲛⲥⲱ	PREP	ⲛⲥⲁ
ⲛⲧ	ACONJ	ⲛⲧⲉ
ⲛⲧⲁ	PREP	ⲛⲧⲉ
ⲛⲧⲉ	ACONJ	ⲛⲧⲉ
ⲛⲧⲉ	PREP	ⲛⲧⲉ
ⲛⲧⲉ	V	ⲛⲧⲉ
ⲛⲧⲉⲧⲛ	PPERS	ⲛⲑⲱⲧⲉⲛ
ⲛⲧⲏϫ	N	ⲉⲛⲧⲏϫ
ⲛⲧⲟⲗⲏ	N	ⲛⲧⲟⲗⲏ
ⲛⲧⲟⲧ	PREP	ⲛⲧⲉⲛ
ⲛⲩⲕⲏⲥⲓⲥ	N	ⲛⲩⲕⲏⲥⲓⲥ
ⲛⲩⲕⲧⲉⲣⲓⲥ	N	ⲛⲩⲕⲧⲉⲣⲓⲥ
ⲛⲩⲙⲫⲏ	N	ⲛⲩⲙⲫⲏ
ⲛⲩⲙⲫⲓⲟⲥ	N	ⲛⲩⲙⲫⲓⲟⲥ
ⲛⲩⲙⲫⲱⲛ	N	ⲛⲩⲙⲫⲱⲛ
ⲛⲩⲙⲯⲓⲥ	N	ⲛⲩⲙⲯⲓⲥ
ⲛⲩⲥⲁⲉⲩⲥ	N	ⲛⲩⲥⲁⲉⲩⲥ
ⲛⲭⲁⲓ	N	ⲛⲭⲁⲓ
ⲛⲱ	PREP	ⲛⲁ
ⲛⲱ	PREP	ⲛⲱ
ⲛⲱ	V	ⲛⲱ
ⲛⲱϩⲉⲃ	V	ⲛⲟϩⲉⲃ
ⲛⲱⲓϣ	N	ⲛⲱⲓϣ
ⲛⲱⲓⲕ	N	ⲛⲱⲓⲕ
ⲛⲱⲓⲛⲓ	V	ⲛⲟⲓⲛⲓ
ⲛⲱⲟⲩϯ	N	ⲛⲱⲟⲩϯ
ⲝⲉⲛⲉⲓⲟⲥ	N	ⲝⲉⲛⲉⲓⲟⲥ
ⲝⲉⲛⲓⲟⲛ	N	ⲝⲉⲛⲓⲟⲛ
ⲝⲉⲥⲧⲏⲥ	N	ⲝⲉⲥⲧⲏⲥ
ⲝⲟⲩⲣ	N	ⲝⲟⲩⲣ
ⲟϣ	V	ⲱϣ
ⲟϣ	VSTAT	ⲁϣⲁⲓ
#ⲟϣ	VSTAT	ⲱϣ
ⲟϣϫ	V	ⲱϣϫ
ⲟϣϫ	VSTAT	ⲱϣϫ
ⲟϣⲉⲙ	V	ⲱϣⲉⲙ
ⲟϣⲉⲙ	VSTAT	ⲱϣⲉⲙ
ⲟϣⲙ	V	ⲱϣⲉⲙ
ⲟϥ	V	ⲱϥⲓ
ⲟϥⲧ	V	ⲱϥⲧ
ⲟϥⲧ	VSTAT	ⲱϥⲧ
ⲟϧⲧ	VSTAT	ⲱϧⲧ
ⲟϩϫ	V	ⲱϫϩ
ⲟϩⲓ	N	ⲟϩⲓ
ⲟϩⲓ	V	ⲟϩⲓ
ⲟϩⲓ	VSTAT	ⲟϩⲓ
ⲟϫϩ	V	ⲱϫϩ
ⲟϫⲉⲃ	VSTAT	ⲱϫⲉⲃ
ⲟϫⲓ	N	ⲟϫⲓ
ⲟϯ	N	ⲟϯ
ⲟⲃϣ	V	ⲱⲃϣ
ⲟⲃϣ	VSTAT	ⲱⲃϣ
ⲟⲃⲓ	VSTAT	ⲓⲃⲓ
ⲟⲃⲣⲩⲍⲟⲛ	N	ⲟⲃⲣⲩⲍⲟⲛ
ⲟⲅⲇⲟⲁⲥ	N	ⲟⲅⲇⲟⲁⲥ
ⲟⲇⲟⲗⲗⲁ	NPROP	ⲟⲇⲟⲗⲗⲁ
ⲟⲉⲓϣ	N	ⲟⲉⲓϣ
#ⲟⲓ	VSTAT	ⲁⲓⲁⲓ
ⲟⲓ	VSTAT	ⲓⲣⲓ
ⲟⲓⲕⲟⲇⲉⲥⲡⲟⲧⲏⲥ	N	ⲟⲓⲕⲟⲇⲉⲥⲡⲟⲧⲏⲥ
ⲟⲓⲕⲟⲑⲉⲛ	ADV	ⲟⲓⲕⲟⲑⲉⲛ
ⲟⲓⲕⲟⲛⲟⲙⲉⲓ	V	ⲟⲓⲕⲟⲛⲟⲙⲉⲓ
ⲟⲓⲕⲟⲛⲟⲙⲓⲁ	N	ⲟⲓⲕⲟⲛⲟⲙⲓⲁ
ⲟⲓⲕⲟⲛⲟⲙⲟⲥ	N	ⲟⲓⲕⲟⲛⲟⲙⲟⲥ
ⲟⲓⲕⲟⲥ	N	ⲟⲓⲕⲟⲥ
ⲟⲓⲕⲟⲩⲙⲉⲛⲏ	N	ⲟⲓⲕⲟⲩⲙⲉⲛⲏ
ⲟⲓⲗⲓ	N	ⲱⲓⲗⲓ
ⲟⲕⲙ	VSTAT	ⲱⲕⲉⲙ
ⲟⲕⲧⲟⲏⲥ	N	ⲟⲕⲧⲟⲏⲥ
ⲟⲗ	V	ⲱⲗⲓ
ⲟⲗ	VSTAT	ⲱⲗⲓ
ⲟⲗⲓⲅⲱⲣⲉⲓ	V	ⲟⲗⲓⲅⲱⲣⲉⲓ
ⲟⲗⲓⲕⲉ	V	ⲟⲗⲓⲕⲉ
ⲟⲗⲕ	V	ⲱⲗⲕ
ⲟⲗⲕ	VSTAT	ⲱⲗⲕ
ⲟⲗⲗⲁⲣⲓⲟⲛ	N	ⲟⲗⲗⲁⲣⲓⲟⲛ
ⲟⲗⲟⲕⲁⲩⲧⲱⲙⲁ	N	ⲟⲗⲟⲕⲁⲩⲧⲱⲙⲁ
ⲟⲙⲓ	N	ⲟⲙⲓ
ⲟⲙⲕ	V	ⲱⲙⲕ
ⲟⲙⲟⲓⲱⲥ	ADV	ⲟⲙⲟⲓⲱⲥ
ⲟⲙⲥ	V	ⲱⲙⲥ
ⲟⲛ	ADV	ⲟⲛ
ⲟⲛϣ	VSTAT	ⲟⲛϣ
ⲟⲛϧ	V	ⲱⲛϧ
ⲟⲛϧ	VSTAT	ⲱⲛϧ
ⲟⲛϩ	N	ⲟⲛϩ
ⲟⲛⲅⲓⲁ	N	ⲟⲛⲅⲓⲁ
ⲟⲛⲓ	VSTAT	ⲓⲛⲓ
ⲟⲛⲟⲙⲁⲍⲉ	V	ⲟⲛⲟⲙⲁⲍⲉ
ⲟⲛⲟⲙⲁⲥⲓⲁ	N	ⲟⲛⲟⲙⲁⲥⲓⲁ
ⲟⲛⲟⲙⲁⲥⲧⲟⲥ	N	ⲟⲛⲟⲙⲁⲥⲧⲟⲥ
ⲟⲛⲟⲣⲓⲟⲥ	NPROP	ⲟⲛⲟⲣⲓⲟⲥ
ⲟⲛⲧⲱⲥ	ADV	ⲟⲛⲧⲱⲥ
ⲟⲟ	N	ⲟⲟ
ⲟⲡ	V	ⲱⲡ
ⲟⲡϣ	V	ⲱⲃϣ
ⲟⲡⲓⲥⲱ	ADV	ⲟⲡⲓⲥⲱ
ⲟⲡⲧ	V	ⲱⲃⲧ
ⲟⲡⲧ	VSTAT	ⲱⲃⲧ
ⲟⲡⲧⲁⲥⲓⲁ	N	ⲟⲡⲧⲁⲥⲓⲁ
ⲟⲡⲧⲉⲩⲉ	V	ⲟⲡⲧⲉⲩⲉ
ⲟⲡⲱⲣⲁ	N	ⲟⲡⲱⲣⲁ
ⲟⲣ	V	ⲟⲣ
ⲟⲣϥ	V	ⲱⲣϥ
ⲟⲣϥ	VSTAT	ⲱⲣϥ
ⲟⲣⲁⲝ	N	ⲟⲣⲁⲝ
ⲟⲣⲃ	V	ⲱⲣⲉⲃ
ⲟⲣⲅⲁⲛⲟⲛ	N	ⲟⲣⲅⲁⲛⲟⲛ
ⲟⲣⲅⲏ	N	ⲟⲣⲅⲏ
ⲟⲣⲇⲓⲛⲟⲛ	N	ⲟⲣⲇⲓⲛⲟⲛ
ⲟⲣⲉⲃ	VSTAT	ⲱⲣⲉⲃ
ⲟⲣⲑⲏⲥⲓⲥ	N	ⲟⲣⲑⲏⲥⲓⲥ
ⲟⲣⲑⲟⲇⲟⲝⲟⲥ	N	ⲟⲣⲑⲟⲇⲟⲝⲟⲥ
ⲟⲣⲑⲟⲛ	N	ⲟⲣⲑⲟⲛ
ⲟⲣⲑⲱⲧⲱⲕⲝⲏⲓⲁ	N	ⲟⲣⲑⲱⲧⲱⲕⲝⲏⲓⲁ
ⲟⲣⲫⲁⲛⲟⲥ	N	ⲟⲣⲫⲁⲛⲟⲥ
ⲟⲣⲭⲉ	V	ⲟⲣⲭⲉ
ⲟⲣⲭⲉⲓ	V	ⲟⲣⲭⲉⲓ
ⲟⲥϧ	N	ⲱⲥϧ
ⲟⲥϧ	V	ⲱⲥϧ
ⲟⲥⲓ	N	ⲟⲥⲓ
ⲟⲥⲕ	VSTAT	ⲱⲥⲕ
ⲟⲧⲓ	CONJ	ⲟⲧⲓ
ⲟⲧⲡ	VSTAT	ⲱⲃⲧ
ⲟⲧⲡ	VSTAT	ⲱⲧⲡ
ⲟⲩ	ART	ⲟⲩ
ⲟⲩ	PINT	ⲟⲩ
ⲟⲩ	PPERO	ⲛⲑⲱⲟⲩ
ⲟⲩ	PPERS	ⲛⲑⲱⲟⲩ
ⲟⲩϣⲁⲡ	N	ⲟⲩϣⲁⲡ
ⲟⲩϧⲉ	N	ⲟⲩϧⲉ
ⲟⲩϩⲟ	N	ϩⲟⲩⲟ
ⲟⲩϩⲟⲣ	N	ⲟⲩϩⲟⲣ
ⲟⲩϩⲱⲣ	N	ⲟⲩϩⲟⲣ
ⲟⲩϫⲁⲓ	V	ⲟⲩϫⲁⲓ
ⲟⲩⲁ	N	ⲟⲩⲁ
ⲟⲩⲁ	NUM	ⲟⲩⲁ
ⲟⲩⲁϣ	V	ⲟⲩⲱϣ
ⲟⲩⲁϩ	N	ⲟⲩⲁϩ
ⲟⲩⲁϩ	V	ⲟⲩⲱϩ
ⲟⲩⲁϩϥ	V	ⲟⲩⲁϩⲃⲉϥ
ⲟⲩⲁϩⲃⲉϥ	V	ⲟⲩⲁϩⲃⲉϥ
ⲟⲩⲁϩⲉⲙ	V	ⲟⲩⲱϩⲉⲙ
ⲟⲩⲁϩⲉⲙ	VSTAT	ⲟⲩⲱϩⲉⲙ
ⲟⲩⲁϩⲙ	V	ⲟⲩⲱϩⲉⲙ
ⲟⲩⲁϩⲥⲁϩⲛⲓ	V	ⲟⲩⲁϩⲥⲁϩⲛⲓ
ⲟⲩⲁϩⲥⲟⲓ	N	ⲟⲩⲁϩⲥⲟⲓ
ⲟⲩⲁⲃ	VSTAT	ⲟⲩⲁⲃ
ⲟⲩⲁⲓ	NUM	ⲟⲩⲁⲓ
ⲟⲩⲁⲙ	V	ⲟⲩⲱⲙ
ⲟⲩⲁⲛ	N	ⲟⲩⲁⲛ
ⲟⲩⲁⲥ	V	ⲟⲩⲓⲥⲓ
ⲟⲩⲁⲥⲃⲓⲛ	N	ⲟⲩⲁⲥⲃⲓⲛ
ⲟⲩⲁⲧⲉϥ	V	ⲟⲩⲱⲧⲉⲃ
ⲟⲩⲁⲧⲉⲃ	V	ⲟⲩⲱⲧⲉⲃ
ⲟⲩⲃⲁϣ	V	ⲟⲩⲃⲁϣ
ⲟⲩⲇ[.......]	UNKNOWN	UNKNOWN
ⲟⲩⲇⲉ	CONJ	ⲟⲩⲇⲉ
ⲟⲩⲉϣ	V	ⲟⲩⲱϣ
ⲟⲩⲉϣⲟⲩⲱϣ	V	ⲟⲩⲟϣⲟⲩⲉϣ
ⲟⲩⲉϣⲟⲩⲱϣ	VSTAT	ⲟⲩⲟϣⲟⲩⲉϣ
ⲟⲩⲉϣⲥ	V	ⲟⲩⲱϣⲥ
ⲟⲩⲉϩ	V	ⲟⲩⲱϩ
ⲟⲩⲉϩ	VSTAT	ⲟⲩⲱϩ
ⲟⲩⲉϩⲉⲙ	V	ⲟⲩⲱϩⲉⲙ
ⲟⲩⲉϫ	V	ⲟⲩⲱϫ
ⲟⲩⲉϫⲟⲩⲱϫ	V	ⲟⲩⲟϫⲟⲩⲉϫ
ⲟⲩⲉϫⲡ	V	ⲟⲩⲱϫⲡ
ⲟⲩⲉⲉⲓⲉⲛⲓⲛ	N	ⲟⲩⲉⲉⲓⲉⲛⲓⲛ
ⲟⲩⲉⲓ	N	ⲟⲩⲉⲓ
ⲟⲩⲉⲓ	V	ⲟⲩⲉⲓ
ⲟⲩⲉⲓⲉⲛⲓⲛ	N	ⲟⲩⲉⲓⲉⲛⲓⲛ
ⲟⲩⲉⲓⲛⲓⲛ	NPROP	ⲟⲩⲉⲓⲛⲓⲛ
ⲟⲩⲉⲙ	V	ⲟⲩⲱⲙ
ⲟⲩⲉⲙϣϫⲉ	V	ⲟⲩⲉⲙϣϫⲉ
ⲟⲩⲉⲙⲱⲓⲕ	V	ⲟⲩⲉⲙⲱⲓⲕ
ⲟⲩⲉⲛ	N	ⲟⲩⲱⲛ
ⲟⲩⲉⲛⲧ	N	ⲟⲩⲉⲛⲧ
ⲟⲩⲉⲣϣⲓ	N	ⲟⲩⲉⲣϣⲓ
ⲟⲩⲉⲣⲡ	V	ⲟⲩⲱⲣⲡ
ⲟⲩⲉⲣⲧ	N	ⲟⲩⲉⲣⲧ
ⲟⲩⲉⲥⲑⲉⲛ	V	ⲟⲩⲟⲥⲑⲉⲛ
ⲟⲩⲉⲥⲑⲱⲛ	V	ⲟⲩⲟⲥⲑⲉⲛ
ⲟⲩⲉⲧ	V	ⲟⲩⲱϯ
ⲟⲩⲉⲧϩ	V	ⲱⲧⲑ
ⲟⲩⲉⲧⲉϥ	V	ⲟⲩⲱⲧⲉⲃ
ⲟⲩⲉⲧⲉⲃ	V	ⲟⲩⲱⲧⲉⲃ
ⲟⲩⲏⲃ	N	ⲟⲩⲏⲃ
ⲟⲩⲏⲓ	ADV	ⲟⲩⲏⲓ
ⲟⲩⲏⲓ	V	ⲟⲩⲏⲓ
ⲟⲩⲏⲗⲟⲛ	N	ⲟⲩⲏⲗⲟⲛ
ⲟⲩⲏⲛ	VSTAT	ⲟⲩⲱⲛ
ⲟⲩⲏⲟⲩ	VSTAT	ⲟⲩⲉⲓ
ⲟⲩⲏⲟⲩⲧ	VSTAT	ⲟⲩⲱ
ⲟⲩⲏⲣ	PINT	ⲟⲩⲏⲣ
ⲟⲩⲓ	NUM	ⲟⲩⲁ
ⲟⲩⲓⲛⲁⲙ	N	ⲟⲩⲓⲛⲁⲙ
ⲟⲩⲓⲥⲓ	V	ⲟⲩⲓⲥⲓ
ⲟⲩⲕ	NEG	ⲟⲩⲕ
ⲟⲩⲕ	V	ⲟⲩⲕ
ⲟⲩⲕⲉⲧⲓ	ADV	ⲟⲩⲕⲉⲧⲓ
ⲟⲩⲕⲟⲩⲛ	CONJ	ⲟⲩⲕⲟⲩⲛ
ⲟⲩⲗⲁⲓ	N	ⲟⲩⲗⲁⲓ
ⲟⲩⲗⲏ	N	ⲟⲩⲗⲏ
ⲟⲩⲙ	V	ⲟⲩⲱⲙ
ⲟⲩⲙⲟⲧ	V	ⲟⲩⲙⲟⲧ
ⲟⲩⲛⲟϥ	V	ⲟⲩⲛⲟϥ
ⲟⲩⲛⲟⲩ	N	ⲟⲩⲛⲟⲩ
ⲟⲩⲛⲱⲟⲩⲓ	N	ⲟⲩⲛⲟⲩ
ⲟⲩⲟϣϥ	V	ⲟⲩⲱϣϥ
ⲟⲩⲟϣϥ	VSTAT	ⲟⲩⲱϣϥ
ⲟⲩⲟϣⲉⲙ	VSTAT	ⲟⲩⲱϣⲉⲙ
ⲟⲩⲟϣⲙ	V	ⲟⲩⲱϣⲉⲙ
ⲟⲩⲟϣⲟⲩⲉϣ	V	ⲟⲩⲟϣⲟⲩⲉϣ
ⲟⲩⲟϣⲥ	VSTAT	ⲟⲩⲱϣⲥ
ⲟⲩⲟϩ	CONJ	ⲟⲩⲟϩ
ⲟⲩⲟϩ	V	ⲟⲩⲱϩ
ⲟⲩⲟϩ	VSTAT	ⲟⲩⲱϩ
ⲟⲩⲟϩⲉⲙ	V	ⲟⲩⲱϩⲉⲙ
ⲟⲩⲟϩⲉⲙ	VSTAT	ⲟⲩⲱϩⲉⲙ
ⲟⲩⲟϩⲓ	N	ⲟⲩⲟϩⲓ
ⲟⲩⲟϫ	V	ⲟⲩⲱϫ
ⲟⲩⲟϫ	VSTAT	ⲟⲩϫⲁⲓ
ⲟⲩⲟϫⲃⲉϫ	V	ⲟⲩⲟϫⲟⲩⲉϫ
ⲟⲩⲟϫⲓ	N	ⲟⲩⲟϫⲓ
ⲟⲩⲟϫⲓ	V	ⲟⲩⲟϫⲓ
ⲟⲩⲟϫⲟⲩⲉϫ	V	ⲟⲩⲟϫⲟⲩⲉϫ
ⲟⲩⲟϫⲡ	V	ⲟⲩⲱϫⲡ
ⲟⲩⲟϫⲡ	VSTAT	ⲟⲩⲱϫⲡ
ⲟⲩⲟϯ	N	ⲟⲩⲟϯ
ⲟⲩⲟⲃϣ	VSTAT	ⲟⲩⲃⲁϣ
ⲟⲩⲟⲑϥ	V	ⲟⲩⲱⲧⲉⲃ
ⲟⲩⲟⲑⲃ	V	ⲟⲩⲱⲧⲉⲃ
ⲟⲩⲟⲑⲛ	V	ⲟⲱⲧⲉⲛ
ⲟⲩⲟⲓ	N	ⲟⲩⲟⲓ
ⲟⲩⲟⲕⲓ	N	ⲟⲩⲟⲕⲓ
ⲟⲩⲟⲙ	V	ⲟⲩⲱⲙ
ⲟⲩⲟⲙⲧ	VSTAT	ⲟⲩⲙⲟⲧ
ⲟⲩⲟⲛ	EXIST	ⲟⲩⲟⲛ
ⲟⲩⲟⲛ	N	ⲟⲩⲟⲛ
ⲟⲩⲟⲛϩ	V	ⲟⲩⲱⲛϩ
ⲟⲩⲟⲛϩ	VSTAT	ⲟⲩⲱⲛϩ
ⲟⲩⲟⲛϩϥ	N	ⲟⲩⲟⲛϩϥ
ⲟⲩⲟⲛⲧⲁ	EXIST	ⲟⲩⲟⲛⲧⲉ
ⲟⲩⲟⲛⲧⲉ	EXIST	ⲟⲩⲟⲛⲧⲉ
ⲟⲩⲟⲣϣϥ	N	ⲟⲩⲟⲣϣϥ
ⲟⲩⲟⲣⲡ	V	ⲟⲩⲟⲣⲡ
ⲟⲩⲟⲣⲡ	V	ⲟⲩⲱⲣⲡ
ⲟⲩⲟⲥⲉⲣ	N	ⲟⲩⲟⲥⲉⲣ
ⲟⲩⲟⲥⲑⲉⲛ	V	ⲟⲩⲟⲥⲑⲉⲛ
ⲟⲩⲟⲧ	V	ⲟⲩⲱϯ
ⲟⲩⲟⲧ	VSTAT	ⲟⲩⲱϯ
ⲟⲩⲟⲧϥ	V	ⲟⲩⲱⲧⲉⲃ
ⲟⲩⲟⲧⲃ	V	ⲟⲩⲱⲧⲉⲃ
ⲟⲩⲟⲧⲉϥ	VSTAT	ⲟⲩⲱⲧⲉⲃ
ⲟⲩⲟⲧⲉⲃ	VSTAT	ⲟⲩⲱⲧⲉⲃ
ⲟⲩⲟⲧⲉⲛ	VSTAT	ⲟⲱⲧⲉⲛ
ⲟⲩⲟⲧⲛ	V	ⲟⲱⲧⲉⲛ
ⲟⲩⲟⲧⲡ	V	ⲟⲩⲱⲧⲉⲃ
ⲟⲩⲣⲁϯ	N	ⲟⲩⲣⲓⲧ
ⲟⲩⲣⲁⲛⲓⲟⲛ	N	ⲟⲩⲣⲁⲛⲓⲟⲛ
ⲟⲩⲣⲏⲧⲉ	N	ⲟⲩⲣⲏⲧⲉ
ⲟⲩⲣⲓⲥ	N	ⲟⲩⲣⲓⲥ
ⲟⲩⲣⲓⲧ	N	ⲟⲩⲣⲓⲧ
ⲟⲩⲣⲟ	N	ⲟⲩⲣⲟ
ⲟⲩⲣⲱ	N	ⲟⲩⲣⲟ
ⲟⲩⲣⲱ	N	ⲟⲩⲣⲱ
ⲟⲩⲣⲱⲟⲩ	N	ⲟⲩⲣⲟ
ⲟⲩⲥⲓⲁ	N	ⲟⲩⲥⲓⲁ
ⲟⲩⲥⲓⲁⲣⲭⲏⲥ	N	ⲟⲩⲥⲓⲁⲣⲭⲏⲥ
ⲟⲩⲧⲁϩ	N	ⲟⲩⲧⲁϩ
ⲟⲩⲧⲁⲩϩ	N	ⲟⲩⲧⲁϩ
ⲟⲩⲧⲉ	CONJ	ⲟⲩⲧⲉ
ⲟⲩⲧⲉ	PREP	ⲟⲩⲧⲉ
ⲟⲩⲫⲁϫⲓ	N	ⲟⲩⲫⲁϫⲓ
ⲟⲩⲭ	PTC	ⲟⲩⲭ
ⲟⲩⲭⲓ	PTC	ⲟⲩⲭⲓ
ⲟⲩⲱ	N	ⲟⲩⲱ
ⲟⲩⲱ	V	ⲟⲩⲱ
ⲟⲩⲱϣ	N	ⲟⲩⲱϣ
ⲟⲩⲱϣ	V	ⲟⲩⲱϣ
ⲟⲩⲱϣϥ	V	ⲟⲩⲱϣϥ
ⲟⲩⲱϣⲉⲙ	V	ⲟⲩⲱϣⲉⲙ
ⲟⲩⲱϣⲥ	V	ⲟⲩⲱϣⲥ
ⲟⲩⲱϣⲧ	V	ⲟⲩⲱϣⲧ
ⲟⲩⲱϩ	V	ⲟⲩⲱϩ
ⲟⲩⲱϩⲉⲙ	V	ⲟⲩⲱϩⲉⲙ
ⲟⲩⲱϩⲛ	V	ⲃⲱϩⲛ
ⲟⲩⲱϫ	V	ⲟⲩⲱϫ
ⲟⲩⲱϫⲡ	V	ⲟⲩⲱϫⲡ
ⲟⲩⲱϯ	V	ⲟⲩⲱϯ
ⲟⲩⲱⲓⲛⲓ	N	ⲟⲩⲱⲓⲛⲓ
ⲟⲩⲱⲗⲥ	V	ⲟⲩⲱⲗⲥ
ⲟⲩⲱⲙ	V	ⲟⲩⲱⲙ
ⲟⲩⲱⲙⲧ	V	ⲟⲩⲱⲙⲧ
ⲟⲩⲱⲛ	N	ⲟⲩⲱⲛ
ⲟⲩⲱⲛ	V	ⲟⲩⲱⲛ
ⲟⲩⲱⲛϣ	N	ⲟⲩⲱⲛϣ
ⲟⲩⲱⲛϩ	N	ⲟⲩⲱⲛϩ
ⲟⲩⲱⲛϩ	V	ⲟⲩⲱⲛϩ
ⲟⲩⲱⲣⲉⲡ	V	ⲟⲩⲱⲣⲡ
ⲟⲩⲱⲣⲡ	V	ⲟⲩⲱⲣⲡ
ⲟⲩⲱⲧ	V	ⲟⲩⲱⲧ
ⲟⲩⲱⲧϩ	V	ⲱⲧϩ
ⲟⲩⲱⲧϩ	V	ⲱⲧⲑ
ⲟⲩⲱⲧⲉϥ	V	ⲟⲩⲱⲧⲉⲃ
ⲟⲩⲱⲧⲉⲃ	V	ⲟⲩⲱⲧⲉⲃ
ⲟⲫⲉⲗⲉⲓ	V	ⲟⲫⲉⲗⲉⲓ
ⲟⲭⲉⲙⲁ	N	ⲟⲭⲉⲙⲁ
ⲟⲭⲗⲏⲥⲓⲥ	N	ⲟⲭⲗⲏⲥⲓⲥ
ⲟⲭⲗⲟⲥ	N	ⲟⲭⲗⲟⲥ
ⲟⲯⲱⲛⲓⲟⲛ	N	ⲟⲯⲱⲛⲓⲟⲛ
ⲟⲱⲧⲉⲛ	V	ⲟⲱⲧⲉⲛ
ⲡ	ART	ⲡ
ⲡ	COP	ⲡ
ⲡⲁϣⲟⲛⲥ	N	ⲡⲁϣⲟⲛⲥ
ⲡⲁⲅⲁⲛⲟⲥ	N	ⲡⲁⲅⲁⲛⲟⲥ
ⲡⲁⲅⲁⲛⲱⲥ	N	ⲡⲁⲅⲁⲛⲱⲥ
ⲡⲁⲇⲁⲗⲟⲥ	N	ⲡⲁⲧⲁⲗⲁⲥ
ⲡⲁⲑⲓ	V	ⲡⲁⲑⲓ
ⲡⲁⲑⲟⲥ	N	ⲡⲁⲑⲟⲥ
ⲡⲁⲓ	PDEM	ⲫⲁⲓ
ⲡⲁⲓⲇⲁⲅⲱⲅⲟⲥ	N	ⲡⲁⲓⲇⲁⲅⲱⲅⲟⲥ
ⲡⲁⲓⲇⲉⲥ	N	ⲡⲁⲓⲇⲉⲥ
ⲡⲁⲓⲇⲉⲩⲉ	V	ⲡⲁⲓⲇⲉⲩⲉ
ⲡⲁⲓⲇⲓⲁ	N	ⲡⲁⲓⲇⲓⲁ
ⲡⲁⲕⲁⲛⲟⲥ	N	ⲡⲁⲕⲁⲛⲟⲥ
ⲡⲁⲕⲧⲟⲛ	N	ⲡⲁⲕⲧⲟⲛ
ⲡⲁⲗⲁⲧⲓⲛⲟⲥ	NPROP	ⲡⲁⲗⲁⲧⲓⲛⲟⲥ
ⲡⲁⲗⲁⲧⲓⲟⲛ	N	ⲡⲁⲗⲁⲧⲓⲟⲛ
ⲡⲁⲗⲓⲛ	ADV	ⲡⲁⲗⲓⲛ
ⲡⲁⲗⲓⲛ	CONJ	ⲡⲁⲗⲓⲛ
ⲡⲁⲗⲗⲁϯⲟⲛ	N	ⲡⲁⲗⲗⲁϯⲟⲛ
ⲡⲁⲗⲗⲁⲕⲏ	N	ⲡⲁⲗⲗⲁⲕⲏ
ⲡⲁⲗⲗⲁⲧⲓⲟⲛ	N	ⲡⲁⲗⲗⲁⲧⲓⲟⲛ
ⲡⲁⲙⲙⲏⲧⲱⲣ	N	ⲡⲁⲙⲙⲏⲧⲱⲣ
ⲡⲁⲛϩⲁⲅⲛⲟⲛ	N	ⲡⲁⲛϩⲁⲅⲛⲟⲛ
ⲡⲁⲛϩⲟⲗⲱⲛ	N	ⲡⲁⲛϩⲟⲗⲱⲛ
ⲡⲁⲛϩⲟⲡⲗⲓⲁ	N	ⲡⲁⲛϩⲟⲡⲗⲓⲁ
ⲡⲁⲛⲁⲅⲓ̈ⲟⲥ	N	ⲡⲁⲛⲁⲅⲓ̈ⲟⲥ
ⲡⲁⲛⲁⲣⲉ	N	ⲡⲁⲛⲁⲣⲉ
ⲡⲁⲛⲅⲉⲛⲓⲁ	N	ⲡⲁⲛⲅⲉⲛⲓⲁ
ⲡⲁⲛⲅⲛⲱⲥⲓⲥ	N	ⲡⲁⲛⲅⲛⲱⲥⲓⲥ
ⲡⲁⲛⲇⲏⲗⲟⲥ	N	ⲡⲁⲛⲇⲏⲗⲟⲥ
ⲡⲁⲛⲇⲓⲁ	N	ⲡⲁⲛⲇⲓⲁ
ⲡⲁⲛⲇⲟⲩⲣⲁ	N	ⲡⲁⲛⲇⲟⲩⲣⲁ
ⲡⲁⲛⲇⲩⲛⲁⲙⲓⲥ	N	ⲡⲁⲛⲇⲩⲛⲁⲙⲓⲥ
ⲡⲁⲛⲉⲩⲫⲏⲙⲟⲥ	N	ⲡⲁⲛⲉⲩⲫⲏⲙⲟⲥ
ⲡⲁⲛⲏⲣⲉⲙⲟⲥ	N	ⲡⲁⲛⲏⲣⲉⲙⲟⲥ
ⲡⲁⲛⲑⲏⲣ	N	ⲡⲁⲛⲑⲏⲣ
ⲡⲁⲛⲙⲩⲥⲧⲏⲣⲓⲟⲛ	N	ⲡⲁⲛⲙⲩⲥⲧⲏⲣⲓⲟⲛ
ⲡⲁⲛⲟⲥⲓⲟⲥ	N	ⲡⲁⲛⲟⲥⲓⲟⲥ
ⲡⲁⲛⲟⲩⲣⲅⲓⲁ	N	ⲡⲁⲛⲟⲩⲣⲅⲓⲁ
ⲡⲁⲛⲟⲩⲣⲅⲟⲥ	N	ⲡⲁⲛⲟⲩⲣⲅⲟⲥ
ⲡⲁⲛⲟⲩⲥⲓⲟⲥ	N	ⲡⲁⲛⲟⲩⲥⲓⲟⲥ
ⲡⲁⲛⲡⲏⲅⲏ	N	ⲡⲁⲛⲡⲏⲅⲏ
ⲡⲁⲛⲥⲟⲫⲟⲥ	N	ⲡⲁⲛⲥⲟⲫⲟⲥ
ⲡⲁⲛⲧⲉⲗⲏⲥ	N	ⲡⲁⲛⲧⲉⲗⲏⲥ
ⲡⲁⲛⲧⲉⲗⲓⲟⲥ	N	ⲡⲁⲛⲧⲉⲗⲓⲟⲥ
ⲡⲁⲛⲧⲟⲇⲩⲛⲁⲙⲓⲥ	N	ⲡⲁⲛⲧⲟⲇⲩⲛⲁⲙⲓⲥ
ⲡⲁⲛⲧⲟⲇⲩⲛⲁⲙⲟⲥ	N	ⲡⲁⲛⲧⲟⲇⲩⲛⲁⲙⲟⲥ
ⲡⲁⲛⲧⲟⲕⲣⲁⲧⲱⲣ	N	ⲡⲁⲛⲧⲟⲕⲣⲁⲧⲱⲣ
ⲡⲁⲛⲧⲟⲙⲟⲣⲫⲟⲥ	N	ⲡⲁⲛⲧⲟⲙⲟⲣⲫⲟⲥ
ⲡⲁⲛⲧⲟⲡⲁⲧⲱⲣ	N	ⲡⲁⲛⲧⲟⲡⲁⲧⲱⲣ
ⲡⲁⲛⲧⲟⲭⲓⲟⲛ	N	ⲡⲁⲛⲧⲟⲭⲓⲟⲛ
ⲡⲁⲛⲧⲱⲕⲣⲁⲧⲱⲣ	N	ⲡⲁⲛⲧⲱⲕⲣⲁⲧⲱⲣ
ⲡⲁⲛⲧⲱⲥ	ADV	ⲡⲁⲛⲧⲱⲥ
ⲡⲁⲟⲡ	N	ⲡⲁⲱⲡⲓ
ⲡⲁⲟⲡⲏⲓ	N	ⲡⲁⲱⲡⲓ
ⲡⲁⲡⲁⲥ	N	ⲡⲁⲡⲁⲥ
ⲡⲁⲣϩⲏⲥⲓⲁ	N	ⲡⲁⲣϩⲏⲥⲓⲁ
ⲡⲁⲣϩⲏⲥⲓⲁⲍⲉ	V	ⲡⲁⲣϩⲏⲥⲓⲁⲍⲉ
ⲡⲁⲣϩⲓⲥⲧⲁ	V	ⲡⲁⲣϩⲓⲥⲧⲁ
ⲡⲁⲣϩⲟⲓⲙⲓⲁ	N	ⲡⲁⲣϩⲟⲓⲙⲓⲁ
ⲡⲁⲣϩⲟⲩⲥⲓⲁ	N	ⲡⲁⲣϩⲟⲩⲥⲓⲁ
ⲡⲁⲣϩⲩⲙⲓⲁⲥⲧⲏⲥ	N	ⲡⲁⲣϩⲩⲙⲓⲁⲥⲧⲏⲥ
ⲡⲁⲣⲁ	FM	ⲡⲁⲣⲁ
ⲡⲁⲣⲁ	PREP	ⲡⲁⲣⲁ
ⲡⲁⲣⲁⲃⲁ	V	ⲡⲁⲣⲁⲃⲁ
ⲡⲁⲣⲁⲃⲁⲥⲓⲥ	N	ⲡⲁⲣⲁⲃⲁⲥⲓⲥ
ⲡⲁⲣⲁⲃⲁⲧⲏⲥ	N	ⲡⲁⲣⲁⲃⲁⲧⲏⲥ
ⲡⲁⲣⲁⲃⲉⲛⲓⲛ	V	ⲡⲁⲣⲁⲃⲉⲛⲓⲛ
ⲡⲁⲣⲁⲃⲟⲗⲏ	N	ⲡⲁⲣⲁⲃⲟⲗⲏ
ⲡⲁⲣⲁⲅⲅⲉⲓⲗⲉ	V	ⲡⲁⲣⲁⲅⲅⲉⲓⲗⲉ
ⲡⲁⲣⲁⲅⲅⲉⲗⲓⲁ	N	ⲡⲁⲣⲁⲅⲅⲉⲗⲓⲁ
ⲡⲁⲣⲁⲅⲉ	N	ⲡⲁⲣⲁⲅⲉ
ⲡⲁⲣⲁⲅⲉ	V	ⲡⲁⲣⲁⲅⲉ
ⲡⲁⲣⲁⲇⲉⲓⲥⲟⲥ	N	ⲡⲁⲣⲁⲇⲉⲓⲥⲟⲥ
ⲡⲁⲣⲁⲇⲉⲭⲉ	V	ⲡⲁⲣⲁⲇⲉⲭⲉ
ⲡⲁⲣⲁⲇⲓⲅⲙⲁ	N	ⲡⲁⲣⲁⲇⲓⲅⲙⲁ
ⲡⲁⲣⲁⲇⲓⲅⲙⲁⲧⲓⲍⲉ	V	ⲡⲁⲣⲁⲇⲓⲅⲙⲁⲧⲓⲍⲉ
ⲡⲁⲣⲁⲇⲓⲇⲟⲩ	V	ⲡⲁⲣⲁⲇⲓⲇⲟⲩ
ⲡⲁⲣⲁⲇⲓⲥⲟⲥ	N	ⲡⲁⲣⲁⲇⲓⲥⲟⲥ
ⲡⲁⲣⲁⲇⲓⲥⲱⲥ	N	ⲡⲁⲣⲁⲇⲓⲥⲱⲥ
ⲡⲁⲣⲁⲇⲟⲝⲟⲛ	N	ⲡⲁⲣⲁⲇⲟⲝⲟⲛ
ⲡⲁⲣⲁⲇⲟⲥⲓⲥ	N	ⲡⲁⲣⲁⲇⲟⲥⲓⲥ
ⲡⲁⲣⲁⲑⲏⲕⲏ	N	ⲡⲁⲣⲁⲑⲏⲕⲏ
ⲡⲁⲣⲁⲓⲧⲉⲓ	V	ⲡⲁⲣⲁⲓⲧⲉⲓ
ⲡⲁⲣⲁⲕⲁⲗⲉⲓ	V	ⲡⲁⲣⲁⲕⲁⲗⲉⲓ
ⲡⲁⲣⲁⲕⲗⲏⲥⲓⲥ	N	ⲡⲁⲣⲁⲕⲗⲏⲥⲓⲥ
ⲡⲁⲣⲁⲕⲗⲏⲧⲓⲕⲟⲛ	N	ⲡⲁⲣⲁⲕⲗⲏⲧⲓⲕⲟⲛ
ⲡⲁⲣⲁⲕⲗⲏⲧⲟⲛ	N	ⲡⲁⲣⲁⲕⲗⲏⲧⲟⲛ
ⲡⲁⲣⲁⲕⲗⲏⲧⲟⲥ	N	ⲡⲁⲣⲁⲕⲗⲏⲧⲟⲥ
ⲡⲁⲣⲁⲗⲏⲙⲡⲧⲱⲣ	N	ⲡⲁⲣⲁⲗⲏⲙⲡⲧⲱⲣ
ⲡⲁⲣⲁⲗⲓⲁ	N	ⲡⲁⲣⲁⲗⲓⲁ
ⲡⲁⲣⲁⲗⲟⲅⲟⲛ	N	ⲡⲁⲣⲁⲗⲟⲅⲟⲛ
ⲡⲁⲣⲁⲙⲉⲓⲛⲉ	V	ⲡⲁⲣⲁⲙⲉⲓⲛⲉ
ⲡⲁⲣⲁⲙⲟⲛⲏ	N	ⲡⲁⲣⲁⲙⲟⲛⲏ
ⲡⲁⲣⲁⲙⲩⲑⲓⲁ	N	ⲡⲁⲣⲁⲙⲩⲑⲓⲁ
ⲡⲁⲣⲁⲙⲩⲑⲓⲍⲉ	V	ⲡⲁⲣⲁⲙⲩⲑⲓⲍⲉ
ⲡⲁⲣⲁⲛⲟⲙⲉⲓ	V	ⲡⲁⲣⲁⲛⲟⲙⲉⲓ
ⲡⲁⲣⲁⲛⲟⲙⲓⲁ	N	ⲡⲁⲣⲁⲛⲟⲙⲓⲁ
ⲡⲁⲣⲁⲛⲟⲙⲟⲛ	N	ⲡⲁⲣⲁⲛⲟⲙⲟⲛ
ⲡⲁⲣⲁⲛⲟⲙⲟⲥ	N	ⲡⲁⲣⲁⲛⲟⲙⲟⲥ
ⲡⲁⲣⲁⲡⲉⲧⲁⲥⲙⲁ	N	ⲡⲁⲣⲁⲡⲉⲧⲁⲥⲙⲁ
ⲡⲁⲣⲁⲡⲧⲱⲙⲁ	N	ⲡⲁⲣⲁⲡⲧⲱⲙⲁ
ⲡⲁⲣⲁⲣⲟ	PREP	ⲡⲁⲣⲁ
ⲡⲁⲣⲁⲥⲕⲉⲩⲉⲍⲉ	V	ⲡⲁⲣⲁⲥⲕⲉⲩⲉⲍⲉ
ⲡⲁⲣⲁⲥⲕⲉⲩⲏ	N	ⲡⲁⲣⲁⲥⲕⲉⲩⲏ
ⲡⲁⲣⲁⲥⲧⲁⲧⲏⲥ	N	ⲡⲁⲣⲁⲥⲧⲁⲧⲏⲥ
ⲡⲁⲣⲁⲧⲏⲣⲉⲓ	V	ⲡⲁⲣⲁⲧⲏⲣⲉⲓ
ⲡⲁⲣⲁⲧⲏⲣⲓ	V	ⲡⲁⲣⲁⲧⲏⲣⲓ
ⲡⲁⲣⲁⲧⲓⲅⲙⲁⲧⲓⲍⲉ	V	ⲡⲁⲣⲁⲧⲓⲅⲙⲁⲧⲓⲍⲉ
ⲡⲁⲣⲁⲫⲣⲁⲥⲓⲥ	N	ⲡⲁⲣⲁⲫⲣⲁⲥⲓⲥ
ⲡⲁⲣⲁⲫⲩⲥⲓⲥ	N	ⲡⲁⲣⲁⲫⲩⲥⲓⲥ
ⲡⲁⲣⲁⲭⲓⲙⲁⲍⲉ	V	ⲡⲁⲣⲁⲭⲓⲙⲁⲍⲉ
ⲡⲁⲣⲁⲭⲱⲣⲉⲓ	V	ⲡⲁⲣⲁⲭⲱⲣⲉⲓ
ⲡⲁⲣⲇⲁⲗⲓⲥ	N	ⲡⲁⲣⲇⲁⲗⲓⲥ
ⲡⲁⲣⲉⲗⲑⲉ	V	ⲡⲁⲣⲉⲗⲑⲉ
ⲡⲁⲣⲉⲙⲃⲟⲗⲏ	N	ⲡⲁⲣⲉⲙⲃⲟⲗⲏ
ⲡⲁⲣⲑⲉⲛⲓⲁ	N	ⲡⲁⲣⲑⲉⲛⲓⲁ
ⲡⲁⲣⲑⲉⲛⲓⲕⲏ	N	ⲡⲁⲣⲑⲉⲛⲓⲕⲏ
ⲡⲁⲣⲑⲉⲛⲓⲕⲟⲛ	N	ⲡⲁⲣⲑⲉⲛⲓⲕⲟⲛ
ⲡⲁⲣⲑⲉⲛⲟⲥ	N	ⲡⲁⲣⲑⲉⲛⲟⲥ
ⲡⲁⲣⲑⲟⲥ	N	ⲡⲁⲣⲑⲟⲥ
ⲡⲁⲣⲓⲅⲟⲣⲓ	NPROP	ⲡⲁⲣⲓⲅⲟⲣⲓ
ⲡⲁⲣⲓⲥⲑⲙⲓⲟⲛ	N	ⲡⲁⲣⲓⲥⲑⲙⲓⲟⲛ
ⲡⲁⲣⲟⲓⲕⲏⲥⲓⲥ	N	ⲡⲁⲣⲟⲓⲕⲏⲥⲓⲥ
ⲡⲁⲣⲟⲝⲩⲥⲙⲟⲥ	N	ⲡⲁⲣⲟⲝⲩⲥⲙⲟⲥ
ⲡⲁⲣⲟⲣⲁ	V	ⲡⲁⲣⲟⲣⲁ
ⲡⲁⲣⲟⲩⲥⲓⲁ	N	ⲡⲁⲣⲟⲩⲥⲓⲁ
ⲡⲁⲣⲣⲏⲥⲓⲁ	N	ⲡⲁⲣⲣⲏⲥⲓⲁ
ⲡⲁⲣⲣⲟⲩⲥⲓⲁ	N	ⲡⲁⲣⲣⲟⲩⲥⲓⲁ
ⲡⲁⲣⲱⲝⲩⲛⲉ	V	ⲡⲁⲣⲱⲝⲩⲛⲉ
ⲡⲁⲥⲧⲟⲥ	N	ⲡⲁⲥⲧⲟⲥ
ⲡⲁⲥⲭⲁ	N	ⲡⲁⲥⲭⲁ
ⲡⲁⲧϣⲉⲗⲉⲧ	ART	ⲡⲁⲧϣⲉⲗⲉⲧ
ⲡⲁⲧϣⲉⲗⲉⲧ	N	ⲡⲁⲧϣⲉⲗⲉⲧ
ⲡⲁⲧⲁⲗⲁⲥ	N	ⲡⲁⲧⲁⲗⲁⲥ
ⲡⲁⲧⲁⲗⲟⲥ	N	ⲡⲁⲧⲁⲗⲁⲥ
ⲡⲁⲧⲁⲥⲥⲉ	V	ⲡⲁⲧⲁⲥⲥⲉ
ⲡⲁⲧⲉⲓ	V	ⲡⲁⲧⲉⲓ
ⲡⲁⲧⲣⲓⲁ	N	ⲡⲁⲧⲣⲓⲁ
ⲡⲁⲧⲣⲓⲁⲣⲭⲏⲥ	N	ⲡⲁⲧⲣⲓⲁⲣⲭⲏⲥ
ⲡⲁⲧⲣⲓⲥ	N	ⲡⲁⲧⲣⲓⲥ
ⲡⲁⲩⲗⲟⲥ	NPROP	ⲡⲁⲩⲗⲟⲥ
ⲡⲁⲱⲛⲓ	N	ⲡⲁⲱⲛⲓ
ⲡⲁⲱⲡⲓ	N	ⲡⲁⲱⲡⲓ
ⲡⲉ	ART	ⲡ
ⲡⲉ	COP	ⲡⲉ
ⲡⲉ	PPOS	ⲡⲉ
ⲡⲉϥ	PPOS	ⲡⲉϥ
ⲡⲉϫⲁ	VBD	ⲡⲉϫⲉ
ⲡⲉϫⲉ	V	ⲡⲉϫⲉ
ⲡⲉϫⲱ	VBD	ⲡⲉϫⲉ
ⲡⲉⲇⲏ	N	ⲡⲉⲇⲏ
ⲡⲉⲓⲑⲉ	N	ⲡⲉⲓⲑⲉ
ⲡⲉⲓⲑⲉ	V	ⲡⲉⲓⲑⲉ
ⲡⲉⲓⲣⲁⲍⲉ	V	ⲡⲉⲓⲣⲁⲍⲉ
ⲡⲉⲓⲣⲁⲥⲙⲟⲥ	N	ⲡⲉⲓⲣⲁⲥⲙⲟⲥ
ⲡⲉⲓⲣⲁⲧⲏⲣⲓⲟⲛ	N	ⲡⲉⲓⲣⲁⲧⲏⲣⲓⲟⲛ
ⲡⲉⲕ	PPOS	ⲡⲉⲕ
ⲡⲉⲗⲁⲅⲟⲥ	N	ⲡⲉⲗⲁⲅⲟⲥ
ⲡⲉⲗⲁⲕ	NPROP	ⲡⲉⲗⲁⲕ
ⲡⲉⲗⲓⲥ	N	ⲡⲉⲗⲓⲥ
ⲡⲉⲗⲙⲁ	N	ⲡⲉⲗⲙⲁ
ⲡⲉⲙⲡⲧⲉ	N	ⲡⲉⲙⲡⲧⲉ
ⲡⲉⲛⲁⲅⲓⲥ	N	ⲡⲉⲛⲁⲅⲓⲥ
ⲡⲉⲛⲑⲉⲓ	V	ⲡⲉⲛⲑⲉⲓ
ⲡⲉⲛⲑⲟⲥ	N	ⲡⲉⲛⲑⲟⲥ
ⲡⲉⲛⲧⲁⲥ	N	ⲡⲉⲛⲧⲁⲥ
ⲡⲉⲛⲧⲉⲕⲟⲛⲧⲁⲣⲭⲟⲥ	N	ⲡⲉⲛⲧⲉⲕⲟⲛⲧⲁⲣⲭⲟⲥ
ⲡⲉⲛⲧⲏⲕⲟⲥⲧⲏ	N	ⲡⲉⲛⲧⲏⲕⲟⲥⲧⲏ
ⲡⲉⲛⲧⲏⲕⲟⲥⲧⲏ	NPROP	ⲡⲉⲛⲧⲏⲕⲟⲥⲧⲏ
ⲡⲉⲣⲉⲙⲟⲩ	N	ⲡⲉⲣⲙⲟⲩ
ⲡⲉⲣⲓⲁⲅⲉ	V	ⲡⲉⲣⲓⲁⲅⲉ
ⲡⲉⲣⲓⲅⲣⲁⲫⲏ	N	ⲡⲉⲣⲓⲅⲣⲁⲫⲏ
ⲡⲉⲣⲓⲇⲱⲛ	N	ⲡⲉⲣⲓⲇⲱⲛ
ⲡⲉⲣⲓⲍⲱⲙⲁ	N	ⲡⲉⲣⲓⲍⲱⲙⲁ
ⲡⲉⲣⲓⲕⲁⲑⲁⲣⲙⲁ	N	ⲡⲉⲣⲓⲕⲁⲑⲁⲣⲙⲁ
ⲡⲉⲣⲓⲕⲉⲫⲁⲗⲁⲓⲁ	N	ⲡⲉⲣⲓⲕⲉⲫⲁⲗⲁⲓⲁ
ⲡⲉⲣⲓⲟⲇⲟⲥ	N	ⲡⲉⲣⲓⲟⲇⲟⲥ
ⲡⲉⲣⲓⲥⲟⲛ	N	ⲡⲉⲣⲓⲥⲟⲛ
ⲡⲉⲣⲓⲥⲡⲁⲥⲙⲟⲥ	N	ⲡⲉⲣⲓⲥⲡⲁⲥⲙⲟⲥ
ⲡⲉⲣⲓⲥⲥⲟⲛ	N	ⲡⲉⲣⲓⲥⲥⲟⲛ
ⲡⲉⲣⲓⲭⲱⲣⲟⲥ	N	ⲡⲉⲣⲓⲭⲱⲣⲟⲥ
ⲡⲉⲣⲙⲟⲩ	N	ⲡⲉⲣⲙⲟⲩ
ⲡⲉⲣⲡⲉⲣⲟⲥ	N	ⲡⲉⲣⲡⲉⲣⲟⲥ
ⲡⲉⲣⲥⲏⲥ	N	ⲡⲉⲣⲥⲏⲥ
ⲡⲉⲣⲥⲟⲥ	NPROP	ⲡⲉⲣⲥⲟⲥ
ⲡⲉⲥ	PPOS	ⲡⲉⲥ
ⲡⲉⲧⲉⲛ	PPOS	ⲡⲉⲧⲉⲛ
ⲡⲉⲧⲉⲡⲏⲡ	N	ⲡⲉⲧⲉⲡⲏⲡ
ⲡⲉⲧⲉⲡⲏⲧ	N	ⲡⲉⲧⲉⲡⲏⲡ
ⲡⲉⲧⲣⲁ	N	ⲡⲉⲧⲣⲁ
ⲡⲉⲧⲣⲁ	NPROP	ⲡⲉⲧⲣⲁ
ⲡⲉⲧⲣⲟⲥ	NPROP	ⲡⲉⲧⲣⲟⲥ
ⲡⲏⲅⲏ	N	ⲡⲏⲅⲏ
ⲡⲏⲣⲁ	N	ⲡⲏⲣⲁ
ⲡⲏⲣⲓ	N	ⲡⲏⲣⲓ
ⲡⲏⲥⲥⲉ	V	ⲡⲏⲥⲥⲉ
ⲡⲓ	ART	ⲡⲓ
ⲡⲓⲑⲉⲥⲑⲁⲓ	V	ⲡⲓⲑⲉⲥⲑⲁⲓ
ⲡⲓⲑⲟⲥ	N	ⲡⲓⲑⲟⲥ
ⲡⲓⲕⲣⲓⲁ	N	ⲡⲓⲕⲣⲓⲁ
ⲡⲓⲗⲁⲧⲟⲥ	NPROP	ⲡⲓⲗⲁⲧⲟⲥ
ⲡⲓⲗⲁⲧⲟⲥ	V	ⲡⲓⲗⲁⲧⲟⲥ
ⲡⲓⲛⲁⲅⲓⲥ	N	ⲡⲓⲛⲁⲅⲓⲥ
ⲡⲓⲛⲁⲝ	N	ⲡⲓⲛⲁⲝ
ⲡⲓⲥⲧⲉⲩⲉ	V	ⲡⲓⲥⲧⲉⲩⲉ
ⲡⲓⲥⲧⲏ	N	ⲡⲓⲥⲧⲏ
ⲡⲓⲥⲧⲓⲕⲏ	N	ⲡⲓⲥⲧⲓⲕⲏ
ⲡⲓⲥⲧⲓⲥ	N	ⲡⲓⲥⲧⲓⲥ
ⲡⲓⲥⲧⲟⲛ	N	ⲡⲓⲥⲧⲟⲛ
ⲡⲓⲥⲧⲟⲥ	N	ⲡⲓⲥⲧⲟⲥ
ⲡⲗⲁϯⲁ	N	ⲡⲗⲁϯⲁ
ⲡⲗⲁⲛⲁ	V	ⲡⲗⲁⲛⲁ
ⲡⲗⲁⲛⲁⲥⲑⲁⲓ	V	ⲡⲗⲁⲛⲁⲥⲑⲁⲓ
ⲡⲗⲁⲛⲁⲥⲑⲉ	V	ⲡⲗⲁⲛⲁⲥⲑⲉ
ⲡⲗⲁⲛⲏ	N	ⲡⲗⲁⲛⲏ
ⲡⲗⲁⲛⲟⲥ	N	ⲡⲗⲁⲛⲟⲥ
ⲡⲗⲁⲝ	N	ⲡⲗⲁⲝ
ⲡⲗⲁⲥⲓⲥ	N	ⲡⲗⲁⲥⲓⲥ
ⲡⲗⲁⲥⲙⲁ	N	ⲡⲗⲁⲥⲙⲁ
ⲡⲗⲁⲥⲥⲉ	V	ⲡⲗⲁⲥⲥⲉ
ⲡⲗⲁⲥⲧⲏⲥ	N	ⲡⲗⲁⲥⲧⲏⲥ
ⲡⲗⲁⲧⲁⲛⲟⲥ	N	ⲡⲗⲁⲧⲁⲛⲟⲥ
ⲡⲗⲁⲧⲉⲓⲁ	N	ⲡⲗⲁⲧⲉⲓⲁ
ⲡⲗⲁⲧⲏⲣⲉ	N	ⲡⲗⲁⲧⲏⲣⲉ
ⲡⲗⲁⲧⲓⲁ	N	ⲡⲗⲁⲧⲓⲁ
ⲡⲗⲉⲁ	V	ⲡⲗⲉⲁ
ⲡⲗⲉⲟⲛⲉⲝⲓⲁ	N	ⲡⲗⲉⲟⲛⲉⲝⲓⲁ
ⲡⲗⲉⲣⲟⲫⲟⲣⲓⲁ	N	ⲡⲗⲉⲣⲟⲫⲟⲣⲓⲁ
ⲡⲗⲉⲥⲥⲉ	V	ⲡⲗⲉⲥⲥⲉ
ⲡⲗⲏⲅⲉ	V	ⲡⲗⲏⲅⲉ
ⲡⲗⲏⲅⲏ	N	ⲡⲗⲏⲅⲏ
ⲡⲗⲏⲕⲧⲣⲟⲛ	N	ⲡⲗⲏⲕⲧⲣⲟⲛ
ⲡⲗⲏⲛ	CONJ	ⲡⲗⲏⲛ
ⲡⲗⲏⲣⲟⲩ	V	ⲡⲗⲏⲣⲟⲩ
ⲡⲗⲏⲣⲟⲫⲟⲣⲉⲓ	V	ⲡⲗⲏⲣⲟⲫⲟⲣⲉⲓ
ⲡⲗⲏⲣⲱⲙⲁ	N	ⲡⲗⲏⲣⲱⲙⲁ
ⲡⲗⲏⲱⲣⲙⲁ	N	ⲡⲗⲏⲱⲣⲙⲁ
ⲡⲗⲟⲩⲧⲱⲛⲓⲟⲥ	N	ⲡⲗⲟⲩⲧⲱⲛⲓⲟⲥ
ⲡⲗⲩⲅⲏ	N	ⲡⲗⲩⲅⲏ
ⲡⲛⲉⲩⲙⲁ	N	ⲡⲛⲉⲩⲙⲁ
ⲡⲛⲉⲩⲙⲁⲧⲓⲕⲏ	N	ⲡⲛⲉⲩⲙⲁⲧⲓⲕⲏ
ⲡⲛⲉⲩⲙⲁⲧⲓⲕⲟⲛ	N	ⲡⲛⲉⲩⲙⲁⲧⲓⲕⲟⲛ
ⲡⲛⲉⲩⲙⲁⲧⲓⲕⲟⲥ	N	ⲡⲛⲉⲩⲙⲁⲧⲓⲕⲟⲥ
ⲡⲛⲉⲩⲙⲁⲧⲓⲕⲱⲥ	ADV	ⲡⲛⲉⲩⲙⲁⲧⲓⲕⲱⲥ
ⲡⲛⲉⲩⲙⲁⲧⲟⲫⲟⲣⲟⲥ	N	ⲡⲛⲉⲩⲙⲁⲧⲟⲫⲟⲣⲟⲥ
ⲡⲛⲉⲩⲙⲱⲛ	N	ⲡⲛⲉⲩⲙⲱⲛ
ⲡⲛⲟⲏ	N	ⲡⲛⲟⲏ
ⲡⲟⲇⲏⲣⲏ	N	ⲡⲟⲇⲏⲣⲏ
ⲡⲟⲇⲟⲛⲓⲡⲧⲏⲣ	N	ⲡⲟⲇⲟⲛⲓⲡⲧⲏⲣ
ⲡⲟⲓⲙⲏⲛ	N	ⲡⲟⲓⲙⲏⲛ
ⲡⲟⲓⲙⲏⲛ	NPROP	ⲡⲟⲓⲙⲏⲛ
ⲡⲟⲗⲉⲙⲉⲓ	V	ⲡⲟⲗⲉⲙⲉⲓ
ⲡⲟⲗⲉⲙⲓⲕⲟⲛ	N	ⲡⲟⲗⲉⲙⲓⲕⲟⲛ
ⲡⲟⲗⲉⲙⲟⲥ	N	ⲡⲟⲗⲉⲙⲟⲥ
ⲡⲟⲗⲓⲥ	N	ⲡⲟⲗⲓⲥ
ⲡⲟⲗⲓⲧⲉⲓⲁ	N	ⲡⲟⲗⲓⲧⲉⲓⲁ
ⲡⲟⲗⲓⲧⲉⲩⲉ	V	ⲡⲟⲗⲓⲧⲉⲩⲉ
ⲡⲟⲗⲓⲧⲉⲩⲉⲥⲑⲁⲓ	V	ⲡⲟⲗⲓⲧⲉⲩⲉⲥⲑⲁⲓ
ⲡⲟⲗⲓⲧⲉⲩⲙⲁ	N	ⲡⲟⲗⲓⲧⲉⲩⲙⲁ
ⲡⲟⲗⲓⲧⲉⲩⲧⲏⲥ	N	ⲡⲟⲗⲓⲧⲉⲩⲧⲏⲥ
ⲡⲟⲗⲓⲧⲏⲥ	N	ⲡⲟⲗⲓⲧⲏⲥ
ⲡⲟⲗⲗⲁⲕⲓⲥ	ADV	ⲡⲟⲗⲗⲁⲕⲓⲥ
ⲡⲟⲗⲩⲙⲁⲣⲭⲏⲥ	N	ⲡⲟⲗⲩⲙⲁⲣⲭⲏⲥ
ⲡⲟⲗⲩⲙⲉⲓ	V	ⲡⲟⲗⲩⲙⲉⲓ
ⲡⲟⲗⲩⲙⲓⲥⲧⲏⲥ	N	ⲡⲟⲗⲩⲙⲓⲥⲧⲏⲥ
ⲡⲟⲛⲏⲣⲁ	N	ⲡⲟⲛⲏⲣⲁ
ⲡⲟⲛⲏⲣⲉⲩⲉ	V	ⲡⲟⲛⲏⲣⲉⲩⲉ
ⲡⲟⲛⲏⲣⲓⲁ	N	ⲡⲟⲛⲏⲣⲓⲁ
ⲡⲟⲛⲏⲣⲟⲛ	N	ⲡⲟⲛⲏⲣⲟⲛ
ⲡⲟⲛⲏⲣⲟⲥ	N	ⲡⲟⲛⲏⲣⲟⲥ
ⲡⲟⲣⲛⲉⲓⲁ	N	ⲡⲟⲣⲛⲉⲓⲁ
ⲡⲟⲣⲛⲉⲩⲉ	V	ⲡⲟⲣⲛⲉⲩⲉ
ⲡⲟⲣⲛⲏ	N	ⲡⲟⲣⲛⲏ
ⲡⲟⲣⲛⲓⲁ	N	ⲡⲟⲣⲛⲓⲁ
ⲡⲟⲣⲛⲓⲕⲟⲛ	N	ⲡⲟⲣⲛⲓⲕⲟⲛ
ⲡⲟⲣⲛⲓⲟⲛ	N	ⲡⲟⲣⲛⲓⲟⲛ
ⲡⲟⲣⲛⲟⲕⲟⲡⲟⲥ	N	ⲡⲟⲣⲛⲟⲕⲟⲡⲟⲥ
ⲡⲟⲣⲛⲟⲥ	N	ⲡⲟⲣⲛⲟⲥ
ⲡⲟⲣⲫⲩⲣⲁ	N	ⲡⲟⲣⲫⲩⲣⲁ
ⲡⲟⲥⲓⲇⲱⲛ	N	ⲡⲟⲥⲓⲇⲱⲛ
ⲡⲟⲥⲱ	ADV	ⲡⲟⲥⲱ
ⲡⲟⲧⲁⲕⲓⲟⲛ	N	ⲡⲟⲧⲁⲕⲓⲟⲛ
ⲡⲟⲧⲏⲣⲓⲟⲛ	N	ⲡⲟⲧⲏⲣⲓⲟⲛ
ⲡⲟⲩ	PPOS	ⲡⲟⲩ
ⲡⲟⲩⲛⲓ	N	ⲡⲟⲩⲛⲓ
ⲡⲣ̣ⲟⲧⲣⲟⲡⲏ	N	ⲡⲣ̣ⲟⲧⲣⲟⲡⲏ
ⲡⲣⲁⲅⲙⲁ	N	ⲡⲣⲁⲅⲙⲁ
ⲡⲣⲁⲅⲙⲁⲧⲉⲩⲉⲥⲑⲁⲓ	V	ⲡⲣⲁⲅⲙⲁⲧⲉⲩⲉⲥⲑⲁⲓ
ⲡⲣⲁⲅⲙⲁⲧⲉⲩⲧⲏⲥ	N	ⲡⲣⲁⲅⲙⲁⲧⲉⲩⲧⲏⲥ
ⲡⲣⲁⲅⲙⲁⲧⲓⲁ	N	ⲡⲣⲁⲅⲙⲁⲧⲓⲁ
ⲡⲣⲁⲓⲧⲁ	V	ⲡⲣⲁⲓⲧⲁ
ⲡⲣⲁⲓⲧⲱⲣⲓⲟⲛ	N	ⲡⲣⲁⲓⲧⲱⲣⲓⲟⲛ
ⲡⲣⲁⲝⲓⲥ	N	ⲡⲣⲁⲝⲓⲥ
ⲡⲣⲁⲥⲓⲥ	N	ⲡⲣⲁⲥⲓⲥ
ⲡⲣⲁⲥⲥⲁ	V	ⲡⲣⲁⲥⲥⲁ
ⲡⲣⲁⲥⲥⲉ	V	ⲡⲣⲁⲥⲥⲉ
ⲡⲣⲁⲧⲧⲉⲥⲑⲁⲓ	V	ⲡⲣⲁⲧⲧⲉⲥⲑⲁⲓ
ⲡⲣⲁⲧⲧⲉⲩⲑⲁⲓ	V	ⲡⲣⲁⲧⲧⲉⲩⲑⲁⲓ
ⲡⲣⲉⲡⲉⲓ	V	ⲡⲣⲉⲡⲉⲓ
ⲡⲣⲉⲡⲟⲥⲓⲧⲟⲥ	N	ⲡⲣⲉⲡⲟⲥⲓⲧⲟⲥ
ⲡⲣⲉⲥⲃⲉⲓⲁ	N	ⲡⲣⲉⲥⲃⲉⲓⲁ
ⲡⲣⲉⲥⲃⲉⲩⲉ	V	ⲡⲣⲉⲥⲃⲉⲩⲉ
ⲡⲣⲉⲥⲃⲉⲩⲧⲏⲥ	N	ⲡⲣⲉⲥⲃⲉⲩⲧⲏⲥ
ⲡⲣⲉⲥⲃⲩⲧⲉⲣⲟⲥ	N	ⲡⲣⲉⲥⲃⲩⲧⲉⲣⲟⲥ
ⲡⲣⲓⲥⲕⲁ	NPROP	ⲡⲣⲓⲥⲕⲁ
ⲡⲣⲟϩⲁⲓⲣⲉⲥⲓⲥ	N	ⲡⲣⲟϩⲁⲓⲣⲉⲥⲓⲥ
ⲡⲣⲟϩⲓⲥⲧⲁ	V	ⲡⲣⲟϩⲓⲥⲧⲁ
ⲡⲣⲟϩⲟⲓⲙⲓⲟⲛ	N	ⲡⲣⲟϩⲟⲓⲙⲓⲟⲛ
ⲡⲣⲟⲁⲓⲥⲧⲓⲟⲛ	N	ⲡⲣⲟⲁⲓⲥⲧⲓⲟⲛ
ⲡⲣⲟⲃⲁⲗⲉ	V	ⲡⲣⲟⲃⲁⲗⲉ
ⲡⲣⲟⲃⲁⲧⲓⲕⲏ	N	ⲡⲣⲟⲃⲁⲧⲓⲕⲏ
ⲡⲣⲟⲃⲗⲏⲙⲁ	N	ⲡⲣⲟⲃⲗⲏⲙⲁ
ⲡⲣⲟⲃⲟⲗⲟⲟⲩⲉ	N	ⲡⲣⲟⲃⲟⲗⲟⲟⲩⲉ
ⲡⲣⲟⲅⲉⲛⲏⲧⲱⲣ	N	ⲡⲣⲟⲅⲉⲛⲏⲧⲱⲣ
ⲡⲣⲟⲅⲛⲱⲥⲓⲥ	N	ⲡⲣⲟⲅⲛⲱⲥⲓⲥ
ⲡⲣⲟⲇⲓⲇⲟⲩ	V	ⲡⲣⲟⲇⲓⲇⲟⲩ
ⲡⲣⲟⲇⲟⲇⲓ̈ⲁⲕⲟⲛⲟⲥ	N	ⲡⲣⲟⲇⲟⲇⲓ̈ⲁⲕⲟⲛⲟⲥ
ⲡⲣⲟⲇⲟⲧⲏⲥ	N	ⲡⲣⲟⲇⲟⲧⲏⲥ
ⲡⲣⲟⲇⲣⲟⲙⲟⲥ	N	ⲡⲣⲟⲇⲣⲟⲙⲟⲥ
ⲡⲣⲟⲉⲗⲑⲉ	V	ⲡⲣⲟⲉⲗⲑⲉ
ⲡⲣⲟⲉⲥⲧⲱⲥ	N	ⲡⲣⲟⲉⲥⲧⲱⲥ
ⲡⲣⲟⲑⲉⲥⲓⲛ	N	ⲡⲣⲟⲑⲉⲥⲓⲛ
ⲡⲣⲟⲑⲉⲥⲓⲥ	N	ⲡⲣⲟⲑⲉⲥⲓⲥ
ⲡⲣⲟⲑⲉⲥⲙⲓⲁ	N	ⲡⲣⲟⲑⲉⲥⲙⲓⲁ
ⲡⲣⲟⲑⲩⲙⲓⲁ	N	ⲡⲣⲟⲑⲩⲙⲓⲁ
ⲡⲣⲟⲑⲩⲙⲟⲥ	N	ⲡⲣⲟⲑⲩⲙⲟⲥ
ⲡⲣⲟⲕⲉⲓⲙⲉⲛⲟⲛ	N	ⲡⲣⲟⲕⲉⲓⲙⲉⲛⲟⲛ
ⲡⲣⲟⲕⲓⲙⲉⲛⲟⲛ	N	ⲡⲣⲟⲕⲓⲙⲉⲛⲟⲛ
ⲡⲣⲟⲕⲟⲡⲏ	N	ⲡⲣⲟⲕⲟⲡⲏ
ⲡⲣⲟⲕⲟⲡⲧⲉ	V	ⲡⲣⲟⲕⲟⲡⲧⲉ
ⲡⲣⲟⲕⲣⲓⲙⲁⲧⲓⲍⲉ	V	ⲡⲣⲟⲕⲣⲓⲙⲁⲧⲓⲍⲉ
ⲡⲣⲟⲛⲓⲕⲟⲥ	N	ⲡⲣⲟⲛⲓⲕⲟⲥ
ⲡⲣⲟⲛⲟⲏⲧⲏⲥ	N	ⲡⲣⲟⲛⲟⲏⲧⲏⲥ
ⲡⲣⲟⲛⲟⲏⲧⲟⲥ	N	ⲡⲣⲟⲛⲟⲏⲧⲟⲥ
ⲡⲣⲟⲛⲟⲓⲁ	N	ⲡⲣⲟⲛⲟⲓⲁ
ⲡⲣⲟⲡⲁⲧⲱⲣ	N	ⲡⲣⲟⲡⲁⲧⲱⲣ
ⲡⲣⲟⲡⲉⲧⲏⲥ	N	ⲡⲣⲟⲡⲉⲧⲏⲥ
ⲡⲣⲟⲥ	PREP	ⲡⲣⲟⲥ
ⲡⲣⲟⲥⲁⲃⲃⲁⲧⲟⲛ	N	ⲡⲣⲟⲥⲁⲃⲃⲁⲧⲟⲛ
ⲡⲣⲟⲥⲇⲟⲕⲁ	V	ⲡⲣⲟⲥⲇⲟⲕⲁ
ⲡⲣⲟⲥⲇⲟⲕⲉⲓ	V	ⲡⲣⲟⲥⲇⲟⲕⲉⲓ
ⲡⲣⲟⲥⲇⲟⲕⲓⲁ	N	ⲡⲣⲟⲥⲇⲟⲕⲓⲁ
ⲡⲣⲟⲥⲉⲗⲉⲩⲥⲓⲥ	N	ⲡⲣⲟⲥⲉⲗⲉⲩⲥⲓⲥ
ⲡⲣⲟⲥⲉⲗⲑⲉ	V	ⲡⲣⲟⲥⲉⲗⲑⲉ
ⲡⲣⲟⲥⲉⲩⲭⲉ	V	ⲡⲣⲟⲥⲉⲩⲭⲉ
ⲡⲣⲟⲥⲉⲩⲭⲏ	N	ⲡⲣⲟⲥⲉⲩⲭⲏ
ⲡⲣⲟⲥⲉⲭⲉ	V	ⲡⲣⲟⲥⲉⲭⲉ
ⲡⲣⲟⲥⲏⲗⲩⲧⲟⲥ	N	ⲡⲣⲟⲥⲏⲗⲩⲧⲟⲥ
ⲡⲣⲟⲥⲑⲉⲙⲁ	N	ⲡⲣⲟⲥⲑⲉⲙⲁ
ⲡⲣⲟⲥⲑⲏⲣⲟⲥ	N	ⲡⲣⲟⲥⲑⲏⲣⲟⲥ
ⲡⲣⲟⲥⲑⲩⲕⲏ	N	ⲡⲣⲟⲥⲑⲩⲕⲏ
ⲡⲣⲟⲥⲕ/	N	ⲡⲣⲟⲥⲕ/
ⲡⲣⲟⲥⲕⲁⲣⲧⲉⲣⲉⲓ	V	ⲡⲣⲟⲥⲕⲁⲣⲧⲉⲣⲉⲓ
ⲡⲣⲟⲥⲕⲩⲛⲉⲓ	V	ⲡⲣⲟⲥⲕⲩⲛⲉⲓ
ⲡⲣⲟⲥⲕⲩⲛⲏⲥⲓⲥ	N	ⲡⲣⲟⲥⲕⲩⲛⲏⲥⲓⲥ
ⲡⲣⲟⲥⲧⲁⲅⲙⲁ	N	ⲡⲣⲟⲥⲧⲁⲅⲙⲁ
ⲡⲣⲟⲥⲧⲁⲥⲓⲁ	N	ⲡⲣⲟⲥⲧⲁⲥⲓⲁ
ⲡⲣⲟⲥⲧⲁⲧⲏⲥ	N	ⲡⲣⲟⲥⲧⲁⲧⲏⲥ
ⲡⲣⲟⲥⲧⲓⲙⲟⲛ	N	ⲡⲣⲟⲥⲧⲓⲙⲟⲛ
ⲡⲣⲟⲥⲫⲉⲣⲉⲓ	V	ⲡⲣⲟⲥⲫⲉⲣⲉⲓ
ⲡⲣⲟⲥⲫⲟⲣⲁ	N	ⲡⲣⲟⲥⲫⲟⲣⲁ
ⲡⲣⲟⲥⲫⲱⲛⲉⲓ	V	ⲡⲣⲟⲥⲫⲱⲛⲉⲓ
ⲡⲣⲟⲥⲭⲁⲣⲓⲍⲉ	V	ⲡⲣⲟⲥⲭⲁⲣⲓⲍⲉ
ⲡⲣⲟⲥⲱⲡⲟⲛ	N	ⲡⲣⲟⲥⲱⲡⲟⲛ
ⲡⲣⲟⲧⲉⲕⲧⲱⲣ	N	ⲡⲣⲟⲧⲉⲕⲧⲱⲣ
ⲡⲣⲟⲧⲟⲅⲉⲛⲏⲧⲟⲥ	N	ⲡⲣⲟⲧⲟⲅⲉⲛⲏⲧⲟⲥ
ⲡⲣⲟⲧⲟⲅⲉⲛⲛⲏⲧⲱⲣ	N	ⲡⲣⲟⲧⲟⲅⲉⲛⲛⲏⲧⲱⲣ
ⲡⲣⲟⲧⲟⲡⲗⲁⲥⲙⲁ	N	ⲡⲣⲟⲧⲟⲡⲗⲁⲥⲙⲁ
ⲡⲣⲟⲧⲟⲡⲟⲗⲓⲧⲏⲥ	N	ⲡⲣⲟⲧⲟⲡⲟⲗⲓⲧⲏⲥ
ⲡⲣⲟⲧⲟⲫⲓⲗⲟⲥ	N	ⲡⲣⲟⲧⲟⲫⲓⲗⲟⲥ
ⲡⲣⲟⲧⲣⲉⲡⲉ	V	ⲡⲣⲟⲧⲣⲉⲡⲉ
ⲡⲣⲟⲫⲁⲥⲓⲥ	N	ⲡⲣⲟⲫⲁⲥⲓⲥ
ⲡⲣⲟⲫⲉⲧⲉⲩⲉ	V	ⲡⲣⲟⲫⲉⲧⲉⲩⲉ
ⲡⲣⲟⲫⲏⲧⲉⲓⲁ	N	ⲡⲣⲟⲫⲏⲧⲉⲓⲁ
ⲡⲣⲟⲫⲏⲧⲉⲩⲉ	V	ⲡⲣⲟⲫⲏⲧⲉⲩⲉ
ⲡⲣⲟⲫⲏⲧⲏⲥ	N	ⲡⲣⲟⲫⲏⲧⲏⲥ
ⲡⲣⲟⲫⲏⲧⲓⲁ	N	ⲡⲣⲟⲫⲏⲧⲓⲁ
ⲡⲣⲟⲫⲏⲧⲓⲕⲟⲛ	N	ⲡⲣⲟⲫⲏⲧⲓⲕⲟⲛ
ⲡⲣⲟⲱⲛⲧⲟⲥ	N	ⲡⲣⲟⲱⲛⲧⲟⲥ
ⲡⲣⲱⲧⲁⲣⲭⲱⲛ	N	ⲡⲣⲱⲧⲁⲣⲭⲱⲛ
ⲡⲣⲱⲧⲉⲛⲛⲟⲓⲁ	N	ⲡⲣⲱⲧⲉⲛⲛⲟⲓⲁ
ⲡⲣⲱⲧⲏ	N	ⲡⲣⲱⲧⲏ
ⲡⲣⲱⲧⲓⲁ	N	ⲡⲣⲱⲧⲓⲁ
ⲡⲣⲱⲧⲟⲛ	ADV	ⲡⲣⲱⲧⲟⲛ
ⲡⲣⲱⲧⲟⲧⲩⲡⲱⲥ	ADV	ⲡⲣⲱⲧⲟⲧⲩⲡⲱⲥ
ⲡⲣⲱⲧⲟⲫⲁⲛⲏⲥ	N	ⲡⲣⲱⲧⲟⲫⲁⲛⲏⲥ
ⲡⲧⲱⲙⲁ	N	ⲡⲧⲱⲙⲁ
ⲡⲩⲕⲧⲉⲩⲉ	V	ⲡⲩⲕⲧⲉⲩⲉ
ⲡⲩⲗⲏ	N	ⲡⲩⲗⲏ
ⲡⲩⲗⲱⲛ	N	ⲡⲩⲗⲱⲛ
ⲡⲩⲝⲓⲟⲛ	N	ⲡⲩⲝⲓⲟⲛ
ⲡⲩⲣⲁ	N	ⲡⲩⲣⲁ
ⲡⲩⲣⲅⲟⲥ	N	ⲡⲩⲣⲅⲟⲥ
ⲡⲩⲣⲟⲩ	V	ⲡⲩⲣⲟⲩ
ⲡⲱⲥ	ADV	ⲡⲱⲥ
ⲡⲱⲧⲏⲣⲓⲟⲛ	N	ⲡⲱⲧⲏⲣⲓⲟⲛ
ⲣϩⲉⲙ	V	ⲣϩⲉⲙ
ⲣⲁ	N	ⲣⲁ
ⲣⲁ	PPERS	ⲛⲑⲟ
ⲣⲁ	V	ⲓⲣⲓ
ⲣⲁϣ	V	ⲣⲱϣ
ⲣⲁϣ	V	ⲣⲱϣⲓ
ⲣⲁϣⲓ	N	ⲣⲁϣⲓ
ⲣⲁϣⲓ	V	ⲣⲁϣⲓ
ⲣⲁϣⲓ	VSTAT	ⲣⲱϣⲓ
ⲣⲁϣⲧ	V	ⲣⲱϣⲓ
ⲣⲁϧ	V	ⲣⲱϧⲓ
ⲣⲁϧⲓ	VSTAT	ⲣⲱϧⲓ
ⲣⲁϧⲧ	V	ⲣⲱϧⲧ
ⲣⲁϧⲧ	VSTAT	ⲣⲱϧⲧ
ⲣⲁϫⲣⲉϫ	V	ϧⲣⲁϫⲣⲉϫ
ⲣⲁⲃⲏ	N	ⲣⲁⲟⲩⲏ
ⲣⲁⲃⲏⲟⲩⲧ	VSTAT	ⲣⲁⲟⲩⲱ
ⲣⲁⲕ	V	ⲣⲓⲕⲓ
ⲣⲁⲕⲓ	VSTAT	ⲣⲓⲕⲓ
ⲣⲁⲕⲧ	V	ⲣⲓⲕⲓ
ⲣⲁⲙⲓ	N	ⲣⲁⲙⲓ
ⲣⲁⲛ	N	ⲣⲁⲛ
ⲣⲁⲟⲩⲏ	N	ⲣⲁⲟⲩⲏ
ⲣⲁⲟⲩⲏⲟⲩⲧ	VSTAT	ⲣⲁⲟⲩⲱ
ⲣⲁⲟⲩⲱ	V	ⲣⲁⲟⲩⲱ
ⲣⲁⲥϯ	N	ⲣⲁⲥϯ
ⲣⲁⲥⲟⲩⲓ	N	ⲣⲁⲥⲟⲩⲓ
ⲣⲁⲧ	N	ⲣⲁⲧ
ⲣⲁⲧ	VSTAT	ⲣⲱⲧ
ⲣⲁⲩϣ	N	ⲣⲁⲩϣ
ⲣⲉ	N	ⲣⲟ
ⲣⲉϣ	V	ⲣⲱϣⲓ
ⲣⲉϥϯⲥⲃⲱ	N	ⲣⲉϥϯⲥⲃⲱ
ⲣⲉϥϯⲱⲙⲥ	N	ⲣⲉϥϯⲱⲙⲥ
ⲣⲉϥⲉⲣϩⲱⲃ	N	ⲣⲉϥⲉⲣϩⲱⲃ
ⲣⲉϥⲉⲣⲛⲟⲃⲓ	N	ⲣⲉϥⲉⲣⲛⲟⲃⲓ
ⲣⲉϥⲕⲓϯ	N	ⲕⲓϯ
ⲣⲉϥⲧⲁϩⲉⲣⲱⲙⲓ	N	ⲣⲉϥⲧⲁϩⲉⲣⲱⲙⲓ
ⲣⲉϧⲧ	V	ⲣⲱϧⲧ
ⲣⲉϫⲡ	V	ⲣⲱϫⲡ
ⲣⲉⲕ	V	ⲣⲓⲕⲓ
ⲣⲉⲕϩ	V	ⲣⲱⲕϩ
ⲣⲉⲕⲣⲓⲕⲓ	N	ⲣⲉⲕⲣⲓⲕⲓ
ⲣⲉⲕⲣⲱⲕ	VSTAT	ⲣⲉⲕⲣⲱⲕ
ⲣⲉⲙ	N	ⲣⲱⲙⲓ
ⲣⲉⲙϩⲉ	N	ⲣⲉⲙϩⲉ
ⲣⲉⲙⲛⲁⲍⲁⲣⲉⲑ	N	ⲣⲉⲙⲛⲁⲍⲁⲣⲉⲑ
ⲣⲉⲛ	N	ⲣⲁⲛ
ⲣⲉⲧ	V	ⲣⲱⲧ
ⲣⲏ	N	ⲣⲏ
ⲣⲏϯ	N	ⲣⲏϯ
ⲣⲏⲃ	N	ⲁⲣⲏⲃ
ⲣⲏⲓ	N	ⲣⲏⲓ
ⲣⲏⲓⲥⲉⲛ	N	ⲣⲏⲓⲥⲓ
ⲣⲏⲓⲥⲓ	N	ⲣⲏⲓⲥⲓ
ⲣⲏⲥ	N	ⲣⲏⲥ
ⲣⲏⲥ	VSTAT	ⲣⲱⲓⲥ
ⲣⲏⲥⲓⲥ	N	ⲣⲏⲥⲓⲥ
ⲣⲏⲧ	V	ⲉⲣⲏⲧ
ⲣⲏⲧ	VSTAT	ⲣⲱⲧ
ⲣⲓ	N	ⲣⲓ
ⲣⲓⲃⲏ	N	ⲣⲓⲃⲏ
ⲣⲓⲃⲓ	N	ⲣⲓⲃⲏ
ⲣⲓⲕⲓ	V	ⲣⲓⲕⲓ
ⲣⲓⲙⲓ	V	ⲣⲓⲙⲓ
ⲣⲓⲣ	N	ⲣⲓⲣ
ⲣⲓⲧⲁ	N	ⲣⲓⲧⲁ
ⲣⲓⲧⲓⲑⲓ	N	ⲣⲓⲧⲓⲑⲓ
ⲣⲙϩⲉⲩ	N	ⲣⲉⲙϩⲉ
ⲣⲙϩⲏⲟⲩ	N	ⲣⲉⲙϩⲉ
ⲣⲙⲛϩⲏ	N	ⲣⲉⲙϩⲉ
ⲣⲙⲟⲛⲁⲭⲟⲥ	N	ⲣⲙⲟⲛⲁⲭⲟⲥ
ⲣⲙⲟⲛⲁⲭⲟⲥ	V	ⲣⲙⲟⲛⲁⲭⲟⲥ
ⲣⲟ	N	ⲣⲟ
ⲣⲟϫⲡ	V	ⲣⲱϫⲡ
ⲣⲟϫⲡ	VSTAT	ⲣⲱϫⲡ
ⲣⲟϯ	N	ⲣⲟϯ
ⲣⲟⲑⲃ	V	ⲣⲱⲧⲉⲃ
ⲣⲟⲕϩ	V	ⲣⲱⲕϩ
ⲣⲟⲕϩ	VSTAT	ⲣⲱⲕϩ
ⲣⲟⲙⲡⲓ	N	ⲣⲟⲙⲡⲓ
ⲣⲟⲙⲥⲓⲛ	N	ⲣⲟⲙⲥⲓⲛ
ⲣⲟⲧ	V	ⲣⲱⲧ
ⲣⲟⲧⲉⲃ	VSTAT	ⲣⲱⲧⲉⲃ
ⲣⲟⲩϩⲓ	N	ⲣⲟⲩϩⲓ
ⲣⲧⲁⲃ	N	ⲣⲧⲁⲃ
ⲣⲧⲁⲃ	N	ⲣⲧⲟⲃ
ⲣⲭⲣⲉⲓⲁ	V	ⲣⲭⲣⲉⲓⲁ
ⲣⲱ	N	ⲣⲟ
ⲣⲱϣ	V	ⲣⲱϣ
ⲣⲱϣⲓ	V	ⲣⲱϣⲓ
ⲣⲱϧⲓ	V	ⲣⲱϧⲓ
ⲣⲱϧⲧ	V	ⲣⲱϧⲧ
ⲣⲱϫⲡ	V	ⲣⲱϫⲡ
ⲣⲱⲓⲥ	V	ⲣⲱⲓⲥ
ⲣⲱⲕϩ	V	ⲣⲱⲕϩ
ⲣⲱⲙⲓ	ART	ⲣⲱⲙⲓ
ⲣⲱⲙⲓ	N	ⲣⲱⲙⲓ
ⲣⲱⲛ	N	ⲣⲱⲛ
ⲣⲱⲟⲩ	N	ⲣⲟ
ⲣⲱⲟⲩϣ	N	ⲣⲱⲟⲩϣ
ⲣⲱⲟⲩϣ	V	ⲣⲱⲟⲩϣ
ⲣⲱⲟⲩⲓ	N	ⲣⲱⲟⲩⲓ
ⲣⲱⲟⲩⲧ	V	ⲉⲣⲟⲩⲟⲧ
ⲣⲱⲟⲩⲧ	VSTAT	ⲉⲣⲟⲩⲟⲧ
ⲣⲱⲥ	V	ⲣⲱⲓⲥ
ⲣⲱⲧ	V	ⲣⲱⲧ
ⲣⲱⲧⲉⲃ	V	ⲣⲱⲧⲉⲃ
ⲥ	PPERO	ⲛⲑⲟⲥ
ⲥ	PPERS	ⲛⲑⲟⲥ
ⲥϣⲉ	N	ⲥϣⲉ
ⲥϣⲉ	V	ⲥϣⲉ
ⲥϥⲱϯ	N	ⲥϥⲱϯ
ⲥϧⲁⲓ	V	ⲥϧⲁⲓ
ⲥϧⲉ	V	ⲥϧⲁⲓ
ⲥϧⲏⲟⲩⲧ	VSTAT	ⲥϧⲁⲓ
ⲥϧⲏⲧ	V	ⲥϧⲁⲓ
ⲥϧⲟ	N	ⲥϧⲟ
ⲥϩⲓⲙⲓ	N	ⲥϩⲓⲙⲓ
ⲥϩⲟⲩⲉⲣ	V	ⲥⲁϩⲟⲩⲓ
ⲥϩⲟⲩⲟⲣⲧ	VSTAT	ⲥⲁϩⲟⲩⲓ
ⲥϩⲟⲩⲱⲣ	V	ⲥⲁϩⲟⲩⲓ
ⲥϯⲭⲟⲥ	N	ⲥϯⲭⲟⲥ
ⲥⲁ	N	ⲥⲁ
ⲥⲁ	PREP	ⲥⲁ
ⲥⲁϥ	N	ⲥⲁϥ
ⲥⲁϥ	VSTAT	ⲥⲱϥ
ⲥⲁϧ	N	ⲥⲁϧ
ⲥⲁϧ	V	ⲥⲱϧⲓ
ⲥⲁϧⲉⲙ	V	ⲥⲱϧⲉⲙ
ⲥⲁϧⲉⲙ	VSTAT	ⲥⲁϧⲉⲙ
ⲥⲁϧⲙ	V	ⲥⲱϧⲉⲙ
ⲥⲁϧⲟⲧ	N	ⲥⲁϧⲱⲧ
ⲥⲁϧⲱⲧ	N	ⲥⲁϧⲱⲧ
ⲥⲁϩ	N	ⲥⲁϩ
ⲥⲁϩϯ	V	ⲥⲁϩϯ
ⲥⲁϩⲉⲙ	V	ⲥⲱϧⲉⲙ
ⲥⲁϩⲏⲟⲩⲧ	VSTAT	ⲥⲱϩⲓ
ⲥⲁϩⲛⲏⲧ	V	ⲥⲁϩⲛⲓ
ⲥⲁϩⲛⲓ	V	ⲥⲁϩⲛⲓ
ⲥⲁϩⲟϥ	V	ⲥⲁϩⲟϥ
ⲥⲁϩⲟⲩⲓ	V	ⲥⲁϩⲟⲩⲓ
ⲥⲁϩⲣ	VSTAT	ⲥⲱⲣϩ
ⲥⲁϩⲥ	V	ⲥⲁϩⲥ
ⲥⲁϩⲥⲉϩ	V	ⲥⲁϩⲥⲉϩ
ⲥⲁϩⲥⲉϩ	VSTAT	ⲥⲁϩⲥⲉϩ
ⲥⲁϩⲥⲱϩ	V	ⲥⲁϩⲥⲉϩ
ⲥⲁϩⲧ	V	ⲥⲱϧⲓ
ⲥⲁϩⲱ	V	ⲥⲟϩⲓ
ⲥⲁϩⲱ	V	ⲥⲱϩⲓ
ⲥⲁϫⲓ	N	ⲥⲁϫⲓ
ⲥⲁϫⲓ	V	ⲥⲁϫⲓ
ⲥⲁϯ	N	ⲥⲁϯ
ⲥⲁϯ	V	ⲥⲁϯ
ⲥⲁϯ	VSTAT	ⲥⲓϯ
ⲥⲁⲃⲁⲕⲁⲧⲉ	N	ⲥⲁⲃⲁⲕⲁⲧⲉ
ⲥⲁⲃⲁⲱⲑ	NPROP	ⲥⲁⲃⲁⲱⲑ
ⲥⲁⲃⲃⲁⲧⲟⲛ	N	ⲥⲁⲃⲃⲁⲧⲟⲛ
ⲥⲁⲃⲉ	N	ⲥⲁⲃⲉ
ⲥⲁⲃⲉⲕ	N	ⲥⲁⲃⲉⲕ
ⲥⲁⲃⲉⲩ	N	ⲥⲁⲃⲉ
ⲥⲁⲃⲏ	N	ⲥⲁⲃⲉ
ⲥⲁⲃⲟⲗ	ADV	ⲥⲁⲃⲟⲗ
ⲥⲁⲇⲇⲟⲩⲕⲁⲓⲟⲥ	NPROP	ⲥⲁⲇⲇⲟⲩⲕⲁⲓⲟⲥ
ⲥⲁⲑⲉⲣⲓ	N	ⲥⲁⲑⲉⲣⲓ
ⲥⲁⲑⲙⲓ	V	ⲥⲁⲑⲙⲓ
ⲥⲁⲓ	V	ⲥϧⲁⲓ
ⲥⲁⲓ	V	ⲥⲓ
ⲥⲁⲓ	NPROP	ⲥⲁⲓ
ⲥⲁⲓⲉ	VSTAT	ⲥⲁⲓ
ⲥⲁⲓⲱⲟⲩ	VSTAT	ⲥⲁⲓ
ⲥⲁⲓⲱⲟⲩ	VSTAT	ⲥⲁⲓⲱⲟⲩ
ⲥⲁⲕ	N	ⲥⲁⲕ
ⲥⲁⲕⲓⲁ	N	ⲥⲁⲕⲓⲁ
ⲥⲁⲗϩⲟ	N	ⲥⲉⲗϩⲟ
ⲥⲁⲗⲁⲙⲁⲛⲇⲣⲁ	N	ⲥⲁⲗⲁⲙⲁⲛⲇⲣⲁ
ⲥⲁⲗⲙⲱⲛ	NPROP	ⲥⲁⲗⲙⲱⲛ
ⲥⲁⲗⲟⲩⲕⲓ	N	ⲥⲁⲗⲟⲩⲕⲓ
ⲥⲁⲗⲡⲓⲅⲅⲟⲥ	N	ⲥⲁⲗⲡⲓⲅⲅⲟⲥ
ⲥⲁⲗⲡⲓⲅⲝ	N	ⲥⲁⲗⲡⲓⲅⲝ
ⲥⲁⲗⲡⲓⲍⲉ	V	ⲥⲁⲗⲡⲓⲍⲉ
ⲥⲁⲗⲱⲙⲏ	N	ⲥⲁⲗⲱⲙⲏ
ⲥⲁⲗⲱⲙⲏ	NPROP	ⲥⲁⲗⲱⲙⲏ
ⲥⲁⲙⲁⲣⲓⲁ	NPROP	ⲥⲁⲙⲁⲣⲓⲁ
ⲥⲁⲙⲁⲣⲓⲧⲏⲥ	N	ⲥⲁⲙⲁⲣⲓⲧⲏⲥ
ⲥⲁⲙⲃⲉϩⲓ	N	ⲥⲁⲙⲃⲉϩⲓ
ⲥⲁⲙⲉⲛϩⲉ	PREP	ⲥⲁⲙⲉⲛϩⲉ
ⲥⲁⲙⲉⲛϩⲏ	PREP	ⲥⲁⲙⲉⲛϩⲉ
ⲥⲁⲙⲓⲧ	N	ⲥⲁⲙⲓⲧ
ⲥⲁⲙⲟⲩⲏⲗ	NPROP	ⲥⲁⲙⲟⲩⲏⲗ
ⲥⲁⲛⲇⲁⲗⲓⲟⲛ	N	ⲥⲁⲛⲇⲁⲗⲓⲟⲛ
ⲥⲁⲛⲓⲥ	N	ⲥⲁⲛⲓⲥ
ⲥⲁⲡⲡⲉⲓⲣⲓⲛⲟⲛ	N	ⲥⲁⲡⲡⲉⲓⲣⲓⲛⲟⲛ
ⲥⲁⲡⲡⲓⲣⲟⲛ	N	ⲥⲁⲡⲡⲓⲣⲟⲛ
ⲥⲁⲡⲡⲓⲣⲟⲥ	N	ⲥⲁⲡⲡⲓⲣⲟⲥ
ⲥⲁⲣϩ	V	ⲥⲱⲣϩ
ⲥⲁⲣϩ	VSTAT	ⲥⲱⲣϩ
ⲥⲁⲣⲁϫⲱϥ	N	ⲥⲁⲣⲁϫⲱϥ
ⲥⲁⲣⲁⲅⲏⲛⲟⲥ	N	ⲥⲁⲣⲁⲅⲏⲛⲟⲥ
ⲥⲁⲣⲁⲕⲱϯ	N	ⲥⲁⲣⲁⲕⲱϯ
ⲥⲁⲣⲁⲡⲓⲟⲛ	NPROP	ⲥⲁⲣⲁⲡⲓⲟⲛ
ⲥⲁⲣⲁⲫⲉⲓⲛ	N	ⲥⲁⲣⲁⲫⲉⲓⲛ
ⲥⲁⲣⲇⲓⲟⲛ	N	ⲥⲁⲣⲇⲓⲟⲛ
ⲥⲁⲣⲕⲁⲛⲏ	N	ⲥⲁⲣⲕⲁⲛⲏ
ⲥⲁⲣⲕⲓⲕⲏ	N	ⲥⲁⲣⲕⲓⲕⲏ
ⲥⲁⲣⲕⲓⲕⲟⲛ	N	ⲥⲁⲣⲕⲓⲕⲟⲛ
ⲥⲁⲣⲕⲓⲕⲟⲥ	N	ⲥⲁⲣⲕⲓⲕⲟⲥ
ⲥⲁⲣⲕⲓⲕⲱⲥ	N	ⲥⲁⲣⲕⲓⲕⲱⲥ
ⲥⲁⲣⲝ	N	ⲥⲁⲣⲝ
ⲥⲁⲣⲟⲩⲕⲓ	N	ⲥⲁⲣⲟⲩⲕⲓ
ⲥⲁⲣⲣⲁ	NPROP	ⲥⲁⲣⲣⲁ
ⲥⲁⲥⲉⲗ	V	ⲥⲁⲥⲉⲗ
ⲥⲁⲧ	N	ⲥⲁⲧ
ⲥⲁⲧ	V	ⲥⲓϯ
ⲥⲁⲧⲁⲛⲁⲥ	N	ⲥⲁⲧⲁⲛⲁⲥ
ⲥⲁⲧⲁⲛⲁⲥ	NPROP	ⲥⲁⲧⲁⲛⲁⲥ
ⲥⲁⲧⲉⲉⲣⲉ	N	ⲥⲁⲧⲉⲉⲣⲉ
ⲥⲁⲧⲏⲟⲩⲧ	V	ⲥⲁⲧⲏⲟⲩⲧ
ⲥⲁⲧⲏⲣ	VSTAT	ⲥⲱⲧⲉⲣ
ⲥⲁⲧⲟⲧ	N	ⲥⲁⲧⲟⲧ
ⲥⲁⲧⲟⲧϥ	ADV	ⲥⲁⲧⲟⲧϥ
ⲥⲁⲧⲟⲧⲟⲩ	ADV	ⲥⲁⲧⲟⲧⲟⲩ
ⲥⲁⲩ	V	ⲥⲱ
ⲥⲁⲫⲏⲛⲓⲍⲉ	V	ⲥⲁⲫⲏⲛⲓⲍⲉ
ⲥⲁⲭⲑⲁⲛⲉⲓ	V	ⲥⲁⲭⲑⲁⲛⲉⲓ
ⲥⲁⲭⲟⲗ	N	ⲥⲁⲭⲟⲗ
ⲥⲃⲉ	N	ⲥⲃⲉ
ⲥⲃⲑⲁⲓⲟⲩ	N	ⲥⲟⲃⲧ
ⲥⲃⲟⲕ	V	ⲥⲃⲟⲕ
ⲥⲃⲱ	N	ⲥⲃⲱ
ⲥⲉ	PPERS	ⲛⲑⲱⲟⲩ
ⲥⲉ	V	ⲥⲱ
ⲥⲉϥ	V	ⲥⲱϥ
ⲥⲉϩⲛⲉ	V	ⲥⲁϩⲛⲓ
ⲥⲉϩⲛⲏⲟⲩⲧ	VSTAT	ⲥⲁϩⲛⲓ
ⲥⲉϩⲧ	N	ⲥⲉϩⲧ
ⲥⲉϫⲡ	V	ⲥⲱϫⲡ
ⲥⲉⲃ	V	ⲥⲱⲡ
ⲥⲉⲃⲉⲛ	N	ⲥⲉⲃⲉⲛ
ⲥⲉⲃⲉⲥⲑⲁⲓ	V	ⲥⲉⲃⲉⲥⲑⲁⲓ
ⲥⲉⲃⲏⲣⲓⲟⲛ	N	ⲥⲉⲃⲏⲣⲓⲟⲛ
ⲥⲉⲃⲓ	N	ⲥⲏⲃⲓ
ⲥⲉⲃⲓ	V	ⲥⲉⲃⲓ
ⲥⲉⲃⲧⲉ	V	ⲥⲟⲃϯ
ⲥⲉⲃⲧⲱⲧ	V	ⲥⲟⲃϯ
ⲥⲉⲃⲧⲱⲧ	VSTAT	ⲥⲟⲃϯ
ⲥⲉⲑⲃⲁⲓⲟⲩ	N	ⲥⲑⲃⲁⲓϩ
ⲥⲉⲓⲱⲟⲩⲛⲓ	N	ⲥⲓⲱⲟⲩⲛⲓ
ⲥⲉⲕ	V	ⲥⲱⲕ
ⲥⲉⲕⲉϩ	V	ⲥⲉⲕⲉϩ
ⲥⲉⲕⲥⲉⲕ	V	ⲥⲟⲕⲥⲉⲕ
ⲥⲉⲕⲥⲓⲕ	N	ⲥⲉⲕⲥⲓⲕ
ⲥⲉⲗϩⲟ	N	ⲥⲉⲗϩⲟ
ⲥⲉⲗϫ	V	ⲥⲱⲗϫ
ⲥⲉⲗⲏⲛⲓⲁⲍⲉ	V	ⲥⲉⲗⲏⲛⲓⲁⲍⲉ
ⲥⲉⲗⲓⲥ	N	ⲥⲉⲗⲓⲥ
ⲥⲉⲗⲟⲩⲡⲓⲛ	N	ⲥⲉⲗⲟⲩⲡⲓⲛ
ⲥⲉⲗⲥⲉⲗ	V	ⲥⲟⲗⲥⲉⲗ
ⲥⲉⲗⲥⲱⲗ	V	ⲥⲟⲗⲥⲉⲗ
ⲥⲉⲗⲥⲱⲗ	VSTAT	ⲥⲟⲗⲥⲉⲗ
ⲥⲉⲙⲓ	V	ⲥⲉⲙⲓ
ⲥⲉⲙⲛⲉ	V	ⲥⲉⲙⲛⲉ
ⲥⲉⲙⲛⲏ	N	ⲥⲉⲙⲛⲏ
ⲥⲉⲙⲛⲏⲧ	V	ⲥⲉⲙⲛⲓ
ⲥⲉⲙⲛⲏⲟⲩⲧ	VSTAT	ⲥⲉⲙⲛⲓ
ⲥⲉⲙⲛⲓ	V	ⲥⲉⲙⲛⲓ
ⲥⲉⲙⲛⲟⲛ	N	ⲥⲉⲙⲛⲟⲛ
ⲥⲉⲙⲛⲟⲥ	N	ⲥⲉⲙⲛⲟⲥ
ⲥⲉⲙⲡⲟⲇⲓⲟⲛ	N	ⲥⲉⲙⲡⲟⲇⲓⲟⲛ
ⲥⲉⲛ	V	ⲥⲓⲛⲓ
ⲥⲉⲛϩ	V	ⲥⲱⲛϩ
ⲥⲉⲛϩⲏⲟⲩⲧ	VSTAT	ⲥⲁϩⲛⲓ
ⲥⲉⲛⲁⲗⲁⲥⲉ	V	ⲥⲉⲛⲁⲗⲁⲥⲉ
ⲥⲉⲛⲕ	V	ⲥⲱⲛⲕ
ⲥⲉⲛⲥⲉⲛ	V	ⲥⲉⲛⲥⲉⲛ
ⲥⲉⲛⲧ	V	ⲥⲱⲛⲧ
ⲥⲉⲛϯ	N	ⲥⲉⲛϯ
ⲥⲉⲡ	V	ⲥⲱⲡ
ⲥⲉⲡⲓ	V	ⲥⲉⲡⲓ
ⲥⲉⲡⲥⲉⲡ	V	ⲥⲟⲡⲥⲉⲡ
ⲥⲉⲣ	N	ⲥⲟⲩⲣⲓ
ⲥⲉⲣ	V	ⲥⲱⲣ
ⲥⲉⲣⲁ	N	ⲥⲉⲣⲁ
ⲥⲉⲣⲁⲡⲓⲥ	NPROP	ⲥⲉⲣⲁⲡⲓⲥ
ⲥⲉⲣⲉⲙ	V	ⲥⲱⲣⲉⲙ
ⲥⲉⲣⲫⲱⲧ	N	ⲥⲉⲣⲫⲱⲧ
ⲥⲉⲥⲃⲟϩ	N	ⲥⲉⲥⲃⲟϩ
ⲥⲉⲧ	N	ⲥⲁⲧ
ⲥⲉⲧ	V	ⲥⲓϯ
ⲥⲉⲧ	V	ⲥⲱϯ
ⲥⲉⲧϥ	V	ⲥⲱⲧϥ
ⲥⲉⲧⲡ	V	ⲥⲱⲧⲡ
ⲥⲉⲧⲥⲱⲧ	VSTAT	ⲥⲉⲧⲥⲱⲧ
ⲥⲉⲱⲟⲩⲛⲓ	N	ⲥⲓⲱⲟⲩⲛⲓ
ⲥⲏϥⲓ	N	ⲥⲏϥⲓ
ⲥⲏϧ	VSTAT	ⲥⲱϧⲓ
ⲥⲏϧⲓ	VSTAT	ⲥⲱϧⲓ
ⲥⲏϫ	N	ⲥⲏϫ
ⲥⲏϯ	VSTAT	ⲥⲓϯ
ⲥⲏⲃⲓ	N	ⲥⲏⲃⲓ
ⲥⲏⲓⲛⲓ	N	ⲥⲏⲓⲛⲓ
ⲥⲏⲙⲁⲛⲉ	V	ⲥⲏⲙⲁⲛⲉ
ⲥⲏⲙⲉⲓⲟⲛ	N	ⲥⲏⲙⲉⲓⲟⲛ
ⲥⲏⲙⲓⲟⲛ	N	ⲥⲏⲙⲓⲟⲛ
ⲥⲏⲟⲩ	N	ⲥⲏⲟⲩ
ⲥⲏⲟⲩ	VSTAT	ⲥⲓ
ⲥⲏⲣ	VSTAT	ⲥⲱⲣ
ⲥⲏⲣϥⲉ	V	ⲥⲣⲃⲉ
ⲥⲏⲧ	N	ⲥⲁⲧ
ⲥⲏⲧ	V	ⲥϧⲁⲓ
ⲥⲑⲃⲁⲓ	N	ⲥⲑⲃⲁⲓϩ
ⲥⲑⲃⲁⲓϩ	N	ⲥⲑⲃⲁⲓϩ
ⲥⲑⲉⲣⲧⲉⲣ	V	ⲥⲑⲉⲣⲧⲉⲣ
ⲥⲑⲏⲙ	N	ⲥⲧⲏⲙ
ⲥⲑⲓ	N	ⲥⲑⲟⲓ
ⲥⲑⲟ	V	ⲧⲁⲥⲑⲟ
ⲥⲑⲟⲓ	N	ⲥⲑⲟⲓ
ⲥⲑⲩ	N	ⲥⲑⲟⲓ
ⲥⲓ	V	ⲥⲓ
ⲥⲓϥⲓ	N	ⲥⲓϥⲓ
ⲥⲓϩⲓ	V	ⲥⲓϩⲓ
ⲥⲓϯ	N	ⲥⲓϯ
ⲥⲓϯ	V	ⲥⲓϯ
ⲥⲓⲅⲏ	N	ⲥⲓⲅⲏ
ⲥⲓⲅⲛⲟⲛ	N	ⲥⲓⲅⲛⲟⲛ
ⲥⲓⲅⲛⲟⲩⲫⲩⲗⲁⲝ	N	ⲥⲓⲅⲛⲟⲩⲫⲩⲗⲁⲝ
ⲥⲓⲇⲱⲛ	NPROP	ⲥⲓⲇⲱⲛ
ⲥⲓⲕ	N	ⲥⲓⲕ
ⲥⲓⲕⲓ	V	ⲥⲓⲕⲓ
ⲥⲓⲗⲁⲥ	NPROP	ⲥⲓⲗⲁⲥ
ⲥⲓⲗⲓ	N	ⲥⲓⲗⲓ
ⲥⲓⲗⲟⲩⲕⲓ	N	ⲥⲓⲗⲟⲩⲕⲓ
ⲥⲓⲙ	N	ⲥⲓⲙ
ⲥⲓⲙⲱⲛ	NPROP	ⲥⲓⲙⲱⲛ
ⲥⲓⲙⲱⲛⲓⲁⲛⲟⲥ	N	ⲥⲓⲙⲱⲛⲓⲁⲛⲟⲥ
ⲥⲓⲛⲁϩⲃⲓ	N	ⲥⲓⲛⲁϩⲃⲓ
ⲥⲓⲛⲇⲱⲛ	N	ⲥⲓⲛⲇⲱⲛ
ⲥⲓⲛⲇⲱⲛⲓⲟⲛ	N	ⲥⲓⲛⲇⲱⲛⲓⲟⲛ
ⲥⲓⲛⲓ	V	ⲥⲓⲛⲓ
ⲥⲓⲛⲓⲱⲟⲩ	VSTAT	ⲥⲓⲛⲓ
ⲥⲓⲛⲱⲟⲩⲓ	N	ⲥⲟⲛⲓ
ⲥⲓⲟⲩ	N	ⲥⲓⲟⲩ
ⲥⲓⲟⲩⲣ	N	ⲥⲓⲟⲩⲣ
ⲥⲓⲡ	N	ⲥⲓⲡ
ⲥⲓⲡⲡⲓⲟⲛ	N	ⲥⲓⲡⲡⲓⲟⲛ
ⲥⲓⲣ	N	ⲥⲓⲣ
ⲥⲓⲥⲙⲟⲥ	N	ⲥⲓⲥⲙⲟⲥ
ⲥⲓⲭⲁⲛⲉ	V	ⲥⲓⲭⲁⲛⲉ
ⲥⲓⲭⲁⲛⲉⲥⲑⲁⲓ	V	ⲥⲓⲭⲁⲛⲉⲥⲑⲁⲓ
ⲥⲓⲱⲟⲩⲛⲓ	N	ⲥⲓⲱⲟⲩⲛⲓ
ⲥⲕⲁⲗⲁ	N	ⲥⲕⲁⲗⲁ
ⲥⲕⲁⲛⲇⲁⲗⲓⲍⲉ	V	ⲥⲕⲁⲛⲇⲁⲗⲓⲍⲉ
ⲥⲕⲁⲛⲇⲁⲗⲓⲥⲍⲉⲥⲑⲉ	V	ⲥⲕⲁⲛⲇⲁⲗⲓⲥⲍⲉⲥⲑⲉ
ⲥⲕⲁⲛⲇⲁⲗⲟⲛ	N	ⲥⲕⲁⲛⲇⲁⲗⲟⲛ
ⲥⲕⲁⲛⲇⲁⲗⲟⲥ	N	ⲥⲕⲁⲛⲇⲁⲗⲟⲥ
ⲥⲕⲁⲫⲏ	N	ⲥⲕⲁⲫⲏ
ⲥⲕⲁⲫⲟⲥ	N	ⲥⲕⲁⲫⲟⲥ
ⲥⲕⲉⲛ	N	ⲥⲕⲉⲛ
ⲥⲕⲉⲛⲧ	N	ⲥⲕⲉⲛ
ⲥⲕⲉⲡⲁⲍⲉ	V	ⲥⲕⲉⲡⲁⲍⲉ
ⲥⲕⲉⲡⲁⲥⲧⲏⲥ	N	ⲥⲕⲉⲡⲁⲥⲧⲏⲥ
ⲥⲕⲉⲡⲉ	N	ⲥⲕⲉⲡⲉ
ⲥⲕⲉⲡⲓ	N	ⲥⲕⲉⲡⲓ
ⲥⲕⲉⲡⲧⲉⲓ	V	ⲥⲕⲉⲡⲧⲉⲓ
ⲥⲕⲉⲡⲧⲓⲛ	V	ⲥⲕⲉⲡⲧⲓⲛ
ⲥⲕⲉⲡⲱⲗⲁⲧⲱⲣ	N	ⲥⲕⲉⲡⲱⲗⲁⲧⲱⲣ
ⲥⲕⲉⲣⲕⲉⲣ	V	ⲥⲕⲉⲣⲕⲉⲣ
ⲥⲕⲉⲣⲕⲱⲣ	V	ⲥⲕⲉⲣⲕⲉⲣ
ⲥⲕⲉⲣⲕⲱⲣ	VSTAT	ⲥⲕⲉⲣⲕⲉⲣ
ⲥⲕⲉⲩⲉ	N	ⲥⲕⲉⲩⲟⲥ
ⲥⲕⲉⲩⲏ	N	ⲥⲕⲉⲩⲏ
ⲥⲕⲉⲩⲟⲥ	N	ⲥⲕⲉⲩⲟⲥ
ⲥⲕⲉⲯⲓⲥ	N	ⲥⲕⲉⲯⲓⲥ
ⲥⲕⲏⲇⲁⲗⲏ	N	ⲥⲕⲏⲇⲁⲗⲏ
ⲥⲕⲏⲛⲏ	N	ⲥⲕⲏⲛⲏ
ⲥⲕⲏⲛⲟⲡⲏⲅⲓⲁ	N	ⲥⲕⲏⲛⲟⲡⲏⲅⲓⲁ
ⲥⲕⲓⲃⲩⲧⲱⲣ	N	ⲥⲕⲓⲃⲩⲧⲱⲣ
ⲥⲕⲓⲣⲧⲁ	V	ⲥⲕⲓⲣⲧⲁ
ⲥⲕⲗⲁⲇⲟⲥ	N	ⲥⲕⲗⲁⲇⲟⲥ
ⲥⲕⲗⲏⲣⲓⲁ	N	ⲥⲕⲗⲏⲣⲓⲁ
ⲥⲕⲟⲡⲟⲥ	N	ⲥⲕⲟⲡⲟⲥ
ⲥⲕⲟⲣⲕⲉⲣ	N	ⲥⲕⲟⲣⲕⲉⲣ
ⲥⲕⲩⲑⲏⲥ	N	ⲥⲕⲩⲑⲏⲥ
ⲥⲕⲩⲗⲗⲉⲓ	V	ⲥⲕⲩⲗⲗⲉⲓ
ⲥⲕⲩⲗⲙⲟⲥ	N	ⲥⲕⲩⲗⲙⲟⲥ
ⲥⲕⲩⲛⲱⲙⲁ	N	ⲥⲕⲩⲛⲱⲙⲁ
ⲥⲗⲁϫⲗⲉϫ	V	ⲥⲗⲁϫⲗⲉϫ
ⲥⲗⲁϯ	V	ⲥⲗⲁϯ
ⲥⲗⲁⲧⲗⲉⲧ	N	ⲥⲗⲁⲧⲗⲉⲧ
ⲥⲗⲉϫⲗⲱϫ	VSTAT	ⲥⲗⲁϫⲗⲉϫ
ⲥⲗⲉⲡⲗⲱⲡ	VSTAT	ⲥⲗⲟⲡⲗⲉⲡ
ⲥⲗⲏ	N	ⲥⲗⲏ
ⲥⲗⲓϥⲓ	N	ⲥⲗⲓϥⲓ
ⲥⲗⲓϫ	N	ⲥⲗⲓϫ
ⲥⲗⲟⲡⲗⲉⲡ	V	ⲥⲗⲟⲡⲗⲉⲡ
ⲥⲙⲁϩ	N	ⲥⲙⲁϩ
ⲥⲙⲁⲁⲩ	N	ⲥⲙⲁⲩ
ⲥⲙⲁⲙⲁⲧ	VSTAT	ⲥⲙⲟⲩ
ⲥⲙⲁⲣⲁⲅⲇⲟⲥ	N	ⲥⲙⲁⲣⲁⲅⲇⲟⲥ
ⲥⲙⲁⲣⲱⲟⲩⲧ	VSTAT	ⲥⲙⲟⲩ
ⲥⲙⲁⲩ	N	ⲥⲙⲁⲩ
ⲥⲙⲁⲩⲁⲧ	VSTAT	ⲥⲙⲟⲩ
ⲥⲙⲉϩ	N	ⲥⲙⲁϩ
ⲥⲙⲉϩ	N	ⲥⲙⲉϩ
ⲥⲙⲉⲗⲓⲛ	N	ⲥⲙⲉⲗⲓⲛ
ⲥⲙⲏ	N	ⲥⲙⲏ
ⲥⲙⲓⲗⲁⲝ	N	ⲥⲙⲓⲗⲁⲝ
ⲥⲙⲛⲏⲟⲩⲧ	VSTAT	ⲥⲉⲙⲛⲉ
ⲥⲙⲟⲛⲧ	N	ⲥⲙⲟⲧ
ⲥⲙⲟⲛⲧ	VSTAT	ⲥⲉⲙⲛⲉ
ⲥⲙⲟⲧ	N	ⲥⲙⲟⲧ
ⲥⲙⲟⲧ	VSTAT	ⲥⲉⲙⲛⲉ
ⲥⲙⲟⲩ	V	ⲥⲙⲟⲩ
ⲥⲙⲟⲩⲣ	N	ⲥⲙⲟⲩⲣ
ⲥⲛⲁⲩ	NUM	ⲥⲛⲁⲩ
ⲥⲛⲏⲓⲛⲓ	N	ⲥⲛⲏⲓⲛⲓ
ⲥⲛⲏⲓⲛⲓ	V	ⲥⲛⲏⲓⲛⲓ
ⲥⲛⲏⲟⲩ	N	ⲥⲟⲛ
ⲥⲛⲏⲩ	N	ⲥⲟⲛ
ⲥⲛⲟϥ	N	ⲥⲛⲟϥ
ⲥⲛⲟⲩϥ	N	ⲥⲛⲟⲩϥ
ⲥⲛⲟⲩϯ	NUM	ⲥⲛⲟⲩϯ
ⲥⲛⲧⲁⲍⲉ	V	ⲥⲛⲧⲁⲍⲉ
ⲥⲛⲧⲉ	N	ⲥⲛⲧⲉ
ⲥⲛⲱϥ	N	ⲥⲛⲟϥ
ⲥⲟ	V	ⲥⲱ
ⲥⲟϥ	V	ⲥⲱϥ
ⲥⲟϥ	VSTAT	ⲥⲱϥ
ⲥⲟϩⲓ	V	ⲥⲟϩⲓ
ⲥⲟϫ	N	ⲥⲟϭ
ⲥⲟϫⲉⲛ	N	ⲥⲟϫⲉⲛ
ⲥⲟϫⲡ	V	ⲥⲱϫⲡ
ⲥⲟϫⲡ	VSTAT	ⲥⲱϫⲡ
ⲥⲟϭ	N	ⲥⲟϭ
ⲥⲟϭⲛⲓ	N	ⲥⲟϭⲛⲓ
ⲥⲟϭⲛⲓ	V	ⲥⲟϭⲛⲓ
ⲥⲟⲃϯ	PPERS	ⲥⲟⲃϯ
ⲥⲟⲃϯ	V	ⲥⲟⲃϯ
ⲥⲟⲃⲕ	VSTAT	ⲥⲃⲟⲕ
ⲥⲟⲃⲥⲉⲃ	V	ⲥⲟⲡⲥⲉⲡ
ⲥⲟⲃⲧ	N	ⲥⲟⲃⲧ
ⲥⲟⲇⲟⲙⲓⲧⲏⲥ	N	ⲥⲟⲇⲟⲙⲓⲧⲏⲥ
ⲥⲟⲑⲙ	V	ⲥⲱⲧⲉⲙ
ⲥⲟⲑⲛⲉϥ	N	ⲥⲟⲑⲛⲉϥ
ⲥⲟⲓ	N	ⲥⲟⲓ
ⲥⲟⲕ	N	ⲥⲟⲕ
ⲥⲟⲕ	V	ⲥⲱⲕ
ⲥⲟⲕⲙⲁϫⲓ	N	ⲥⲟⲕⲙⲁϫⲓ
ⲥⲟⲕⲥⲉⲕ	V	ⲥⲟⲕⲥⲉⲕ
ⲥⲟⲗ	N	ⲥⲟⲗ
ⲥⲟⲗ	V	ⲥⲱⲗ
ⲥⲟⲗϫ	V	ⲥⲱⲗϫ
ⲥⲟⲗⲓ	N	ⲥⲟⲩⲗⲓ
ⲥⲟⲗⲟⲙⲱⲛ	NPROP	ⲥⲟⲗⲟⲙⲱⲛ
ⲥⲟⲗⲡ	V	ⲥⲱⲗⲉⲡ
ⲥⲟⲗⲡ	VSTAT	ⲥⲱⲗⲉⲡ
ⲥⲟⲗⲥⲉⲗ	V	ⲥⲟⲗⲥⲉⲗ
ⲥⲟⲙⲁⲛⲓ	N	ⲥⲟⲩⲙⲁⲛⲓ
ⲥⲟⲙⲉⲛⲓ	N	ⲥⲟⲩⲙⲁⲛⲓ
ⲥⲟⲙⲥ	V	ⲥⲟⲙⲥ
ⲥⲟⲙⲧ	V	ⲥⲟⲙⲧ
ⲥⲟⲙⲧ	VSTAT	ⲥⲟⲙⲧ
ⲥⲟⲛ	N	ⲥⲟⲛ
ⲥⲟⲛϩ	V	ⲥⲱⲛϩ
ⲥⲟⲛϩ	VSTAT	ⲥⲱⲛϩ
ⲥⲟⲛϯ	N	ⲥⲟⲛϯ
ⲥⲟⲛⲓ	N	ⲥⲟⲛⲓ
ⲥⲟⲛⲕ	V	ⲥⲱⲛⲕ
ⲥⲟⲛⲧ	V	ⲥⲱⲛⲧ
ⲥⲟⲡ	N	ⲥⲟⲡ
ⲥⲟⲡ	V	ⲥⲱⲡ
ⲥⲟⲡⲥⲉⲡ	V	ⲥⲟⲡⲥⲉⲡ
ⲥⲟⲣ	V	ⲥⲱⲣ
ⲥⲟⲣⲉⲙ	N	ⲥⲟⲣⲉⲙ
ⲥⲟⲣⲉⲙ	VSTAT	ⲥⲱⲣⲉⲙ
ⲥⲟⲣⲙ	V	ⲥⲱⲣⲉⲙ
ⲥⲟⲣⲧ	N	ⲥⲟⲣⲧ
ⲥⲟⲥⲓ	V	ⲥⲱⲥ
ⲥⲟⲧ	V	ⲥⲱϯ
ⲥⲟⲧϥ	VSTAT	ⲥⲱⲧϥ
ⲥⲟⲧⲉⲣ	VSTAT	ⲥⲱⲧⲉⲣ
ⲥⲟⲧⲏⲣ	VSTAT	ⲥⲱⲧⲉⲣ
ⲥⲟⲧⲡ	V	ⲥⲱⲧⲡ
ⲥⲟⲧⲡ	VSTAT	ⲥⲱⲧⲡ
ⲥⲟⲩ	N	ⲥⲏⲟⲩ
ⲥⲟⲩ	N	ⲥⲓⲟⲩ
ⲥⲟⲩⲃⲉ	V	ⲥⲉⲃⲓ
ⲥⲟⲩⲃⲏ	V	ⲥⲉⲃⲓ
ⲥⲟⲩⲃⲏⲧ	VSTAT	ⲥⲉⲃⲓ
ⲥⲟⲩⲇⲁⲣⲓⲟⲛ	N	ⲥⲟⲩⲇⲁⲣⲓⲟⲛ
ⲥⲟⲩⲉⲛ	N	ⲥⲟⲩⲉⲛ
ⲥⲟⲩⲉⲛ	V	ⲥⲱⲟⲩⲛ
ⲥⲟⲩⲏⲧ	VSTAT	ⲥⲉⲃⲓ
ⲥⲟⲩⲗⲓ	N	ⲥⲟⲩⲗⲓ
ⲥⲟⲩⲙⲁⲛⲓ	N	ⲥⲟⲩⲙⲁⲛⲓ
ⲥⲟⲩⲟ	N	ⲥⲟⲩⲟ
ⲥⲟⲩⲣⲓ	N	ⲥⲟⲩⲣⲓ
ⲥⲟⲩⲣⲟⲧ	N	ⲥⲟⲩⲣⲟⲧ
ⲥⲟⲩⲣⲱⲧ	N	ⲥⲟⲩⲣⲟⲧ
ⲥⲟⲩⲥⲁⲛⲛⲁ	NPROP	ⲥⲟⲩⲥⲁⲛⲛⲁ
ⲥⲟⲩⲥⲟⲩ	N	ⲥⲟⲩⲥⲟⲩ
ⲥⲟⲩⲧⲉⲛ	V	ⲥⲟⲩⲧⲉⲛ
ⲥⲟⲩⲧⲉⲛ	V	ⲥⲟⲩⲧⲱⲛ
ⲥⲟⲩⲧⲉⲛ	V	ⲥⲱⲟⲩⲧⲉⲛ
ⲥⲟⲩⲧⲱⲛ	V	ⲥⲱⲟⲩⲧⲉⲛ
ⲥⲟⲩⲧⲱⲛ	VSTAT	ⲥⲟⲩⲧⲱⲛ
ⲥⲟⲩⲧⲱⲛ	VSTAT	ⲥⲱⲟⲩⲧⲉⲛ
ⲥⲟⲩⲱⲛ	V	ⲥⲱⲟⲩⲛ
ⲥⲟⲫⲓⲁ	N	ⲥⲟⲫⲓⲁ
ⲥⲟⲫⲟⲥ	N	ⲥⲟⲫⲟⲥ
ⲥⲡⲁⲧⲁⲗⲁ	V	ⲥⲡⲁⲧⲁⲗⲁ
ⲥⲡⲁⲧⲁⲗⲟⲥ	N	ⲥⲡⲁⲧⲁⲗⲟⲥ
ⲥⲡⲉⲕⲟⲩⲗⲁⲧⲱⲣ	N	ⲥⲡⲉⲕⲟⲩⲗⲁⲧⲱⲣ
ⲥⲡⲉⲣⲙⲁ	N	ⲥⲡⲉⲣⲙⲁ
ⲥⲡⲏⲗⲁⲓⲟⲛ	N	ⲥⲡⲏⲗⲁⲓⲟⲛ
ⲥⲡⲓⲛⲑⲏⲣ	N	ⲥⲡⲓⲛⲑⲏⲣ
ⲥⲡⲓⲣⲁ	N	ⲥⲡⲓⲣⲁ
ⲥⲡⲓⲣⲱⲟⲩⲓ	N	ⲥⲫⲓⲣ
ⲥⲡⲗⲁⲅⲭⲛⲟⲛ	N	ⲥⲡⲗⲁⲅⲭⲛⲟⲛ
ⲥⲡⲗⲏⲛ	N	ⲥⲡⲗⲏⲛ
ⲥⲡⲟⲅⲅⲟⲥ	N	ⲥⲡⲟⲅⲅⲟⲥ
ⲥⲡⲟⲛⲇⲏ	N	ⲥⲡⲟⲛⲇⲏ
ⲥⲡⲟⲣⲁ	N	ⲥⲡⲟⲣⲁ
ⲥⲡⲟⲩⲇⲁⲍⲉ	V	ⲥⲡⲟⲩⲇⲁⲍⲉ
ⲥⲡⲟⲩⲇⲁⲓⲟⲥ	N	ⲥⲡⲟⲩⲇⲁⲓⲟⲥ
ⲥⲡⲟⲩⲇⲏ	N	ⲥⲡⲟⲩⲇⲏ
ⲥⲣⲁϩ	N	ⲥⲣⲁϩ
ⲥⲣⲁϩ	VSTAT	ⲥⲱⲣϩ
ⲥⲣⲃⲉ	V	ⲥⲣⲃⲉ
ⲥⲣⲉⲙⲣⲱⲙ	V	ⲥⲣⲉⲙⲣⲱⲙ
ⲥⲣⲉⲙⲣⲱⲙ	V	ⲥⲣⲟⲙⲣⲉⲙ
ⲥⲣⲉⲙⲣⲱⲙ	VSTAT	ⲥⲣⲉⲙⲣⲱⲙ
ⲥⲣⲓⲧ	V	ⲥⲣⲓⲧ
ⲥⲣⲟϥⲧ	VSTAT	ⲥⲣⲃⲉ
ⲥⲣⲱϥⲧ	VSTAT	ⲥⲣⲃⲉ
ⲥⲧⲁϫⲟⲩⲗ	N	ⲥⲧⲁϫⲟⲩⲗ
ⲥⲧⲁⲅⲱⲛ	N	ⲥⲧⲁⲅⲱⲛ
ⲥⲧⲁⲇⲓⲟⲛ	N	ⲥⲧⲁⲇⲓⲟⲛ
ⲥⲧⲁⲕⲧⲏ	N	ⲥⲧⲁⲕⲧⲏ
ⲥⲧⲁⲥⲓⲁⲍⲉ	V	ⲥⲧⲁⲥⲓⲁⲍⲉ
ⲥⲧⲁⲥⲓⲁⲥⲧⲏⲥ	N	ⲥⲧⲁⲥⲓⲁⲥⲧⲏⲥ
ⲥⲧⲁⲥⲓⲥ	N	ⲥⲧⲁⲥⲓⲥ
ⲥⲧⲁⲩⲗⲟⲛ	N	ⲥⲧⲁⲩⲗⲟⲛ
ⲥⲧⲁⲩⲣⲟⲥ	N	ⲥⲧⲁⲩⲣⲟⲥ
ⲥⲧⲁⲩⲣⲟⲩ	V	ⲥⲧⲁⲩⲣⲟⲩ
ⲥⲧⲁⲫⲩⲗⲏ	N	ⲥⲧⲁⲫⲩⲗⲏ
ⲥⲧⲉⲓⲣⲁ	N	ⲥⲧⲉⲓⲣⲁ
ⲥⲧⲉⲛⲱⲥⲓⲥ	N	ⲥⲧⲉⲛⲱⲥⲓⲥ
ⲥⲧⲉⲣⲉⲩⲙⲁ	N	ⲥⲧⲉⲣⲉⲩⲙⲁ
ⲥⲧⲉⲣⲉⲱⲙⲁ	N	ⲥⲧⲉⲣⲉⲱⲙⲁ
ⲥⲧⲉⲫⲁⲛⲁ	N	ⲥⲧⲉⲫⲁⲛⲁ
ⲥⲧⲉⲫⲁⲛⲁ	NPROP	ⲥⲧⲉⲫⲁⲛⲁ
ⲥⲧⲉⲫⲁⲛⲟⲩ	V	ⲥⲧⲉⲫⲁⲛⲟⲩ
ⲥⲧⲉⲫⲁⲛⲟⲩⲫⲟⲣⲟⲥ	N	ⲥⲧⲉⲫⲁⲛⲟⲩⲫⲟⲣⲟⲥ
ⲥⲧⲏⲗⲏ	N	ⲥⲧⲏⲗⲏ
ⲥⲧⲏⲗⲟⲅⲣⲁⲫⲓⲁ	N	ⲥⲧⲏⲗⲟⲅⲣⲁⲫⲓⲁ
ⲥⲧⲏⲙ	N	ⲥⲧⲏⲙ
ⲥⲧⲓⲅⲙⲏ	N	ⲥⲧⲓⲅⲙⲏ
ⲥⲧⲓⲍⲉ	V	ⲥⲧⲓⲍⲉ
ⲥⲧⲓⲭⲉⲣⲟⲛ	N	ⲥⲧⲓⲭⲉⲣⲟⲛ
ⲥⲧⲓⲭⲟⲥ	N	ⲥⲧⲓⲭⲟⲥ
ⲥⲧⲟⲁ	N	ⲥⲧⲟⲁ
ⲥⲧⲟⲓⲭⲉⲓ	V	ⲥⲧⲟⲓⲭⲉⲓ
ⲥⲧⲟⲓⲭⲓⲟⲛ	N	ⲥⲧⲟⲓⲭⲓⲟⲛ
ⲥⲧⲟⲗⲁⲣⲭⲏⲥ	N	ⲥⲧⲟⲗⲁⲣⲭⲏⲥ
ⲥⲧⲟⲗⲏ	N	ⲥⲧⲟⲗⲏ
ⲥⲧⲟⲗⲓⲍⲉ	V	ⲥⲧⲟⲗⲓⲍⲉ
ⲥⲧⲟⲗⲟⲧⲟⲥ	N	ⲥⲧⲟⲗⲟⲧⲟⲥ
ⲥⲧⲟⲙⲁⲭⲟⲥ	N	ⲥⲧⲟⲙⲁⲭⲟⲥ
ⲥⲧⲣⲁⲧⲉⲓⲁ	N	ⲥⲧⲣⲁⲧⲉⲓⲁ
ⲥⲧⲣⲁⲧⲉⲩⲉ	V	ⲥⲧⲣⲁⲧⲉⲩⲉ
ⲥⲧⲣⲁⲧⲉⲩⲙⲁ	N	ⲥⲧⲣⲁⲧⲉⲩⲙⲁ
ⲥⲧⲣⲁⲧⲏⲅⲟⲥ	N	ⲥⲧⲣⲁⲧⲏⲅⲟⲥ
ⲥⲧⲣⲁⲧⲏⲗⲁⲧⲏⲥ	N	ⲥⲧⲣⲁⲧⲏⲗⲁⲧⲏⲥ
ⲥⲧⲣⲁⲧⲟⲛ	N	ⲥⲧⲣⲁⲧⲟⲛ
ⲥⲧⲣⲁⲧⲱⲡⲉⲧⲱⲛ	N	ⲥⲧⲣⲁⲧⲱⲡⲉⲧⲱⲛ
ⲥⲧⲣⲉⲃⲗⲟⲩ	V	ⲥⲧⲣⲉⲃⲗⲟⲩ
ⲥⲧⲣⲟⲅⲓⲗⲗⲟⲥ	N	ⲥⲧⲣⲟⲅⲓⲗⲗⲟⲥ
ⲥⲧⲣⲱⲙⲁ	N	ⲥⲧⲣⲱⲙⲁ
ⲥⲧⲩⲗⲗⲟⲥ	N	ⲥⲧⲩⲗⲗⲟⲥ
ⲥⲧⲩⲗⲟⲥ	N	ⲥⲧⲩⲗⲟⲥ
ⲥⲧⲩⲣⲁⲝ	N	ⲥⲧⲩⲣⲁⲝ
ⲥⲧⲩⲫⲏ	N	ⲥⲧⲩⲫⲏ
ⲥⲧⲩⲭⲉⲓ	V	ⲥⲧⲩⲭⲉⲓ
ⲥⲧⲱⲧ	V	ⲥⲧⲱⲧ
ⲥⲩⲅⲅⲉⲛⲉⲓⲁ	N	ⲥⲩⲅⲅⲉⲛⲉⲓⲁ
ⲥⲩⲅⲅⲉⲛⲏⲥ	N	ⲥⲩⲅⲅⲉⲛⲏⲥ
ⲥⲩⲅⲏ	N	ⲥⲩⲅⲏ
ⲥⲩⲅⲕⲉⲣⲁ	V	ⲥⲩⲅⲕⲉⲣⲁ
ⲥⲩⲅⲕⲗⲏⲧⲓⲕⲏ	NPROP	ⲥⲩⲅⲕⲗⲏⲧⲓⲕⲏ
ⲥⲩⲅⲕⲣⲓⲙⲁ	N	ⲥⲩⲅⲕⲣⲓⲙⲁ
ⲥⲩⲅⲟⲥ	N	ⲥⲩⲅⲟⲥ
ⲥⲩⲗⲁ	V	ⲥⲩⲗⲁ
ⲥⲩⲗⲉⲩⲉ	V	ⲥⲩⲗⲉⲩⲉ
ⲥⲩⲙⲃⲟⲗⲏ	N	ⲥⲩⲙⲃⲟⲗⲏ
ⲥⲩⲙⲃⲟⲗⲟⲛ	N	ⲥⲩⲙⲃⲟⲗⲟⲛ
ⲥⲩⲙⲃⲟⲗⲟⲥ	N	ⲥⲩⲙⲃⲟⲗⲟⲥ
ⲥⲩⲙⲃⲟⲩⲗⲉⲩⲉ	V	ⲥⲩⲙⲃⲟⲩⲗⲉⲩⲉ
ⲥⲩⲙⲃⲟⲩⲗⲓⲁ	N	ⲥⲩⲙⲃⲟⲩⲗⲓⲁ
ⲥⲩⲙⲃⲟⲩⲗⲓⲟⲛ	N	ⲥⲩⲙⲃⲟⲩⲗⲓⲟⲛ
ⲥⲩⲙⲙⲁⲭⲟⲥ	N	ⲥⲩⲙⲙⲁⲭⲟⲥ
ⲥⲩⲙⲙⲉⲧⲟⲭⲟⲥ	N	ⲥⲩⲙⲙⲉⲧⲟⲭⲟⲥ
ⲥⲩⲙⲡⲟⲥⲓⲟⲛ	N	ⲥⲩⲙⲡⲟⲥⲓⲟⲛ
ⲥⲩⲙⲫⲁⲛⲉⲍⲉ	V	ⲥⲩⲙⲫⲁⲛⲉⲍⲉ
ⲥⲩⲙⲫⲉⲣⲉⲓ	V	ⲥⲩⲙⲫⲉⲣⲉⲓ
ⲥⲩⲙⲫⲟⲛⲉⲓ	V	ⲥⲩⲙⲫⲟⲛⲉⲓ
ⲥⲩⲙⲫⲟⲣⲁ	N	ⲥⲩⲙⲫⲟⲣⲁ
ⲥⲩⲙⲫⲱⲛⲉⲓ	V	ⲥⲩⲙⲫⲱⲛⲉⲓ
ⲥⲩⲙⲫⲱⲛⲓⲁ	N	ⲥⲩⲙⲫⲱⲛⲓⲁ
ⲥⲩⲙⲫⲱⲛⲟⲛ	N	ⲥⲩⲙⲫⲱⲛⲟⲛ
ⲥⲩⲛϩⲉⲇⲣⲓⲟⲛ	N	ⲥⲩⲛϩⲉⲇⲣⲓⲟⲛ
ⲥⲩⲛϩⲉⲇⲣⲓⲟⲛ	NPROP	ⲥⲩⲛϩⲉⲇⲣⲓⲟⲛ
ⲥⲩⲛϩⲓⲥⲧⲁ	V	ⲥⲩⲛϩⲓⲥⲧⲁ
ⲥⲩⲛϩⲟⲇⲟⲥ	N	ⲥⲩⲛϩⲟⲇⲟⲥ
ⲥⲩⲛⲁⲅⲉ	V	ⲥⲩⲛⲁⲅⲉ
ⲥⲩⲛⲁⲅⲱⲅⲏ	N	ⲥⲩⲛⲁⲅⲱⲅⲏ
ⲥⲩⲛⲁⲓⲛⲉⲓ	V	ⲥⲩⲛⲁⲓⲛⲉⲓ
ⲥⲩⲛⲁⲛⲧⲏⲙⲁ	N	ⲥⲩⲛⲁⲛⲧⲏⲙⲁ
ⲥⲩⲛⲁⲝⲓⲥ	N	ⲥⲩⲛⲁⲝⲓⲥ
ⲥⲩⲛⲁⲣⲡⲁⲅⲏ	N	ⲥⲩⲛⲁⲣⲡⲁⲅⲏ
ⲥⲩⲛⲃⲓⲁ	N	ⲥⲩⲛⲃⲓⲁ
ⲥⲩⲛⲃⲟⲏⲑⲉⲓ	V	ⲥⲩⲛⲃⲟⲏⲑⲉⲓ
ⲥⲩⲛⲃⲟⲏⲑⲓⲁ	N	ⲥⲩⲛⲃⲟⲏⲑⲓⲁ
ⲥⲩⲛⲃⲟⲗⲏ	N	ⲥⲩⲛⲃⲟⲗⲏ
ⲥⲩⲛⲅⲛⲱⲙⲏ	N	ⲥⲩⲛⲅⲛⲱⲙⲏ
ⲥⲩⲛⲅⲣⲁⲫⲉⲩⲥ	N	ⲥⲩⲛⲅⲣⲁⲫⲉⲩⲥ
ⲥⲩⲛⲇⲟⲛⲓⲟⲛ	N	ⲥⲩⲛⲇⲟⲛⲓⲟⲛ
ⲥⲩⲛⲉⲓⲇⲏⲥⲓⲥ	N	ⲥⲩⲛⲉⲓⲇⲏⲥⲓⲥ
ⲥⲩⲛⲉⲩⲇⲟⲕⲉⲓ	V	ⲥⲩⲛⲉⲩⲇⲟⲕⲉⲓ
ⲥⲩⲛⲉⲭⲉ	V	ⲥⲩⲛⲉⲭⲉ
ⲥⲩⲛⲍⲏⲧⲉⲓ	V	ⲥⲩⲛⲍⲏⲧⲉⲓ
ⲥⲩⲛⲍⲏⲧⲏⲧⲏⲥ	N	ⲥⲩⲛⲍⲏⲧⲏⲧⲏⲥ
ⲥⲩⲛⲍⲩⲅⲟⲥ	N	ⲥⲩⲛⲍⲩⲅⲟⲥ
ⲥⲩⲛⲏⲇⲏⲥⲓⲥ	N	ⲥⲩⲛⲏⲇⲏⲥⲓⲥ
ⲥⲩⲛⲏⲑⲉⲓⲁ	N	ⲥⲩⲛⲏⲑⲉⲓⲁ
ⲥⲩⲛⲏⲗⲑⲁⲓ	V	ⲥⲩⲛⲏⲗⲑⲁⲓ
ⲥⲩⲛⲑⲉⲥⲓⲥ	N	ⲥⲩⲛⲑⲉⲥⲓⲥ
ⲥⲩⲛⲑⲏⲧⲟⲛ	N	ⲥⲩⲛⲑⲏⲧⲟⲛ
ⲥⲩⲛⲕⲁⲑⲉⲇⲣⲟⲥ	N	ⲥⲩⲛⲕⲁⲑⲉⲇⲣⲟⲥ
ⲥⲩⲛⲕⲗⲏⲣⲟⲛⲟⲙⲟⲥ	N	ⲥⲩⲛⲕⲗⲏⲣⲟⲛⲟⲙⲟⲥ
ⲥⲩⲛⲕⲗⲏⲧⲓⲕⲏ	NPROP	ⲥⲩⲛⲕⲗⲏⲧⲓⲕⲏ
ⲥⲩⲛⲕⲗⲏⲧⲓⲕⲟⲥ	N	ⲥⲩⲛⲕⲗⲏⲧⲓⲕⲟⲥ
ⲥⲩⲛⲕⲗⲏⲧⲟⲥ	N	ⲥⲩⲛⲕⲗⲏⲧⲟⲥ
ⲥⲩⲛⲕⲗⲓϯⲕⲟⲥ	N	ⲥⲩⲛⲕⲗⲓϯⲕⲟⲥ
ⲥⲩⲛⲟⲩⲥⲓⲁ	N	ⲥⲩⲛⲟⲩⲥⲓⲁ
ⲥⲩⲛⲧⲁⲅⲏ	N	ⲥⲩⲛⲧⲁⲅⲏ
ⲥⲩⲛⲧⲁⲅⲙⲁ	N	ⲥⲩⲛⲧⲁⲅⲙⲁ
ⲥⲩⲛⲧⲁⲍⲉ	V	ⲥⲩⲛⲧⲁⲍⲉ
ⲥⲩⲛⲧⲉⲗⲉⲓⲁ	N	ⲥⲩⲛⲧⲉⲗⲉⲓⲁ
ⲥⲩⲛⲧⲉⲗⲓⲁ	N	ⲥⲩⲛⲧⲉⲗⲓⲁ
ⲥⲩⲛⲧⲓⲙⲁⲍⲉ	V	ⲥⲩⲛⲧⲓⲙⲁⲍⲉ
ⲥⲩⲛⲭⲱⲣⲉⲓ	V	ⲥⲩⲛⲭⲱⲣⲉⲓ
ⲥⲩⲛⲭⲱⲣⲏⲥⲓⲥ	N	ⲥⲩⲛⲭⲱⲣⲏⲥⲓⲥ
ⲥⲩⲣⲉ	V	ⲥⲩⲣⲉ
ⲥⲩⲣⲓⲁ	NPROP	ⲥⲩⲣⲓⲁ
ⲥⲩⲥⲧⲁⲥⲓⲥ	N	ⲥⲩⲥⲧⲁⲥⲓⲥ
ⲥⲫⲁⲅⲓⲁ	N	ⲥⲫⲁⲅⲓⲁ
ⲥⲫⲁⲗⲙⲁ	N	ⲥⲫⲁⲗⲙⲁ
ⲥⲫⲉⲛⲇⲟⲛⲏ	N	ⲥⲫⲉⲛⲇⲟⲛⲏ
ⲥⲫⲉⲣⲁ	N	ⲥⲫⲉⲣⲁ
ⲥⲫⲏⲓϯ	V	ⲥⲫⲏⲓϯ
ⲥⲫⲓⲣ	N	ⲥⲫⲓⲣ
ⲥⲫⲗⲁⲅⲛⲟⲛ	N	ⲥⲫⲗⲁⲅⲛⲟⲛ
ⲥⲫⲟⲛⲅⲟⲥ	N	ⲥⲫⲟⲛⲅⲟⲥ
ⲥⲫⲟⲛⲇⲩⲗⲟⲥ	N	ⲥⲫⲟⲛⲇⲩⲗⲟⲥ
ⲥⲫⲟⲧⲟⲩ	N	ⲥⲫⲟⲧⲟⲩ
ⲥⲫⲣⲁⲅⲓⲍⲉ	V	ⲥⲫⲣⲁⲅⲓⲍⲉ
ⲥⲫⲣⲁⲅⲓⲥ	N	ⲥⲫⲣⲁⲅⲓⲥ
ⲥⲫⲣⲁⲛϣ	N	ⲥⲫⲣⲁⲛϣ
ⲥⲭⲁⲓ	V	ⲥⲭⲁⲓ
ⲥⲭⲉⲇⲟⲛ	ADV	ⲥⲭⲉⲇⲟⲛ
ⲥⲭⲏⲙⲁ	N	ⲥⲭⲏⲙⲁ
ⲥⲭⲏⲧ	V	ⲥⲭⲁⲓ
ⲥⲭⲓⲙ	N	ⲥⲭⲓⲙ
ⲥⲭⲓⲥⲙⲁ	N	ⲥⲭⲓⲥⲙⲁ
ⲥⲭⲟⲓⲛⲓⲟⲛ	N	ⲥⲭⲟⲓⲛⲓⲟⲛ
ⲥⲭⲟⲓⲛⲟⲥ	N	ⲥⲭⲟⲓⲛⲟⲥ
ⲥⲭⲟⲗⲁⲍⲉ	V	ⲥⲭⲟⲗⲁⲍⲉ
ⲥⲭⲟⲗⲁⲥⲧⲓⲕⲟⲥ	N	ⲥⲭⲟⲗⲁⲥⲧⲓⲕⲟⲥ
ⲥⲱ	V	ⲥⲱ
ⲥⲱϣⲧ	V	ⲥⲱϣⲧ
ⲥⲱϥ	V	ⲥⲱϥ
ⲥⲱϧⲉⲙ	V	ⲥⲱϧⲉⲙ
ⲥⲱϧⲓ	V	ⲥⲱϧⲓ
ⲥⲱϧⲙ	V	ⲥⲱϧⲉⲙ
ⲥⲱϩⲓ	V	ⲥⲱϩⲓ
ⲥⲱϩⲧ	V	ⲥⲱϣⲧ
ⲥⲱϫⲡ	N	ⲥⲱϫⲡ
ⲥⲱϫⲡ	V	ⲥⲱϫⲡ
ⲥⲱϯ	V	ⲥⲱϯ
ⲥⲱⲃ	V	ⲥⲱⲡ
ⲥⲱⲃⲓ	V	ⲥⲱⲃⲓ
ⲥⲱⲇⲓⲟⲛ	N	ⲥⲱⲇⲓⲟⲛ
ⲥⲱⲓ	V	ⲥⲱⲓ
ⲥⲱⲓⲧ	N	ⲥⲱⲓⲧ
ⲥⲱⲕ	N	ⲥⲟⲕ
ⲥⲱⲕ	V	ⲥⲱⲕ
ⲥⲱⲕⲓ	V	ⲥⲱⲕ
ⲥⲱⲗ	V	ⲥⲱⲗ
ⲥⲱⲗϫ	V	ⲥⲱⲗϫ
ⲥⲱⲗⲉⲡ	V	ⲥⲱⲗⲉⲡ
ⲥⲱⲗⲕ	V	ⲥⲱⲗⲕ
ⲥⲱⲙⲁ	N	ⲥⲱⲙⲁ
ⲥⲱⲙⲁⲧⲓⲍⲉ	V	ⲥⲱⲙⲁⲧⲓⲍⲉ
ⲥⲱⲙⲁⲧⲓⲕⲟⲛ	N	ⲥⲱⲙⲁⲧⲓⲕⲟⲛ
ⲥⲱⲙⲁⲧⲓⲕⲟⲥ	N	ⲥⲱⲙⲁⲧⲓⲕⲟⲥ
ⲥⲱⲛϩ	V	ⲥⲱⲛϩ
ⲥⲱⲛⲓ	N	ⲥⲱⲛⲓ
ⲥⲱⲛⲕ	V	ⲥⲱⲛⲕ
ⲥⲱⲛⲧ	N	ⲥⲱⲛⲧ
ⲥⲱⲛⲧ	V	ⲥⲱⲛⲧ
ⲥⲱⲟⲩϩⲓ	N	ⲥⲱⲟⲩϩⲓ
ⲥⲱⲟⲩⲃⲉⲛ	N	ⲥⲱⲟⲩⲃⲉⲛ
ⲥⲱⲟⲩⲛ	N	ⲥⲱⲟⲩⲛ
ⲥⲱⲟⲩⲛ	V	ⲥⲱⲟⲩⲛ
ⲥⲱⲟⲩⲛⲟⲩ	V	ⲥⲱⲟⲩⲛ
ⲥⲱⲟⲩⲧⲉⲛ	V	ⲥⲱⲟⲩⲧⲉⲛ
ⲥⲱⲡ	N	ⲥⲱⲡ
ⲥⲱⲡ	V	ⲥⲱⲡ
ⲥⲱⲡⲓ	N	ⲥⲱⲡⲓ
ⲥⲱⲣ	V	ⲥⲱⲣ
ⲥⲱⲣϩ	V	ⲥⲱⲣϩ
ⲥⲱⲣϫ	N	ⲥⲱⲣϫ
ⲥⲱⲣⲉⲙ	V	ⲥⲱⲣⲉⲙ
ⲥⲱⲥ	V	ⲥⲱⲥ
ⲥⲱⲥⲑⲉⲛⲏⲥ	N	ⲥⲱⲥⲑⲉⲛⲏⲥ
ⲥⲱⲥⲓ	V	ⲥⲱⲥ
ⲥⲱⲧϥ	V	ⲥⲱⲧϥ
ⲥⲱⲧⲉⲙ	V	ⲥⲱⲧⲉⲙ
ⲥⲱⲧⲉⲣ	V	ⲥⲱⲧⲉⲣ
ⲥⲱⲧⲏⲣ	V	ⲥⲱⲧⲉⲣ
ⲥⲱⲧⲏⲣⲓⲁ	N	ⲥⲱⲧⲏⲣⲓⲁ
ⲥⲱⲧⲡ	V	ⲥⲱⲧⲡ
ⲥⲱⲧⲡ	VSTAT	ⲥⲱⲧⲡ
ⲧ	ART	ⲡ
ⲧ	PPERO	ⲁⲛⲟⲕ
ⲧϣⲙⲟ	V	ⲧϣⲙⲟ
ⲧϣⲟⲩⲓⲉ	V	ⲧϣⲟⲩⲓⲟ
ⲧϣⲟⲩⲓⲟ	V	ⲧϣⲟⲩⲓⲟ
ⲧϧⲙⲟ	V	ⲧϧⲙⲟ
ⲧϧⲙⲟⲙ	V	ⲧϧⲙⲟ
ⲧϩⲉⲙⲕⲏⲟⲩⲧ	VSTAT	ⲧϩⲉⲙⲕⲟ
ⲧϩⲉⲙⲕⲟ	V	ⲧϩⲉⲙⲕⲟ
ⲧϩⲉⲙⲙⲟ	V	ⲧϧⲙⲟ
ⲧϩⲉⲙⲙⲟ	V	ⲧⲉⲙϩⲟ
ⲧϩⲉⲙⲥⲉ	V	ⲧϩⲉⲙⲥⲟ
ⲧϩⲉⲙⲥⲏⲟⲩⲧ	VSTAT	ⲧϩⲉⲙⲥⲟ
ⲧϩⲉⲙⲥⲟ	V	ⲧϩⲉⲙⲥⲟ
ⲧϩⲟ	V	ⲧϩⲟ
ⲧϩⲫⲉ	V	ϫⲫⲟ
ⲧϩⲫⲟ	V	ⲧϩⲫⲟ
ⲧϭⲉ	V	ⲧϭⲟ
ⲧϭⲟ	V	ϭⲟ
ⲧϭⲟ	V	ⲧϭⲟ
ⲧⲁ	PPERS	ⲁⲛⲟⲕ
ⲧⲁ	PPOS	ⲫⲁ
ⲧⲁ	PPOS	ⲡⲁ
ⲧⲁϣⲉ	V	ⲧⲁϣⲟ
ⲧⲁϣⲟ	V	ⲧⲁϣⲟ
ⲧⲁϩⲉ	V	ⲧⲁϩⲟ
ⲧⲁϩⲏⲟⲩⲧ	VSTAT	ⲧⲁϩⲟ
ⲧⲁϩⲛⲟ	V	ⲧⲁϩⲛⲟ
ⲧⲁϩⲟ	V	ⲧⲁϩⲟ
ⲧⲁϩⲧ	N	ⲧⲁϩⲧ
ⲧⲁϫ	N	ⲧⲁϫ
ⲧⲁϫⲣⲉ	V	ⲧⲁϫⲣⲟ
ⲧⲁϫⲣⲏⲟⲩⲧ	VSTAT	ⲧⲁϫⲣⲟ
ⲧⲁϫⲣⲟ	V	ⲧⲁϫⲣⲟ
ⲧⲁⲃⲓⲑⲁ	NPROP	ⲧⲁⲃⲓⲑⲁ
ⲧⲁⲃⲓⲣ	N	ⲧⲁⲃⲓⲣ
ⲧⲁⲃⲧⲉⲃ	V	ⲧⲁⲃⲧⲉⲃ
ⲧⲁⲅⲙⲁ	N	ⲧⲁⲅⲙⲁ
ⲧⲁⲉⲓⲉ	V	ⲧⲁⲉⲓⲟ
ⲧⲁⲉⲓⲟ	N	ⲧⲁⲉⲓⲟ
ⲧⲁⲉⲓⲟ	V	ⲧⲁⲉⲓⲟ
ⲧⲁⲓ	PDEM	ⲡⲁⲓ
ⲧⲁⲓ	PDEM	ⲫⲁⲓ
ⲧⲁⲓⲃⲓ	N	ⲧⲁⲓⲃⲓ
ⲧⲁⲓⲉ	V	ⲧⲁⲉⲓⲟ
ⲧⲁⲓⲏⲟⲩⲧ	VSTAT	ⲧⲁⲉⲓⲟ
ⲧⲁⲓⲟ	N	ⲧⲁⲉⲓⲟ
ⲧⲁⲓⲟ	V	ⲧⲁⲉⲓⲟ
ⲧⲁⲕⲉ	V	ⲧⲁⲕⲟ
ⲧⲁⲕⲏⲟⲩⲧ	VSTAT	ⲧⲁⲕⲟ
ⲧⲁⲕⲟ	V	ⲧⲁⲕⲟ
ⲧⲁⲕⲧⲉ	V	ⲧⲁⲕⲧⲟ
ⲧⲁⲕⲧⲏⲟⲩⲧ	VSTAT	ⲧⲁⲕⲧⲟ
ⲧⲁⲕⲧⲟ	V	ⲧⲁⲕⲧⲟ
ⲧⲁⲗϭⲉ	V	ⲧⲁⲗϭⲟ
ⲧⲁⲗϭⲟ	V	ⲧⲁⲗϭⲟ
ⲧⲁⲗⲁⲓⲡⲟⲣⲉⲓ	V	ⲧⲁⲗⲁⲓⲡⲟⲣⲉⲓ
ⲧⲁⲗⲁⲓⲡⲱⲣⲓⲁ	N	ⲧⲁⲗⲁⲓⲡⲱⲣⲓⲁ
ⲧⲁⲗⲁⲓⲡⲱⲣⲟⲥ	N	ⲧⲁⲗⲁⲓⲡⲱⲣⲟⲥ
ⲧⲁⲗⲉ	V	ⲧⲁⲗⲟ
ⲧⲁⲗⲉⲓⲑⲁ	NPROP	ⲧⲁⲗⲉⲓⲑⲁ
ⲧⲁⲗⲏⲟⲩⲧ	VSTAT	ⲧⲁⲗⲟ
ⲧⲁⲗⲟ	V	ⲧⲁⲗⲟ
ⲧⲁⲙⲉ	V	ⲧⲁⲙⲟ
ⲧⲁⲙⲉⲓⲟⲛ	N	ⲧⲁⲙⲉⲓⲟⲛ
ⲧⲁⲙⲓⲉⲓⲟⲛ	N	ⲧⲁⲙⲓⲉⲓⲟⲛ
ⲧⲁⲙⲓⲟⲛ	N	ⲧⲁⲙⲉⲓⲟⲛ
ⲧⲁⲙⲟ	V	ⲧⲁⲙⲟ
ⲧⲁⲛϣⲉ	V	ⲧⲁϣⲟ
ⲧⲁⲛϣⲟ	V	ⲧⲁϣⲟ
ⲧⲁⲛϧⲉ	V	ⲧⲁⲛϧⲟ
ⲧⲁⲛϧⲟ	V	ⲧⲁⲛϧⲟ
ⲧⲁⲛⲓⲥⲧⲏⲥ	N	ⲧⲁⲛⲓⲥⲧⲏⲥ
ⲧⲁⲝⲓⲥ	N	ⲧⲁⲝⲓⲥ
ⲧⲁⲟⲩⲉ	V	ⲧⲁⲟⲩⲉ
ⲧⲁⲟⲩⲏⲟⲩⲧ	VSTAT	ⲧⲁⲟⲩⲉ
ⲧⲁⲟⲩⲟ	V	ⲧⲁⲟⲩⲉ
ⲧⲁⲡ	N	ⲧⲁⲡ
ⲧⲁⲡⲣⲟ	N	ⲧⲁⲡⲣⲟ
ⲧⲁⲣ	N	ⲧⲁⲣ
ⲧⲁⲣϣⲏⲟⲩⲧ	VSTAT	ⲧⲁⲣϣⲟ
ⲧⲁⲣϣⲟ	V	ⲧⲁⲣϣⲟ
ⲧⲁⲣⲁϩ	N	ⲧⲁⲣⲁϩ
ⲧⲁⲣⲁⲥⲥⲉ	V	ⲧⲁⲣⲁⲥⲥⲉ
ⲧⲁⲣⲁⲭⲏ	N	ⲧⲁⲣⲁⲭⲏ
ⲧⲁⲣⲁⲭⲟⲥ	N	ⲧⲁⲣⲁⲭⲟⲥ
ⲧⲁⲣⲓⲭⲓⲟⲛ	N	ⲧⲁⲣⲓⲭⲓⲟⲛ
ⲧⲁⲣⲕⲉ	V	ⲧⲁⲣⲕⲟ
ⲧⲁⲣⲕⲟ	V	ⲧⲁⲣⲕⲟ
ⲧⲁⲣⲙⲟⲥ	N	ⲧⲁⲣⲙⲟⲥ
ⲧⲁⲣⲧⲁⲣⲟⲛ	N	ⲧⲁⲣⲧⲁⲣⲟⲛ
ⲧⲁⲣⲧⲁⲣⲟⲥ	N	ⲧⲁⲣⲧⲁⲣⲟⲥ
ⲧⲁⲣⲧⲁⲣⲟⲥ	NPROP	ⲧⲁⲣⲧⲁⲣⲟⲥ
ⲧⲁⲥⲑⲉ	V	ⲧⲁⲥⲑⲟ
ⲧⲁⲥⲑⲏⲟⲩⲧ	VSTAT	ⲧⲁⲥⲑⲟ
ⲧⲁⲥⲑⲟ	V	ⲧⲁⲥⲑⲟ
ⲧⲁⲥⲥⲉ	V	ⲧⲁⲥⲥⲉ
ⲧⲁⲧ	V	ⲑⲱⲧ
ⲧⲁⲧϩ	N	ⲧⲁϩⲧ
ⲧⲁⲧϩⲏⲟⲩⲧ	VSTAT	ⲧⲁⲧϩⲟ
ⲧⲁⲧϩⲟ	V	ⲧⲁⲧϩⲟ
ⲧⲁⲧⲥⲓ	N	ⲧⲁⲧⲥⲓ
ⲧⲁⲩⲣⲟⲥ	N	ⲧⲁⲩⲣⲟⲥ
ⲧⲁⲫⲟⲥ	N	ⲧⲁⲫⲟⲥ
ⲧⲁⲭⲁ	ADV	ⲧⲁⲭⲁ
ⲧⲁⲭⲏ	ADV	ⲧⲁⲭⲏ
ⲧⲁⲭⲏ	N	ⲧⲁⲭⲏ
ⲧⲁⲭⲩ	ADV	ⲧⲁⲭⲩ
ⲧⲁⲭⲩ	N	ⲧⲁⲭⲩ
ⲧⲃⲛⲱⲟⲩⲓ	N	ⲧⲉⲃⲛⲏ
ⲧⲉ	ART	ⲡ
ⲧⲉ	COP	ⲡⲉ
ⲧⲉ	PPERS	ⲛⲑⲟ
ⲧⲉ	PPOS	ⲡⲉ
ⲧⲉϥ	PPOS	ⲡⲉϥ
ⲧⲉϩⲛⲓ	N	ⲧⲉϩⲛⲓ
ⲧⲉⲃ	V	ⲧⲱⲃ
ⲧⲉⲃⲓ	N	ⲧⲉⲃⲓ
ⲧⲉⲃⲛⲏ	N	ⲧⲉⲃⲛⲏ
ⲧⲉⲃⲧ	N	ⲧⲉⲃⲧ
ⲧⲉⲕ	PPOS	ⲡⲉⲕ
ⲧⲉⲕⲁⲧⲏⲥ	N	ⲧⲉⲕⲁⲧⲏⲥ
ⲧⲉⲕⲥ	V	ⲧⲱⲧⲥ
ⲧⲉⲗϥⲓ	N	ⲧⲉⲗϥⲓ
ⲧⲉⲗⲉⲓⲁ	N	ⲧⲉⲗⲉⲓⲁ
ⲧⲉⲗⲉⲓⲟⲛ	N	ⲧⲉⲗⲉⲓⲟⲛ
ⲧⲉⲗⲉⲓⲟⲥ	N	ⲧⲉⲗⲉⲓⲟⲥ
ⲧⲉⲗⲉⲱⲥ	ADV	ⲧⲉⲗⲉⲱⲥ
ⲧⲉⲗⲓ	N	ⲧⲓⲗⲓ
ⲧⲉⲗⲟⲥ	N	ⲧⲉⲗⲟⲥ
ⲧⲉⲗⲧⲉⲗ	V	ⲧⲉⲗⲧⲉⲗ
ⲧⲉⲗⲱⲛⲏⲥ	N	ⲧⲉⲗⲱⲛⲏⲥ
ⲧⲉⲗⲱⲛⲓⲟⲛ	N	ⲧⲉⲗⲱⲛⲓⲟⲛ
ⲧⲉⲙ	V	ⲧⲱⲙⲓ
ⲧⲉⲙϩⲟ	V	ⲧⲉⲙϩⲟ
ⲧⲉⲙⲑⲁⲙ	N	ⲧⲉⲙⲑⲁⲙ
ⲧⲉⲙⲑⲱⲙ	VSTAT	ⲑⲟⲙⲧⲉⲙ
ⲧⲉⲙⲙϩⲟ	V	ⲧⲉⲙϩⲟ
ⲧⲉⲙⲙⲟ	V	ⲧⲉⲙϩⲟ
ⲧⲉⲙⲙⲟ	V	ⲧⲉⲙⲙⲟ
ⲧⲉⲙⲙⲟ	V	ⲧⲉⲛⲛⲟ
ⲧⲉⲙⲟ	V	ⲧⲉⲙⲙⲟ
ⲧⲉⲛ	PPERS	ⲛⲑⲱⲧⲉⲛ
ⲧⲉⲛ	PPERS	ⲁⲛⲟⲛ
ⲧⲉⲛ	PPERO	ⲛⲑⲱⲧⲉⲛ
ⲧⲉⲛ	PPOS	ⲡⲉⲛ
ⲧⲉⲛ	V	ⲧⲱⲟⲩⲛ
ⲧⲉⲛϩ	N	ⲧⲉⲛϩ
ⲧⲉⲛϩⲉⲧ	V	ⲧⲉⲛϩⲟⲩⲧ
ⲧⲉⲛϩⲏⲟⲩⲧ	VSTAT	ⲧⲉⲛϩⲟⲩⲧ
ⲧⲉⲛϩⲟⲩⲧ	V	ⲧⲉⲛϩⲟⲩⲧ
ⲧⲉⲛⲉ	PPERS	ⲛⲑⲱⲧⲉⲛ
ⲧⲉⲛⲑⲱⲛ	V	ⲑⲟⲛⲧⲉⲛ
ⲧⲉⲛⲑⲱⲛ	VSTAT	ⲑⲟⲛⲧⲉⲛ
ⲧⲉⲛⲑⲱⲛⲧ	VSTAT	ⲑⲟⲛⲧⲉⲛ
ⲧⲉⲛⲛⲏⲟⲩⲧ	VSTAT	ⲧⲉⲛⲛⲟ
ⲧⲉⲛⲛⲟ	V	ⲧⲉⲛⲛⲟ
ⲧⲉⲡⲉ	N	ⲧⲉⲃⲓ
ⲧⲉⲡⲓ	N	ⲧⲉⲃⲓ
ⲧⲉⲣ	V	ⲧⲉⲣ
ⲧⲉⲣⲉⲃⲓⲛⲑⲟⲥ	N	ⲧⲉⲣⲉⲃⲓⲛⲑⲟⲥ
ⲧⲉⲣⲧⲱⲣ	V	ⲧⲟⲣⲧⲉⲣ
ⲧⲉⲣⲯⲓⲥ	N	ⲧⲉⲣⲯⲓⲥ
ⲧⲉⲥ	PPOS	ⲡⲉⲥ
ⲧⲉⲥ	VSTAT	ⲧⲱⲥ
ⲧⲉⲥⲉⲣⲁⲕⲟⲥⲧⲉ	N	ⲧⲉⲥⲉⲣⲁⲕⲟⲥⲧⲉ
ⲧⲉⲥⲥⲁⲣⲉⲥⲕⲁⲓⲇⲉⲕⲁⲧⲏ	N	ⲧⲉⲥⲥⲁⲣⲉⲥⲕⲁⲓⲇⲉⲕⲁⲧⲏ
ⲧⲉⲧⲁⲣⲧⲏⲥ	N	ⲧⲉⲧⲁⲣⲧⲏⲥ
ⲧⲉⲧⲁⲣⲧⲟⲛ	N	ⲧⲉⲧⲁⲣⲧⲟⲛ
ⲧⲉⲧⲉⲛ	PPERS	ⲛⲑⲱⲧⲉⲛ
ⲧⲉⲧⲉⲛ	PPOS	ⲡⲉⲧⲉⲛ
ⲛⲉⲧⲉⲛ	PPOS	ⲡⲉⲧⲉⲛ
ⲧⲉⲧⲣⲁⲅⲱⲛⲟⲛ	N	ⲧⲉⲧⲣⲁⲅⲱⲛⲟⲛ
ⲧⲉⲧⲣⲁⲡⲩⲗⲱⲛ	N	ⲧⲉⲧⲣⲁⲡⲩⲗⲱⲛ
ⲧⲉⲧⲣⲁⲣⲭⲏⲥ	N	ⲧⲉⲧⲣⲁⲣⲭⲏⲥ
ⲧⲉⲧⲣⲁⲥ	N	ⲧⲉⲧⲣⲁⲥ
ⲧⲉⲩⲧⲉⲣⲟⲛⲟⲙⲓⲟⲛ	N	ⲧⲉⲩⲧⲉⲣⲟⲛⲟⲙⲓⲟⲛ
ⲧⲉⲭⲛⲉ	N	ⲧⲉⲭⲛⲉ
ⲧⲉⲭⲛⲏ	N	ⲧⲉⲭⲛⲏ
ⲧⲉⲭⲛⲓⲧⲏⲥ	N	ⲧⲉⲭⲛⲓⲧⲏⲥ
ⲧⲉⲱⲥ	ADV	ⲧⲉⲱⲥ
ⲧⲏ	ADV	ⲧⲏ
ⲧⲏⲃ	N	ⲧⲏⲃ
ⲧⲏⲃ	VSTAT	ⲧⲱⲃ
ⲧⲏⲓ	V	ϯ
ⲧⲏⲓ	V	ⲧⲏⲓ
ⲧⲏⲓⲧ	V	ϯ
ⲧⲏⲙ	VSTAT	ⲧⲏⲙ
ⲧⲏⲙⲟⲥ	N	ⲧⲏⲙⲟⲥ
ⲧⲏⲛⲟⲗⲟⲧⲓⲛ	FM	ⲧⲏⲛⲟⲗⲟⲧⲓⲛ
ⲧⲏⲡ	VSTAT	ⲧⲱⲃ
ⲧⲏⲣ	IMOD	ⲧⲏⲣ
ⲧⲏⲣϥ	N	ⲧⲏⲣϥ
ⲧⲏⲣⲉⲓ	V	ⲧⲏⲣⲉⲓ
ⲧⲏⲣⲓ	V	ⲧⲏⲣⲓ
ⲧⲏⲥ	VSTAT	ⲧⲱⲥ
ⲧⲓⲗⲓ	N	ⲧⲓⲗⲓ
ⲧⲓⲙⲁ	V	ⲧⲓⲙⲁ
ⲧⲓⲙⲁⲓⲟⲥ	NPROP	ⲧⲓⲙⲁⲓⲟⲥ
ⲧⲓⲙⲏ	N	ⲧⲓⲙⲏ
ⲧⲓⲙⲓ	N	ϯⲙⲓ
ⲧⲓⲙⲓⲱⲧⲁⲧⲟⲥ	N	ⲧⲓⲙⲓⲱⲧⲁⲧⲟⲥ
ⲧⲓⲙⲓⲱⲧⲏⲥ	N	ⲧⲓⲙⲓⲱⲧⲏⲥ
ⲧⲓⲙⲟⲑⲉⲟⲥ	NPROP	ⲧⲓⲙⲟⲑⲉⲟⲥ
ⲧⲓⲙⲱⲣⲉⲓ	V	ⲧⲓⲙⲱⲣⲉⲓ
ⲧⲓⲙⲱⲣⲓⲁ	N	ⲧⲓⲙⲱⲣⲓⲁ
ⲧⲓⲣⲱⲛ	N	ⲧⲓⲣⲱⲛ
ⲧⲓⲧⲗⲟⲥ	N	ⲧⲓⲧⲗⲟⲥ
ⲧⲕⲁⲥ	N	ⲧⲕⲁⲥ
ⲧⲙϩⲉ	V	ⲧⲉⲙϩⲟ
ⲧⲙⲟ	V	ⲧⲉⲙϩⲟ
ⲧⲟϩ	N	ⲧⲟϩ
ⲧⲟϫ	V	ⲧⲱϫⲓ
ⲧⲟϫⲓ	V	ⲑⲱⲕ
ⲧⲟϯ	N	ⲟϯ
ⲧⲟⲃ	N	ⲧⲟⲃ
ⲧⲟⲃ	V	ⲧⲱⲃ
ⲧⲟⲃ	VSTAT	ⲧⲱⲃ
ⲧⲟⲃϩ	V	ⲧⲱⲃϩ
ⲧⲟⲓ	N	ⲧⲟⲓ
ⲧⲟⲓ	VSTAT	ϯ
ⲧⲟⲕⲙⲁⲇⲓⲕⲟⲥ	N	ⲧⲟⲕⲙⲁⲇⲓⲕⲟⲥ
ⲧⲟⲕⲙⲁⲧⲓⲕⲟⲛ	N	ⲧⲟⲕⲙⲁⲧⲓⲕⲟⲛ
ⲧⲟⲕⲝⲟⲧⲟⲥ	N	ⲧⲟⲕⲝⲟⲧⲟⲥ
ⲧⲟⲕⲥ	VSTAT	ⲧⲱⲧⲥ
ⲧⲟⲗⲉⲙⲟⲛ	N	ⲧⲟⲗⲉⲙⲟⲛ
ⲧⲟⲗⲙⲁ	V	ⲧⲟⲗⲙⲁ
ⲧⲟⲗⲙⲉⲥⲓⲁ	N	ⲧⲟⲗⲙⲉⲥⲓⲁ
ⲧⲟⲗⲙⲏⲣⲓⲁ	N	ⲧⲟⲗⲙⲏⲣⲓⲁ
ⲧⲟⲗⲙⲏⲣⲟⲥ	N	ⲧⲟⲗⲙⲏⲣⲟⲥ
ⲧⲟⲗⲟⲓⲡⲟⲛ	N	ⲧⲟⲗⲟⲓⲡⲟⲛ
ⲧⲟⲗⲟⲙⲁ	V	ⲧⲟⲗⲟⲙⲁ
ⲧⲟⲙ	V	ⲧⲱⲙⲓ
ⲧⲟⲙⲁⲣⲓⲟⲛ	N	ⲧⲟⲙⲁⲣⲓⲟⲛ
ⲧⲟⲙⲉⲥⲧⲓⲕⲟⲥ	N	ⲧⲟⲙⲉⲥⲧⲓⲕⲟⲥ
ⲧⲟⲙⲓ	VSTAT	ⲧⲱⲙⲓ
ⲧⲟⲙⲟⲥ	N	ⲧⲟⲙⲟⲥ
ⲧⲟⲙⲧ	VSTAT	ⲧⲱⲙⲧ
ⲧⲟⲙⲧⲉⲙ	V	ⲑⲟⲙⲧⲉⲙ
ⲧⲟⲛϣ	V	ⲧⲟⲛϣ
ⲧⲟⲛⲁ	ADV	ⲧⲱⲛⲟⲩ
ⲧⲟⲛⲟⲩ	ADV	ⲧⲱⲛⲟⲩ
ⲧⲟⲛⲱ	ADV	ⲧⲱⲛⲟⲩ
ⲧⲟⲛⲱ	V	ⲧⲟⲛⲱ
ⲧⲟⲛⲱⲟⲩ	ADV	ⲧⲱⲛⲟⲩ
ⲧⲟⲟⲩⲓ	N	ⲧⲟⲟⲩⲓ
ⲧⲟⲡ	V	ⲧⲟⲡ
ⲧⲟⲡ	V	ⲧⲱⲃ
ⲧⲟⲡ	VSTAT	ⲧⲱⲃ
ⲧⲟⲡⲁⲇⲓⲟⲛ	N	ⲧⲟⲡⲁⲇⲓⲟⲛ
ⲧⲟⲡⲟⲡⲓⲟⲥ	N	ⲧⲟⲡⲟⲡⲓⲟⲥ
ⲧⲟⲡⲟⲥ	N	ⲧⲟⲡⲟⲥ
ⲧⲟⲣⲧⲉⲣ	V	ⲧⲟⲣⲧⲉⲣ
ⲧⲟⲥ	V	ⲧⲱⲥ
ⲧⲟⲧ	N	ⲧⲱⲣⲓ
ⲧⲟⲧⲉ	ADV	ⲧⲟⲧⲉ
ⲧⲟⲧⲥ	VSTAT	ⲧⲱⲧⲥ
ⲧⲟⲩϩⲉ	V	ⲧⲟⲩϩⲟ
ⲧⲟⲩϩⲟ	V	ⲧⲟⲩϩⲟ
ⲧⲟⲩϫⲉ	V	ⲧⲟⲩϫⲟ
ⲧⲟⲩϫⲏⲟⲩⲧ	VSTAT	ⲧⲟⲩϫⲟ
ⲧⲟⲩϫⲟ	V	ⲧⲟⲩϫⲟ
ⲧⲟⲩⲃⲉ	V	ⲧⲟⲩⲃⲟ
ⲧⲟⲩⲃⲏⲟⲩⲧ	VSTAT	ⲧⲟⲩⲃⲟ
ⲧⲟⲩⲃⲟ	N	ⲧⲟⲩⲃⲟ
ⲧⲟⲩⲃⲟ	V	ⲧⲟⲩⲃⲟ
ⲧⲟⲩⲓⲉ	V	ⲧⲟⲩⲓⲟ
ⲧⲟⲩⲓⲟ	V	ⲧⲟⲩⲓⲟ
ⲧⲟⲩⲗⲟ	V	ⲑⲟⲩⲉⲗⲟ
ⲧⲟⲩⲛ	V	ⲧⲟⲩⲛ
ⲧⲟⲩⲛⲉⲥ	V	ⲧⲟⲩⲛⲟⲥ
ⲧⲟⲩⲛⲟⲥ	V	ⲧⲟⲩⲛⲟⲥ
ⲧⲣⲁⲡⲉⲍⲁ	N	ⲧⲣⲁⲡⲉⲍⲁ
ⲧⲣⲓⲁⲥ	N	ⲧⲣⲓⲁⲥ
ⲧⲣⲓⲃⲏ	N	ⲧⲣⲓⲃⲏ
ⲧⲣⲓⲃⲟⲗⲗⲟⲥ	N	ⲧⲣⲓⲃⲟⲗⲗⲟⲥ
ⲧⲣⲓⲃⲟⲩⲛⲟⲥ	N	ⲧⲣⲓⲃⲟⲩⲛⲟⲥ
ⲧⲣⲓⲅⲉⲛⲉⲑⲗⲟⲥ	N	ⲧⲣⲓⲅⲉⲛⲉⲑⲗⲟⲥ
ⲧⲣⲓⲅⲉⲛⲏⲥ	N	ⲧⲣⲓⲅⲉⲛⲏⲥ
ⲧⲣⲓⲇⲩⲛⲁⲙⲓⲥ	N	ⲧⲣⲓⲇⲩⲛⲁⲙⲓⲥ
ⲧⲣⲓⲇⲩⲛⲁⲙⲟⲥ	N	ⲧⲣⲓⲇⲩⲛⲁⲙⲟⲥ
ⲧⲣⲓⲕⲟⲛ	N	ⲧⲣⲓⲕⲟⲛ
ⲧⲣⲓⲙ	N	ⲧⲣⲓⲙ
ⲧⲣⲓⲙⲏⲥⲓⲟⲛ	N	ⲧⲣⲓⲙⲏⲥⲓⲟⲛ
ⲧⲣⲓⲡⲟⲥ	N	ⲧⲣⲓⲡⲟⲥ
ⲧⲣⲓⲥϩⲁⲅⲓⲉ	N	ⲧⲣⲓⲥϩⲁⲅⲓⲉ
ⲧⲣⲓⲥⲁⲣⲥⲏⲥ	N	ⲧⲣⲓⲥⲁⲣⲥⲏⲥ
ⲧⲣⲓⲥⲙⲁⲕⲁⲣⲓⲟⲥ	N	ⲧⲣⲓⲥⲙⲁⲕⲁⲣⲓⲟⲥ
ⲧⲣⲓⲥⲙⲉⲅⲓⲥⲧⲉ	N	ⲧⲣⲓⲥⲙⲉⲅⲓⲥⲧⲉ
ⲧⲣⲓⲥⲙⲉⲅⲓⲥⲧⲟⲥ	N	ⲧⲣⲓⲥⲙⲉⲅⲓⲥⲧⲟⲥ
ⲧⲣⲓⲧⲏⲥ	N	ⲧⲣⲓⲧⲏⲥ
ⲧⲣⲓⲧⲟⲛ	N	ⲧⲣⲓⲧⲟⲛ
ⲧⲣⲟⲡⲉⲟⲛ	N	ⲧⲣⲟⲡⲉⲟⲛ
ⲧⲣⲟⲡⲟⲥ	N	ⲧⲣⲟⲡⲟⲥ
ⲧⲣⲟⲫⲏ	N	ⲧⲣⲟⲫⲏ
ⲧⲣⲟⲭⲟⲥ	N	ⲧⲣⲟⲭⲟⲥ
ⲧⲣⲩⲫⲁ	V	ⲧⲣⲩⲫⲁ
ⲧⲣⲩⲫⲏ	N	ⲧⲣⲩⲫⲏ
ⲧⲣⲩⲫⲩⲣⲓⲟⲛ	N	ⲧⲣⲩⲫⲩⲣⲓⲟⲛ
ⲧⲥⲁⲃⲉ	V	ⲧⲥⲁⲃⲟ
ⲧⲥⲁⲃⲏⲟⲩⲧ	VSTAT	ⲧⲥⲁⲃⲟ
ⲧⲥⲁⲃⲟ	V	ⲧⲥⲁⲃⲟ
ⲧⲥⲉ	V	ⲧⲥⲟ
ⲧⲥⲏⲟⲩⲧ	VSTAT	ⲧⲥⲓⲟ
ⲧⲥⲓⲟ	V	ⲧⲥⲓⲟ
ⲧⲥⲟ	V	ⲧⲥⲟ
ⲧⲩⲡⲟⲥ	N	ⲧⲩⲡⲟⲥ
ⲧⲩⲡⲟⲩ	V	ⲧⲩⲡⲟⲩ
ⲧⲩⲣⲁⲛⲛⲟⲥ	N	ⲧⲩⲣⲁⲛⲛⲟⲥ
ⲧⲩⲣⲟⲥ	NPROP	ⲧⲩⲣⲟⲥ
ⲧⲩⲫⲱⲛ	N	ⲧⲩⲫⲱⲛ
ⲧⲩⲭⲏ	N	ⲧⲩⲭⲏ
ⲧⲫⲉ	V	ⲧϩⲫⲟ
ⲧⲫⲉⲣⲓⲟ	V	ⲧⲫⲉⲣⲓⲟ
ⲧⲫⲟ	V	ⲧϩⲫⲟ
ⲧⲱϧ	V	ⲧⲱϧ
ⲧⲱϫⲓ	V	ⲧⲱϫⲓ
ⲧⲱⲃ	V	ⲧⲱⲃ
ⲧⲱⲃϩ	V	ⲧⲱⲃϩ
ⲧⲱⲃⲓ	N	ⲧⲁⲓⲃⲓ
ⲧⲱⲃⲓ	N	ⲧⲱⲃⲓ
ⲧⲱⲃⲓⲁⲥ	NPROP	ⲧⲱⲃⲓⲁⲥ
ⲧⲱⲇⲓⲕⲁⲓⲧⲏⲥ	N	ⲧⲱⲇⲓⲕⲁⲓⲧⲏⲥ
ⲧⲱⲓ	N	ⲧⲟⲓ
ⲧⲱⲓⲥ	N	ⲧⲱⲓⲥ
ⲧⲱⲓⲥⲓ	N	ⲧⲱⲓⲥ
ⲧⲱⲓⲧ	V	ⲧⲱⲓⲧ
ⲧⲱⲕⲓⲙⲁⲥⲓⲁ	N	ⲧⲱⲕⲓⲙⲁⲥⲓⲁ
ⲧⲱⲙⲓ	V	ⲧⲱⲙⲓ
ⲧⲱⲙⲧ	V	ⲧⲱⲙⲧ
ⲧⲱⲛ	PINT	ⲧⲱⲛ
ⲧⲱⲛ	V	ⲧⲱⲟⲩⲛ
ⲧⲱⲛⲁ	ADV	ⲧⲱⲛⲟⲩ
ⲧⲱⲛⲟ	ADV	ⲧⲱⲛⲟⲩ
ⲧⲱⲛⲟⲩ	ADV	ⲧⲱⲛⲟⲩ
ⲧⲱⲟⲩ	N	ⲧⲱⲟⲩ
ⲧⲱⲟⲩⲛ	V	ⲧⲱⲟⲩⲛ
ⲧⲱⲟⲩⲛⲟⲩ	V	ⲧⲱⲟⲩⲛ
ⲧⲱⲡ	V	ⲧⲱⲃ
ⲧⲱⲣⲓ	N	ⲧⲱⲣⲓ
ⲧⲱⲣⲡ	V	ⲧⲱⲣⲡ
ⲧⲱⲥ	V	ⲧⲱⲥ
ⲧⲱⲧⲥ	V	ⲧⲱⲧⲥ
ⲩ	ART	ⲟⲩ
ⲩ	PPERO	ⲛⲑⲱⲟⲩ
ⲩ	PPERS	ⲛⲑⲱⲟⲩ
ⲩⲃⲣⲓⲥ	N	ⲩⲃⲣⲓⲥ
ⲩⲓⲟⲥ	N	ⲩⲓⲟⲥ
ⲩⲡⲟⲭⲟⲛⲇⲣⲓⲟⲥ	N	ⲩⲡⲟⲭⲟⲛⲇⲣⲓⲟⲥ
ⲫ	ART	ⲡ
ⲫⲁ	PPOS	ⲡⲁ
ⲫⲁ	PPOS	ⲫⲁ
ⲫⲁϣ	N	ⲫⲁϣ
ⲫⲁϣ	V	ⲫⲱϣ
ⲫⲁϣⲙ	V	ⲫⲁϣⲙ
ⲫⲁϧ	V	ⲫⲱϧ
ⲫⲁϧⲉⲣ	VSTAT	ⲫⲁϧⲉⲣ
ⲫⲁϧⲣⲓ	N	ⲫⲁϧⲣⲓ
ⲫⲁϧⲧ	V	ⲫⲱϧⲧ
ⲫⲁϧⲧ	VSTAT	ⲫⲱϧⲧ
ⲫⲁϩⲟⲩ	N	ⲫⲁϩⲟⲩ
ⲫⲁⲓ	PDEM	ⲡⲁⲓ
ⲫⲁⲓ	PDEM	ⲫⲁⲓ
ⲫⲁⲓϣⲓ	N	ⲫⲁⲓϣⲓ
ⲫⲁⲕⲓⲁⲣⲓⲟⲛ	N	ⲫⲁⲕⲓⲁⲣⲓⲟⲛ
ⲫⲁⲙⲉⲛⲱⲑ	N	ⲫⲁⲙⲉⲛⲱⲑ
ⲫⲁⲛⲉⲣⲓⲟⲥ	N	ⲫⲁⲛⲉⲣⲓⲟⲥ
ⲫⲁⲛⲉⲣⲟⲛ	ADV	ⲫⲁⲛⲉⲣⲟⲛ
ⲫⲁⲛⲉⲣⲟⲩ	V	ⲫⲁⲛⲉⲣⲟⲩ
ⲫⲁⲛⲉⲣⲱⲥⲓⲥ	N	ⲫⲁⲛⲉⲣⲱⲥⲓⲥ
ⲫⲁⲛⲓⲁ	N	ⲫⲁⲛⲓⲁ
ⲫⲁⲛⲟⲥ	N	ⲫⲁⲛⲟⲥ
ⲫⲁⲛⲟⲩⲏⲗ	NPROP	ⲫⲁⲛⲟⲩⲏⲗ
ⲫⲁⲛⲧⲁⲥⲓⲁ	N	ⲫⲁⲛⲧⲁⲥⲓⲁ
ⲫⲁⲛⲧⲁⲥⲙⲁ	N	ⲫⲁⲛⲧⲁⲥⲙⲁ
ⲫⲁⲡⲉ	V	ⲫⲁⲡⲉ
ⲫⲁⲣⲁⲅⲝ	N	ⲫⲁⲣⲁⲅⲝ
ⲫⲁⲣⲁⲱ	NPROP	ⲫⲁⲣⲁⲱ
ⲫⲁⲣⲉⲥ	NPROP	ⲫⲁⲣⲉⲥ
ⲫⲁⲣⲓⲥⲁⲓⲟⲥ	N	ⲫⲁⲣⲓⲥⲁⲓⲟⲥ
ⲫⲁⲣⲓⲥⲉⲟⲥ	N	ⲫⲁⲣⲓⲥⲁⲓⲟⲥ
ⲫⲁⲣⲓⲥⲥⲁⲓⲟⲥ	N	ⲫⲁⲣⲓⲥⲥⲁⲓⲟⲥ
ⲫⲁⲣⲓⲥⲥⲁⲓⲟⲥ	NPROP	ⲫⲁⲣⲓⲥⲥⲁⲓⲟⲥ
ⲫⲁⲣⲙⲁⲅⲟⲛ	N	ⲫⲁⲣⲙⲁⲅⲟⲛ
ⲫⲁⲣⲙⲁⲅⲟⲥ	N	ⲫⲁⲣⲙⲁⲅⲟⲥ
ⲫⲁⲣⲙⲁⲕⲓⲁ	N	ⲫⲁⲣⲙⲁⲕⲓⲁ
ⲫⲁⲣⲙⲟⲩⲑⲓ	N	ⲫⲁⲣⲙⲟⲩⲑⲓ
ⲫⲁⲣⲣⲓⲥⲁⲓⲟⲥ	N	ⲫⲁⲣⲣⲓⲥⲁⲓⲟⲥ
ⲫⲁⲥ	V	ⲫⲓⲥⲓ
ⲫⲁⲥ	VSTAT	ⲫⲓⲥⲓ
ⲫⲁⲥⲅⲓⲁ	N	ⲫⲁⲥⲅⲓⲁ
ⲫⲁⲥⲓⲥ	N	ⲫⲁⲥⲓⲥ
ⲫⲁⲥⲫⲉⲥ	N	ⲫⲁⲥⲫⲉⲥ
ⲫⲁⲧ	N	ⲫⲁⲧ
ⲫⲁⲩⲗⲟⲥ	N	ⲫⲁⲩⲗⲟⲥ
ⲫⲉ	N	ⲫⲉ
ⲫⲉϣ	V	ⲫⲱϣ
ⲫⲉϧ	N	ⲫⲉϧ
ⲫⲉϧ	V	ⲫⲱϧ
ⲫⲉϩ	V	ⲫⲟϩ
ⲫⲉϩ	VSTAT	ⲫⲟϩ
ⲫⲉⲅⲅⲟⲕⲁⲧⲟⲭⲟⲥ	N	ⲫⲉⲅⲅⲟⲕⲁⲧⲟⲭⲟⲥ
ⲫⲉⲓ	N	ⲫⲉⲓ
ⲫⲉⲗ	N	ⲫⲉⲗ
ⲫⲉⲗϫⲓ	N	ⲫⲉⲗϫⲓ
ⲫⲉⲙⲁⲛⲁⲣⲓⲟⲛ	N	ⲫⲉⲙⲁⲛⲁⲣⲓⲟⲛ
ⲫⲉⲛ	V	ⲫⲱⲛ
ⲫⲉⲛϩ	V	ⲫⲱⲛϩ
ⲫⲉⲛϫ	V	ⲫⲱⲛϫ
ⲫⲉⲛⲉⲥⲑⲁⲓ	V	ⲫⲉⲛⲉⲥⲑⲁⲓ
ⲫⲉⲛⲕ	V	ⲫⲱⲛⲕ
ⲫⲉⲛⲫⲱⲛ	VSTAT	ⲫⲟⲛⲡⲉⲛ
ⲫⲉⲣ	V	ⲫⲓⲣⲓ
ⲫⲉⲣ	V	ⲫⲱⲣ
ⲫⲉⲣϣ	V	ⲫⲱⲣϣ
ⲫⲉⲣϫ	V	ⲫⲱⲣϫ
ⲫⲉⲣⲉⲍⲁⲓⲟⲥ	N	ⲫⲉⲣⲉⲍⲁⲓⲟⲥ
ⲫⲉⲣⲉⲍⲁⲓⲟⲥ	NPROP	ⲫⲉⲣⲉⲍⲁⲓⲟⲥ
ⲫⲉⲣⲓⲱⲟⲩ	VSTAT	ⲫⲓⲣⲓ
ⲫⲉⲣⲓⲱⲟⲩⲧ	VSTAT	ⲫⲓⲣⲓ
ⲫⲉⲣⲕ	V	ⲫⲱⲣⲕ
ⲫⲉⲣⲕ	VSTAT	ⲫⲱⲣⲕ
ⲫⲉⲣⲫⲱⲣ	V	ⲫⲟⲣⲡⲉⲣ
ⲫⲉⲣⲫⲱⲣ	VSTAT	ⲫⲟⲣⲡⲉⲣ
ⲫⲉⲥ	V	ⲫⲓⲥⲓ
ⲫⲉⲥⲏⲥ	N	ⲫⲉⲥⲏⲥ
ⲫⲉⲧⲫⲱⲧ	V	ⲫⲟⲧⲫⲉⲧ
ⲫⲉⲧⲫⲱⲧ	VSTAT	ⲫⲟⲧⲫⲉⲧ
ⲫⲏ	PDEM	ⲫⲏ
ⲫⲏϣ	VSTAT	ⲫⲱϣ
ⲫⲏϧ	VSTAT	ⲫⲱϧ
ⲫⲏⲓ	N	ⲫⲉⲓ
ⲫⲏⲛ	VSTAT	ⲫⲱⲛ
ⲫⲏⲟⲩⲓ	N	ⲫⲉ
ⲫⲏⲣϣ	N	ⲫⲏⲣϣ
ⲫⲏⲧ	VSTAT	ⲫⲱⲧ
ⲫⲑⲟⲛⲉⲓ	V	ⲫⲑⲟⲛⲉⲓ
ⲫⲑⲟⲛⲏⲣⲓⲁ	N	ⲫⲑⲟⲛⲏⲣⲓⲁ
ⲫⲑⲟⲛⲓ	V	ⲫⲑⲟⲛⲓ
ⲫⲑⲟⲛⲟⲥ	N	ⲫⲑⲟⲛⲟⲥ
ⲫⲓ	N	ⲫⲓ
ⲫⲓϯ	N	ⲫⲓϯ
ⲫⲓⲁⲗⲏ	N	ⲫⲓⲁⲗⲏ
ⲫⲓⲏ	N	ⲫⲓⲏ
ⲫⲓⲗⲁⲅⲣⲓⲟⲥ	NPROP	ⲫⲓⲗⲁⲅⲣⲓⲟⲥ
ⲫⲓⲗⲉⲥⲧⲁⲧⲟⲥ	N	ⲫⲓⲗⲉⲥⲧⲁⲧⲟⲥ
ⲫⲓⲗⲓⲕⲣⲓⲛⲏⲥ	N	ⲫⲓⲗⲓⲕⲣⲓⲛⲏⲥ
ⲫⲓⲗⲓⲡⲡⲉ	NPROP	ⲫⲓⲗⲓⲡⲡⲟⲥ
ⲫⲓⲗⲓⲡⲡⲟⲥ	NPROP	ⲫⲓⲗⲓⲡⲡⲟⲥ
ⲫⲓⲗⲟⲇⲱⲛⲓ̈ⲁ	N	ⲫⲓⲗⲟⲇⲱⲛⲓ̈ⲁ
ⲫⲓⲗⲟⲑⲉⲟⲥ	NPROP	ⲫⲓⲗⲟⲑⲉⲟⲥ
ⲫⲓⲗⲟⲑⲉⲥ	NPROP	ⲫⲓⲗⲟⲑⲉⲥ
ⲫⲓⲗⲟⲕⲁⲗⲉⲓ	V	ⲫⲓⲗⲟⲕⲁⲗⲉⲓ
ⲫⲓⲗⲟⲕⲁⲗⲓⲁ	N	ⲫⲓⲗⲟⲕⲁⲗⲓⲁ
ⲫⲓⲗⲟⲛⲓⲕⲏ	V	ⲫⲓⲗⲟⲛⲓⲕⲏ
ⲫⲓⲗⲟⲥⲟⲫⲓⲁ	N	ⲫⲓⲗⲟⲥⲟⲫⲓⲁ
ⲫⲓⲛ	N	ⲫⲓⲛ
ⲫⲓⲣⲓ	V	ⲫⲓⲣⲓ
ⲫⲓⲥⲓ	V	ⲫⲓⲥⲓ
ⲫⲗⲉⲯ	N	ⲫⲗⲉⲯ
ⲫⲗⲏⲟⲩ	N	ⲉⲫⲗⲏⲟⲩ
ⲫⲗⲩⲁⲣⲟⲥ	N	ⲫⲗⲩⲁⲣⲟⲥ
ⲫⲟϣⲛ	V	ⲫⲱϣⲉⲛ
ⲫⲟϣⲛ	VSTAT	ⲫⲱϣⲉⲛ
ⲫⲟϧⲉⲛ	N	ⲫⲱϧⲉⲛ
ⲫⲟϩ	V	ⲫⲟϩ
ⲫⲟϩⲧ	VSTAT	ⲫⲱⲧϩ
ⲫⲟϫⲓ	VSTAT	ⲫⲱϫⲓ
ⲫⲟⲃⲟⲥ	N	ⲫⲟⲃⲟⲥ
ⲫⲟⲓ	N	ⲫⲟⲓ
ⲫⲟⲓⲃⲁⲙⲙⲱⲛ	NPROP	ⲫⲟⲓⲃⲁⲙⲙⲱⲛ
ⲫⲟⲓⲛⲓⲕⲏ	NPROP	ⲫⲟⲓⲛⲓⲕⲏ
ⲫⲟⲓⲛⲓⲝ	N	ⲫⲟⲓⲛⲓⲝ
ⲫⲟⲗϩ	V	ⲫⲱⲗϩ
ⲫⲟⲗϫ	V	ⲫⲱⲗϫ
ⲫⲟⲛ	V	ⲫⲱⲛ
ⲫⲟⲛϩ	V	ⲫⲱⲛϩ
ⲫⲟⲛϩ	VSTAT	ⲫⲱⲛϩ
ⲫⲟⲛϫ	V	ⲫⲱⲛϫ
ⲫⲟⲛϫ	VSTAT	ⲫⲱⲛϫ
ⲫⲟⲛⲉⲩⲥ	N	ⲫⲟⲛⲉⲩⲥ
ⲫⲟⲛⲕ	VSTAT	ⲫⲱⲛⲕ
ⲫⲟⲛⲟⲥ	N	ⲫⲟⲛⲟⲥ
ⲫⲟⲛⲡⲉⲛ	V	ⲫⲟⲛⲡⲉⲛ
ⲫⲟⲛⲫⲉⲛ	V	ⲫⲟⲛⲡⲉⲛ
ⲫⲟⲣϣ	V	ⲫⲱⲣϣ
ⲫⲟⲣϣ	VSTAT	ⲫⲱⲣϣ
ⲫⲟⲣϫ	V	ⲫⲱⲣϫ
ⲫⲟⲣϫ	VSTAT	ⲫⲱⲣϫ
ⲫⲟⲣⲉⲓ	V	ⲫⲟⲣⲉⲓ
ⲫⲟⲣⲓ	N	ϥⲟⲣⲓ
ⲫⲟⲣⲓ	VSTAT	ⲫⲓⲣⲓ
ⲫⲟⲣⲕ	N	ⲫⲟⲣⲕ
ⲫⲟⲣⲕ	N	ⲫⲱⲣⲕ
ⲫⲟⲣⲕ	V	ⲫⲱⲣⲕ
ⲫⲟⲣⲟⲥ	N	ⲫⲟⲣⲟⲥ
ⲫⲟⲣⲡⲉⲣ	V	ⲫⲟⲣⲡⲉⲣ
ⲫⲟⲣⲥ	V	ⲫⲟⲣⲥ
ⲫⲟⲣⲧⲟⲩⲛⲁⲧⲟⲥ	NPROP	ⲫⲟⲣⲧⲟⲩⲛⲁⲧⲟⲥ
ⲫⲟⲥⲓ	VSTAT	ⲫⲓⲥⲓ
ⲫⲟⲧϩ	V	ⲫⲱⲧϩ
ⲫⲟⲧϩ	VSTAT	ⲫⲱⲧϩ
ⲫⲟⲧⲫⲉⲧ	V	ⲫⲟⲧⲫⲉⲧ
ⲫⲣⲁⲅⲉⲗⲗⲓⲟⲛ	N	ⲫⲣⲁⲅⲉⲗⲗⲓⲟⲛ
ⲫⲣⲁⲅⲉⲗⲗⲟⲩ	V	ⲫⲣⲁⲅⲉⲗⲗⲟⲩ
ⲫⲣⲁⲅⲙⲟⲥ	N	ⲫⲣⲁⲅⲙⲟⲥ
ⲫⲣⲁⲥⲓⲥ	N	ⲫⲣⲁⲥⲓⲥ
ⲫⲣⲟⲛⲏⲥⲓⲥ	N	ⲫⲣⲟⲛⲏⲥⲓⲥ
ⲫⲣⲟⲛⲧⲓⲍⲉ	V	ⲫⲣⲟⲛⲧⲓⲍⲉ
ⲫⲣⲱ	N	ⲫⲣⲱ
ⲫⲩⲗⲁⲅⲙⲁ	N	ⲫⲩⲗⲁⲅⲙⲁ
ⲫⲩⲗⲁⲕⲏ	N	ⲫⲩⲗⲁⲕⲏ
ⲫⲩⲗⲁⲕⲧⲏⲣⲓⲟⲛ	N	ⲫⲩⲗⲁⲕⲧⲏⲣⲓⲟⲛ
ⲫⲩⲗⲁⲝ	N	ⲫⲩⲗⲁⲝ
ⲫⲩⲗⲏ	N	ⲫⲩⲗⲏ
ⲫⲩⲗⲟⲡⲟⲛⲟⲥ	N	ⲫⲩⲗⲟⲡⲟⲛⲟⲥ
ⲫⲩⲥⲉⲓ	ADV	ⲫⲩⲥⲉⲓ
ⲫⲩⲥⲉⲱⲥ	N	ⲫⲩⲥⲉⲱⲥ
ⲫⲩⲥⲓ	ADV	ⲫⲩⲥⲓ
ⲫⲩⲥⲓⲕⲟⲛ	N	ⲫⲩⲥⲓⲕⲟⲛ
ⲫⲩⲥⲓⲥ	N	ⲫⲩⲥⲓⲥ
ⲫⲱ	N	ⲫⲱ
ⲫⲱϣ	V	ⲫⲱϣ
ⲫⲱϣⲉⲛ	V	ⲫⲱϣⲉⲛ
ⲫⲱϥ	PPOS	ⲫⲱϥ
ⲫⲱϧ	N	ⲫⲱϧ
ⲫⲱϧ	V	ⲫⲱϧ
ⲫⲱϧⲉⲛ	N	ⲫⲱϧⲉⲛ
ⲫⲱϧⲓ	N	ⲫⲱϧⲓ
ⲫⲱϧⲧ	V	ⲫⲱϧⲧ
ⲫⲱϫⲓ	N	ⲫⲱϫⲓ
ⲫⲱϫⲓ	V	ⲫⲱϫⲓ
ⲫⲱⲓ	PPOS	ⲫⲱⲓ
ⲫⲱⲕ	PPOS	ⲫⲱⲕ
ⲫⲱⲗϩ	V	ⲫⲱⲗϩ
ⲫⲱⲗϫ	V	ⲫⲱⲗϫ
ⲫⲱⲛ	PPOS	ⲫⲱⲛ
ⲫⲱⲛ	V	ⲫⲱⲛ
ⲫⲱⲛϩ	V	ⲫⲱⲛϩ
ⲫⲱⲛϫ	V	ⲫⲱⲛϫ
ⲫⲱⲛⲉⲩⲥ	N	ⲫⲱⲛⲉⲩⲥ
ⲫⲱⲛⲏ	N	ⲫⲱⲛⲏ
ⲫⲱⲛⲕ	V	ⲫⲱⲛⲕ
ⲫⲱⲣ	V	ⲫⲱⲣ
ⲫⲱⲣϣ	V	ⲫⲱⲣϣ
ⲫⲱⲣϫ	V	ⲫⲱⲣϣ
ⲫⲱⲣϫ	V	ⲫⲱⲣϫ
ⲫⲱⲣⲉⲓ	V	ⲫⲱⲣⲉⲓ
ⲫⲱⲣⲓⲥⲙⲁ	N	ⲫⲱⲣⲓⲥⲙⲁ
ⲫⲱⲣⲕ	N	ⲫⲱⲣⲕ
ⲫⲱⲣⲕ	V	ⲫⲱⲣⲕ
ⲫⲱⲥ	PPOS	ⲫⲱⲥ
ⲫⲱⲥⲥⲁ	N	ⲫⲱⲥⲥⲁ
ⲫⲱⲥⲧⲏⲣ	N	ⲫⲱⲥⲧⲏⲣ
ⲫⲱⲧ	V	ⲫⲱⲧ
ⲫⲱⲧϩ	V	ⲫⲱⲧϩ
ⲭ	PPERS	ⲛⲑⲟⲕ
ⲭⲁ	V	ⲭⲱ
ⲭⲁϥ	N	ⲭⲁϥ
ⲭⲁⲓⲣⲉ	PTC	ⲭⲁⲓⲣⲉ
ⲭⲁⲓⲣⲉⲓⲛ	V	ⲭⲁⲓⲣⲉⲓⲛ
ⲭⲁⲓⲣⲉⲧⲉ	PTC	ⲭⲁⲓⲣⲉⲧⲉ
ⲭⲁⲕ	N	ⲭⲁⲕ
ⲭⲁⲕⲑⲓ	N	ⲕⲁⲕⲑⲓ
ⲭⲁⲕⲓ	N	ⲭⲁⲕⲓ
ⲭⲁⲕⲕⲁⲙⲁⲩ	N	ⲭⲁⲕⲕⲁⲙⲁⲩ
ⲭⲁⲗⲁ	V	ⲭⲁⲗⲁ
ⲭⲁⲗⲁⲍⲁ	N	ⲭⲁⲗⲁⲍⲁ
ⲭⲁⲗⲃⲁⲛⲏ	N	ⲭⲁⲗⲃⲁⲛⲏ
ⲭⲁⲗⲇⲁⲓⲟⲥ	N	ⲭⲁⲗⲇⲁⲓⲟⲥ
ⲭⲁⲗⲓⲛⲟⲥ	N	ⲭⲁⲗⲓⲛⲟⲥ
ⲭⲁⲗⲓⲛⲟⲩ	V	ⲭⲁⲗⲓⲛⲟⲩ
ⲭⲁⲗⲕⲓⲛ	N	ⲭⲁⲗⲕⲓⲛ
ⲭⲁⲗⲕⲓⲟⲛ	N	ⲭⲁⲗⲕⲓⲟⲛ
ⲭⲁⲙⲁⲓⲗⲉⲱⲛ	N	ⲭⲁⲙⲁⲓⲗⲉⲱⲛ
ⲭⲁⲙⲱⲥ	N	ⲭⲁⲙⲱⲥ
ⲭⲁⲛⲁⲁⲛ	NPROP	ⲭⲁⲛⲁⲁⲛ
ⲭⲁⲛⲁⲛⲁⲓⲟⲥ	N	ⲭⲁⲛⲁⲛⲁⲓⲟⲥ
ⲭⲁⲛⲁⲛⲁⲓⲟⲥ	NPROP	ⲭⲁⲛⲁⲛⲁⲓⲟⲥ
ⲭⲁⲛⲁⲛⲓⲧⲓⲥ	N	ⲭⲁⲛⲁⲛⲓⲧⲓⲥ
ⲭⲁⲛⲟⲃⲓ	V	ⲭⲁⲛⲟⲃⲓ
ⲭⲁⲛⲥⲣⲱϥ	N	ⲭⲁⲛⲥⲣⲱϥ
ⲭⲁⲟⲥ	N	ⲭⲁⲟⲥ
ⲭⲁⲣⲁ	N	ϧⲣⲱⲟⲩ
ⲭⲁⲣⲁⲕⲧⲏⲣ	N	ⲭⲁⲣⲁⲕⲧⲏⲣ
ⲭⲁⲣⲓⲍⲉ	V	ⲭⲁⲣⲓⲍⲉ
ⲭⲁⲣⲓⲍⲉⲥⲑⲉ	V	ⲭⲁⲣⲓⲍⲉⲥⲑⲉ
ⲭⲁⲣⲓⲥ	N	ⲭⲁⲣⲓⲥ
ⲭⲁⲣⲓⲥⲙⲁ	N	ⲭⲁⲣⲓⲥⲙⲁ
ⲭⲁⲣⲓⲧⲥⲱⲛ	N	ⲭⲁⲣⲓⲧⲥⲱⲛ
ⲭⲁⲣⲟⲩⲕⲓ	N	ⲭⲁⲣⲟⲩⲕⲓ
ⲭⲁⲣⲧⲏⲥ	N	ⲭⲁⲣⲧⲏⲥ
ⲭⲁⲣⲱϫⲓ	N	ⲭⲁⲣⲱϫⲓ
ⲭⲁⲥⲕⲉⲥ	V	ⲭⲁⲥⲕⲉⲥ
ⲭⲁⲧⲏⲣ	N	ⲭⲁⲧⲏⲣ
ⲭⲁⲫⲁϫⲓ	N	ⲕⲁⲫⲁϫⲓ
ⲭⲃⲟⲃ	V	ⲭⲃⲟⲃ
ⲭⲉⲓⲙⲁⲣⲣⲟⲥ	N	ⲭⲉⲓⲙⲁⲣⲣⲟⲥ
ⲭⲉⲓⲙⲏⲧⲓ	V	ⲭⲉⲓⲙⲏⲧⲓ
ⲭⲉⲓⲣⲟⲅⲣⲁⲫⲟⲛ	N	ⲭⲉⲓⲣⲟⲅⲣⲁⲫⲟⲛ
ⲭⲉⲓⲣⲟⲧⲟⲛⲉⲓ	V	ⲭⲉⲓⲣⲟⲧⲟⲛⲉⲓ
ⲭⲉⲓⲣⲟⲧⲟⲛⲓⲁ	N	ⲭⲉⲓⲣⲟⲧⲟⲛⲓⲁ
ⲭⲉⲗⲙⲓ	N	ⲭⲉⲗⲙⲓ
ⲭⲉⲗⲭⲁⲭⲱϥ	N	ⲭⲉⲗⲭⲁⲭⲱϥ
ⲭⲉⲡ	V	ⲭⲱⲡ
ⲭⲉⲣ	V	ⲭⲉⲣ
ⲭⲉⲣⲁ	N	ⲭⲉⲣⲁ
ⲭⲉⲣⲉⲃ	N	ϧⲉⲣⲉⲃ
ⲭⲉⲣⲟⲩⲃⲓⲛ	N	ⲭⲉⲣⲟⲩⲃⲓⲛ
ⲭⲉⲣⲥ	N	ⲕⲉⲣⲥ
ⲭⲉⲧⲧⲁⲓⲟⲥ	N	ⲭⲉⲧⲧⲁⲓⲟⲥ
ⲭⲉⲧⲧⲁⲓⲟⲥ	NPROP	ⲭⲉⲧⲧⲁⲓⲟⲥ
ⲭⲏ	VSTAT	ⲭⲱ
ⲭⲏⲙ	VSTAT	ⲭⲙⲟⲙ
ⲭⲏⲡ	VSTAT	ⲭⲱⲡ
ⲭⲏⲡⲓ	N	ⲭⲏⲡⲓ
ⲭⲏⲣⲁ	N	ⲭⲏⲣⲁ
ⲭⲏⲣⲉⲩⲉ	V	ⲭⲏⲣⲉⲩⲉ
ⲭⲏⲧ	N	ϧⲏⲧ
ⲭⲓϥⲧ	N	ⲭⲓϥⲧ
ⲭⲓⲗⲓⲁⲣⲭⲟⲥ	N	ⲭⲓⲗⲓⲁⲣⲭⲟⲥ
ⲭⲓⲙⲁⲣⲣⲁⲓⲥ	N	ⲭⲓⲙⲁⲣⲣⲁⲓⲥ
ⲭⲓⲙⲱⲛ	N	ⲭⲓⲙⲱⲛ
ⲭⲓⲣⲟⲇⲟⲛⲓⲁ	N	ⲭⲓⲣⲟⲇⲟⲛⲓⲁ
ⲭⲓⲱⲛ	N	ⲭⲓⲱⲛ
ⲭⲗⲁϥⲧ	N	ⲕⲗⲁϥⲧ
ⲭⲗⲁⲗ	N	ⲭⲗⲁⲗ
ⲭⲗⲁⲙⲩⲥ	N	ⲭⲗⲁⲙⲩⲥ
ⲭⲗⲏ	N	ⲕⲗⲏ
ⲭⲗⲟ	N	ⲭⲗⲟ
ⲭⲗⲟⲏ	NPROP	ⲭⲗⲟⲏ
ⲭⲗⲟⲗ	N	ⲭⲗⲟⲗ
ⲭⲗⲟⲙ	N	ⲭⲗⲟⲙ
ⲭⲗⲟⲙⲗⲉⲙ	V	ϭⲗⲟⲙⲗⲉⲙ
ⲭⲗⲟⲙⲗⲉⲙ	V	ⲭⲗⲟⲙⲗⲉⲙ
ⲭⲙⲟⲙ	V	ⲭⲙⲟⲙ
ⲭⲛⲁⲩ	N	ⲭⲛⲁⲩ
ⲭⲟϩ	N	ⲭⲟϩ
ⲭⲟϩ	V	ⲭⲟϩ
ⲭⲟⲓⲁⲕ	N	ⲭⲟⲓⲁⲕ
ⲭⲟⲓⲕⲟⲥ	N	ⲭⲟⲓⲕⲟⲥ
ⲭⲟⲓⲣⲟⲅⲩⲗⲓⲟⲛ	N	ⲭⲟⲓⲣⲟⲅⲩⲗⲓⲟⲛ
ⲭⲟⲗ	N	ⲭⲟⲗ
ⲭⲟⲗⲉⲙ	VSTAT	ⲭⲱⲗⲉⲙ
ⲭⲟⲗⲏ	N	ⲭⲟⲗⲏ
ⲭⲟⲛⲉⲩⲧⲟⲛ	N	ⲭⲟⲛⲉⲩⲧⲟⲛ
ⲭⲟⲛⲥ	VSTAT	ⲭⲱⲛⲥ
ⲭⲟⲡ	V	ⲭⲱⲡ
ⲭⲟⲣⲇⲏ	N	ⲭⲟⲣⲇⲏ
ⲭⲟⲣⲉⲕⲓ	V	ⲭⲟⲣⲉⲕⲓ
ⲭⲟⲣⲉⲩⲉ	V	ⲭⲟⲣⲉⲩⲉ
ⲭⲟⲣⲏⲅⲓⲁ	N	ⲭⲟⲣⲏⲅⲓⲁ
ⲭⲟⲣⲏⲙⲁ	N	ⲭⲟⲣⲏⲙⲁ
ⲭⲟⲣⲓⲟⲛ	N	ⲭⲟⲣⲓⲟⲛ
ⲭⲟⲣⲟⲥ	N	ⲭⲟⲣⲟⲥ
ⲭⲟⲣⲧⲉⲛ	N	ⲕⲟⲣⲧⲉⲛ
ⲭⲟⲣⲧⲟⲥ	N	ⲭⲟⲣⲧⲟⲥ
ⲭⲟⲣⲩⲙⲁ	N	ⲭⲟⲣⲩⲙⲁ
ⲭⲟⲥ	N	ⲭⲟⲥ
ⲭⲟⲩⲁⲓⲛ	N	ⲭⲟⲩⲁⲓⲛ
ⲭⲟⲩⲡⲉⲣ	N	ⲕⲟⲩⲡⲉⲣ
ⲭⲟⲩⲥ	N	ⲭⲟⲩⲥ
ⲭⲣⲁⲓⲟⲥ	N	ⲭⲣⲁⲓⲟⲥ
ⲭⲣⲁⲥⲑⲁⲓ	V	ⲭⲣⲁⲥⲑⲁⲓ
ⲭⲣⲉⲓⲁ	N	ⲭⲣⲉⲓⲁ
ⲭⲣⲉⲓⲥⲧⲓⲁⲛⲟⲥ	N	ⲭⲣⲉⲓⲥⲧⲓⲁⲛⲟⲥ
ⲭⲣⲉⲙⲣⲉⲙ	V	ⲭⲣⲉⲙⲣⲉⲙ
ⲭⲣⲉⲙⲣⲱⲙ	VSTAT	ⲭⲣⲉⲙⲣⲱⲙ
ⲭⲣⲉⲱⲥⲧⲉⲓ	V	ⲭⲣⲉⲱⲥⲧⲉⲓ
ⲭⲣⲉⲱⲥⲧⲓⲕⲟⲛ	N	ⲭⲣⲉⲱⲥⲧⲓⲕⲟⲛ
ⲭⲣⲏⲙⲁ	N	ⲭⲣⲏⲙⲁ
ⲭⲣⲏⲙⲁⲧⲓⲍⲉ	V	ⲭⲣⲏⲙⲁⲧⲓⲍⲉ
ⲭⲣⲏⲥⲓⲙⲟⲛ	N	ⲭⲣⲏⲥⲓⲙⲟⲛ
ⲭⲣⲏⲥⲙⲟⲥ	N	ⲭⲣⲏⲥⲙⲟⲥ
ⲭⲣⲏⲥⲧⲏⲣⲓⲟⲛ	N	ⲭⲣⲏⲥⲧⲏⲣⲓⲟⲛ
ⲭⲣⲏⲥⲧⲟⲥ	N	ⲭⲣⲏⲥⲧⲟⲥ
ⲭⲣⲓⲁ	N	ⲭⲣⲓⲁ
ⲭⲣⲓⲙ	N	ⲭⲣⲓⲙ
ⲭⲣⲓⲥⲓⲙⲱⲛ	N	ⲭⲣⲓⲥⲓⲙⲱⲛ
ⲭⲣⲓⲥⲙⲁ	N	ⲭⲣⲓⲥⲙⲁ
ⲭⲣⲓⲥⲧⲓⲁⲛⲏ	NPROP	ⲭⲣⲓⲥⲧⲓⲁⲛⲏ
ⲭⲣⲓⲥⲧⲓⲁⲛⲟⲥ	N	ⲭⲣⲓⲥⲧⲓⲁⲛⲟⲥ
ⲭⲣⲓⲥⲧⲓⲁⲛⲟⲥ	NPROP	ⲭⲣⲓⲥⲧⲓⲁⲛⲟⲥ
ⲭⲣⲓⲥⲧⲟⲥ	N	ⲭⲣⲓⲥⲧⲟⲥ
ⲭⲣⲟ	N	ⲭⲣⲟ
ⲭⲣⲟϣ	N	ⲭⲣⲟϣ
ⲭⲣⲟϥ	N	ⲭⲣⲟϥ
ⲭⲣⲟⲃⲓ	N	ⲭⲣⲟⲃⲓ
ⲭⲣⲟⲛⲟⲥ	N	ⲭⲣⲟⲛⲟⲥ
ⲭⲣⲟⲩⲣ	N	ⲭⲣⲟⲩⲣ
ⲭⲣⲩⲥⲓⲥ	N	ⲭⲣⲩⲥⲓⲥ
ⲭⲣⲩⲥⲟⲗⲓⲛⲑⲟⲥ	N	ⲭⲣⲩⲥⲟⲗⲓⲛⲑⲟⲥ
ⲭⲣⲩⲥⲟⲡⲗⲁⲥⲱⲥ	N	ⲭⲣⲩⲥⲟⲡⲗⲁⲥⲱⲥ
ⲭⲣⲱ	V	ⲭⲣⲱ
ⲭⲣⲱϣ	N	ⲭⲣⲟϣ
ⲭⲣⲱϣ	N	ⲭⲣⲱϣ
ⲭⲣⲱⲙ	N	ⲭⲣⲱⲙ
ⲭⲣⲱⲟⲩⲛ	N	ⲭⲣⲱⲟⲩⲛⲓ
ⲭⲣⲱⲟⲩⲛⲓ	N	ⲭⲣⲱⲟⲩⲛⲓ
ⲭⲱ	N	ⲭⲱ
ⲭⲱ	V	ⲭⲱ
ⲭⲱⲕ	V	ⲕⲱⲕ
ⲭⲱⲗⲉⲙ	N	ⲭⲱⲗⲉⲙ
ⲭⲱⲗⲉⲙ	V	ⲭⲱⲗⲉⲙ
ⲭⲱⲛⲥ	V	ⲭⲱⲛⲥ
ⲭⲱⲟⲩⲛⲓ	N	ⲭⲱⲟⲩⲛⲓ
ⲭⲱⲡ	V	ⲭⲱⲡ
ⲭⲱⲣⲁ	N	ⲭⲱⲣⲁ
ⲭⲱⲣⲉⲩⲉ	V	ⲭⲱⲣⲉⲩⲉ
ⲭⲱⲣⲏⲅⲉⲓ	V	ⲭⲱⲣⲏⲅⲉⲓ
ⲭⲱⲣⲓ	V	ⲭⲱⲣⲓ
ⲭⲱⲣⲓⲛ	V	ⲭⲱⲣⲓⲛ
ⲭⲱⲣⲓⲟⲛ	N	ⲭⲱⲣⲓⲟⲛ
ⲭⲱⲣⲓⲥ	PREP	ⲭⲱⲣⲓⲥ
ⲯⲁⲗⲗⲉⲓ	V	ⲯⲁⲗⲗⲉⲓ
ⲯⲁⲗⲗⲏ	V	ⲯⲁⲗⲗⲏ
ⲯⲁⲗⲗⲓ	V	ⲯⲁⲗⲗⲓ
ⲯⲁⲗⲙⲟⲥ	N	ⲯⲁⲗⲙⲟⲥ
ⲯⲁⲗⲙⲱⲇⲓⲁ	N	ⲯⲁⲗⲙⲱⲇⲓⲁ
ⲯⲁⲗⲙⲱⲇⲟⲥ	N	ⲯⲁⲗⲙⲱⲇⲟⲥ
ⲯⲁⲗⲧⲏⲣⲓⲟⲛ	N	ⲯⲁⲗⲧⲏⲣⲓⲟⲛ
ⲯⲁⲗⲧⲏⲥ	N	ⲯⲁⲗⲧⲏⲥ
ⲯⲉⲩⲇⲟⲡⲣⲟⲫⲏⲧⲏⲥ	N	ⲯⲉⲩⲇⲟⲡⲣⲟⲫⲏⲧⲏⲥ
ⲯⲉⲩⲇⲟⲭⲣⲓⲥⲧⲟⲥ	N	ⲯⲉⲩⲇⲟⲭⲣⲓⲥⲧⲟⲥ
ⲯⲏⲫⲟⲥ	N	ⲯⲏⲫⲟⲥ
ⲯⲓⲕⲟⲥⲧⲁⲧⲏⲥ	N	ⲯⲓⲕⲟⲥⲧⲁⲧⲏⲥ
ⲯⲩⲫⲓⲥⲙⲁ	N	ⲯⲩⲫⲓⲥⲙⲁ
ⲯⲩⲭⲏ	N	ⲯⲩⲭⲏ
ⲯⲩⲭⲓⲕⲏ	N	ⲯⲩⲭⲓⲕⲏ
ⲯⲩⲭⲓⲕⲟⲛ	N	ⲯⲩⲭⲓⲕⲟⲛ
ⲯⲩⲭⲓⲕⲟⲥ	N	ⲯⲩⲭⲓⲕⲟⲥ
ⲯⲩⲭⲟⲟⲩⲉ	N	ⲯⲩⲭⲏ
ⲱ	PTC	ⲱ
ⲱ	V	ⲱⲱ
ⲱϣ	V	ⲱϣ
ⲱϣϫ	V	ⲱϣϫ
ⲱϣϯ	V	ⲱϣϯ
ⲱϣⲉⲙ	V	ⲱϣⲉⲙ
ⲱϣⲓ	N	ⲱϣⲓ
ⲱϥⲓ	V	ⲱϥⲓ
ⲱϥⲧ	V	ⲱϥⲧ
ⲱϧⲧ	V	ⲱϧⲧ
ⲱϫϩ	V	ⲱϫϩ
ⲱϫⲉϥ	V	ⲱϫⲉⲃ
ⲱϫⲉⲃ	V	ⲱϫⲉⲃ
ⲱϫⲉⲣ	V	ⲱϫⲉⲣ
ⲱⲃ	N	ⲱⲃ
ⲱⲃϣ	V	ⲱⲃϣ
ⲱⲃⲉⲛ	N	ⲱⲃⲉⲛ
ⲱⲃⲧ	V	ⲱⲃⲧ
ⲱⲇⲏ	N	ⲱⲇⲏ
ⲱⲓϣ	N	ⲟⲉⲓϣ
ⲱⲓⲕ	N	ⲱⲓⲕ
ⲱⲓⲗⲓ	N	ⲱⲓⲗⲓ
ⲱⲓⲙⲓ	N	ⲱⲓⲙⲓ
ⲱⲓⲡⲓ	N	ⲱⲓⲡⲓ
ⲱⲕ	V	ⲱⲕ
ⲱⲕⲉⲁⲛⲟⲥ	N	ⲱⲕⲉⲁⲛⲟⲥ
ⲱⲕⲉⲙ	V	ⲱⲕⲉⲙ
ⲱⲕⲛⲉⲓ	V	ⲱⲕⲛⲉⲓ
ⲱⲗⲓ	N	ⲱⲗⲓ
ⲱⲗⲓ	V	ⲱⲗⲓ
ⲱⲗⲕ	V	ⲱⲗⲕ
ⲱⲙⲕ	V	ⲱⲙⲕ
ⲱⲙⲟⲫⲟⲣⲟⲥ	N	ⲱⲙⲟⲫⲟⲣⲟⲥ
ⲱⲙⲥ	N	ⲱⲙⲥ
ⲱⲙⲥ	V	ⲱⲙⲥ
ⲱⲛϧ	N	ⲱⲛϧ
ⲱⲛϧ	V	ⲱⲛϧ
ⲱⲛⲏ	N	ⲱⲛⲏ
ⲱⲛⲓ	N	ⲱⲛⲓ
ⲱⲟⲩ	N	ⲱⲟⲩ
ⲱⲟⲩ	V	ⲱⲟⲩ
ⲱⲟⲩϣ	N	ⲱⲟⲩϣ
ⲱⲡ	V	ⲱⲡ
ⲱⲣϥ	V	ⲱⲣϥ
ⲱⲣⲃⲁⲛ	N	ⲱⲣⲃⲁⲛ
ⲱⲣⲅⲁⲛⲟⲛ	N	ⲱⲣⲅⲁⲛⲟⲛ
ⲱⲣⲉⲃ	V	ⲱⲣⲉⲃ
ⲱⲣⲕ	V	ⲱⲣⲕ
ⲱⲥϧ	N	ⲱⲥϧ
ⲱⲥϧ	V	ⲱⲥϧ
ⲱⲥⲁⲛⲛⲁ	PTC	ⲱⲥⲁⲛⲛⲁ
ⲱⲥⲁⲛⲛⲁ	V	ⲱⲥⲁⲛⲛⲁ
ⲱⲥⲕ	V	ⲱⲥⲕ
ⲱⲧ	N	ⲱⲧ
ⲱⲧϩ	V	ⲱⲧϩ
ⲱⲧⲑ	V	ⲱⲧⲑ
ⲱⲧⲡ	V	ⲱⲧⲡ
ⲱⲫⲉⲗⲉⲓ	V	ⲱⲫⲉⲗⲉⲓ
ⲱⲫⲉⲗⲓⲁ	N	ⲱⲫⲉⲗⲓⲁ
ⲱⲫⲓⲕⲓⲟⲛ	N	ⲱⲫⲓⲕⲓⲟⲛ
ⲙⲉⲛⲣⲁϯ	N	ⲙⲉⲛⲣⲓⲧ
ⲛⲧⲱ	PREP	ⲛⲧⲉ
ⲛⲟⲩⲧⲉⲛ	PPOS	ⲫⲱⲧⲉⲛ
ⲫⲱⲧⲉⲛ	PPOS	ⲫⲱⲧⲉⲛ
ⲑⲱⲧⲉⲛ	PPOS	ⲫⲱⲧⲉⲛ
ⲟⲟⲩ	N	ϩⲟⲟⲩ
ⲁⲩ	ADV	ⲁ
ⲉⲧⲉⲣⲉ	CREL	ⲉⲧⲉ
ⲙⲫⲏ	NEG	ⲙⲫⲏ
ⲉⲕⲉ	AOPT_PPERS	ⲉⲣⲉ_ⲛⲑⲟⲕ
ⲉⲑⲃⲏⲧ	PREP	ⲉⲑⲃⲉ
ⲉⲓⲉ	AOPT_PPERS	ⲉⲣⲉ_ⲁⲛⲟⲕ
ⲉϥⲉ	AOPT_PPERS	ⲉⲣⲉ_ⲛⲑⲟϥ
ⲉⲥⲉ	AOPT_PPERS	ⲉⲣⲉ_ⲛⲑⲟⲥ
ⲉⲣⲉⲧⲉⲛⲉ	AOPT_PPERS	ⲉⲣⲉ_ⲛⲑⲱⲧⲉⲛ
ⲑⲁⲓ	PDEM	ⲫⲁⲓ
ⲙⲁⲣ	AJUS	ⲙⲁⲣⲉ
ⲛⲱ	PREP	ⲛⲁ
ⲉⲣⲙⲱⲟⲩⲓ	N	ⲉⲣⲙⲏ
ⲉⲣⲙⲏ	N	ⲉⲣⲙⲏ
ⲁⲣⲓⲧⲓⲙⲁⲛ	VIMP	ⲉⲣⲧⲓⲙⲁⲛ
