.	.
...	...
_warn:empty_norm_	_warn:empty_norm_
oⲩ	oⲩ
ϣ	ϣ
ϣϣⲏⲛ	ϣϣⲏⲛ
ϣϣⲟⲧ	ϣϣⲟⲧ
ϣϫⲉ	ϣϫⲉ
ϣϫⲉⲙϫⲟⲙ	ϣ|ϫⲉⲙϫⲟⲙ
ϣϫⲟⲙ	ϣ|ϫⲟⲙ
ϣϭⲛⲏⲛ	ϣϭⲛⲏⲛ
ϣⲁ	ϣⲁ
ϣⲁϣ	ϣⲁϣ
ϣⲁϣⲓ	ϣⲁϣⲓ
ϣⲁϥⲉ	ϣⲁϥⲉ
ϣⲁϫⲓ	ϣⲁϫⲓ
ϣⲁϯ	ϣⲁϯ
ϣⲁⲉϧⲟⲩⲛ	ϣⲁⲉϧⲟⲩⲛ
ϣⲁⲉⲛⲉϩ	ϣⲁ|ⲉⲛⲉϩ
ϣⲁⲓ	ϣⲁⲓ
ϣⲁⲙϣⲉ	ϣⲁⲙϣⲉ
ϣⲁⲛ	ϣⲁⲛ
ϣⲁⲛⲧⲉ	ϣⲁⲛⲧⲉ
ϣⲁⲣ	ϣⲁⲣ
ϣⲁⲣⲉ	ϣⲁⲣⲉ
ϣⲁⲣⲓ	ϣⲁⲣⲓ
ϣⲁⲣⲟ	ϣⲁⲣⲟ
ϣⲁⲧ	ϣⲁⲧ
ϣⲁⲧⲉ	ϣⲁⲧⲉ
ϣⲁⲧⲉⲛ	ϣⲁⲧⲉⲛ
ϣⲃⲱⲧ	ϣⲃⲱⲧ
ϣⲉ	ϣⲉ
ϣⲉⲃⲓⲱ	ϣⲉⲃⲓⲱ
ϣⲉⲗⲧⲁⲙ	ϣⲉⲗⲧⲁⲙ
ϣⲉⲙϣⲏⲧ	ϣⲉⲙϣⲏⲧ
ϣⲉⲙϣⲓ	ϣⲉⲙϣⲓ
ϣⲉⲙⲏⲣ	ϣⲉⲙⲏⲣ
ϣⲉⲙⲙⲟ	ϣⲉⲙⲙⲟ
ϣⲉⲛ	ϣⲉⲛ
ϣⲉⲛϩⲏⲧ	ϣⲉⲛ|ϩⲏⲧ
ϣⲉⲛⲧⲱ	ϣⲉⲛⲧⲱ
ϣⲉⲡ	ϣⲉⲡ
ϣⲉⲡϧⲓⲥⲓ	ϣⲉⲡ|ϧⲓⲥⲓ
ϣⲉⲡϩⲙⲟⲧ	ϣⲉⲡ|ϩⲙⲟⲧ
ϣⲉⲣ	ϣⲉⲣ
ϣⲉⲣⲓ	ϣⲉⲣⲓ
ϣⲉⲩⲛⲓ	ϣⲉⲩⲛⲓ
ϣⲏϣ	ϣⲏϣ
ϣⲏⲕ	ϣⲏⲕ
ϣⲏⲗ	ϣⲏⲗ
ϣⲏⲟⲩ	ϣⲏⲟⲩ
ϣⲏⲡ	ϣⲏⲡ
ϣⲏⲣⲓ	ϣⲏⲣⲓ
ϣⲑⲉⲣⲑⲱⲣ	ϣⲑⲉⲣⲑⲱⲣ
ϣⲑⲏⲛ	ϣⲑⲏⲛ
ϣⲑⲟⲣⲧⲉⲣ	ϣⲑⲟⲣⲧⲉⲣ
ϣⲓ	ϣⲓ
ϣⲓⲃϯ	ϣⲓⲃϯ
ϣⲓⲏ	ϣⲓⲏ
ϣⲓⲏⲧ	ϣⲓⲏⲧ
ϣⲓⲛⲓ	ϣⲓⲛⲓ
ϣⲓⲡⲓ	ϣⲓⲡⲓ
ϣⲗⲏⲗⲟⲩⲓ	ϣⲗⲏⲗⲟⲩⲓ
ϣⲗⲱⲗ	ϣⲗⲱⲗ
ϣⲛⲉ	ϣⲛⲉ
ϣⲛⲉϩⲓⲟⲩⲓ	ϣⲛⲉ|ϩⲓⲟⲩⲓ
ϣⲛⲏⲟⲩ	ϣⲛⲏⲟⲩ
ϣⲟ	ϣⲟ
ϣⲟϣ	ϣⲟϣ
ϣⲟϣϥ	ϣⲟϣϥ
ϣⲟϣⲟⲩ	ϣⲟϣⲟⲩ
ϣⲟⲃⲓ	ϣⲟⲃⲓ
ϣⲟⲃⲧ	ϣⲟⲃⲧ
ϣⲟⲗ	ϣⲟⲗ
ϣⲟⲗϩ	ϣⲟⲗϩ
ϣⲟⲡ	ϣⲟⲡ
ϣⲟⲡⲧ	ϣⲟⲡⲧ
ϣⲟⲣⲡ	ϣⲟⲣⲡ
ϣⲟⲩϣⲟⲩ	ϣⲟⲩϣⲟⲩ
ϣⲟⲩϣⲱⲟⲩϣⲓ	ϣⲟⲩϣⲱⲟⲩϣⲓ
ϣⲟⲩⲓⲧ	ϣⲟⲩⲓⲧ
ϣⲟⲩⲱ	ϣⲟⲩⲱ
ϣⲟⲩⲱⲟⲩ	ϣⲟⲩⲱⲟⲩ
ϣⲥⲉⲃⲧⲱⲧ	ϣ|ⲥⲉⲃⲧⲱⲧ
ϣⲧⲁϯ	ϣⲧⲁϯ
ϣⲧⲉⲕⲟ	ϣⲧⲉⲕⲟ
ϣⲧⲉⲙ	ϣⲧⲉⲙ
ϣⲧⲉⲣⲑⲱⲣ	ϣⲧⲉⲣⲑⲱⲣ
ϣⲫⲏⲣ	ϣⲫⲏⲣ
ϣⲫⲏⲣⲓ	ϣⲫⲏⲣⲓ
ϣⲫⲓⲧ	ϣⲫⲓⲧ
ϣⲱϣ	ϣⲱϣ
ϣⲱϥ	ϣⲱϥ
ϣⲱϥⲧ	ϣⲱϥⲧ
ϣⲱⲓ	ϣⲱⲓ
ϣⲱⲓϣ	ϣⲱⲓϣ
ϣⲱⲕ	ϣⲱⲕ
ϣⲱⲕⲓ	ϣⲱⲕⲓ
ϣⲱⲗⲉⲙ	ϣⲱⲗⲉⲙ
ϣⲱⲙ	ϣⲱⲙ
ϣⲱⲙⲓ	ϣⲱⲙⲓ
ϣⲱⲛⲓ	ϣⲱⲛⲓ
ϣⲱⲛⲧ	ϣⲱⲛⲧ
ϣⲱⲟⲩⲓ	ϣⲱⲟⲩⲓ
ϣⲱⲡ	ϣⲱⲡ
ϣⲱⲡⲓ	ϣⲱⲡⲓ
ϣⲱⲣⲡ	ϣⲱⲣⲡ
ϣⲱⲧ	ϣⲱⲧ
ϥ	ϥ
ϥϫⲟⲧ	ϥϫⲟⲧ
ϥⲁⲓ	ϥⲁⲓ
ϥⲉϫ	ϥⲉϫ
ϥⲉϫϧⲉⲙⲥ	ϥⲉϫ|ϧⲉⲙⲥ
ϥⲉⲛⲧ	ϥⲉⲛⲧ
ϥⲓⲁϩⲟⲙ	ϥⲓ|ⲁϩⲟⲙ
ϥⲓⲣⲱⲟⲩϣ	ϥⲓ|ⲣⲱⲟⲩϣ
ϥⲓⲧ	ϥⲓⲧ
ϥⲟϫ	ϥⲟϫ
ϥⲧⲟⲩ	ϥⲧⲟⲩ
ϥⲱϫⲓ	ϥⲱϫⲓ
ϥⲱⲓ	ϥⲱⲓ
ϧⲁ	ϧⲁ
ϧⲁϫⲱ	ϧⲁϫⲱ
ϧⲁⲉ	ϧⲁⲉ
ϧⲁⲉⲩ	ϧⲁⲉⲩ
ϧⲁⲣⲁⲃⲁⲓ	ϧⲁⲣⲁⲃⲁⲓ
ϧⲁⲣⲁⲧ	ϧⲁⲣⲁⲧ
ϧⲁⲣⲟ	ϧⲁⲣⲟ
ϧⲁⲣⲱ	ϧⲁⲣⲱ
ϧⲁⲧⲉⲛ	ϧⲁⲧⲉⲛ
ϧⲁⲧⲟⲧ	ϧⲁⲧⲟⲧ
ϧⲁⲧⲟⲧⲉ	ϧⲁⲧⲟⲧⲉ
ϧⲉ	ϧⲉ
ϧⲉⲗϣⲓⲣⲓ	ϧⲉⲗ|ϣⲓⲣⲓ
ϧⲉⲗⲗⲟ	ϧⲉⲗⲗⲟ
ϧⲉⲙⲥ	ϧⲉⲙⲥ
ϧⲉⲛ	ϧⲉⲛ
ϧⲉⲛⲧ	ϧⲉⲛⲧ
ϧⲉⲧϧⲉⲧ	ϧⲉⲧϧⲉⲧ
ϧⲉⲧϧⲱⲧ	ϧⲉⲧϧⲱⲧ
ϧⲏⲃⲥ	ϧⲏⲃⲥ
ϧⲏⲓⲃⲓ	ϧⲏⲓⲃⲓ
ϧⲏⲙ	ϧⲏⲙ
ϧⲏⲧ	ϧⲏⲧ
ϧⲏⲧⲓ	ϧⲏⲧⲓ
ϧⲓⲣ	ϧⲓⲣ
ϧⲓⲥⲓ	ϧⲓⲥⲓ
ϧⲓⲧⲉⲛ	ϧⲓⲧⲉⲛ
ϧⲙⲟⲙ	ϧⲙⲟⲙ
ϧⲟⲑⲃ	ϧⲟⲑⲃ
ϧⲟⲑⲃⲉ	ϧⲟⲑⲃⲉ
ϧⲟⲕϩ	ϧⲟⲕϩ
ϧⲟⲙϧⲉⲙ	ϧⲟⲙϧⲉⲙ
ϧⲟⲥⲓ	ϧⲟⲥⲓ
ϧⲟⲧϧⲉⲧ	ϧⲟⲧϧⲉⲧ
ϧⲣⲁϫⲣⲉϫ	ϧⲣⲁϫⲣⲉϫ
ϧⲣⲉ	ϧⲣⲉ
ϧⲣⲏⲓ	ϧⲣⲏⲓ
ϧⲣⲏⲟⲩⲓ	ϧⲣⲏⲟⲩⲓ
ϧⲣⲱⲟⲩ	ϧⲣⲱⲟⲩ
ϧⲱⲛⲧ	ϧⲱⲛⲧ
ϧⲱⲧⲉⲃ	ϧⲱⲧⲉⲃ
ϩⲁ	ϩⲁ
ϩⲁϫⲓ	ϩⲁϫⲓ
ϩⲁⲅⲓⲟⲥ	ϩⲁⲅⲓⲟⲥ
ϩⲁⲓ	ϩⲁⲓ
ϩⲁⲓⲣⲉⲥⲓⲥ	ϩⲁⲓⲣⲉⲥⲓⲥ
ϩⲁⲓⲣⲉⲧⲓⲕⲟⲥ	ϩⲁⲓⲣⲉⲧⲓⲕⲟⲥ
ϩⲁⲗⲁϯ	ϩⲁⲗⲁϯ
ϩⲁⲗⲁⲓ	ϩⲁⲗⲁⲓ
ϩⲁⲗⲩⲥⲓⲥ	ϩⲁⲗⲩⲥⲓⲥ
ϩⲁⲛ	ϩⲁⲛ
ϩⲁⲛⲁⲧⲟⲟⲩⲓ	ϩⲁⲛⲁⲧⲟⲟⲩⲓ
ϩⲁⲡ	ϩⲁⲡ
ϩⲁⲣⲁ	ϩⲁⲣⲁ
ϩⲁⲣⲟ	ϩⲁⲣⲟ
ϩⲁⲣⲱ	ϩⲁⲣⲱ
ϩⲁⲧ	ϩⲁⲧ
ϩⲃⲏⲟⲩⲓ	ϩⲃⲏⲟⲩⲓ
ϩⲃⲟⲥ	ϩⲃⲟⲥ
ϩⲃⲱⲛ	ϩⲃⲱⲛ
ϩⲃⲱⲥ	ϩⲃⲱⲥ
ϩⲉϫϩⲱϫ	ϩⲉϫϩⲱϫ
ϩⲉⲃⲥ	ϩⲉⲃⲥ
ϩⲉⲃⲥⲱ	ϩⲉⲃⲥⲱ
ϩⲉⲓ	ϩⲉⲓ
ϩⲉⲓⲣⲏⲛⲏ	ϩⲉⲓⲣⲏⲛⲏ
ϩⲉⲗⲡⲓⲥ	ϩⲉⲗⲡⲓⲥ
ϩⲉⲙϫ	ϩⲉⲙϫ
ϩⲉⲙⲥⲓ	ϩⲉⲙⲥⲓ
ϩⲉⲣⲉⲥⲓⲥ	ϩⲉⲣⲉⲥⲓⲥ
ϩⲉⲣⲓ	ϩⲉⲣⲓ
ϩⲉⲣⲙⲏⲛⲉⲓⲁ	ϩⲉⲣⲙⲏⲛⲉⲓⲁ
ϩⲏ	ϩⲏ
ϩⲏⲃⲓ	ϩⲏⲃⲓ
ϩⲏⲅⲉⲙⲱⲛ	ϩⲏⲅⲉⲙⲱⲛ
ϩⲏⲅⲟⲩⲙⲉⲛⲟⲥ	ϩⲏⲅⲟⲩⲙⲉⲛⲟⲥ
ϩⲏⲇⲉⲱⲥ	ϩⲏⲇⲉⲱⲥ
ϩⲏⲇⲏ	ϩⲏⲇⲏ
ϩⲏⲕⲓ	ϩⲏⲕⲓ
ϩⲏⲗ	ϩⲏⲗ
ϩⲏⲟⲩ	ϩⲏⲟⲩ
ϩⲏⲡ	ϩⲏⲡ
ϩⲏⲡⲡⲉ	ϩⲏⲡⲡⲉ
ϩⲏⲧ	ϩⲏⲧ
ϩⲑⲏ	ϩⲑⲏ
ϩⲑⲱⲣ	ϩⲑⲱⲣ
ϩⲓ	ϩⲓ
ϩⲓϣⲉⲛⲛⲟⲩϥⲓ	ϩⲓ|ϣⲉⲛ|ⲛⲟⲩϥⲓ
ϩⲓϩⲟⲙⲧ	ϩⲓ|ϩⲟⲙⲧ
ϩⲓϫⲉⲛ	ϩⲓϫⲉⲛ
ϩⲓϫⲱ	ϩⲓϫⲱ
ϩⲓϫⲱⲃⲓ	ϩⲓ|ϫⲱⲃⲓ
ϩⲓⲇⲁⲓⲙⲱⲛ	ϩⲓ|ⲇⲁⲓⲙⲱⲛ
ϩⲓⲇⲉⲙⲱⲛ	ϩⲓ|ⲇⲉⲙⲱⲛ
ϩⲓⲉⲣⲟⲩⲥⲁⲗⲏⲙ	ϩⲓⲉⲣⲟⲩⲥⲁⲗⲏⲙ
ϩⲓⲏⲃ	ϩⲓⲏⲃ
ϩⲓⲑⲁϥ	ϩⲓ|ⲑⲁϥ
ϩⲓⲕⲟⲧ	ϩⲓⲕⲟⲧ
ϩⲓⲕⲱⲛ	ϩⲓⲕⲱⲛ
ϩⲓⲛⲁ	ϩⲓⲛⲁ
ϩⲓⲟⲙⲓ	ϩⲓⲟⲙⲓ
ϩⲓⲟⲩⲓ	ϩⲓⲟⲩⲓ
ϩⲓⲣⲉⲛ	ϩⲓⲣⲉⲛ
ϩⲓⲣⲏⲛⲏ	ϩⲓⲣⲏⲛⲏ
ϩⲓⲥⲕⲉⲛ	ϩⲓⲥⲕⲉⲛ
ϩⲓⲥⲧⲟⲣⲉⲓⲛ	ϩⲓⲥⲧⲟⲣⲉⲓⲛ
ϩⲓⲧ	ϩⲓⲧ
ϩⲓⲧⲉⲛ	ϩⲓⲧⲉⲛ
ϩⲓⲧⲟⲟⲧ	ϩⲓⲧⲟⲟⲧ
ϩⲓⲧⲟⲧ	ϩⲓ|ⲧⲟⲧ
ϩⲓⲱ	ϩⲓⲱ
ϩⲓⲱⲓϣ	ϩⲓ|ⲱⲓϣ
ϩⲓⲱⲛⲓ	ϩⲓ|ⲱⲛⲓ
ϩⲓⲱⲟⲩⲧ	ϩⲓⲱⲟⲩⲧ
ϩⲓⲱⲡ	ϩⲓ|ⲱⲡ
ϩⲓⲱⲧ	ϩⲓⲱⲧ
ϩⲕⲟ	ϩⲕⲟ
ϩⲗⲓ	ϩⲗⲓ
ϩⲙⲟⲧ	ϩⲙⲟⲧ
ϩⲙⲟⲩ	ϩⲙⲟⲩ
ϩⲛⲁ	ϩⲛⲁ
ϩⲛⲉ	ϩⲛⲉ
ϩⲛⲏ	ϩⲛⲏ
ϩⲟ	ϩⲟ
ϩⲟϥ	ϩⲟϥ
ϩⲟϫϩⲉϫ	ϩⲟϫϩⲉϫ
ϩⲟϯ	ϩⲟϯ
ϩⲟⲃⲥ	ϩⲟⲃⲥ
ϩⲟⲕⲉⲣ	ϩⲟⲕⲉⲣ
ϩⲟⲗϫ	ϩⲟⲗϫ
ϩⲟⲗⲱⲥ	ϩⲟⲗⲱⲥ
ϩⲟⲙⲟⲗⲟⲅⲏⲧⲏⲥ	ϩⲟⲙⲟⲗⲟⲅⲏⲧⲏⲥ
ϩⲟⲙⲟⲗⲟⲅⲓⲁ	ϩⲟⲙⲟⲗⲟⲅⲓⲁ
ϩⲟⲙⲧ	ϩⲟⲙⲧ
ϩⲟⲛϩⲉⲛ	ϩⲟⲛϩⲉⲛ
ϩⲟⲟⲩ	ϩⲟⲟⲩ
ϩⲟⲡ	ϩⲟⲡ
ϩⲟⲡⲱⲥ	ϩⲟⲡⲱⲥ
ϩⲟⲣϣ	ϩⲟⲣϣ
ϩⲟⲣⲧϥ	ϩⲟⲣⲧϥ
ϩⲟⲥⲇⲉ	ϩⲟⲥⲇⲉ
ϩⲟⲥⲓⲱⲧⲁⲧⲟⲥ	ϩⲟⲥⲓⲱⲧⲁⲧⲟⲥ
ϩⲟⲥⲟⲛ	ϩⲟⲥⲟⲛ
ϩⲟⲧⲁⲛ	ϩⲟⲧⲁⲛ
ϩⲟⲧⲉ	ϩⲟⲧⲉ
ϩⲟⲩⲁϯ	ϩⲟⲩⲁϯ
ϩⲟⲩⲉⲧⲟⲩⲱⲧ	ϩⲟⲩⲉⲧⲟⲩⲱⲧ
ϩⲟⲩⲓⲧ	ϩⲟⲩⲓⲧ
ϩⲟⲩⲟ	ϩⲟⲩⲟ
ϩⲣⲁ	ϩⲣⲁ
ϩⲣⲏⲓ	ϩⲣⲏⲓ
ϩⲣⲱⲧ	ϩⲣⲱⲧ
ϩⲩⲅⲟⲩⲙⲉⲛⲟⲥ	ϩⲩⲅⲟⲩⲙⲉⲛⲟⲥ
ϩⲩⲇⲟⲩⲙⲉⲁ	ϩⲩⲇⲟⲩⲙⲉⲁ
ϩⲩⲡⲁⲣⲭⲟⲛⲧⲁ	ϩⲩⲡⲁⲣⲭⲟⲛⲧⲁ
ϩⲩⲡⲉⲣⲉⲧⲏⲥ	ϩⲩⲡⲉⲣⲉⲧⲏⲥ
ϩⲩⲡⲏⲣⲉⲧⲏⲥ	ϩⲩⲡⲏⲣⲉⲧⲏⲥ
ϩⲩⲡⲟⲙⲟⲛⲏ	ϩⲩⲡⲟⲙⲟⲛⲏ
ϩⲩⲥⲟⲥ	ϩⲩⲥⲟⲥ
ϩⲱ	ϩⲱ
ϩⲱϯ	ϩⲱϯ
ϩⲱⲃ	ϩⲱⲃ
ϩⲱⲃⲥ	ϩⲱⲃⲥ
ϩⲱⲗ	ϩⲱⲗ
ϩⲱⲗⲉⲙ	ϩⲱⲗⲉⲙ
ϩⲱⲟⲩ	ϩⲱⲟⲩ
ϩⲱⲟⲩϣ	ϩⲱⲟⲩϣ
ϩⲱⲟⲩⲧ	ϩⲱⲟⲩⲧ
ϩⲱⲡ	ϩⲱⲡ
ϩⲱⲣⲡ	ϩⲱⲣⲡ
ϩⲱⲥ	ϩⲱⲥ
ϩⲱⲥⲧⲉ	ϩⲱⲥⲧⲉ
ϩⲱⲧⲡ	ϩⲱⲧⲡ
ϫⲁϫⲓ	ϫⲁϫⲓ
ϫⲁϫⲣⲓⲙ	ϫⲁϫⲣⲓⲙ
ϫⲁϭⲏ	ϫⲁϭⲏ
ϫⲁⲓⲱⲟⲩ	ϫⲁⲓⲱⲟⲩ
ϫⲁⲗ	ϫⲁⲗ
ϫⲁⲙⲏ	ϫⲁⲙⲏ
ϫⲉ	ϫⲉ
ϫⲉϣⲥⲫⲏⲓϯ	ϫⲉϣ|ⲥⲫⲏⲓϯ
ϫⲉϫⲉⲃ	ϫⲉϫⲉⲃ
ϫⲉⲃⲥ	ϫⲉⲃⲥ
ϫⲉⲕⲉⲙ	ϫⲉⲕⲉⲙ
ϫⲉⲕⲣⲱ	ϫⲉⲕ|ⲣⲱ
ϫⲉⲙ	ϫⲉⲙ
ϫⲉⲙϩⲏⲟⲩ	ϫⲉⲙ|ϩⲏⲟⲩ
ϫⲉⲙϫⲟⲙ	ϫⲉⲙ|ϫⲟⲙ
ϫⲉⲙϯⲡⲓ	ϫⲉⲙ|ϯⲡⲓ
ϫⲉⲙⲉⲩⲕⲉⲣⲓⲁ	ϫⲉⲙ|ⲉⲩⲕⲉⲣⲓⲁ
ϫⲉⲙⲛⲟⲙϯ	ϫⲉⲙ|ⲛⲟⲙϯ
ϫⲉⲙⲟⲩⲧⲁϩ	ϫⲉⲙ|ⲟⲩⲧⲁϩ
ϫⲉⲛ	ϫⲉⲛ
ϫⲉⲛⲉⲫⲱⲣ	ϫⲉⲛⲉⲫⲱⲣ
ϫⲉⲟⲩⲁ	ϫⲉ|ⲟⲩⲁ
ϫⲉⲣⲉ	ϫⲉⲣⲉ
ϫⲏ	ϫⲏ
ϫⲏϫ	ϫⲏϫ
ϫⲏⲕ	ϫⲏⲕ
ϫⲏⲗ	ϫⲏⲗ
ϫⲓ	ϫⲓ
ϫⲓϫ	ϫⲓϫ
ϫⲓⲙⲓ	ϫⲓⲙⲓ
ϫⲓⲛϧⲟⲑⲃⲉϥ	ϫⲓⲛ|ϧⲟⲑⲃ|ⲉϥ
ϫⲓⲛⲉⲣⲟⲩⲱ	ϫⲓⲛ|ⲉⲣ|ⲟⲩⲱ
ϫⲓⲛⲉⲣⲡⲁⲙⲉⲩⲓ	ϫⲓⲛ|ⲉⲣ|ⲡⲁ|ⲙⲉⲩⲓ
ϫⲓⲛⲑⲣⲉϥⲟⲩⲉⲙϣⲱⲧ	ϫⲓⲛ|ⲑⲣⲉ|ϥ|ⲟⲩⲉⲙ|ϣⲱⲧ
ϫⲓⲛⲑⲣⲉϥⲥⲓϯ	ϫⲓⲛ|ⲑⲣⲉ|ϥ|ⲥⲓϯ
ϫⲓⲛⲑⲣⲉϥⲱⲙⲉ	ϫⲓⲛ|ⲑⲣⲉ|ϥ|ⲱⲙⲉ
ϫⲓⲛⲑⲣⲉⲡϭⲟⲉⲓⲥ	ϫⲓⲛ|ⲑⲣⲉ|ⲡ|ϭⲟⲉⲓⲥ
ϫⲓⲛⲑⲣⲉⲡⲓⲁⲥⲉⲃⲏⲥ	ϫⲓⲛ|ⲑⲣⲉ|ⲡⲓ|ⲁⲥⲉⲃⲏⲥ
ϫⲓⲛⲓ	ϫⲓⲛⲓ
ϫⲓⲛⲕⲟⲥⲧ	ϫⲓⲛ|ⲕⲟⲥ|ⲧ
ϫⲓⲛⲥⲱⲕ	ϫⲓ|ⲛ|ⲥⲱⲕ
ϫⲓⲛⲥⲱⲣⲉⲙ	ϫⲓⲛ|ⲥⲱⲣⲉⲙ
ϫⲓⲛⲭⲱ	ϫⲓⲛ|ⲭⲱ
ϫⲓⲛⲱⲛϧ	ϫⲓⲛ|ⲱⲛϧ
ϫⲟ	ϫⲟ
ϫⲟϣ	ϫⲟϣ
ϫⲟϫ	ϫⲟϫ
ϫⲟⲃⲥ	ϫⲟⲃⲥ
ϫⲟⲉⲓ	ϫⲟⲉⲓ
ϫⲟⲓ	ϫⲟⲓ
ϫⲟⲗ	ϫⲟⲗ
ϫⲟⲙ	ϫⲟⲙ
ϫⲟⲛⲥ	ϫⲟⲛⲥ
ϫⲟⲟ	ϫⲟⲟ
ϫⲟⲣ	ϫⲟⲣ
ϫⲟⲣϫ	ϫⲟⲣϫ
ϫⲟⲣϫⲥ	ϫⲟⲣϫⲥ
ϫⲟⲥ	ϫⲟⲥ
ϫⲟⲧ	ϫⲟⲧ
ϫⲟⲩϣⲧ	ϫⲟⲩϣⲧ
ϫⲣⲟϫ	ϫⲣⲟϫ
ϫⲫⲉ	ϫⲫⲉ
ϫⲫⲓⲟ	ϫⲫⲓⲟ
ϫⲫⲟ	ϫⲫⲟ
ϫⲱ	ϫⲱ
ϫⲱϫ	ϫⲱϫ
ϫⲱⲃ	ϫⲱⲃ
ϫⲱⲃⲓ	ϫⲱⲃⲓ
ϫⲱⲓⲗⲓ	ϫⲱⲓⲗⲓ
ϫⲱⲓⲧ	ϫⲱⲓⲧ
ϫⲱⲕ	ϫⲱⲕ
ϫⲱⲗ	ϫⲱⲗ
ϫⲱⲙ	ϫⲱⲙ
ϫⲱⲛⲧ	ϫⲱⲛⲧ
ϫⲱⲟⲩ	ϫⲱⲟⲩ
ϫⲱⲣ	ϫⲱⲣ
ϫⲱⲣϩ	ϫⲱⲣϩ
ϫⲱⲣϫ	ϫⲱⲣϫ
ϫⲱⲣⲓ	ϫⲱⲣⲓ
ϭⲁϧⲉⲙ	ϭⲁϧⲉⲙ
ϭⲁⲗⲁⲩϫ	ϭⲁⲗⲁⲩϫ
ϭⲁⲗⲉ	ϭⲁⲗⲉ
ϭⲁⲗⲟϫ	ϭⲁⲗⲟϫ
ϭⲁⲙⲟⲩⲗ	ϭⲁⲙⲟⲩⲗ
ϭⲁⲥⲓϩⲑⲟ	ϭⲁⲥⲓ|ϩⲑⲟ
ϭⲁⲧϥⲓ	ϭⲁⲧϥⲓ
ϭⲁⲩⲙⲱⲓⲧ	ϭⲁⲩ|ⲙⲱⲓⲧ
ϭⲉ	ϭⲉ
ϭⲉⲛⲟ	ϭⲉⲛⲟ
ϭⲉⲡϫⲱⲣⲓ	ϭⲉⲡ|ϫⲱⲣⲓ
ϭⲉⲣⲉ	ϭⲉⲣⲉ
ϭⲏϫⲓ	ϭⲏϫⲓ
ϭⲏⲟⲩ	ϭⲏⲟⲩ
ϭⲏⲡⲓ	ϭⲏⲡⲓ
ϭⲓ	ϭⲓ
ϭⲓϣϣⲱⲟⲩ	ϭⲓ|ϣϣⲱⲟⲩ
ϭⲓϣⲉⲙⲏⲣ	ϭⲓ|ϣⲉⲙⲏⲣ
ϭⲓϣⲓⲡⲓ	ϭⲓ|ϣⲓⲡⲓ
ϭⲓϧⲓⲥⲓ	ϭⲓ|ϧⲓⲥⲓ
ϭⲓϩⲁⲡ	ϭⲓ|ϩⲁⲡ
ϭⲓϩⲟ	ϭⲓ|ϩⲟ
ϭⲓⲙⲕⲁϩ	ϭⲓ|ⲙⲕⲁϩ
ϭⲓⲙⲡϣⲓϣ	ϭⲓⲙ|ⲡ|ϣⲓϣ
ϭⲓⲟⲩⲓ	ϭⲓ|ⲟⲩⲓ
ϭⲓⲥϩⲓⲙⲓ	ϭⲓ|ⲥϩⲓⲙⲓ
ϭⲓⲥⲁⲛⲓⲥ	ϭⲓ|ⲥⲁⲛⲓⲥ
ϭⲓⲥⲃⲱ	ϭⲓ|ⲥⲃⲱ
ϭⲓⲥⲓ	ϭⲓⲥⲓ
ϭⲓⲧ	ϭⲓⲧ
ϭⲓⲫⲉⲓ	ϭⲓ|ⲫⲉⲓ
ϭⲓⲭⲣⲱⲙ	ϭⲓ|ⲭⲣⲱⲙ
ϭⲓⲱⲓⲕ	ϭⲓ|ⲱⲓⲕ
ϭⲓⲱⲙⲥ	ϭⲓ|ⲱⲙⲥ
ϭⲓⲱⲟⲩ	ϭⲓ|ⲱⲟⲩ
ϭⲗⲓⲗ	ϭⲗⲓⲗ
ϭⲗⲟϫ	ϭⲗⲟϫ
ϭⲛⲉ	ϭⲛⲉ
ϭⲛⲉϫⲱ	ϭⲛⲉ|ϫⲱ
ϭⲛⲟⲛ	ϭⲛⲟⲛ
ϭⲟ	ϭⲟ
ϭⲟϫⲓ	ϭⲟϫⲓ
ϭⲟⲉⲓⲥ	ϭⲟⲉⲓⲥ
ϭⲟⲓⲥ	ϭⲟⲓⲥ
ϭⲟⲛⲧ	ϭⲟⲛⲧ
ϭⲟⲣⲡ	ϭⲟⲣⲡ
ϭⲟⲥϫⲉⲥ	ϭⲟⲥϫⲉⲥ
ϭⲟⲥⲓ	ϭⲟⲥⲓ
ϭⲣⲟ	ϭⲣⲟ
ϭⲣⲟϩ	ϭⲣⲟϩ
ϭⲣⲟⲙⲡⲓ	ϭⲣⲟⲙⲡⲓ
ϭⲣⲟⲡ	ϭⲣⲟⲡ
ϭⲱϧⲉⲙ	ϭⲱϧⲉⲙ
ϭⲱⲛⲧ	ϭⲱⲛⲧ
ϭⲱⲣⲡ	ϭⲱⲣⲡ
ϯ	ϯ
ϯϣⲉⲩⲛⲓ	ϯ|ϣⲉⲩⲛⲓ
ϯϣⲓⲡⲓ	ϯ|ϣⲓⲡⲓ
ϯϣⲱϣ	ϯ|ϣⲱϣ
ϯϧⲓⲥⲓ	ϯ|ϧⲓⲥⲓ
ϯϩⲁⲡ	ϯ|ϩⲁⲡ
ϯϩⲟ	ϯ|ϩⲟ
ϯϫⲱ	ϯ|ϫⲱ
ϯϭⲓ	ϯ|ϭⲓ
ϯϭⲗⲁⲕ	ϯ|ϭⲗⲁⲕ
ϯⲁⲥⲟ	ϯ|ⲁⲥⲟ
ϯⲉⲛⲧⲟⲗⲏ	ϯ|ⲉⲛⲧⲟⲗⲏ
ϯⲉⲣϣⲓϣⲓ	ϯ|ⲉⲣ|ϣⲓϣⲓ
ϯⲕⲉϩ	ϯ|ⲕⲉϩ
ϯⲙⲁϯ	ϯ|ⲙⲁϯ
ϯⲙⲓ	ϯⲙⲓ
ϯⲙⲧⲟⲛ	ϯ|ⲙⲧⲟⲛ
ϯⲛⲟⲙϯ	ϯ|ⲛⲟⲙϯ
ϯⲛⲟⲩ	ϯⲛⲟⲩ
ϯⲟⲥⲓ	ϯ|ⲟⲥⲓ
ϯⲟⲩⲧⲁϩ	ϯ|ⲟⲩⲧⲁϩ
ϯⲟⲩⲱ	ϯ|ⲟⲩⲱ
ϯⲟⲩⲱⲙ	ϯ|ⲟⲩⲱⲙ
ϯⲡⲓ	ϯⲡⲓ
ϯⲣⲁⲛ	ϯ|ⲣⲁⲛ
ϯⲥⲃⲱ	ϯ|ⲥⲃⲱ
ϯⲧⲟⲧ	ϯ|ⲧⲟⲧ
ϯⲫⲓ	ϯ|ⲫⲓ
ϯⲫⲟ	ϯⲫⲟ
ϯⲭⲟϩ	ϯ|ⲭⲟϩ
ϯⲱⲙⲥ	ϯ|ⲱⲙⲥ
ϯⲱⲟⲩ	ϯ|ⲱⲟⲩ
ⲁ	ⲁ
ⲁϣ	ⲁϣ
ⲁϣⲁⲓ	ⲁϣⲁⲓ
ⲁϥ	ⲁϥ
ⲁϥϣⲁⲛ	ⲁϥϣⲁⲛ
ⲁϧⲟ	ⲁϧⲟ
ⲁϧⲱ	ⲁϧⲱ
ⲁϧⲱⲙ	ⲁϧⲱⲙ
ⲁϩⲟ	ⲁϩⲟ
ⲁϫⲟ	ⲁϫⲟ
ⲁϫⲡⲅ	ⲁϫⲡ|ⲅ
ⲁϫⲡⲋ	ⲁϫⲡ|ⲋ
ⲁϫⲡⲑ	ⲁϫⲡ|ⲑ
ⲁϫⲱ	ⲁϫⲱ
ⲁϭⲛⲉ	ⲁϭⲛⲉ
ⲁⲃⲃⲁ	ⲁⲃⲃⲁ
ⲁⲃⲃⲁⲕⲟⲩⲙ	ⲁⲃⲃⲁⲕⲟⲩⲙ
ⲁⲃⲏⲧ	ⲁⲃⲏⲧ
ⲁⲃⲓⲁⲑⲁⲣ	ⲁⲃⲓⲁⲑⲁⲣ
ⲁⲃⲟⲧ	ⲁⲃⲟⲧ
ⲁⲃⲣⲁⲁⲙ	ⲁⲃⲣⲁⲁⲙ
ⲁⲃⲱ	ⲁⲃⲱ
ⲁⲅⲁⲑⲟⲛ	ⲁⲅⲁⲑⲟⲛ
ⲁⲅⲁⲑⲟⲥ	ⲁⲅⲁⲑⲟⲥ
ⲁⲅⲁⲡⲏ	ⲁⲅⲁⲡⲏ
ⲁⲅⲁⲡⲏⲧⲟⲥ	ⲁⲅⲁⲡⲏⲧⲟⲥ
ⲁⲅⲅⲉⲗⲟⲥ	ⲁⲅⲅⲉⲗⲟⲥ
ⲁⲅⲉⲗⲏ	ⲁⲅⲉⲗⲏ
ⲁⲅⲓⲟⲥ	ⲁⲅⲓⲟⲥ
ⲁⲅⲟⲣⲁ	ⲁⲅⲟⲣⲁ
ⲁⲇⲁⲙ	ⲁⲇⲁⲙ
ⲁⲇⲟⲕⲓⲙⲟⲥ	ⲁⲇⲟⲕⲓⲙⲟⲥ
ⲁⲏⲣ	ⲁⲏⲣ
ⲁⲑⲙⲟⲩⲛⲕ	ⲁⲑ|ⲙⲟⲩⲛⲕ
ⲁⲑⲛⲁϩϯ	ⲁⲑ|ⲛⲁϩϯ
ⲁⲓ	ⲁⲓ
ⲁⲓϣⲁⲛ	ⲁⲓϣⲁⲛ
ⲁⲓⲁⲓ	ⲁⲓⲁⲓ
ⲁⲓⲧ	ⲁⲓⲧ
ⲁⲓⲧⲓⲁ	ⲁⲓⲧⲓⲁ
ⲁⲕϣⲁⲛ	ⲁⲕϣⲁⲛ
ⲁⲕⲁⲑⲁⲣⲧⲟⲛ	ⲁⲕⲁⲑⲁⲣⲧⲟⲛ
ⲁⲕⲁⲑⲣⲧⲟⲛ	ⲁⲕⲁⲑⲣⲧⲟⲛ
ⲁⲕⲩⲗⲁ	ⲁⲕⲩⲗⲁ
ⲁⲗⲉⲕⲧⲱⲣ	ⲁⲗⲉⲕⲧⲱⲣ
ⲁⲗⲉⲝⲁⲛⲇⲣⲟⲥ	ⲁⲗⲉⲝⲁⲛⲇⲣⲟⲥ
ⲁⲗⲏⲑⲓⲛⲟⲛ	ⲁⲗⲏⲑⲓⲛⲟⲛ
ⲁⲗⲏⲑⲱⲥ	ⲁⲗⲏⲑⲱⲥ
ⲁⲗⲏⲓ	ⲁⲗⲏⲓ
ⲁⲗⲓⲟⲩⲓ	ⲁⲗⲓⲟⲩⲓ
ⲁⲗⲗⲁ	ⲁⲗⲗⲁ
ⲁⲗⲟⲗⲓ	ⲁⲗⲟⲗⲓ
ⲁⲗⲟⲩ	ⲁⲗⲟⲩ
ⲁⲗⲫⲉⲟⲥ	ⲁⲗⲫⲉⲟⲥ
ⲁⲗⲱϫ	ⲁⲗⲱϫ
ⲁⲗⲱⲟⲩⲓ	ⲁⲗⲱⲟⲩⲓ
ⲁⲙϣⲉ	ⲁⲙϣⲉ
ⲁⲙⲁϩⲓ	ⲁⲙⲁϩⲓ
ⲁⲙⲏⲛ	ⲁⲙⲏⲛ
ⲁⲙⲟⲓ	ⲁⲙⲟⲓ
ⲁⲙⲟⲛⲓ	ⲁⲙⲟⲛⲓ
ⲁⲙⲟⲩ	ⲁⲙⲟⲩ
ⲁⲙⲱⲓⲛⲓ	ⲁⲙⲱⲓⲛⲓ
ⲁⲛ	ⲁⲛ
ⲁⲛϣⲁⲛ	ⲁⲛϣⲁⲛ
ⲁⲛⲁ	ⲁⲛⲁ
ⲁⲛⲁϣ	ⲁⲛⲁϣ
ⲁⲛⲁⲅⲕⲁⲓⲟⲛ	ⲁⲛⲁⲅⲕⲁⲓⲟⲛ
ⲁⲛⲁⲅⲕⲉⲟⲛ	ⲁⲛⲁⲅⲕⲉⲟⲛ
ⲁⲛⲁⲅⲕⲏ	ⲁⲛⲁⲅⲕⲏ
ⲁⲛⲁⲑⲉⲙⲁ	ⲁⲛⲁⲑⲉⲙⲁ
ⲁⲛⲁⲙⲏⲓ	ⲁⲛⲁⲙⲏⲓ
ⲁⲛⲁⲥⲧⲁⲥⲓⲥ	ⲁⲛⲁⲥⲧⲁⲥⲓⲥ
ⲁⲛⲁⲩ	ⲁⲛⲁⲩ
ⲁⲛⲁⲩϣ	ⲁⲛⲁⲩϣ
ⲁⲛⲇⲣⲉⲁⲥ	ⲁⲛⲇⲣⲉⲁⲥ
ⲁⲛⲍⲏⲃ	ⲁⲛⲍⲏⲃ
ⲁⲛⲓⲟⲩⲓ	ⲁⲛⲓⲟⲩⲓ
ⲁⲛⲓⲧ	ⲁⲛⲓⲧ
ⲁⲛⲛⲁ	ⲁⲛⲛⲁ
ⲁⲛⲟⲕ	ⲁⲛⲟⲕ
ⲁⲛⲟⲙⲟⲥ	ⲁⲛⲟⲙⲟⲥ
ⲁⲛⲟⲛ	ⲁⲛⲟⲛ
ⲁⲛⲧⲓⲕⲓⲙⲉⲛⲟⲥ	ⲁⲛⲧⲓⲕⲓⲙⲉⲛⲟⲥ
ⲁⲟⲩⲱⲛ	ⲁⲟⲩⲱⲛ
ⲁⲡⲁⲣⲭⲏ	ⲁⲡⲁⲣⲭⲏ
ⲁⲡⲁⲥ	ⲁⲡⲁⲥ
ⲁⲡⲁⲧⲏ	ⲁⲡⲁⲧⲏ
ⲁⲡⲉⲗⲉⲩⲑⲉⲣⲟⲥ	ⲁⲡⲉⲗⲉⲩⲑⲉⲣⲟⲥ
ⲁⲡⲟⲗⲗⲱ	ⲁⲡⲟⲗⲗⲱ
ⲁⲡⲟⲗⲟⲅⲓⲁ	ⲁⲡⲟⲗⲟⲅⲓⲁ
ⲁⲡⲟⲙⲉⲣⲟⲥ	ⲁⲡⲟⲙⲉⲣⲟⲥ
ⲁⲡⲟⲥⲧⲏⲑⲏⲥ	ⲁⲡⲟⲥⲧⲏⲑⲏⲥ
ⲁⲡⲟⲥⲧⲟⲗⲟⲥ	ⲁⲡⲟⲥⲧⲟⲗⲟⲥ
ⲁⲣⲁⲃⲓⲁ	ⲁⲣⲁⲃⲓⲁ
ⲁⲣⲉ	ⲁⲣⲉ
ⲁⲣⲉϣⲁⲛ	ⲁⲣⲉϣⲁⲛ
ⲁⲣⲉϩ	ⲁⲣⲉϩ
ⲁⲣⲉⲧⲉⲛϣⲁⲛ	ⲁⲣⲉⲧⲉⲛϣⲁⲛ
ⲁⲣⲉⲧⲏ	ⲁⲣⲉⲧⲏ
ⲁⲣⲏⲟⲩ	ⲁⲣⲏⲟⲩ
ⲁⲣⲓ	ⲁⲣⲓ
ⲁⲣⲓϣⲫⲏⲣⲓ	ⲁⲣⲓ|ϣⲫⲏⲣⲓ
ⲁⲣⲓϩⲓⲣⲏⲛⲏ	ⲁⲣⲓ|ϩⲓⲣⲏⲛⲏ
ⲁⲣⲓⲁⲗⲟⲩ	ⲁⲣⲓ|ⲁⲗⲟⲩ
ⲁⲣⲓⲁⲥⲡⲁⲍⲉⲥⲑⲉ	ⲁⲣⲓ|ⲁⲥⲡⲁⲍⲉⲥⲑⲉ
ⲁⲣⲓⲃⲟⲏⲑⲓⲛ	ⲁⲣⲓ|ⲃⲟⲏⲑⲓⲛ
ⲁⲣⲓⲇⲟⲕⲓⲙⲁⲍⲉⲓⲛ	ⲁⲣⲓ|ⲇⲟⲕⲓⲙⲁⲍⲉⲓⲛ
ⲁⲣⲓⲉⲓⲙⲉ	ⲁⲣⲓ|ⲉⲓⲙⲉ
ⲁⲣⲓⲉⲙⲓ	ⲁⲣⲓ|ⲉⲙⲓ
ⲁⲣⲓⲉⲧⲓⲛ	ⲁⲣⲓ|ⲉⲧⲓⲛ
ⲁⲣⲓⲕⲁⲑⲁⲣⲓⲍⲉⲓⲛ	ⲁⲣⲓ|ⲕⲁⲑⲁⲣⲓⲍⲉⲓⲛ
ⲁⲣⲓⲙⲁⲑⲉⲁⲥ	ⲁⲣⲓⲙⲁⲑⲉⲁⲥ
ⲁⲣⲓⲙⲉⲧⲁⲛⲟⲓⲛ	ⲁⲣⲓ|ⲙⲉⲧⲁⲛⲟⲓⲛ
ⲁⲣⲓⲟⲩⲓ	ⲁⲣⲓⲟⲩⲓ
ⲁⲣⲓⲟⲩⲱ	ⲁⲣⲓ|ⲟⲩⲱ
ⲁⲣⲓⲡⲣⲟⲥⲉⲩⲭⲉⲥⲑⲉ	ⲁⲣⲓ|ⲡⲣⲟⲥⲉⲩⲭⲉⲥⲑⲉ
ⲁⲣⲓⲡⲣⲟⲫⲏⲧⲉⲩⲓⲛ	ⲁⲣⲓ|ⲡⲣⲟⲫⲏⲧⲉⲩⲓⲛ
ⲁⲣⲓⲧ	ⲁⲣⲓⲧ
ⲁⲣⲓⲧⲓⲙⲁⲛ	ⲁⲣⲓ|ⲧⲓⲙⲁⲛ
ⲁⲣⲭⲉⲓⲣⲉⲩⲥ	ⲁⲣⲭⲉⲓⲣⲉⲩⲥ
ⲁⲣⲭⲉⲟⲥ	ⲁⲣⲭⲉⲟⲥ
ⲁⲣⲭⲏ	ⲁⲣⲭⲏ
ⲁⲣⲭⲏⲇⲉⲕⲧⲱⲛ	ⲁⲣⲭⲏⲇⲉⲕⲧⲱⲛ
ⲁⲣⲭⲏⲥⲩⲛⲁⲅⲱⲅⲟⲥ	ⲁⲣⲭⲏⲥⲩⲛⲁⲅⲱⲅⲟⲥ
ⲁⲣⲭⲓⲉⲡⲓⲥⲕⲟⲡⲟⲥ	ⲁⲣⲭⲓⲉⲡⲓⲥⲕⲟⲡⲟⲥ
ⲁⲣⲭⲓⲉⲣⲉⲩⲥ	ⲁⲣⲭⲓⲉⲣⲉⲩⲥ
ⲁⲣⲭⲱⲛ	ⲁⲣⲭⲱⲛ
ⲁⲥϣⲁⲛ	ⲁⲥϣⲁⲛ
ⲁⲥⲉⲃⲏⲥ	ⲁⲥⲉⲃⲏⲥ
ⲁⲥⲑⲉⲛⲏⲥ	ⲁⲥⲑⲉⲛⲏⲥ
ⲁⲥⲓⲁ	ⲁⲥⲓⲁ
ⲁⲥⲓⲱⲟⲩ	ⲁⲥⲓⲱⲟⲩ
ⲁⲥⲕⲏⲥⲓⲥ	ⲁⲥⲕⲏⲥⲓⲥ
ⲁⲥⲕⲏⲧⲏⲥ	ⲁⲥⲕⲏⲧⲏⲥ
ⲁⲥⲕⲟⲥ	ⲁⲥⲕⲟⲥ
ⲁⲥⲡⲁⲥⲙⲟⲥ	ⲁⲥⲡⲁⲥⲙⲟⲥ
ⲁⲥⲡⲓ	ⲁⲥⲡⲓ
ⲁⲥⲫⲁⲗⲱⲥ	ⲁⲥⲫⲁⲗⲱⲥ
ⲁⲧϣⲉⲙⲏⲣ	ⲁⲧ|ϣⲉⲙⲏⲣ
ⲁⲧϣⲧⲁϩⲱⲟⲩ	ⲁⲧ|ϣ|ⲧⲁϩⲱⲟⲩ
ⲁⲧϧⲣⲱⲟⲩ	ⲁⲧ|ϧⲣⲱⲟⲩ
ⲁⲧϩⲏⲧ	ⲁⲧ|ϩⲏⲧ
ⲁⲧϩⲛⲁϩϯ	ⲁⲑ|ϩⲛⲁϩϯ
ⲁⲧϭⲉⲛⲟ	ⲁⲧ|ϭⲉⲛⲟ
ⲁⲧϭⲛⲉ	ⲁⲧϭⲛⲉ
ⲁⲧϭⲛⲟⲩ	ⲁⲧϭⲛⲟⲩ
ⲁⲧϭⲣⲟⲡ	ⲁⲧ|ϭⲣⲟⲡ
ⲁⲧⲁⲕⲟ	ⲁ|ⲧⲁⲕⲟ
ⲁⲧⲁⲣⲓⲕⲓ	ⲁⲧ|ⲁⲣⲓⲕⲓ
ⲁⲧⲉⲙⲓ	ⲁⲧ|ⲉⲙⲓ
ⲁⲧⲓⲁⲧⲟⲧⲟⲩ	ⲁⲧ|ⲓⲁ|ⲧⲟⲧ|ⲟⲩ
ⲁⲧⲕⲁϯ	ⲁⲧ|ⲕⲁϯ
ⲁⲧⲕⲓⲙ	ⲁⲧ|ⲕⲓⲙ
ⲁⲧⲛⲁϩϯ	ⲁⲧ|ⲛⲁϩϯ
ⲁⲧⲟⲟⲩⲓ	ⲁⲧⲟⲟⲩⲓ
ⲁⲧⲟⲩⲧⲁϩ	ⲁⲧ|ⲟⲩⲧⲁϩ
ⲁⲧⲟⲩⲱⲙ	ⲁⲧ|ⲟⲩⲱⲙ
ⲁⲧⲣⲱⲟⲩϣ	ⲁⲧ|ⲣⲱⲟⲩϣ
ⲁⲧⲥⲁϫⲓ	ⲁⲧ|ⲥⲁϫⲓ
ⲁⲧⲥⲙⲟⲩ	ⲁⲧ|ⲥⲙⲟⲩ
ⲁⲧⲧⲁⲕⲟ	ⲁⲧ|ⲧⲁⲕⲟ
ⲁⲧⲯⲩⲭⲏ	ⲁⲧ|ⲯⲩⲭⲏ
ⲁⲩ	ⲁⲩ
ⲁⲩϣⲁⲛ	ⲁⲩϣⲁⲛ
ⲁⲩⲗⲏ	ⲁⲩⲗⲏ
ⲁⲩⲣⲏϫ	ⲁⲩⲣⲏϫ
ⲁⲫⲉ	ⲁⲫⲉ
ⲁⲫⲏⲟⲩⲓ	ⲁⲫⲏⲟⲩⲓ
ⲁⲫⲟϩ	ⲁⲫⲟϩ
ⲁⲫⲟⲧ	ⲁⲫⲟⲧ
ⲁⲭⲁⲓⲁ	ⲁⲭⲁⲓⲁ
ⲁⲭⲁⲓⲕⲟⲥ	ⲁⲭⲁⲓⲕⲟⲥ
ⲃ	ⲃ
ⲃⲁϣ	ⲃⲁϣ
ⲃⲁⲓ	ⲃⲁⲓ
ⲃⲁⲕⲓ	ⲃⲁⲕⲓ
ⲃⲁⲗ	ⲃⲁⲗ
ⲃⲁⲣⲁⲃⲃⲁⲥ	ⲃⲁⲣⲁⲃⲃⲁⲥ
ⲃⲁⲣⲃⲁⲣⲟⲥ	ⲃⲁⲣⲃⲁⲣⲟⲥ
ⲃⲁⲣⲃⲃⲁⲥ	ⲃⲁⲣⲃⲃⲁⲥ
ⲃⲁⲣⲑⲟⲗⲟⲙⲉⲟⲥ	ⲃⲁⲣⲑⲟⲗⲟⲙⲉⲟⲥ
ⲃⲁⲣⲛⲁⲃⲁⲥ	ⲃⲁⲣⲛⲁⲃⲁⲥ
ⲃⲁⲣⲧⲓⲙⲉⲟⲥ	ⲃⲁⲣⲧⲓⲙⲉⲟⲥ
ⲃⲁⲧⲟⲥ	ⲃⲁⲧⲟⲥ
ⲃⲉⲗ	ⲃⲉⲗ
ⲃⲉⲗⲍⲉⲃⲟⲩⲗ	ⲃⲉⲗⲍⲉⲃⲟⲩⲗ
ⲃⲉⲗⲗⲉ	ⲃⲉⲗⲗⲉ
ⲃⲉⲣⲃⲱⲣ	ⲃⲉⲣⲃⲱⲣ
ⲃⲉⲣⲓ	ⲃⲉⲣⲓ
ⲃⲉⲭⲉ	ⲃⲉⲭⲉ
ⲃⲏϣ	ⲃⲏϣ
ⲃⲏⲃ	ⲃⲏⲃ
ⲃⲏⲑⲁⲛⲓⲁ	ⲃⲏⲑⲁⲛⲓⲁ
ⲃⲏⲑⲥⲁⲓⲇⲁ	ⲃⲏⲑⲥⲁⲓⲇⲁ
ⲃⲏⲑⲫⲁⲅⲏ	ⲃⲏⲑⲫⲁⲅⲏ
ⲃⲏⲗ	ⲃⲏⲗ
ⲃⲏⲙⲁ	ⲃⲏⲙⲁ
ⲃⲓⲛⲁϫ	ⲃⲓⲛⲁϫ
ⲃⲓⲟⲥ	ⲃⲓⲟⲥ
ⲃⲓⲣ	ⲃⲓⲣ
ⲃⲟⲁⲛⲏⲣⲅⲉⲥ	ⲃⲟⲁⲛⲏⲣⲅⲉⲥ
ⲃⲟⲕⲓ	ⲃⲟⲕⲓ
ⲃⲟⲗ	ⲃⲟⲗ
ⲃⲟⲩⲗⲉⲩⲧⲏⲥ	ⲃⲟⲩⲗⲉⲩⲧⲏⲥ
ⲃⲱ	ⲃⲱ
ⲃⲱϣ	ⲃⲱϣ
ⲃⲱⲕ	ⲃⲱⲕ
ⲃⲱⲕⲓ	ⲃⲱⲕⲓ
ⲃⲱⲗ	ⲃⲱⲗ
ⲅ	ⲅ
ⲅⲁⲍⲟⲫⲩⲗⲁⲕⲓⲟⲛ	ⲅⲁⲍⲟⲫⲩⲗⲁⲕⲓⲟⲛ
ⲅⲁⲓⲟⲥ	ⲅⲁⲓⲟⲥ
ⲅⲁⲗⲁⲧⲓⲁ	ⲅⲁⲗⲁⲧⲓⲁ
ⲅⲁⲗⲓⲗⲉⲁ	ⲅⲁⲗⲓⲗⲉⲁ
ⲅⲁⲗⲓⲗⲉⲟⲥ	ⲅⲁⲗⲓⲗⲉⲟⲥ
ⲅⲁⲙⲟⲥ	ⲅⲁⲙⲟⲥ
ⲅⲁⲣ	ⲅⲁⲣ
ⲅⲉ	ⲅⲉ
ⲅⲉⲉⲛⲛⲁ	ⲅⲉⲉⲛⲛⲁ
ⲅⲉⲑⲥⲏⲙⲁⲛⲓ	ⲅⲉⲑⲥⲏⲙⲁⲛⲓ
ⲅⲉⲛⲉⲁ	ⲅⲉⲛⲉⲁ
ⲅⲉⲛⲛⲏⲥⲁⲣⲉⲑ	ⲅⲉⲛⲛⲏⲥⲁⲣⲉⲑ
ⲅⲉⲛⲟⲥ	ⲅⲉⲛⲟⲥ
ⲅⲉⲣⲅⲉⲥⲏⲛⲟⲥ	ⲅⲉⲣⲅⲉⲥⲏⲛⲟⲥ
ⲅⲉⲱⲣⲅⲓⲟⲥ	ⲅⲉⲱⲣⲅⲓⲟⲥ
ⲅⲛⲱⲙⲏ	ⲅⲛⲱⲙⲏ
ⲅⲟⲗⲅⲟⲑⲁ	ⲅⲟⲗⲅⲟⲑⲁ
ⲅⲣⲁϥⲏ	ⲅⲣⲁϥⲏ
ⲅⲣⲁⲫⲏ	ⲅⲣⲁⲫⲏ
ⲇ	ⲇ
ⲇⲁⲓⲙⲱⲛ	ⲇⲁⲓⲙⲱⲛ
ⲇⲁⲗⲙⲁⲛⲟⲩⲑⲁ	ⲇⲁⲗⲙⲁⲛⲟⲩⲑⲁ
ⲇⲁⲩⲓⲇ	ⲇⲁⲩⲓⲇ
ⲇⲉ	ⲇⲉ
ⲇⲉⲛ	ⲇⲉⲛ
ⲇⲓⲁⲃⲟⲗⲟⲥ	ⲇⲓⲁⲃⲟⲗⲟⲥ
ⲇⲓⲁⲑⲏⲕⲏ	ⲇⲓⲁⲑⲏⲕⲏ
ⲇⲓⲁⲕⲟⲛⲓⲁ	ⲇⲓⲁⲕⲟⲛⲓⲁ
ⲇⲓⲁⲕⲱⲛ	ⲇⲓⲁⲕⲱⲛ
ⲇⲓⲁⲕⲱⲛⲓⲁ	ⲇⲓⲁⲕⲱⲛⲓⲁ
ⲇⲓⲕⲁⲓⲟⲥⲩⲛⲏ	ⲇⲓⲕⲁⲓⲟⲥⲩⲛⲏ
ⲇⲓⲕⲉⲟⲥ	ⲇⲓⲕⲉⲟⲥ
ⲇⲓⲟⲥⲕⲟⲣⲟⲥ	ⲇⲓⲟⲥⲕⲟⲣⲟⲥ
ⲇⲓⲡⲛⲟⲛ	ⲇⲓⲡⲛⲟⲛ
ⲇⲓⲱⲅⲙⲟⲥ	ⲇⲓⲱⲅⲙⲟⲥ
ⲇⲟⲕⲓⲙⲏ	ⲇⲟⲕⲓⲙⲏ
ⲇⲟⲗⲟⲥ	ⲇⲟⲗⲟⲥ
ⲇⲱⲣⲟⲛ	ⲇⲱⲣⲟⲛ
ⲉ	ⲉ
ⲉϣ	ⲉϣ
ⲉϣⲁⲩ	ⲉϣⲁⲩ
ⲉϣⲗⲏⲗⲟⲩⲓ	ⲉϣⲗⲏⲗⲟⲩⲓ
ⲉϣⲱⲡ	ⲉϣⲱⲡ
ⲉϥ	ⲉϥ
ⲉϥⲉ	ⲉϥⲉ
ⲉϧⲟⲩⲛ	ⲉϧⲟⲩⲛ
ⲉϧⲣⲏⲓ	ⲉϧⲣⲏⲓ
ⲉϩⲉ	ⲉϩⲉ
ⲉϩⲛⲁ	ⲉϩⲛⲁ
ⲉϩⲟⲟⲩ	ⲉϩⲟⲟⲩ
ⲉϩⲟⲧ	ⲉϩⲟⲧ
ⲉϩⲟⲧⲉ	ⲉϩⲟⲧⲉ
ⲉϩⲟⲧⲉⲣⲟ	ⲉϩⲟⲧⲉⲣⲟ
ⲉϩⲣⲁ	ⲉϩⲣⲁ
ⲉϩⲣⲉⲛ	ⲉϩⲣⲉⲛ
ⲉϩⲣⲏⲓ	ⲉϩⲣⲏⲓ
ⲉϩⲱⲟⲩ	ⲉϩⲱⲟⲩ
ⲉϫⲉⲛ	ⲉϫⲉⲛ
ⲉϫⲏⲟⲩ	ⲉϫⲏⲟⲩ
ⲉϫⲱ	ⲉϫⲱ
ⲉϫⲱⲣϩ	ⲉϫⲱⲣϩ
ⲉⲁ	ⲉⲁ
ⲉⲃⲏⲗ	ⲉⲃⲏⲗ
ⲉⲃⲓ	ⲉⲃⲓ
ⲉⲃⲓⲁⲓⲕ	ⲉⲃⲓⲁⲓⲕ
ⲉⲃⲓⲱ	ⲉⲃⲓⲱ
ⲉⲃⲟ	ⲉⲃⲟ
ⲉⲃⲟⲗ	ⲉⲃⲟⲗ
ⲉⲃⲣⲏϫ	ⲉⲃⲣⲏϫ
ⲉⲅⲕⲱⲓⲟⲛ	ⲉⲅⲕⲱⲓⲟⲛ
ⲉⲑ	ⲉⲑ
ⲉⲑⲃⲉ	ⲉⲑⲃⲉ
ⲉⲑⲃⲏ	ⲉⲑⲃⲏ
ⲉⲑⲃⲏⲧ	ⲉⲑⲃⲏⲧ
ⲉⲑⲃⲏⲧⲉ	ⲉⲑⲃⲏⲧⲉ
ⲉⲑⲛⲟⲥ	ⲉⲑⲛⲟⲥ
ⲉⲑⲣⲉ	ⲉⲑⲣⲉ
ⲉⲓ	ⲉⲓ
ⲉⲓⲉ	ⲉⲓⲉ
ⲉⲓⲱⲧ	ⲉⲓⲱⲧ
ⲉⲕ	ⲉⲕ
ⲉⲕⲁⲧⲟⲛⲧⲁⲣⲭⲟⲥ	ⲉⲕⲁⲧⲟⲛⲧⲁⲣⲭⲟⲥ
ⲉⲕⲉ	ⲉⲕⲉ
ⲉⲕⲕⲗⲏⲥⲓⲁ	ⲉⲕⲕⲗⲏⲥⲓⲁ
ⲉⲗ	ⲉⲗ
ⲉⲗⲁⲭⲓⲥⲧⲟⲥ	ⲉⲗⲁⲭⲓⲥⲧⲟⲥ
ⲉⲗⲱⲓ	ⲉⲗⲱⲓ
ⲉⲙⲁϣⲱ	ⲉⲙⲁϣⲱ
ⲉⲙⲁⲩ	ⲉⲙⲁⲩ
ⲉⲙⲉⲛⲧ	ⲉⲙⲉⲛⲧ
ⲉⲙⲓ	ⲉⲙⲓ
ⲉⲙⲙⲁⲩ	ⲉⲙⲙⲁⲩ
ⲉⲙⲛⲟⲩⲧ	ⲉⲙⲛⲟⲩⲧ
ⲉⲙⲡϣⲁ	ⲉⲙⲡϣⲁ
ⲉⲙⲥ	ⲉⲙⲥ
ⲉⲛ	ⲉⲛ
ⲉⲛϣⲁϣⲓ	ⲉⲛϣⲁϣⲓ
ⲉⲛϩⲟⲧ	ⲉⲛϩⲟⲧ
ⲉⲛⲉ	ⲉⲛⲉ
ⲉⲛⲉϩ	ⲉⲛⲉϩ
ⲉⲛⲕⲟⲧ	ⲉⲛⲕⲟⲧ
ⲉⲛⲟⲭⲟⲥ	ⲉⲛⲟⲭⲟⲥ
ⲉⲛⲥⲑⲟⲓⲛⲟⲩϥⲓ	ⲉⲛ|ⲥ̀ⲑⲟⲓ|ⲛⲟⲩϥⲓ
ⲉⲛⲧⲟⲗⲏ	ⲉⲛⲧⲟⲗⲏ
ⲉⲛⲭⲁⲓ	ⲉⲛⲭⲁⲓ
ⲉⲝⲁⲡⲓⲛⲁ	ⲉⲝⲁⲡⲓⲛⲁ
ⲉⲝⲉⲥⲧⲓⲛ	ⲉⲝⲉⲥⲧⲓⲛ
ⲉⲝⲟⲩⲥⲓⲁ	ⲉⲝⲟⲩⲥⲓⲁ
ⲉⲡⲁⲣⲭⲟⲥ	ⲉⲡⲁⲣⲭⲟⲥ
ⲉⲡⲉⲓⲇⲏ	ⲉⲡⲉⲓⲇⲏ
ⲉⲡⲓ	ⲉⲡⲓ
ⲉⲡⲓⲅⲣⲁⲫⲏ	ⲉⲡⲓⲅⲣⲁⲫⲏ
ⲉⲡⲓⲇⲏ	ⲉⲡⲓⲇⲏ
ⲉⲡⲓⲑⲁⲛⲁⲧⲓⲟⲥ	ⲉⲡⲓⲑⲁⲛⲁⲧⲓⲟⲥ
ⲉⲡⲓⲑⲩⲙⲓⲁ	ⲉⲡⲓⲑⲩⲙⲓⲁ
ⲉⲡⲓⲕⲁⲑⲉⲣⲙⲁ	ⲉⲡⲓⲕⲁⲑⲉⲣⲙⲁ
ⲉⲡⲓⲥⲕⲟⲡⲟⲥ	ⲉⲡⲓⲥⲕⲟⲡⲟⲥ
ⲉⲡⲓⲥⲕⲡⲟⲥ	ⲉⲡⲓⲥⲕⲡⲟⲥ
ⲉⲡⲓⲥⲧⲟⲗⲏ	ⲉⲡⲓⲥⲧⲟⲗⲏ
ⲉⲡⲫⲁⲑⲁ	ⲉⲡⲫⲁⲑⲁ
ⲉⲣ	ⲉⲣ
ⲉⲣ=ϣⲟⲣⲡ	ⲉⲣ=ϣⲟⲣⲡ
ⲉⲣϣⲁⲓ	ⲉⲣ|ϣⲁⲓ
ⲉⲣϣⲃⲉ	ⲉⲣ|ϣⲃⲉ
ⲉⲣϣⲓϣⲓ	ⲉⲣ|ϣⲓϣⲓ
ⲉⲣϣⲟⲣⲡ	ⲉⲣ|ϣⲟⲣⲡ
ⲉⲣϣⲟⲩϣⲱⲟⲩϣⲓ	ⲉⲣ|ϣⲟⲩϣⲱⲟⲩϣⲓ
ⲉⲣϣⲫⲏⲣ	ⲉⲣ|ϣⲫⲏⲣ
ⲉⲣϣⲫⲏⲣⲓ	ⲉⲣ|ϣⲫⲏⲣⲓ
ⲉⲣϣⲱⲛ	ⲉⲣϣⲱⲛ
ⲉⲣϣⲱⲟⲩϣⲓ	ⲉⲣ|ϣⲱⲟⲩϣⲓ
ⲉⲣϧⲁⲉ	ⲉⲣ|ϧⲁⲉ
ⲉⲣϧⲏⲓⲃⲓ	ⲉⲣ|ϧⲏⲓⲃⲓ
ⲉⲣϩⲁⲗ	ⲉⲣ|ϩⲁⲗ
ⲉⲣϩⲉⲗϫⲉ	ⲉⲣ|ϩⲉⲗϫⲉ
ⲉⲣϩⲉⲗⲡⲓⲥ	ⲉⲣ|ϩⲉⲗⲡⲓⲥ
ⲉⲣϩⲏⲃⲓ	ⲉⲣ|ϩⲏⲃⲓ
ⲉⲣϩⲙⲟⲧ	ⲉⲣ|ϩⲙⲟⲧ
ⲉⲣϩⲟϯ	ⲉⲣ|ϩⲟϯ
ⲉⲣϩⲟⲩⲓⲧ	ⲉⲣ|ϩⲟⲩⲓⲧ
ⲉⲣϩⲟⲩⲟ	ⲉⲣ|ϩⲟⲩⲟ
ⲉⲣϩⲩⲡⲟⲙⲉⲛⲉⲓⲛ	ⲉⲣ|ϩⲩⲡⲟⲙⲉⲛⲉⲓⲛ
ⲉⲣϩⲱⲃ	ⲉⲣ|ϩⲱⲃ
ⲉⲣϫⲓⲛⲓⲟⲣ	ⲉⲣ|ϫⲓ|ⲛ|ⲓⲟⲣ
ⲉⲣϫⲟⲙ	ⲉⲣ|ϫⲟⲙ
ⲉⲣⲁ	ⲉⲣⲁ
ⲉⲣⲁⲅⲁⲡⲁⲛ	ⲉⲣ|ⲁⲅⲁⲡⲁⲛ
ⲉⲣⲁⲅⲱⲛⲓⲍⲉⲥⲑⲉ	ⲉⲣ|ⲁⲅⲱⲛⲓⲍⲉⲥⲑⲉ
ⲉⲣⲁⲑⲉⲧⲓⲛ	ⲉⲣ|ⲁⲑⲉⲧⲓⲛ
ⲉⲣⲁⲑⲛⲁϩϯ	ⲉⲣ|ⲁⲑ|ⲛⲁϩϯ
ⲉⲣⲁⲑⲟⲩⲱⲛϩ	ⲉⲣ|ⲁⲑ|ⲟⲩⲱⲛϩ
ⲉⲣⲁⲕⲙⲏ	ⲉⲣ|ⲁⲕⲙⲏ
ⲉⲣⲁⲕⲟⲗⲟⲩⲑⲓⲛ	ⲉⲣ|ⲁⲕⲟⲗⲟⲩⲑⲓⲛ
ⲉⲣⲁⲗⲟⲩ	ⲉⲣ|ⲁⲗⲟⲩ
ⲉⲣⲁⲛⲁⲅⲕⲁⲍⲓⲛ	ⲉⲣ|ⲁⲛⲁⲅⲕⲁⲍⲓⲛ
ⲉⲣⲁⲛⲁⲑⲉⲙⲁⲧⲓⲍⲓⲛ	ⲉⲣ|ⲁⲛⲁⲑⲉⲙⲁⲧⲓⲍⲓⲛ
ⲉⲣⲁⲛⲁⲭⲱⲣⲓⲛ	ⲉⲣ|ⲁⲛⲁⲭⲱⲣⲓⲛ
ⲉⲣⲁⲛⲉⲭⲉⲥⲑⲉ	ⲉⲣ|ⲁⲛⲉⲭⲉⲥⲑⲉ
ⲉⲣⲁⲡⲁⲛⲧⲁⲛ	ⲉⲣ|ⲁⲡⲁⲛⲧⲁⲛ
ⲉⲣⲁⲡⲟⲥⲧⲟⲗⲟⲥ	ⲉⲣ|ⲁⲡⲟⲥⲧⲟⲗⲟⲥ
ⲉⲣⲁⲡⲟⲧⲁⲍⲉⲥⲑⲁⲓ	ⲉⲣ|ⲁⲡⲟⲧⲁⲍⲉⲥⲑⲁⲓ
ⲉⲣⲁⲡⲟⲧⲁⲍⲉⲥⲑⲉ	ⲉⲣ|ⲁⲡⲟⲧⲁⲍⲉⲥⲑⲉ
ⲉⲣⲁⲥⲡⲁⲍⲉⲥⲑⲉ	ⲉⲣ|ⲁⲥⲡⲁⲍⲉⲥⲑⲉ
ⲉⲣⲁⲧ	ⲉⲣⲁⲧ
ⲉⲣⲁⲧϩⲙⲟⲩ	ⲉⲣ|ⲁⲧ|ϩⲙⲟⲩ
ⲉⲣⲁⲧϫⲟⲙ	ⲉⲣ|ⲁⲧ|ϫⲟⲙ
ⲉⲣⲁⲧⲟⲩⲧⲁϩ	ⲉⲣ|ⲁⲧ|ⲟⲩⲧⲁϩ
ⲉⲣⲃⲗⲁⲡⲧⲓⲛ	ⲉⲣ|ⲃⲗⲁⲡⲧⲓⲛ
ⲉⲣⲃⲱⲕ	ⲉⲣ|ⲃⲱⲕ
ⲉⲣⲇⲁⲙⲁⲍⲓⲛ	ⲉⲣ|ⲇⲁⲙⲁⲍⲓⲛ
ⲉⲣⲇⲓⲁⲕⲣⲓⲛⲓⲛ	ⲉⲣ|ⲇⲓⲁⲕⲣⲓⲛⲓⲛ
ⲉⲣⲇⲓⲁⲕⲱⲛ	ⲉⲣ|ⲇⲓⲁⲕⲱⲛ
ⲉⲣⲇⲟⲕⲓⲙⲁⲍⲉⲓⲛ	ⲉⲣ|ⲇⲟⲕⲓⲙⲁⲍⲉⲓⲛ
ⲉⲣⲇⲟⲕⲓⲙⲁⲍⲓⲛ	ⲉⲣ|ⲇⲟⲕⲓⲙⲁⲍⲓⲛ
ⲉⲣⲉ	ⲉⲣⲉ
ⲉⲣⲉⲅⲕⲣⲁⲧⲉⲩⲉⲥⲑⲉ	ⲉⲣ|ⲉⲅⲕⲣⲁⲧⲉⲩⲉⲥⲑⲉ
ⲉⲣⲉⲡⲓⲑⲩⲙⲉⲓⲛ	ⲉⲣ|ⲉⲡⲓⲑⲩⲙⲉⲓⲛ
ⲉⲣⲉⲡⲓⲑⲩⲙⲓⲛ	ⲉⲣ|ⲉⲡⲓⲑⲩⲙⲓⲛ
ⲉⲣⲉⲡⲓⲥⲕⲟⲡⲟⲥ	ⲉⲣ|ⲉⲡⲓⲥⲕⲟⲡⲟⲥ
ⲉⲣⲉⲡⲓⲧⲓⲙⲁⲛ	ⲉⲣ|ⲉⲡⲓⲧⲓⲙⲁⲛ
ⲉⲣⲉⲧⲉⲛⲉ	ⲉⲣⲉⲧⲉⲛⲉ
ⲉⲣⲉⲧⲓⲛ	ⲉⲣ|ⲉⲧⲓⲛ
ⲉⲣⲉⲩⲑⲏⲛⲓⲛ	ⲉⲣ|ⲉⲩⲑⲏⲛⲓⲛ
ⲉⲣⲏⲟⲩ	ⲉⲣⲏⲟⲩ
ⲉⲣⲏⲩ	ⲉⲣⲏⲩ
ⲉⲣⲑⲉⲁⲧⲣⲟⲛ	ⲉⲣ|ⲑⲉⲁⲧⲣⲟⲛ
ⲉⲣⲕⲁⲑⲁⲣⲓⲍⲉⲓⲛ	ⲉⲣ|ⲕⲁⲑⲁⲣⲓⲍⲉⲓⲛ
ⲉⲣⲕⲁⲧⲁⲕⲣⲓⲛⲓⲛ	ⲉⲣ|ⲕⲁⲧⲁⲕⲣⲓⲛⲓⲛ
ⲉⲣⲕⲁⲧⲁⲛⲧⲁⲛ	ⲉⲣ|ⲕⲁⲧⲁⲛⲧⲁⲛ
ⲉⲣⲕⲁⲧⲁⲫⲣⲟⲛⲓⲛ	ⲉⲣ|ⲕⲁⲧⲁⲫⲣⲟⲛⲓⲛ
ⲉⲣⲕⲁⲧⲁⲭⲣⲁⲥⲑⲉ	ⲉⲣ|ⲕⲁⲧⲁⲭⲣⲁⲥⲑⲉ
ⲉⲣⲕⲁⲧⲏⲅⲟⲣⲓⲛ	ⲉⲣ|ⲕⲁⲧⲏⲅⲟⲣⲓⲛ
ⲉⲣⲕⲁⲧⲏⲭⲓⲛ	ⲉⲣ|ⲕⲁⲧⲏⲭⲓⲛ
ⲉⲣⲕⲁⲩⲙⲁ	ⲉⲣ|ⲕⲁⲩⲙⲁ
ⲉⲣⲕⲗⲏⲣⲟⲛⲟⲙⲓⲛ	ⲉⲣ|ⲕⲗⲏⲣⲟⲛⲟⲙⲓⲛ
ⲉⲣⲕⲗⲏⲣⲟⲛⲟⲙⲟⲥ	ⲉⲣ|ⲕⲗⲏⲣⲟⲛⲟⲙⲟⲥ
ⲉⲣⲕⲟⲥⲙⲉⲓⲛ	ⲉⲣ|ⲕⲟⲥⲙⲉⲓⲛ
ⲉⲣⲕⲟⲩϫⲓ	ⲉⲣ|ⲕⲟⲩϫⲓ
ⲉⲣⲕⲩⲑⲁⲣⲓⲍⲓⲛ	ⲉⲣ|ⲕⲩⲑⲁⲣⲓⲍⲓⲛ
ⲉⲣⲕⲩⲛⲇⲓⲛⲉⲩⲓⲛ	ⲉⲣ|ⲕⲩⲛⲇⲓⲛⲉⲩⲓⲛ
ⲉⲣⲙⲁⲥⲧⲓⲅⲅⲟⲓⲛ	ⲉⲣ|ⲙⲁⲥⲧⲓⲅⲅⲟⲓⲛ
ⲉⲣⲙⲁⲧⲟⲓ	ⲉⲣ|ⲙⲁⲧⲟⲓ
ⲉⲣⲙⲉⲑⲣⲉ	ⲉⲣ|ⲙⲉⲑⲣⲉ
ⲉⲣⲙⲉⲗⲉⲧⲁⲛ	ⲉⲣ|ⲙⲉⲗⲉⲧⲁⲛ
ⲉⲣⲙⲉⲗⲓ	ⲉⲣ|ⲙⲉⲗⲓ
ⲉⲣⲙⲉⲗⲓⲛ	ⲉⲣ|ⲙⲉⲗⲓⲛ
ⲉⲣⲙⲉⲛⲉⲩⲓⲛ	ⲉⲣ|ⲙⲉⲛⲉⲩⲓⲛ
ⲉⲣⲙⲉⲛⲉⲩⲧⲏⲥ	ⲉⲣⲙⲉⲛⲉⲩⲧⲏⲥ
ⲉⲣⲙⲉⲧⲁⲛⲟⲓⲛ	ⲉⲣ|ⲙⲉⲧⲁⲛⲟⲓⲛ
ⲉⲣⲙⲏⲛⲓⲁ	ⲉⲣⲙⲏⲛⲓⲁ
ⲉⲣⲙⲟⲛⲁⲭⲟⲥ	ⲉⲣ|ⲙⲟⲛⲁⲭⲟⲥ
ⲉⲣⲛⲏⲥⲧⲉⲩⲉⲓⲛ	ⲉⲣ|ⲛⲏⲥⲧⲉⲩⲉⲓⲛ
ⲉⲣⲛⲏⲥⲧⲉⲩⲓⲛ	ⲉⲣ|ⲛⲏⲥⲧⲉⲩⲓⲛ
ⲉⲣⲛⲓϣϯ	ⲉⲣ|ⲛⲓϣϯ
ⲉⲣⲛⲟϥⲣⲓ	ⲉⲣ|ⲛⲟϥⲣⲓ
ⲉⲣⲛⲟⲃⲓ	ⲉⲣ|ⲛⲟⲃⲓ
ⲉⲣⲛⲱⲓⲕ	ⲉⲣ|ⲛⲱⲓⲕ
ⲉⲣⲟ	ⲉⲣⲟ
ⲉⲣⲟⲥ	ⲉⲣ|ⲟⲥ
ⲉⲣⲟⲩⲣⲟ	ⲉⲣ|ⲟⲩⲣⲟ
ⲉⲣⲟⲩⲱ	ⲉⲣ|ⲟⲩⲱ
ⲉⲣⲟⲩⲱⲓⲛⲓ	ⲉⲣ|ⲟⲩⲱⲓⲛⲓ
ⲉⲣⲡⲉⲣⲡⲉⲣⲟⲥ	ⲉⲣ|ⲡⲉⲣⲡⲉⲣⲟⲥ
ⲉⲣⲡⲓⲣⲁⲍⲓⲛ	ⲉⲣ|ⲡⲓⲣⲁⲍⲓⲛ
ⲉⲣⲡⲕⲉ	ⲉⲣⲡⲕⲉ
ⲉⲣⲡⲟⲣⲛⲉⲩⲓⲛ	ⲉⲣ|ⲡⲟⲣⲛⲉⲩⲓⲛ
ⲉⲣⲡⲣⲟⲕⲟⲡⲧⲉⲓⲛ	ⲉⲣ|ⲡⲣⲟⲕⲟⲡⲧⲉⲓⲛ
ⲉⲣⲡⲣⲟⲥⲉⲩⲭⲉⲥⲑⲉ	ⲉⲣ|ⲡⲣⲟⲥⲉⲩⲭⲉⲥⲑⲉ
ⲉⲣⲡⲣⲟⲫⲏ	ⲉⲣ|ⲡⲣⲟⲫⲏ
ⲉⲣⲡⲣⲟⲫⲏⲧⲉⲩⲓⲛ	ⲉⲣ|ⲡⲣⲟⲫⲏⲧⲉⲩⲓⲛ
ⲉⲣⲡⲣⲟⲫⲏⲧⲏⲥ	ⲉⲣ|ⲡⲣⲟⲫⲏⲧⲏⲥ
ⲉⲣⲣⲁⲙⲁⲟ	ⲉⲣ|ⲣⲁⲙ|ⲁⲟ
ⲉⲣⲣⲉϥϣϭ	ⲉⲣ|ⲣⲉϥϣϭ
ⲉⲣⲣⲉϥϯⲥⲃⲱ	ⲉⲣ|ⲣⲉϥ|ϯ|ⲥⲃⲱ
ⲉⲣⲣⲉϥⲉⲣⲭⲣⲉⲙⲣⲉⲙ	ⲉⲣ|ⲣⲉϥ|ⲉⲣ|ⲭⲣⲉⲙⲣⲉⲙ
ⲉⲣⲣⲉⲙϩⲉ	ⲉⲣ|ⲣⲉⲙϩⲉ
ⲉⲣⲣⲱⲙⲓ	ⲉⲣ|ⲣⲱⲙⲓ
ⲉⲣⲥϩⲓⲙⲓ	ⲉⲣ|ⲥϩⲓⲙⲓ
ⲉⲣⲥⲁⲃⲉ	ⲉⲣ|ⲥⲁⲃⲉ
ⲉⲣⲥⲁⲫⲁⲟⲩ	ⲉⲣ|ⲥⲁⲫⲁⲟⲩ
ⲉⲣⲥⲉⲃⲉⲥⲑⲉ	ⲉⲣ|ⲥⲉⲃⲉⲥⲑⲉ
ⲉⲣⲥⲕⲁⲛⲇⲁⲗⲓⲍⲉⲥⲑⲉ	ⲉⲣ|ⲥⲕⲁⲛⲇⲁⲗⲓⲍⲉⲥⲑⲉ
ⲉⲣⲥⲕⲁⲛⲇⲁⲗⲓⲍⲓⲛ	ⲉⲣ|ⲥⲕⲁⲛⲇⲁⲗⲓⲍⲓⲛ
ⲉⲣⲥⲟϫ	ⲉⲣ|ⲥⲟϫ
ⲉⲣⲥⲧⲁⲩⲣⲱⲛⲉⲓⲛ	ⲉⲣ|ⲥⲧⲁⲩⲣⲱⲛⲉⲓⲛ
ⲉⲣⲥⲩⲛⲕⲣⲓⲛⲓⲛ	ⲉⲣ|ⲥⲩⲛⲕⲣⲓⲛⲓⲛ
ⲉⲣⲧⲓⲙⲁⲛ	ⲉⲣ|ⲧⲓⲙⲁⲛ
ⲉⲣⲧⲟⲗⲙⲁⲛ	ⲉⲣ|ⲧⲟⲗⲙⲁⲛ
ⲉⲣⲫⲁϧⲣⲓ	ⲉⲣ|ⲫⲁϧⲣⲓ
ⲉⲣⲫⲉⲓ	ⲉⲣⲫⲉⲓ
ⲉⲣⲫⲏⲟⲩⲓ	ⲉⲣ|ⲫⲏⲟⲩⲓ
ⲉⲣⲫⲙⲉⲩⲓ	ⲉⲣ|ⲫ|ⲙⲉⲩⲓ
ⲉⲣⲫⲟⲣⲉⲓⲛ	ⲉⲣ|ⲫⲟⲣⲉⲓⲛ
ⲉⲣⲫⲟⲣⲓⲛ	ⲉⲣ|ⲫⲟⲣⲓⲛ
ⲉⲣⲫⲣⲁⲅⲉⲗⲗⲓⲛ	ⲉⲣ|ⲫⲣⲁⲅⲉⲗⲗⲓⲛ
ⲉⲣⲭⲁⲕⲓ	ⲉⲣ|ⲭⲁⲕⲓ
ⲉⲣⲭⲁⲣⲓⲍⲉⲥⲑⲁⲓ	ⲉⲣ|ⲭⲁⲣⲓⲍⲉⲥⲑⲁⲓ
ⲉⲣⲭⲣⲁⲥⲑⲉ	ⲉⲣ|ⲭⲣⲁⲥⲑⲉ
ⲉⲣⲭⲣⲓⲁ	ⲉⲣ|ⲭⲣⲓⲁ
ⲉⲣⲭⲣⲟⲛⲟⲥ	ⲉⲣ|ⲭⲣⲟⲛⲟⲥ
ⲉⲣⲯⲁⲗⲓⲛ	ⲉⲣ|ⲯⲁⲗⲓⲛ
ⲉⲣⲯⲁⲗⲗⲉⲓⲛ	ⲉⲣ|ⲯⲁⲗⲗⲉⲓⲛ
ⲉⲣⲱ	ⲉⲣⲱ
ⲉⲣⲱϯ	ⲉⲣⲱϯ
ⲉⲥⲉ	ⲉⲥⲉ
ⲉⲥⲏⲧ	ⲉⲥⲏⲧ
ⲉⲥⲕⲉⲛ	ⲉⲥⲕⲉⲛ
ⲉⲥⲱⲟⲩ	ⲉⲥⲱⲟⲩ
ⲉⲧ	ⲉⲧ
ⲉⲧⲁ	ⲉⲧⲁ
ⲉⲧⲉ	ⲉⲧⲉ
ⲉⲧⲉⲛ	ⲉⲧⲉⲛ
ⲉⲧⲉⲣⲉ	ⲉⲧⲉⲣⲉ
ⲉⲧⲓ	ⲉⲧⲓ
ⲉⲧⲓⲁ	ⲉⲧⲓⲁ
ⲉⲧⲟⲧ	ⲉⲧⲟⲧ
ⲉⲩⲁⲅⲅⲉⲗⲓⲟⲛ	ⲉⲩⲁⲅⲅⲉⲗⲓⲟⲛ
ⲉⲩⲅⲉⲛⲏⲥ	ⲉⲩⲅⲉⲛⲏⲥ
ⲉⲩⲉ	ⲉⲩⲉ
ⲉⲩⲕⲉⲣⲓⲁ	ⲉⲩⲕⲉⲣⲓⲁ
ⲉⲩⲗⲟⲅⲓⲁ	ⲉⲩⲗⲟⲅⲓⲁ
ⲉⲩⲥⲭⲏⲙⲱⲛ	ⲉⲩⲥⲭⲏⲙⲱⲛ
ⲉⲫⲉⲥⲟⲥ	ⲉⲫⲉⲥⲟⲥ
ⲉⲫⲗⲏⲟⲩ	ⲉⲫⲗⲏⲟⲩ
ⲉⲱ	ⲉⲱ
ⲉⲱⲛ	ⲉⲱⲛ
ⲋ	ⲋ
ⲍ	ⲍ
ⲍⲁⲭⲁⲣⲓⲁⲥ	ⲍⲁⲭⲁⲣⲓⲁⲥ
ⲍⲉⲃⲉⲇⲉⲟⲥ	ⲍⲉⲃⲉⲇⲉⲟⲥ
ⲍⲏⲧⲏⲙⲁ	ⲍⲏⲧⲏⲙⲁ
ⲏⲓ	ⲏⲓ
ⲏⲗⲓⲁⲥ	ⲏⲗⲓⲁⲥ
ⲏⲣⲡ	ⲏⲣⲡ
ⲏⲣⲱⲇⲏⲥ	ⲏⲣⲱⲇⲏⲥ
ⲏⲣⲱⲇⲓⲁⲛⲟⲥ	ⲏⲣⲱⲇⲓⲁⲛⲟⲥ
ⲏⲣⲱⲇⲓⲁⲥ	ⲏⲣⲱⲇⲓⲁⲥ
ⲏⲥⲁⲓⲁⲥ	ⲏⲥⲁⲓⲁⲥ
ⲑ	ⲑ
ⲑⲁ	ⲑⲁ
ⲑⲁϣ	ⲑⲁϣ
ⲑⲁϧⲓ	ⲑⲁϧⲓ
ⲑⲁϩⲉⲙ	ⲑⲁϩⲉⲙ
ⲑⲁϩⲙⲉ	ⲑⲁϩⲙⲉ
ⲑⲁϩⲥ	ⲑⲁϩⲥ
ⲑⲁⲇⲇⲉⲟⲥ	ⲑⲁⲇⲇⲉⲟⲥ
ⲑⲁⲓ	ⲑⲁⲓ
ⲑⲁⲙⲓⲉ	ⲑⲁⲙⲓⲉ
ⲑⲁⲙⲓⲟ	ⲑⲁⲙⲓⲟ
ⲑⲃⲁ	ⲑⲃⲁ
ⲑⲉⲃⲓⲉ	ⲑⲉⲃⲓⲉ
ⲑⲉⲃⲓⲏⲟⲩⲧ	ⲑⲉⲃⲓⲏⲟⲩⲧ
ⲑⲉⲃⲓⲟ	ⲑⲉⲃⲓⲟ
ⲑⲉⲕⲉⲙ	ⲑⲉⲕⲉⲙ
ⲑⲉⲗⲏⲗ	ⲑⲉⲗⲏⲗ
ⲑⲉⲟⲗⲟⲅⲟⲥ	ⲑⲉⲟⲗⲟⲅⲟⲥ
ⲑⲉⲧ	ⲑⲉⲧ
ⲑⲏ	ⲑⲏ
ⲑⲏϣ	ⲑⲏϣ
ⲑⲏⲙ	ⲑⲏⲙ
ⲑⲏⲛⲓ	ⲑⲏⲛⲓ
ⲑⲏⲛⲟⲩ	ⲑⲏⲛⲟⲩ
ⲑⲏⲟⲩ	ⲑⲏⲟⲩ
ⲑⲏⲣⲓⲟⲛ	ⲑⲏⲣⲓⲟⲛ
ⲑⲙⲁⲓⲉ	ⲑⲙⲁⲓⲉ
ⲑⲙⲁⲓⲏⲟⲩⲧ	ⲑⲙⲁⲓⲏⲟⲩⲧ
ⲑⲙⲁⲓⲟ	ⲑⲙⲁⲓⲟ
ⲑⲙⲉⲧϭⲓ	ⲑⲙⲉⲧϭⲓ
ⲑⲙⲏⲓ	ⲑ|ⲙⲏⲓ
ⲑⲛⲁⲩ	ⲑⲛⲁⲩ
ⲑⲟϣ	ⲑⲟϣ
ⲑⲟⲗⲉⲃ	ⲑⲟⲗⲉⲃ
ⲑⲟⲛⲧⲉⲛ	ⲑⲟⲛⲧⲉⲛ
ⲑⲟⲩⲱⲧ	ⲑⲟⲩⲱⲧ
ⲑⲣ	ⲑⲣ
ⲑⲣⲉ	ⲑⲣⲉ
ⲑⲣⲟ	ⲑⲣⲟ
ⲑⲣⲟⲩ	ⲑⲣⲟⲩ
ⲑⲱϣ	ⲑⲱϣ
ⲑⲱϥ	ⲑⲱϥ
ⲑⲱϩⲉⲙ	ⲑⲱϩⲉⲙ
ⲑⲱϩⲥ	ⲑⲱϩⲥ
ⲑⲱⲕ	ⲑⲱⲕ
ⲑⲱⲗⲉⲃ	ⲑⲱⲗⲉⲃ
ⲑⲱⲙ	ⲑⲱⲙ
ⲑⲱⲙⲁⲥ	ⲑⲱⲙⲁⲥ
ⲑⲱⲛ	ⲑⲱⲛ
ⲑⲱⲟⲩϯ	ⲑⲱⲟⲩϯ
ⲑⲱⲟⲩⲓ	ⲑⲱⲟⲩⲓ
ⲑⲱⲣⲡ	ⲑⲱⲣⲡ
ⲑⲱⲧ	ⲑⲱⲧ
ⲓ	ⲓ
ⲓⲁ	ⲓⲁ
ⲓⲁϩⲁⲗⲟⲗⲓ	ⲓⲁϩ|ⲁⲗⲟⲗⲓ
ⲓⲁⲓⲣⲟⲥ	ⲓⲁⲓⲣⲟⲥ
ⲓⲁⲓⲧ	ⲓⲁⲓⲧ
ⲓⲁⲕⲱⲃ	ⲓⲁⲕⲱⲃ
ⲓⲁⲕⲱⲃⲟⲥ	ⲓⲁⲕⲱⲃⲟⲥ
ⲓⲁⲗ	ⲓⲁⲗ
ⲓⲁⲛⲛⲏ	ⲓⲁⲛⲛⲏ
ⲓⲁⲣⲟ	ⲓⲁⲣⲟ
ⲓⲁⲧ	ⲓⲁⲧ
ⲓⲃ	ⲓⲃ
ⲓⲇⲓⲱⲧⲏⲥ	ⲓⲇⲓⲱⲧⲏⲥ
ⲓⲇⲱⲗⲟⲛ	ⲓⲇⲱⲗⲟⲛ
ⲓⲉ	ⲓⲉ
ⲓⲉⲣⲉⲙⲓⲁⲥ	ⲓⲉⲣⲉⲙⲓⲁⲥ
ⲓⲉⲣⲓⲭⲱ	ⲓⲉⲣⲓⲭⲱ
ⲓⲉⲣⲟⲥⲁⲗⲏⲙ	ⲓⲉⲣⲟⲥⲁⲗⲏⲙ
ⲓⲉⲫⲟⲩⲱⲓ	ⲓⲉⲫ|ⲟⲩⲱⲓ
ⲓⲏⲥⲟⲩ	ⲓⲏⲥⲟⲩ
ⲓⲏⲥⲟⲩⲥ	ⲓⲏⲥⲟⲩⲥ
ⲓⲙⲏϯ	ⲓⲙⲏϯ
ⲓⲙⲏⲧⲓ	ⲓⲙⲏⲧⲓ
ⲓⲛⲓ	ⲓⲛⲓ
ⲓⲟϩ	ⲓⲟϩ
ⲓⲟϩⲓ	ⲓⲟϩⲓ
ⲓⲟϯ	ⲓⲟϯ
ⲓⲟⲙ	ⲓⲟⲙ
ⲓⲟⲣⲇⲁⲛⲏⲥ	ⲓⲟⲣⲇⲁⲛⲏⲥ
ⲓⲟⲩⲇⲁⲓ	ⲓⲟⲩⲇⲁⲓ
ⲓⲟⲩⲇⲁⲥ	ⲓⲟⲩⲇⲁⲥ
ⲓⲟⲩⲇⲉⲁ	ⲓⲟⲩⲇⲉⲁ
ⲓⲣⲓ	ⲓⲣⲓ
ⲓⲥ	ⲓⲥ
ⲓⲥϫⲉ	ⲓⲥϫⲉ
ⲓⲥϫⲉⲛ	ⲓⲥϫⲉⲛ
ⲓⲥⲁⲁⲕ	ⲓⲥⲁⲁⲕ
ⲓⲥⲕⲁⲣⲓⲱⲧⲏⲥ	ⲓⲥⲕⲁⲣⲓⲱⲧⲏⲥ
ⲓⲥⲗ	ⲓⲥⲗ
ⲓⲥⲣⲁⲏⲗ	ⲓⲥⲣⲁⲏⲗ
ⲓⲥⲣⲁⲏⲗⲓⲧⲏⲥ	ⲓⲥⲣⲁⲏⲗⲓⲧⲏⲥ
ⲓⲧⲁ	ⲓⲧⲁ
ⲓⲧⲉ	ⲓⲧⲉ
ⲓⲱ	ⲓⲱ
ⲓⲱⲁⲛⲛⲏⲥ	ⲓⲱⲁⲛⲛⲏⲥ
ⲓⲱⲥⲏⲧⲟⲥ	ⲓⲱⲥⲏⲧⲟⲥ
ⲓⲱⲥⲏⲫ	ⲓⲱⲥⲏⲫ
ⲓⲱⲧ	ⲓⲱⲧ
ⲕ	ⲕ
ⲕⲁϣ	ⲕⲁϣ
ⲕⲁϩⲓ	ⲕⲁϩⲓ
ⲕⲁϩⲥ	ⲕⲁϩⲥ
ⲕⲁϯ	ⲕⲁϯ
ⲕⲁⲑⲉⲇⲣⲁ	ⲕⲁⲑⲉⲇⲣⲁ
ⲕⲁⲓ	ⲕⲁⲓ
ⲕⲁⲕⲓⲁ	ⲕⲁⲕⲓⲁ
ⲕⲁⲕⲥⲉϩⲧ	ⲕⲁⲕⲥⲉϩⲧ
ⲕⲁⲗⲱⲥ	ⲕⲁⲗⲱⲥ
ⲕⲁⲛ	ⲕⲁⲛ
ⲕⲁⲛⲁⲛⲉⲟⲥ	ⲕⲁⲛⲁⲛⲉⲟⲥ
ⲕⲁⲣⲡⲟⲥ	ⲕⲁⲣⲡⲟⲥ
ⲕⲁⲧϩⲏⲧ	ⲕⲁⲧ|ϩⲏⲧ
ⲕⲁⲧⲁ	ⲕⲁⲧⲁ
ⲕⲁⲧⲁⲡⲉⲧⲁⲥⲙⲁ	ⲕⲁⲧⲁⲡⲉⲧⲁⲥⲙⲁ
ⲕⲁⲧⲁⲫⲣⲟⲛⲓⲛ	ⲕⲁⲧⲁⲫⲣⲟⲛⲓⲛ
ⲕⲁⲧⲁⲫⲣⲟⲛⲓⲧⲏⲥ	ⲕⲁⲧⲁⲫⲣⲟⲛⲓⲧⲏⲥ
ⲕⲁⲫⲁⲣⲛⲁⲟⲩⲙ	ⲕⲁⲫⲁⲣⲛⲁⲟⲩⲙ
ⲕⲅ	ⲕⲅ
ⲕⲉ	ⲕⲉ
ⲕⲉⲓ	ⲕⲉⲓ
ⲕⲉⲗⲓ	ⲕⲉⲗⲓ
ⲕⲉⲛⲓ	ⲕⲉⲛⲓ
ⲕⲉⲛⲧⲉ	ⲕⲉⲛⲧⲉ
ⲕⲉⲥⲁⲣⲓⲁ	ⲕⲉⲥⲁⲣⲓⲁ
ⲕⲉⲭⲱⲟⲩⲛⲓ	ⲕⲉⲭⲱⲟⲩⲛⲓ
ⲕⲏ	ⲕⲏ
ⲕⲏⲛ	ⲕⲏⲛ
ⲕⲏⲧ	ⲕⲏⲧ
ⲕⲏⲫⲁ	ⲕⲏⲫⲁ
ⲕⲓⲙ	ⲕⲓⲙ
ⲕⲓⲛⲇⲩⲛⲟⲥ	ⲕⲓⲛⲇⲩⲛⲟⲥ
ⲕⲗⲏⲣⲟⲛⲟⲙⲓⲁ	ⲕⲗⲏⲣⲟⲛⲟⲙⲓⲁ
ⲕⲗⲏⲣⲟⲛⲟⲙⲟⲥ	ⲕⲗⲏⲣⲟⲛⲟⲙⲟⲥ
ⲕⲟⲓ	ⲕⲟⲓ
ⲕⲟⲓⲛⲱⲛⲓⲁ	ⲕⲟⲓⲛⲱⲛⲓⲁ
ⲕⲟⲓⲧⲱⲛ	ⲕⲟⲓⲧⲱⲛ
ⲕⲟⲗⲩⲃⲏⲑⲣⲁ	ⲕⲟⲗⲩⲃⲏⲑⲣⲁ
ⲕⲟⲗⲩⲃⲓⲥⲧⲏⲥ	ⲕⲟⲗⲩⲃⲓⲥⲧⲏⲥ
ⲕⲟⲛⲇⲣⲁⲛⲧⲏⲥ	ⲕⲟⲛⲇⲣⲁⲛⲧⲏⲥ
ⲕⲟⲣϥ	ⲕⲟⲣϥ
ⲕⲟⲣⲃⲁⲛ	ⲕⲟⲣⲃⲁⲛ
ⲕⲟⲣⲓⲛⲑⲟⲥ	ⲕⲟⲣⲓⲛⲑⲟⲥ
ⲕⲟⲥ	ⲕⲟⲥ
ⲕⲟⲥⲙⲟⲥ	ⲕⲟⲥⲙⲟⲥ
ⲕⲟⲧ	ⲕⲟⲧ
ⲕⲟⲩϫⲓ	ⲕⲟⲩϫⲓ
ⲕⲟⲩⲗⲱⲗ	ⲕⲟⲩⲗⲱⲗ
ⲕⲟⲩⲙ	ⲕⲟⲩⲙ
ⲕⲟⲩⲣ	ⲕⲟⲩⲣ
ⲕⲣⲁⲛⲓⲟⲛ	ⲕⲣⲁⲛⲓⲟⲛ
ⲕⲣⲓⲥⲡⲟⲥ	ⲕⲣⲓⲥⲡⲟⲥ
ⲕⲩⲑⲁⲣⲁ	ⲕⲩⲑⲁⲣⲁ
ⲕⲩⲙⲃⲁⲗⲟⲛ	ⲕⲩⲙⲃⲁⲗⲟⲛ
ⲕⲩⲣⲓⲁⲕⲏ	ⲕⲩⲣⲓⲁⲕⲏ
ⲕⲩⲣⲓⲁⲕⲟⲛ	ⲕⲩⲣⲓⲁⲕⲟⲛ
ⲕⲩⲣⲓⲛⲛⲉⲟⲥ	ⲕⲩⲣⲓⲛⲛⲉⲟⲥ
ⲕⲩⲣⲟⲥ	ⲕⲩⲣⲟⲥ
ⲕⲱϯ	ⲕⲱϯ
ⲕⲱⲃ	ⲕⲱⲃ
ⲕⲱⲙⲟⲡⲟⲗⲓⲥ	ⲕⲱⲙⲟⲡⲟⲗⲓⲥ
ⲕⲱⲡ	ⲕⲱⲡ
ⲕⲱⲣϥ	ⲕⲱⲣϥ
ⲕⲱⲣϫ	ⲕⲱⲣϫ
ⲕⲱⲧ	ⲕⲱⲧ
ⲗ	ⲗ
ⲗⲁⲕϩ	ⲗⲁⲕϩ
ⲗⲁⲟⲥ	ⲗⲁⲟⲥ
ⲗⲁⲥ	ⲗⲁⲥ
ⲗⲁⲩⲣⲁ	ⲗⲁⲩⲣⲁ
ⲗⲉϥⲗⲓϥⲓ	ⲗⲉϥⲗⲓϥⲓ
ⲗⲉⲅⲓⲱⲛ	ⲗⲉⲅⲓⲱⲛ
ⲗⲉⲙⲁ	ⲗⲉⲙⲁ
ⲗⲉⲩⲓ	ⲗⲉⲩⲓ
ⲗⲏⲟⲩ	ⲗⲏⲟⲩ
ⲗⲟϫ	ⲗⲟϫ
ⲗⲟⲃⲓ	ⲗⲟⲃⲓ
ⲗⲟⲅⲟⲥ	ⲗⲟⲅⲟⲥ
ⲗⲟⲓⲡⲟⲛ	ⲗⲟⲓⲡⲟⲛ
ⲗⲟⲓⲡⲟⲡ	ⲗⲟⲓⲡⲟⲡ
ⲗⲩⲭⲛⲓⲁ	ⲗⲩⲭⲛⲓⲁ
ⲗⲱⲓϫⲓ	ⲗⲱⲓϫⲓ
ⲙ	ⲙ
ⲙϩⲁⲩ	ⲙϩⲁⲩ
ⲙⲁ	ⲙⲁ
ⲙⲁϣϫ	ⲙⲁϣϫ
ⲙⲁϣⲉ	ⲙⲁϣⲉ
ⲙⲁϣⲱ	ⲙⲁϣⲱ
ⲙⲁϩ	ⲙⲁϩ
ⲙⲁϩⲁⲡ	ⲙⲁ|ϩⲁⲡ
ⲙⲁϩⲃ	ⲙⲁϩ|ⲃ
ⲙⲁϩⲅ	ⲙⲁϩ|ⲅ
ⲙⲁϩⲇ	ⲙⲁϩ|ⲇ
ⲙⲁϩⲍ	ⲙⲁϩ|ⲍ
ⲙⲁϩⲥⲛⲟⲩϯ	ⲙⲁϩ|ⲥⲛⲟⲩϯ
ⲙⲁϩⲥⲟⲡ	ⲙⲁϩ|ⲥⲟⲡ
ⲙⲁⲅⲇⲁⲗⲓⲛⲏ	ⲙⲁⲅⲇⲁⲗⲓⲛⲏ
ⲙⲁⲑⲏⲙⲁ	ⲙⲁⲑⲏⲙⲁ
ⲙⲁⲑⲏⲧⲏⲥ	ⲙⲁⲑⲏⲧⲏⲥ
ⲙⲁⲓ	ⲙⲁⲓ
ⲙⲁⲓⲏ	ⲙⲁⲓⲏ
ⲙⲁⲓⲛⲟⲩϯ	ⲙⲁⲓ|ⲛⲟⲩϯ
ⲙⲁⲕⲁⲣⲓⲟⲥ	ⲙⲁⲕⲁⲣⲓⲟⲥ
ⲙⲁⲕⲉⲇⲟⲛⲓⲁ	ⲙⲁⲕⲉⲇⲟⲛⲓⲁ
ⲙⲁⲕⲉⲗⲗⲟⲥ	ⲙⲁⲕⲉⲗⲗⲟⲥ
ⲙⲁⲗⲁⲕⲟⲥ	ⲙⲁⲗⲁⲕⲟⲥ
ⲙⲁⲗⲓⲥⲧⲁ	ⲙⲁⲗⲓⲥⲧⲁ
ⲙⲁⲗⲗⲟⲛ	ⲙⲁⲗⲗⲟⲛ
ⲙⲁⲛⲉⲣϣⲱⲟⲩϣⲓ	ⲙⲁⲛ|ⲉⲣ|ϣⲱⲟⲩϣⲓ
ⲙⲁⲣ	ⲙⲁⲣ
ⲙⲁⲣⲁⲛⲁⲑⲁ	ⲙⲁⲣⲁⲛⲁⲑⲁ
ⲙⲁⲣⲉ	ⲙⲁⲣⲉ
ⲙⲁⲣⲓⲁ	ⲙⲁⲣⲓⲁ
ⲙⲁⲣⲟ	ⲙⲁⲣⲟ
ⲙⲁⲥ	ⲙⲁⲥ
ⲙⲁⲥⲧⲓⲅⲝ	ⲙⲁⲥⲧⲓⲅⲝ
ⲙⲁⲧⲁⲙⲉ	ⲙⲁⲧⲁⲙⲉ
ⲙⲁⲧⲑⲉⲟⲥ	ⲙⲁⲧⲑⲉⲟⲥ
ⲙⲁⲧⲟⲓ	ⲙⲁⲧⲟⲓ
ⲙⲁⲧⲟⲩⲃⲟ	ⲙⲁⲧⲟⲩⲃⲟ
ⲙⲁⲩ	ⲙⲁⲩ
ⲙⲁⲱⲟⲩ	ⲙⲁ|ⲱⲟⲩ
ⲙⲃⲟⲛ	ⲙⲃⲟⲛ
ⲙⲉϣⲧ	ⲙⲉϣⲧ
ⲙⲉϩ	ⲙⲉϩ
ⲙⲉⲑⲙⲏⲓ	ⲙⲉⲑ|ⲙⲏⲓ
ⲙⲉⲑⲛⲁϣⲧϩⲏⲧ	ⲙⲉⲑ|ⲛⲁϣⲧ|ϩⲏⲧ
ⲙⲉⲑⲣⲉ	ⲙⲉⲑⲣⲉ
ⲙⲉⲓ	ⲙⲉⲓ
ⲙⲉⲗⲟⲥ	ⲙⲉⲗⲟⲥ
ⲙⲉⲛ	ⲙⲉⲛ
ⲙⲉⲛⲉⲛⲥⲁ	ⲙⲉⲛⲉⲛⲥⲁ
ⲙⲉⲛⲉⲛⲥⲱ	ⲙⲉⲛⲉⲛⲥⲱ
ⲙⲉⲛⲉⲥⲱⲛ	ⲙⲉⲛⲉⲥⲱⲛ
ⲙⲉⲛⲣⲁϯ	ⲙⲉⲛⲣⲁϯ
ⲙⲉⲛⲣⲉ	ⲙⲉⲛⲣⲉ
ⲙⲉⲛⲣⲉⲡⲉⲕϣⲫⲏⲣ	ⲙⲉⲛⲣⲉ|ⲡⲉⲕ|ϣⲫⲏⲣ
ⲙⲉⲛⲣⲓⲧ	ⲙⲉⲛⲣⲓⲧ
ⲙⲉⲛⲣⲓⲧϥ	ⲙⲉⲛⲣⲓⲧ|ϥ
ⲙⲉⲛⲧ	ⲙⲉⲛⲧ
ⲙⲉⲛⲧⲟⲓ	ⲙⲉⲛⲧⲟⲓ
ⲙⲉⲣⲟⲥ	ⲙⲉⲣⲟⲥ
ⲙⲉⲧϣⲁⲙϣⲉ	ⲙⲉⲧ|ϣⲁⲙϣⲉ
ⲙⲉⲧϣⲟⲃⲓ	ⲙⲉⲧ|ϣⲟⲃⲓ
ⲙⲉⲧϣⲫⲏⲣ	ⲙⲉⲧ|ϣⲫⲏⲣ
ⲙⲉⲧϩⲟⲩⲟ	ⲙⲉⲧ|ϩⲟⲩⲟ
ⲙⲉⲧϫⲁϫⲓ	ⲙⲉⲧ|ϫⲁϫⲓ
ⲙⲉⲧϫⲱⲃ	ⲙⲉⲧ|ϫⲱⲃ
ⲙⲉⲧϭⲓⲛϫⲟⲛⲥ	ⲙⲉⲧ|ϭⲓ|ⲛ|ϫⲟⲛⲥ
ⲙⲉⲧⲁⲅⲁⲑⲟⲥ	ⲙⲉⲧ|ⲁⲅⲁⲑⲟⲥ
ⲙⲉⲧⲁⲅⲉⲛⲏⲥ	ⲙⲉⲧⲁⲅⲉⲛⲏⲥ
ⲙⲉⲧⲁⲑⲙⲟⲩ	ⲙⲉⲧ|ⲁⲑ|ⲙⲟⲩ
ⲙⲉⲧⲁⲑⲛⲁϩϯ	ⲙⲉⲧ|ⲁⲑ|ⲛⲁϩϯ
ⲙⲉⲧⲁⲗⲟⲩ	ⲙⲉⲧ|ⲁⲗⲟⲩ
ⲙⲉⲧⲁⲛⲟⲓⲁ	ⲙⲉⲧⲁⲛⲟⲓⲁ
ⲙⲉⲧⲁⲡⲟⲥⲧⲟⲗⲟⲥ	ⲙⲉⲧ|ⲁⲡⲟⲥⲧⲟⲗⲟⲥ
ⲙⲉⲧⲁⲥⲉⲃⲏⲥ	ⲙⲉⲧ|ⲁⲥⲉⲃⲏⲥ
ⲙⲉⲧⲁⲥⲑⲉⲛⲏⲥ	ⲙⲉⲧ|ⲁⲥⲑⲉⲛⲏⲥ
ⲙⲉⲧⲁⲥⲑⲏⲛⲏⲥ	ⲙⲉⲧ|ⲁⲥⲑⲏⲛⲏⲥ
ⲙⲉⲧⲁⲧϣⲉⲙⲏⲣ	ⲙⲉⲧ|ⲁⲧ|ϣⲉⲙⲏⲣ
ⲙⲉⲧⲁⲧϫⲟⲙ	ⲙⲉⲧ|ⲁⲧ|ϫⲟⲙ
ⲙⲉⲧⲁⲧϭⲓϩⲣⲁϥ	ⲙⲉⲧ|ⲁⲧ|ϭⲓϩⲣⲁϥ
ⲙⲉⲧⲁⲧⲑⲱⲧ	ⲙⲉⲧ|ⲁⲧ|ⲑⲱⲧ
ⲙⲉⲧⲁⲧⲕⲁϯ	ⲙⲉⲧ|ⲁⲧ|ⲕⲁϯ
ⲙⲉⲧⲁⲧⲙⲟⲩ	ⲙⲉⲧ|ⲁⲧ|ⲙⲟⲩ
ⲙⲉⲧⲁⲧⲙⲡϣⲁ	ⲙⲉⲧ|ⲁⲧ|ⲙⲡϣⲁ
ⲙⲉⲧⲁⲧⲥⲉⲃⲓ	ⲙⲉⲧ|ⲁⲧ|ⲥⲉⲃⲓ
ⲙⲉⲧⲁⲧⲥⲟⲩⲉⲛ	ⲙⲉⲧ|ⲁⲧ|ⲥⲟⲩⲉⲛ
ⲙⲉⲧⲁⲧⲧⲁⲕⲟ	ⲙⲉⲧ|ⲁⲧ|ⲧⲁⲕⲟ
ⲙⲉⲧⲇⲟⲗⲟⲥ	ⲙⲉⲧ|ⲇⲟⲗⲟⲥ
ⲙⲉⲧⲉⲫⲗⲏⲟⲩ	ⲙⲉⲧ|ⲉⲫⲗⲏⲟⲩ
ⲙⲉⲧⲕⲟⲩϫⲓ	ⲙⲉⲧ|ⲕⲟⲩϫⲓ
ⲙⲉⲧⲙⲉⲑⲣⲉ	ⲙⲉⲧ|ⲙⲉⲑⲣⲉ
ⲙⲉⲧⲙⲟⲛⲁⲭⲟⲥ	ⲙⲉⲧ|ⲙⲟⲛⲁⲭⲟⲥ
ⲙⲉⲧⲛⲁϣⲧϩⲏⲧ	ⲙⲉⲧ|ⲛⲁϣⲧ|ϩⲏⲧ
ⲙⲉⲧⲛⲱⲓⲕ	ⲙⲉⲧ|ⲛⲱⲓⲕ
ⲙⲉⲧⲟⲩⲣⲟ	ⲙⲉⲧ|ⲟⲩⲣⲟ
ⲙⲉⲧⲡⲉⲧϩⲱⲟⲩ	ⲙⲉⲧ|ⲡ|ⲉⲧ|ϩⲱⲟⲩ
ⲙⲉⲧⲣⲁⲙⲁⲟ	ⲙⲉⲧ|ⲣⲁⲙ|ⲁⲟ
ⲙⲉⲧⲣⲉϥϯⲥⲃⲱ	ⲙⲉⲧ|ⲣⲉϥ|ϯ|ⲥⲃⲱ
ⲙⲉⲧⲣⲉϥϯⲧⲟⲧ	ⲙⲉⲧ|ⲣⲉϥ|ϯ|ⲧⲟⲧ
ⲙⲉⲧⲣⲉϥⲉⲣϩⲉⲙⲓ	ⲙⲉⲧ|ⲣⲉϥ|ⲉⲣ|ϩⲉⲙⲓ
ⲙⲉⲧⲣⲉⲙⲣⲁⲩϣ	ⲙⲉⲧ|ⲣⲉⲙ|ⲣⲁⲩϣ
ⲙⲉⲧⲣⲱⲙⲓ	ⲙⲉⲧ|ⲣⲱⲙⲓ
ⲙⲉⲧⲥⲉⲃ	ⲙⲉⲧ|ⲥⲉⲃ
ⲙⲉⲧⲥⲟϫ	ⲙⲉⲧ|ⲥⲟϫ
ⲙⲉⲩⲓ	ⲙⲉⲩⲓ
ⲙⲏ	ⲙⲏ
ⲙⲏϣ	ⲙⲏϣ
ⲙⲏϯ	ⲙⲏϯ
ⲙⲏⲓ	ⲙⲏⲓ
ⲙⲏⲓⲛⲓ	ⲙⲏⲓⲛⲓ
ⲙⲏⲓⲧ	ⲙⲏⲓⲧ
ⲙⲏⲛ	ⲙⲏⲛ
ⲙⲏⲛⲁ	ⲙⲏⲛⲁ
ⲙⲏⲛⲓ	ⲙⲏⲛⲓ
ⲙⲏⲡⲟⲧⲉ	ⲙⲏⲡⲟⲧⲉ
ⲙⲏⲡⲱⲥ	ⲙⲏⲡⲱⲥ
ⲙⲏⲣ	ⲙⲏⲣ
ⲙⲏⲧⲓ	ⲙⲏⲧⲓ
ⲙⲑⲟ	ⲙⲑⲟ
ⲙⲓϣⲓ	ⲙⲓϣⲓ
ⲙⲓⲥⲑⲱⲧⲏⲥ	ⲙⲓⲥⲑⲱⲧⲏⲥ
ⲙⲓⲥⲓ	ⲙⲓⲥⲓ
ⲙⲕⲁϩ	ⲙⲕⲁϩ
ⲙⲕⲁⲩϩ	ⲙⲕⲁⲩϩ
ⲙⲙⲁⲩ	ⲙⲙⲁⲩ
ⲙⲙⲁⲩⲁ	ⲙⲙⲁⲩⲁ
ⲙⲙⲁⲩⲁⲧ	ⲙⲙⲁⲩⲁⲧ
ⲙⲙⲁⲩⲁⲧⲉⲛ	ⲙⲙⲁⲩⲁⲧⲉⲛ
ⲙⲙⲏⲛⲓ	ⲙⲙⲏⲛⲓ
ⲙⲙⲓⲛ	ⲙⲙⲓⲛ
ⲙⲙⲓⲛⲙⲙⲟ	ⲙⲙⲓⲛⲙⲙⲟ
ⲙⲙⲟ	ⲙⲙⲟ
ⲙⲙⲟⲛ	ⲙⲙⲟⲛ
ⲙⲙⲟⲛⲛⲧⲁ	ⲙⲙⲟⲛⲛⲧⲁ
ⲙⲙⲟⲛⲛⲧⲱ	ⲙⲙⲟⲛⲛⲧⲱ
ⲙⲙⲟⲛⲧ	ⲙⲙⲟⲛⲧ
ⲙⲙⲟⲛⲧⲁ	ⲙⲙⲟⲛⲧⲁ
ⲙⲙⲟⲛⲧⲉ	ⲙⲙⲟⲛⲧⲉ
ⲙⲙⲟⲛⲧⲱ	ⲙⲙⲟⲛⲧⲱ
ⲙⲙⲱ	ⲙⲙⲱ
ⲙⲛⲁⲓ	ⲙⲛⲁⲓ
ⲙⲛⲏ	ⲙⲛⲏ
ⲙⲟϣⲓ	ⲙⲟϣⲓ
ⲙⲟϩ	ⲙⲟϩ
ⲙⲟϫϧ	ⲙⲟϫϧ
ⲙⲟϫⲧ	ⲙⲟϫⲧ
ⲙⲟⲓ	ⲙⲟⲓ
ⲙⲟⲕϩ	ⲙⲟⲕϩ
ⲙⲟⲕⲓ	ⲙⲟⲕⲓ
ⲙⲟⲕⲙⲉⲕ	ⲙⲟⲕⲙⲉⲕ
ⲙⲟⲗϩ	ⲙⲟⲗϩ
ⲙⲟⲛⲁⲥⲧⲏⲣⲓⲟⲛ	ⲙⲟⲛⲁⲥⲧⲏⲣⲓⲟⲛ
ⲙⲟⲛⲁⲭⲟⲥ	ⲙⲟⲛⲁⲭⲟⲥ
ⲙⲟⲛⲓ	ⲙⲟⲛⲓ
ⲙⲟⲛⲕ	ⲙⲟⲛⲕ
ⲙⲟⲛⲙⲉⲛ	ⲙⲟⲛⲙⲉⲛ
ⲙⲟⲛⲟⲛ	ⲙⲟⲛⲟⲛ
ⲙⲟⲣⲫⲏ	ⲙⲟⲣⲫⲏ
ⲙⲟⲥϯ	ⲙⲟⲥϯ
ⲙⲟⲧⲉⲛ	ⲙⲟⲧⲉⲛ
ⲙⲟⲩ	ⲙⲟⲩ
ⲙⲟⲩϣϯ	ⲙⲟⲩϣϯ
ⲙⲟⲩϫⲧ	ⲙⲟⲩϫⲧ
ⲙⲟⲩϯ	ⲙⲟⲩϯ
ⲙⲟⲩⲗⲟⲛ	ⲙⲟⲩⲗⲟⲛ
ⲙⲟⲩⲙⲓ	ⲙⲟⲩⲙⲓ
ⲙⲟⲩⲛ	ⲙⲟⲩⲛ
ⲙⲟⲩⲛⲕ	ⲙⲟⲩⲛⲕ
ⲙⲟⲩⲥⲉⲣ	ⲙⲟⲩⲥⲉⲣ
ⲙⲡ	ⲙⲡ
ⲙⲡϣⲁ	ⲙⲡϣⲁ
ⲙⲡⲁ	ⲙⲡⲁ
ⲙⲡⲁⲓ	ⲙⲡⲁⲓ
ⲙⲡⲁⲣⲉ	ⲙⲡⲁⲣⲉ
ⲙⲡⲁⲧ	ⲙⲡⲁⲧ
ⲙⲡⲁⲧⲉ	ⲙⲡⲁⲧⲉ
ⲙⲡⲉ	ⲙⲡⲉ
ⲙⲡⲉⲛⲑⲣⲉ	ⲙⲡⲉⲛⲑⲣⲉ
ⲙⲡⲉⲣ	ⲙⲡⲉⲣ
ⲙⲡⲣ	ⲙⲡⲣ
ⲙⲧⲟⲛ	ⲙⲧⲟⲛ
ⲙⲩⲥⲧⲏⲣⲓⲟⲛ	ⲙⲩⲥⲧⲏⲣⲓⲟⲛ
ⲙⲱⲓⲧ	ⲙⲱⲓⲧ
ⲙⲱⲟⲩ	ⲙⲱⲟⲩ
ⲙⲱⲟⲩⲧ	ⲙⲱⲟⲩⲧ
ⲙⲱⲩⲥⲏⲥ	ⲙⲱⲩⲥⲏⲥ
ⲛ	ⲛ
ⲛϧⲏⲧ	ⲛϧⲏⲧ
ⲛϧⲟⲩⲛ	ⲛϧⲟⲩⲛ
ⲛϧⲣⲏⲓ	ⲛϧⲣⲏⲓ
ⲛϩⲏⲧ	ⲛϩⲏⲧ
ⲛϩⲟⲩⲟ	ⲛϩⲟⲩⲟ
ⲛϩⲣⲏⲓ	ⲛϩⲣⲏⲓ
ⲛϫⲉ	ⲛϫⲉ
ⲛϯϩⲁⲡ	ⲛ|ϯ|ϩⲁⲡ
ⲛⲁ	ⲛⲁ
ⲛⲁϣⲉ	ⲛⲁϣⲉ
ⲛⲁϣⲧ	ⲛⲁϣⲧ
ⲛⲁϣⲱ	ⲛⲁϣⲱ
ⲛⲁϩϯ	ⲛⲁϩϯ
ⲛⲁϩⲃⲓ	ⲛⲁϩⲃⲓ
ⲛⲁϩⲙ	ⲛⲁϩⲙ
ⲛⲁϩⲙⲉ	ⲛⲁϩⲙⲉ
ⲛⲁϩⲣⲁ	ⲛⲁϩⲣⲁ
ⲛⲁϩⲣⲉⲛ	ⲛⲁϩⲣⲉⲛ
ⲛⲁϫϩⲓ	ⲛⲁϫϩⲓ
ⲛⲁⲁ	ⲛⲁⲁ
ⲛⲁⲍⲁⲣⲉⲑ	ⲛⲁⲍⲁⲣⲉⲑ
ⲛⲁⲍⲱⲣⲉⲟⲥ	ⲛⲁⲍⲱⲣⲉⲟⲥ
ⲛⲁⲓ	ⲛⲁⲓ
ⲛⲁⲕϩⲓ	ⲛⲁⲕϩⲓ
ⲛⲁⲛⲉ	ⲛⲁⲛⲉ
ⲛⲁⲣⲇⲟⲥ	ⲛⲁⲣⲇⲟⲥ
ⲛⲁⲣⲉ	ⲛⲁⲣⲉ
ⲛⲁⲩ	ⲛⲁⲩ
ⲛⲁⲫⲣⲓ	ⲛⲁⲫⲣⲓ
ⲛⲉ	ⲛⲉ
ⲛⲉϣ	ⲛⲉϣ
ⲛⲉϥ	ⲛⲉϥ
ⲛⲉϩ	ⲛⲉϩ
ⲛⲉϩⲥⲓ	ⲛⲉϩⲥⲓ
ⲛⲉϫⲓ	ⲛⲉϫⲓ
ⲛⲉⲃⲏⲓ	ⲛⲉⲃ|ⲏⲓ
ⲛⲉⲕ	ⲛⲉⲕ
ⲛⲉⲙ	ⲛⲉⲙ
ⲛⲉⲙⲁ	ⲛⲉⲙⲁ
ⲛⲉⲙⲏ	ⲛⲉⲙⲏ
ⲛⲉⲙⲱ	ⲛⲉⲙⲱ
ⲛⲉⲛ	ⲛⲉⲛ
ⲛⲉⲥ	ⲛⲉⲥ
ⲛⲉⲧⲉⲛ	ⲛⲉⲧⲉⲛ
ⲛⲉⲧⲛ	ⲛⲉⲧⲛ
ⲛⲏ	ⲛⲏ
ⲛⲏⲟⲩ	ⲛⲏⲟⲩ
ⲛⲏⲥⲧⲓⲁ	ⲛⲏⲥⲧⲓⲁ
ⲛⲑⲟϥ	ⲛⲑⲟϥ
ⲛⲑⲟⲕ	ⲛⲑⲟⲕ
ⲛⲑⲟⲥ	ⲛⲑⲟⲥ
ⲛⲑⲱⲟⲩ	ⲛⲑⲱⲟⲩ
ⲛⲑⲱⲧⲉⲛ	ⲛⲑⲱⲧⲉⲛ
ⲛⲓ	ⲛⲓ
ⲛⲓϣϯ	ⲛⲓϣϯ
ⲛⲓϥⲓ	ⲛⲓϥⲓ
ⲛⲓⲃⲉⲛ	ⲛⲓⲃⲉⲛ
ⲛⲓⲙ	ⲛⲓⲙ
ⲛⲕⲟⲧ	ⲛⲕⲟⲧ
ⲛⲛ	ⲛⲛ
ⲛⲛⲉ	ⲛⲛⲉ
ⲛⲛⲟ	ⲛⲛⲟ
ⲛⲟϥⲣⲓ	ⲛⲟϥⲣⲓ
ⲛⲟϩⲉⲙ	ⲛⲟϩⲉⲙ
ⲛⲟⲃⲓ	ⲛⲟⲃⲓ
ⲛⲟⲙϯ	ⲛⲟⲙϯ
ⲛⲟⲙⲟⲥ	ⲛⲟⲙⲟⲥ
ⲛⲟⲧⲁⲣⲓⲟⲥ	ⲛⲟⲧⲁⲣⲓⲟⲥ
ⲛⲟⲩ	ⲛⲟⲩ
ⲛⲟⲩϥ	ⲛⲟⲩϥ
ⲛⲟⲩϫ	ⲛⲟⲩϫ
ⲛⲟⲩϫⲓ	ⲛⲟⲩϫⲓ
ⲛⲟⲩϯ	ⲛⲟⲩϯ
ⲛⲟⲩⲃ	ⲛⲟⲩⲃ
ⲛⲟⲩⲉϣⲉⲛ	ⲛⲟⲩⲉϣⲉⲛ
ⲛⲟⲩⲉⲣⲏⲩ	ⲛⲟⲩⲉⲣⲏⲩ
ⲛⲟⲩⲓ	ⲛⲟⲩⲓ
ⲛⲟⲩⲕ	ⲛⲟⲩⲕ
ⲛⲟⲩⲛⲓ	ⲛⲟⲩⲛⲓ
ⲛⲟⲩⲥ	ⲛⲟⲩⲥ
ⲛⲟⲩⲧⲉⲛ	ⲛⲟⲩⲧⲉⲛ
ⲛⲥⲁ	ⲛⲥⲁ
ⲛⲥⲱ	ⲛⲥⲱ
ⲛⲧ	ⲛⲧ
ⲛⲧϩⲟ	ⲛⲧϩⲟ
ⲛⲧⲁ	ⲛⲧⲁ
ⲛⲧⲉ	ⲛⲧⲉ
ⲛⲧⲉⲛ	ⲛⲧⲉⲛ
ⲛⲧⲏ	ⲛⲧⲏ
ⲛⲧⲟⲧ	ⲛⲧⲟⲧ
ⲛⲧⲱ	ⲛⲧⲱ
ⲛⲧⲱⲧⲉⲛ	ⲛⲧⲱⲧⲉⲛ
ⲛⲭⲁⲓ	ⲛⲭⲁⲓ
ⲛⲱ	ⲛⲱ
ⲛⲱⲓⲕ	ⲛⲱⲓⲕ
ⲝ	ⲝ
ⲝⲉⲥⲧⲏⲥ	ⲝⲉⲥⲧⲏⲥ
ⲟϣ	ⲟϣ
ⲟϩⲓ	ⲟϩⲓ
ⲟϫϩ	ⲟϫϩ
ⲟⲃⲓ	ⲟⲃⲓ
ⲟⲓ	ⲟⲓ
ⲟⲓⲕⲟⲛⲟⲙⲓⲁ	ⲟⲓⲕⲟⲛⲟⲙⲓⲁ
ⲟⲓⲕⲟⲛⲟⲙⲟⲥ	ⲟⲓⲕⲟⲛⲟⲙⲟⲥ
ⲟⲓⲕⲟⲩⲙⲉⲛⲏ	ⲟⲓⲕⲟⲩⲙⲉⲛⲏ
ⲟⲕⲉⲙ	ⲟⲕⲉⲙ
ⲟⲗ	ⲟⲗ
ⲟⲙϯ	ⲟⲙϯ
ⲟⲙⲟⲟⲩⲉⲓⲟⲉ	ⲟⲙⲟⲟⲩⲉⲓⲟⲉ
ⲟⲙⲥ	ⲟⲙⲥ
ⲟⲙⲱⲥ	ⲟⲙⲱⲥ
ⲟⲛ	ⲟⲛ
ⲟⲛϧ	ⲟⲛϧ
ⲟⲛⲓ	ⲟⲛⲓ
ⲟⲛⲧⲱⲥ	ⲟⲛⲧⲱⲥ
ⲟⲟⲩ	ⲟⲟⲩ
ⲟⲡ	ⲟⲡ
ⲟⲡⲧ	ⲟⲡⲧ
ⲟⲡⲧⲁⲥⲓⲁ	ⲟⲡⲧⲁⲥⲓⲁ
ⲟⲥ	ⲟⲥ
ⲟⲥϧ	ⲟⲥϧ
ⲟⲩ	ⲟⲩ
ⲟⲩϧⲉ	ⲟⲩϧⲉ
ⲟⲩϩⲱⲣ	ⲟⲩϩⲱⲣ
ⲟⲩϫⲁⲓ	ⲟⲩϫⲁⲓ
ⲟⲩⲁϣ	ⲟⲩⲁϣ
ⲟⲩⲁϩ	ⲟⲩⲁϩ
ⲟⲩⲁϩⲉⲙ	ⲟⲩⲁϩⲉⲙ
ⲟⲩⲁϩⲙⲉ	ⲟⲩⲁϩⲙⲉ
ⲟⲩⲁϩⲥⲁϩⲛⲓ	ⲟⲩⲁϩ|ⲥⲁϩⲛⲓ
ⲟⲩⲁϩⲥⲟⲓ	ⲟⲩⲁϩⲥⲟⲓ
ⲟⲩⲁϩⲧⲉ	ⲟⲩⲁϩⲧⲉ
ⲟⲩⲁⲃ	ⲟⲩⲁⲃ
ⲟⲩⲁⲓ	ⲟⲩⲁⲓ
ⲟⲩⲁⲛ	ⲟⲩⲁⲛ
ⲟⲩⲃⲁϣ	ⲟⲩⲃⲁϣ
ⲟⲩⲃⲉ	ⲟⲩⲃⲉ
ⲟⲩⲃⲏ	ⲟⲩⲃⲏ
ⲟⲩⲇⲉ	ⲟⲩⲇⲉ
ⲟⲩⲉϣ	ⲟⲩⲉϣ
ⲟⲩⲉϩ	ⲟⲩⲉϩ
ⲟⲩⲉⲓ	ⲟⲩⲉⲓ
ⲟⲩⲉⲓⲛⲓⲛ	ⲟⲩⲉⲓⲛⲓⲛ
ⲟⲩⲉⲙ	ⲟⲩⲉⲙ
ⲟⲩⲉⲙⲁϥ	ⲟⲩⲉⲙ|ⲁϥ
ⲟⲩⲉⲙⲱⲓⲕ	ⲟⲩⲉⲙ|ⲱⲓⲕ
ⲟⲩⲉⲣϣⲓ	ⲟⲩⲉⲣϣⲓ
ⲟⲩⲉⲧ	ⲟⲩⲉⲧ
ⲟⲩⲏϣⲥⲓ	ⲟⲩⲏϣⲥⲓ
ⲟⲩⲏⲃ	ⲟⲩⲏⲃ
ⲟⲩⲏⲓ	ⲟⲩⲏⲓ
ⲟⲩⲏⲟⲩ	ⲟⲩⲏⲟⲩ
ⲟⲩⲏⲣ	ⲟⲩⲏⲣ
ⲟⲩⲓ	ⲟⲩⲓ
ⲟⲩⲓⲏ	ⲟⲩⲓⲏ
ⲟⲩⲓⲛⲁⲙ	ⲟⲩⲓⲛⲁⲙ
ⲟⲩⲕ	ⲟⲩⲕ
ⲟⲩⲛ	ⲟⲩⲛ
ⲟⲩⲛⲟϥ	ⲟⲩⲛⲟϥ
ⲟⲩⲛⲟⲩ	ⲟⲩⲛⲟⲩ
ⲟⲩⲟϩ	ⲟⲩⲟϩ
ⲟⲩⲟϩⲓ	ⲟⲩⲟϩⲓ
ⲟⲩⲟϯ	ⲟⲩⲟϯ
ⲟⲩⲟⲃϣ	ⲟⲩⲟⲃϣ
ⲟⲩⲟⲓ	ⲟⲩⲟⲓ
ⲟⲩⲟⲙ	ⲟⲩⲟⲙ
ⲟⲩⲟⲛ	ⲟⲩⲟⲛ
ⲟⲩⲟⲛϣϫⲟⲙ	ⲟⲩⲟⲛ|ϣ|ϫⲟⲙ
ⲟⲩⲟⲛϩ	ⲟⲩⲟⲛϩ
ⲟⲩⲟⲛϩϥ	ⲟⲩⲟⲛϩ|ϥ
ⲟⲩⲟⲛⲛⲧⲁ	ⲟⲩⲟⲛⲛⲧⲁ
ⲟⲩⲟⲛⲧ	ⲟⲩⲟⲛⲧ
ⲟⲩⲟⲛⲧⲁ	ⲟⲩⲟⲛⲧⲁ
ⲟⲩⲟⲛⲧⲉ	ⲟⲩⲟⲛⲧⲉ
ⲟⲩⲟⲛⲧⲱ	ⲟⲩⲟⲛⲧⲱ
ⲟⲩⲟⲣⲡ	ⲟⲩⲟⲣⲡ
ⲟⲩⲟⲧ	ⲟⲩⲟⲧ
ⲟⲩⲟⲧⲉⲃ	ⲟⲩⲟⲧⲉⲃ
ⲟⲩⲟⲩⲟⲓ	ⲟⲩⲟⲩⲟⲓ
ⲟⲩⲣⲟ	ⲟⲩⲣⲟ
ⲟⲩⲣⲱⲟⲩ	ⲟⲩⲣⲱⲟⲩ
ⲟⲩⲧⲁϩ	ⲟⲩⲧⲁϩ
ⲟⲩⲧⲉ	ⲟⲩⲧⲉ
ⲟⲩⲧⲱ	ⲟⲩⲧⲱ
ⲟⲩⲭⲓ	ⲟⲩⲭⲓ
ⲟⲩⲱ	ⲟⲩⲱ
ⲟⲩⲱϣ	ⲟⲩⲱϣ
ⲟⲩⲱϣⲉⲙ	ⲟⲩⲱϣⲉⲙ
ⲟⲩⲱϣⲧ	ⲟⲩⲱϣⲧ
ⲟⲩⲱϩⲉⲙ	ⲟⲩⲱϩⲉⲙ
ⲟⲩⲱⲓⲛⲓ	ⲟⲩⲱⲓⲛⲓ
ⲟⲩⲱⲙ	ⲟⲩⲱⲙ
ⲟⲩⲱⲛ	ⲟⲩⲱⲛ
ⲟⲩⲱⲛϣ	ⲟⲩⲱⲛϣ
ⲟⲩⲱⲛϧ	ⲟⲩⲱⲛϧ
ⲟⲩⲱⲛϩ	ⲟⲩⲱⲛϩ
ⲟⲩⲱⲣⲡ	ⲟⲩⲱⲣⲡ
ⲟⲩⲱⲧ	ⲟⲩⲱⲧ
ⲟⲩⲱⲧⲉⲃ	ⲟⲩⲱⲧⲉⲃ
ⲟⲩⲱⲧⲉⲛ	ⲟⲩⲱⲧⲉⲛ
ⲟⲯⲱⲛⲓⲟⲛ	ⲟⲯⲱⲛⲓⲟⲛ
ⲡ	ⲡ
ⲡϩⲁⲓ	ⲡϩⲁⲓ
ⲡⲁ	ⲡⲁ
ⲡⲁⲓ	ⲡⲁⲓ
ⲡⲁⲗⲓⲛ	ⲡⲁⲗⲓⲛ
ⲡⲁⲙⲁϩⲟ	ⲡⲁⲙⲁϩⲟ
ⲡⲁⲛⲧⲟⲕⲣⲁⲧⲱⲣ	ⲡⲁⲛⲧⲟⲕⲣⲁⲧⲱⲣ
ⲡⲁⲛⲧⲱⲥ	ⲡⲁⲛⲧⲱⲥ
ⲡⲁⲣⲁ	ⲡⲁⲣⲁ
ⲡⲁⲣⲁⲃⲟⲗⲏ	ⲡⲁⲣⲁⲃⲟⲗⲏ
ⲡⲁⲣⲁⲇⲟⲝⲟⲛ	ⲡⲁⲣⲁⲇⲟⲝⲟⲛ
ⲡⲁⲣⲁⲇⲟⲥⲓⲥ	ⲡⲁⲣⲁⲇⲟⲥⲓⲥ
ⲡⲁⲣⲁⲡⲧⲱⲙⲁ	ⲡⲁⲣⲁⲡⲧⲱⲙⲁ
ⲡⲁⲣⲁⲥⲕⲉⲩⲏ	ⲡⲁⲣⲁⲥⲕⲉⲩⲏ
ⲡⲁⲣⲇⲁⲗⲓⲥ	ⲡⲁⲣⲇⲁⲗⲓⲥ
ⲡⲁⲣⲑⲉⲛⲟⲥ	ⲡⲁⲣⲑⲉⲛⲟⲥ
ⲡⲁⲣⲟⲃⲟⲗⲏ	ⲡⲁⲣⲟⲃⲟⲗⲏ
ⲡⲁⲣⲟⲩⲥⲓⲁ	ⲡⲁⲣⲟⲩⲥⲓⲁ
ⲡⲁⲣⲣⲏⲥⲓⲁ	ⲡⲁⲣⲣⲏⲥⲓⲁ
ⲡⲁⲥⲭⲁ	ⲡⲁⲥⲭⲁ
ⲡⲁⲧϣⲉⲗⲉⲧ	ⲡⲁ|ⲧ|ϣⲉⲗⲉⲧ
ⲡⲁⲧⲣⲓⲁⲣⲭⲏⲥ	ⲡⲁⲧⲣⲓⲁⲣⲭⲏⲥ
ⲡⲁⲩⲗⲟⲥ	ⲡⲁⲩⲗⲟⲥ
ⲡⲉ	ⲡⲉ
ⲡⲉϥ	ⲡⲉϥ
ⲡⲉϫⲁ	ⲡⲉϫⲁ
ⲡⲉϫⲉ	ⲡⲉϫⲉ
ⲡⲉϫⲱ	ⲡⲉϫⲱ
ⲡⲉⲇⲏⲥ	ⲡⲉⲇⲏⲥ
ⲡⲉⲓⲣⲁⲥⲙⲟⲥ	ⲡⲉⲓⲣⲁⲥⲙⲟⲥ
ⲡⲉⲕ	ⲡⲉⲕ
ⲡⲉⲛ	ⲡⲉⲛ
ⲡⲉⲛⲧⲏⲕⲟⲥⲧⲏ	ⲡⲉⲛⲧⲏⲕⲟⲥⲧⲏ
ⲡⲉⲣⲓⲭⲱⲣⲟⲥ	ⲡⲉⲣⲓⲭⲱⲣⲟⲥ
ⲡⲉⲥ	ⲡⲉⲥ
ⲡⲉⲧϩⲱⲟⲩ	ⲡ|ⲉⲧ|ϩⲱⲟⲩ
ⲡⲉⲧⲉⲛ	ⲡⲉⲧⲉⲛ
ⲡⲉⲧⲣⲁ	ⲡⲉⲧⲣⲁ
ⲡⲉⲧⲣⲟⲥ	ⲡⲉⲧⲣⲟⲥ
ⲡⲏⲣⲁ	ⲡⲏⲣⲁ
ⲡⲓ	ⲡⲓ
ⲡⲓϣⲱ	ⲡⲓϣⲱ
ⲡⲓⲗⲁⲧⲟⲥ	ⲡⲓⲗⲁⲧⲟⲥ
ⲡⲓⲣⲁⲥⲙⲟⲥ	ⲡⲓⲣⲁⲥⲙⲟⲥ
ⲡⲓⲥⲧⲓⲕⲏ	ⲡⲓⲥⲧⲓⲕⲏ
ⲡⲓⲥⲧⲟⲥ	ⲡⲓⲥⲧⲟⲥ
ⲡⲗⲏⲛ	ⲡⲗⲏⲛ
ⲡⲛⲁⲧⲓⲕⲟⲥ	ⲡⲛⲁⲧⲓⲕⲟⲥ
ⲡⲛⲁⲧⲓⲕⲱⲥ	ⲡⲛⲁⲧⲓⲕⲱⲥ
ⲡⲛⲉⲩⲙⲁ	ⲡⲛⲉⲩⲙⲁ
ⲡⲛⲉⲩⲙⲁⲧⲓⲕⲏ	ⲡⲛⲉⲩⲙⲁⲧⲓⲕⲏ
ⲡⲛⲉⲩⲙⲁⲧⲓⲕⲟⲛ	ⲡⲛⲉⲩⲙⲁⲧⲓⲕⲟⲛ
ⲡⲛⲉⲩⲙⲁⲧⲓⲕⲟⲥ	ⲡⲛⲉⲩⲙⲁⲧⲓⲕⲟⲥ
ⲡⲛⲉⲩⲙⲁⲧⲟⲫⲟⲣⲟⲥ	ⲡⲛⲉⲩⲙⲁⲧⲟⲫⲟⲣⲟⲥ
ⲡⲟⲗⲉⲙⲟⲥ	ⲡⲟⲗⲉⲙⲟⲥ
ⲡⲟⲗⲓⲥ	ⲡⲟⲗⲓⲥ
ⲡⲟⲗⲓⲧⲉⲓⲁ	ⲡⲟⲗⲓⲧⲉⲓⲁ
ⲡⲟⲛⲏⲣⲓⲁ	ⲡⲟⲛⲏⲣⲓⲁ
ⲡⲟⲛⲏⲣⲟⲥ	ⲡⲟⲛⲏⲣⲟⲥ
ⲡⲟⲣⲛⲏ	ⲡⲟⲣⲛⲏ
ⲡⲟⲣⲛⲓⲁ	ⲡⲟⲣⲛⲓⲁ
ⲡⲟⲣⲛⲟⲥ	ⲡⲟⲣⲛⲟⲥ
ⲡⲟⲩ	ⲡⲟⲩ
ⲡⲣⲁⲓⲧⲱⲣⲓⲟⲛ	ⲡⲣⲁⲓⲧⲱⲣⲓⲟⲛ
ⲡⲣⲉⲥⲃⲩⲧⲉⲣⲟⲥ	ⲡⲣⲉⲥⲃⲩⲧⲉⲣⲟⲥ
ⲡⲣⲉⲧⲱⲣⲓⲟⲛ	ⲡⲣⲉⲧⲱⲣⲓⲟⲛ
ⲡⲣⲓⲥⲕⲁ	ⲡⲣⲓⲥⲕⲁ
ⲡⲣⲟⲑⲉⲥⲓⲥ	ⲡⲣⲟⲑⲉⲥⲓⲥ
ⲡⲣⲟⲥ	ⲡⲣⲟⲥ
ⲡⲣⲟⲥⲉⲩⲭⲏ	ⲡⲣⲟⲥⲉⲩⲭⲏ
ⲡⲣⲟⲥⲟⲩⲥⲏⲟⲩ	ⲡⲣⲟⲥⲟⲩⲥⲏⲟⲩ
ⲡⲣⲟⲫⲏⲧⲏⲥ	ⲡⲣⲟⲫⲏⲧⲏⲥ
ⲡⲣⲟⲫⲏⲧⲓⲁ	ⲡⲣⲟⲫⲏⲧⲓⲁ
ⲡⲣⲟⲫⲏⲧⲓⲕⲟⲛ	ⲡⲣⲟⲫⲏⲧⲓⲕⲟⲛ
ⲡⲩⲣⲅⲟⲥ	ⲡⲩⲣⲅⲟⲥ
ⲡⲱⲣϫ	ⲡⲱⲣϫ
ⲡⲱⲥ	ⲡⲱⲥ
ⲣ	ⲣ
ⲣⲁ	ⲣⲁ
ⲣⲁϣⲓ	ⲣⲁϣⲓ
ⲣⲁϧⲧ	ⲣⲁϧⲧ
ⲣⲁⲃⲃⲓ	ⲣⲁⲃⲃⲓ
ⲣⲁⲃⲃⲟⲩⲛⲓ	ⲣⲁⲃⲃⲟⲩⲛⲓ
ⲣⲁⲕⲟϯ	ⲣⲁⲕⲟϯ
ⲣⲁⲙⲁⲟ	ⲣⲁⲙ|ⲁⲟ
ⲣⲁⲛ	ⲣⲁⲛ
ⲣⲁⲥϯ	ⲣⲁⲥϯ
ⲣⲁⲧ	ⲣⲁⲧ
ⲣⲉϥϣⲁⲙϣⲉⲓⲇⲱⲗⲟⲛ	ⲣⲉϥ|ϣⲁⲙϣⲉ|ⲓⲇⲱⲗⲟⲛ
ⲣⲉϥϣⲱⲛⲓ	ⲣⲉϥ|ϣⲱⲛⲓ
ⲣⲉϥϧⲟⲧϧⲉⲧ	ⲣⲉϥ|ϧⲟⲧϧⲉⲧ
ⲣⲉϥϩⲱⲗⲉⲙ	ⲣⲉϥ|ϩⲱⲗⲉⲙ
ⲣⲉϥϩⲱⲟⲩϣ	ⲣⲉϥ|ϩⲱⲟⲩϣ
ⲣⲉϥϭⲓ	ⲣⲉϥ|ϭⲓ
ⲣⲉϥϭⲓⲛϫⲟⲛⲥ	ⲣⲉϥ|ϭⲓ|ⲛ|ϫⲟⲛⲥ
ⲣⲉϥϭⲓⲟⲩⲓ	ⲣⲉϥ|ϭⲓⲟⲩⲓ
ⲣⲉϥϯ	ⲣⲉϥ|ϯ
ⲣⲉϥϯϣⲱϣ	ⲣⲉϥ|ϯ|ϣⲱϣ
ⲣⲉϥϯϩⲁⲡ	ⲣⲉϥ|ϯ|ϩⲁⲡ
ⲣⲉϥϯⲥⲃⲱ	ⲣⲉϥ|ϯ|ⲥⲃⲱ
ⲣⲉϥϯⲱⲙⲥ	ⲣⲉϥ|ϯ|ⲱⲙⲥ
ⲣⲉϥⲉⲛⲕⲟⲧ	ⲣⲉϥ|ⲉⲛⲕⲟⲧ
ⲣⲉϥⲉⲣϩⲱⲃ	ⲣⲉϥ|ⲉⲣ|ϩⲱⲃ
ⲣⲉϥⲉⲣⲇⲓⲁⲕⲣⲓⲛⲓⲛ	ⲣⲉϥ|ⲉⲣ|ⲇⲓⲁⲕⲣⲓⲛⲓⲛ
ⲣⲉϥⲉⲣⲉⲡⲓⲑⲩⲙⲓⲛ	ⲣⲉϥ|ⲉⲣ|ⲉⲡⲓⲑⲩⲙⲓⲛ
ⲣⲉϥⲉⲣⲕⲗⲏⲣⲟⲛⲟⲙⲓⲛ	ⲣⲉϥ|ⲉⲣ|ⲕⲗⲏⲣⲟⲛⲟⲙⲓⲛ
ⲣⲉϥⲉⲣⲛⲟⲃⲓ	ⲣⲉϥ|ⲉⲣ|ⲛⲟⲃⲓ
ⲣⲉϥⲑⲓϧⲓ	ⲣⲉϥ|ⲑⲓϧⲓ
ⲣⲉϥⲙⲱⲟⲩⲧ	ⲣⲉϥ|ⲙⲱⲟⲩⲧ
ⲣⲉϥⲧⲁϩⲉⲣⲱⲙⲓ	ⲣⲉϥ|ⲧⲁϩⲉ|ⲣⲱⲙⲓ
ⲣⲉϥⲧⲁⲕⲟ	ⲣⲉϥ|ⲧⲁⲕⲟ
ⲣⲉϥⲧⲱⲃϩ	ⲣⲉϥ|ⲧⲱⲃϩ
ⲣⲉϥⲭⲟϩ	ⲣⲉϥ|ⲭⲟϩ
ⲣⲉⲙϩⲉ	ⲣⲉⲙ|ϩⲉ
ⲣⲉⲙϩⲏ	ⲣⲉⲙϩⲏ
ⲣⲉⲙⲙⲫⲉ	ⲣⲉⲙ|ⲙ|ⲫⲉ
ⲣⲉⲙⲛⲁⲍⲁⲣⲉⲑ	ⲣⲉⲙ|ⲛⲁⲍⲁⲣⲉⲑ
ⲣⲉⲙⲛⲕⲁϩⲓ	ⲣⲉⲙ|ⲛ|ⲕⲁϩⲓ
ⲣⲉⲙⲛⲭⲏⲙⲓ	ⲣⲉⲙ|ⲛ|ⲭⲏⲙⲓ
ⲣⲉⲙⲣⲁⲩϣ	ⲣⲉⲙ|ⲣⲁⲩϣ
ⲣⲉⲛ	ⲣⲉⲛ
ⲣⲏ	ⲣⲏ
ⲣⲏϫ	ⲣⲏϫ
ⲣⲏϯ	ⲣⲏϯ
ⲣⲏⲥ	ⲣⲏⲥ
ⲣⲓⲕⲓ	ⲣⲓⲕⲓ
ⲣⲓⲙⲓ	ⲣⲓⲙⲓ
ⲣⲓⲣ	ⲣⲓⲣ
ⲣⲙⲉⲗⲉⲧⲁⲛ	ⲣ|ⲙⲉⲗⲉⲧⲁⲛ
ⲣⲛⲟϥⲣⲓ	ⲣ|ⲛⲟϥⲣⲓ
ⲣⲟ	ⲣⲟ
ⲣⲟϯ	ⲣⲟϯ
ⲣⲟⲕϩ	ⲣⲟⲕϩ
ⲣⲟⲙⲡⲓ	ⲣⲟⲙⲡⲓ
ⲣⲟⲧⲉⲃ	ⲣⲟⲧⲉⲃ
ⲣⲟⲩϩⲓ	ⲣⲟⲩϩⲓ
ⲣⲟⲩⲫⲟⲥ	ⲣⲟⲩⲫⲟⲥ
ⲣⲭⲣⲓⲁ	ⲣ|ⲭⲣⲓⲁ
ⲣⲱ	ⲣⲱ
ⲣⲱⲓⲙⲓ	ⲣⲱⲓⲙⲓ
ⲣⲱⲓⲥ	ⲣⲱⲓⲥ
ⲣⲱⲕϩ	ⲣⲱⲕϩ
ⲣⲱⲙⲓ	ⲣⲱⲙⲓ
ⲣⲱⲟⲩ	ⲣⲱⲟⲩ
ⲣⲱⲟⲩϣ	ⲣⲱⲟⲩϣ
ⲣⲱⲟⲩⲓ	ⲣⲱⲟⲩⲓ
ⲣⲱⲟⲩⲧ	ⲣⲱⲟⲩⲧ
ⲣⲱⲟⲩⲧϥ	ⲣⲱⲟⲩⲧ|ϥ
ⲣⲱⲧ	ⲣⲱⲧ
ⲣⲱⲧⲉⲃ	ⲣⲱⲧⲉⲃ
ⲥ	ⲥ
ⲥϣⲉ	ⲥϣⲉ
ⲥϧⲁⲓ	ⲥϧⲁⲓ
ⲥϧⲉ	ⲥϧⲉ
ⲥϧⲏⲟⲩⲧ	ⲥϧⲏⲟⲩⲧ
ⲥϧⲏⲧ	ⲥϧⲏⲧ
ⲥϧⲓ	ⲥϧⲓ
ⲥϩⲓⲙⲓ	ⲥϩⲓⲙⲓ
ⲥⲁ	ⲥⲁ
ⲥⲁϧ	ⲥⲁϧ
ⲥⲁϧⲟⲩⲛ	ⲥⲁϧⲟⲩⲛ
ⲥⲁϩϯ	ⲥⲁϩϯ
ⲥⲁϩⲟⲩⲓ	ⲥⲁϩⲟⲩⲓ
ⲥⲁϩⲱ	ⲥⲁϩⲱ
ⲥⲁϫⲓ	ⲥⲁϫⲓ
ⲥⲁⲃⲁⲭⲑⲁⲛⲓ	ⲥⲁⲃⲁⲭⲑⲁⲛⲓ
ⲥⲁⲃⲃⲁⲧⲟⲛ	ⲥⲁⲃⲃⲁⲧⲟⲛ
ⲥⲁⲃⲉ	ⲥⲁⲃⲉ
ⲥⲁⲃⲉⲩ	ⲥⲁⲃⲉⲩ
ⲥⲁⲃⲟⲗ	ⲥⲁⲃⲟⲗ
ⲥⲁⲇⲇⲟⲩⲕⲉⲟⲥ	ⲥⲁⲇⲇⲟⲩⲕⲉⲟⲥ
ⲥⲁⲑⲉⲣⲓ	ⲥⲁⲑⲉⲣⲓ
ⲥⲁⲓ	ⲥⲁⲓ
ⲥⲁⲓⲉ	ⲥⲁⲓⲉ
ⲥⲁⲓⲱⲟⲩ	ⲥⲁⲓⲱⲟⲩ
ⲥⲁⲗⲡⲓⲅⲅⲟⲥ	ⲥⲁⲗⲡⲓⲅⲅⲟⲥ
ⲥⲁⲗⲡⲓⲅⲝ	ⲥⲁⲗⲡⲓⲅⲝ
ⲥⲁⲗⲱⲙⲏ	ⲥⲁⲗⲱⲙⲏ
ⲥⲁⲙⲉⲛϩⲏ	ⲥⲁⲙⲉⲛϩⲏ
ⲥⲁⲛⲇⲁⲗⲓⲟⲛ	ⲥⲁⲛⲇⲁⲗⲓⲟⲛ
ⲥⲁⲣⲕⲓⲕⲟⲛ	ⲥⲁⲣⲕⲓⲕⲟⲛ
ⲥⲁⲣⲕⲓⲕⲟⲥ	ⲥⲁⲣⲕⲓⲕⲟⲥ
ⲥⲁⲣⲕⲓⲕⲱⲥ	ⲥⲁⲣⲕⲓⲕⲱⲥ
ⲥⲁⲣⲝ	ⲥⲁⲣⲝ
ⲥⲁⲧ	ⲥⲁⲧ
ⲥⲁⲧⲁⲛⲁⲥ	ⲥⲁⲧⲁⲛⲁⲥ
ⲥⲁⲧⲉⲛ	ⲥⲁⲧⲉⲛ
ⲥⲁⲧⲟⲧ	ⲥⲁⲧⲟⲧ
ⲥⲁⲭⲟⲗ	ⲥⲁⲭⲟⲗ
ⲥⲃⲱ	ⲥⲃⲱ
ⲥⲉ	ⲥⲉ
ⲥⲉϥ	ⲥⲉϥ
ⲥⲉϩⲧ	ⲥⲉϩⲧ
ⲥⲉϫⲡ	ⲥⲉϫⲡ
ⲥⲉⲃⲧⲉ	ⲥⲉⲃⲧⲉ
ⲥⲉⲃⲧⲱⲧ	ⲥⲉⲃⲧⲱⲧ
ⲥⲉⲕ	ⲥⲉⲕ
ⲥⲉⲙⲛⲏⲟⲩⲧ	ⲥⲉⲙⲛⲏⲟⲩⲧ
ⲥⲉⲛ	ⲥⲉⲛ
ⲥⲉⲛϯ	ⲥⲉⲛϯ
ⲥⲉⲛⲥⲉⲛ	ⲥⲉⲛⲥⲉⲛ
ⲥⲉⲛⲧ	ⲥⲉⲛⲧ
ⲥⲉⲡ	ⲥⲉⲡ
ⲥⲉⲡⲓ	ⲥⲉⲡⲓ
ⲥⲉⲣ	ⲥⲉⲣ
ⲥⲉⲣⲉⲙ	ⲥⲉⲣⲉⲙ
ⲥⲉⲧ	ⲥⲉⲧ
ⲥⲏ	ⲥⲏ
ⲥⲏϥⲓ	ⲥⲏϥⲓ
ⲥⲏϫ	ⲥⲏϫ
ⲥⲏⲃⲓ	ⲥⲏⲃⲓ
ⲥⲏⲓⲛⲓ	ⲥⲏⲓⲛⲓ
ⲥⲏⲟⲩ	ⲥⲏⲟⲩ
ⲥⲑⲉⲣⲧⲉⲣ	ⲥⲑⲉⲣⲧⲉⲣ
ⲥⲑⲟⲓ	ⲥⲑⲟⲓ
ⲥⲑⲟⲓⲛⲟⲩϥⲓ	ⲥⲑⲟⲓ|ⲛⲟⲩϥⲓ
ⲥⲓ	ⲥⲓ
ⲥⲓϩⲓ	ⲥⲓϩⲓ
ⲥⲓϯ	ⲥⲓϯ
ⲥⲓⲇⲱⲛ	ⲥⲓⲇⲱⲛ
ⲥⲓⲙ	ⲥⲓⲙ
ⲥⲓⲙⲱⲛ	ⲥⲓⲙⲱⲛ
ⲥⲓⲛⲓ	ⲥⲓⲛⲓ
ⲥⲓⲛⲓⲱⲟⲩ	ⲥⲓⲛⲓⲱⲟⲩ
ⲥⲓⲟⲩ	ⲥⲓⲟⲩ
ⲥⲕⲁⲛⲇⲁⲗⲟⲛ	ⲥⲕⲁⲛⲇⲁⲗⲟⲛ
ⲥⲕⲉⲡⲱⲗⲁⲧⲟⲣ	ⲥⲕⲉⲡⲱⲗⲁⲧⲟⲣ
ⲥⲕⲉⲣⲕⲉⲣ	ⲥⲕⲉⲣⲕⲉⲣ
ⲥⲕⲉⲣⲕⲱⲣ	ⲥⲕⲉⲣⲕⲱⲣ
ⲥⲕⲉⲩⲟⲥ	ⲥⲕⲉⲩⲟⲥ
ⲥⲕⲩⲛⲏ	ⲥⲕⲩⲛⲏ
ⲥⲙⲁⲣⲱⲟⲩⲧ	ⲥⲙⲁⲣⲱⲟⲩⲧ
ⲥⲙⲏ	ⲥⲙⲏ
ⲥⲙⲟⲛⲧ	ⲥⲙⲟⲛⲧ
ⲥⲙⲟⲩ	ⲥⲙⲟⲩ
ⲥⲛⲁϩ	ⲥⲛⲁϩ
ⲥⲛⲁⲩ	ⲥⲛⲁⲩ
ⲥⲛⲏⲟⲩ	ⲥⲛⲏⲟⲩ
ⲥⲛⲏⲟⲩⲙ	ⲥⲛⲏⲟⲩⲙ
ⲥⲛⲏⲩ	ⲥⲛⲏⲩ
ⲥⲛⲟϥ	ⲥⲛⲟϥ
ⲥⲛⲟⲩϯ	ⲥⲛⲟⲩϯ
ⲥⲟ	ⲥⲟ
ⲥⲟϥ	ⲥⲟϥ
ⲥⲟϫ	ⲥⲟϫ
ⲥⲟϫⲉⲛ	ⲥⲟϫⲉⲛ
ⲥⲟϭⲛⲓ	ⲥⲟϭⲛⲓ
ⲥⲟⲃϯ	ⲥⲟⲃϯ
ⲥⲟⲃⲧ	ⲥⲟⲃⲧ
ⲥⲟⲑⲙ	ⲥⲟⲑⲙ
ⲥⲟⲕ	ⲥⲟⲕ
ⲥⲟⲗⲥⲉⲗ	ⲥⲟⲗⲥⲉⲗ
ⲥⲟⲙⲥ	ⲥⲟⲙⲥ
ⲥⲟⲛ	ⲥⲟⲛ
ⲥⲟⲛϩ	ⲥⲟⲛϩ
ⲥⲟⲛⲓ	ⲥⲟⲛⲓ
ⲥⲟⲛⲧ	ⲥⲟⲛⲧ
ⲥⲟⲡ	ⲥⲟⲡ
ⲥⲟⲣⲉⲙ	ⲥⲟⲣⲉⲙ
ⲥⲟⲥⲟⲩ	ⲥⲟⲥⲟⲩ
ⲥⲟⲧⲡ	ⲥⲟⲧⲡ
ⲥⲟⲩⲃⲏⲧ	ⲥⲟⲩⲃⲏⲧ
ⲥⲟⲩⲉⲛ	ⲥⲟⲩⲉⲛ
ⲥⲟⲩⲟ	ⲥⲟⲩⲟ
ⲥⲟⲩⲣⲓ	ⲥⲟⲩⲣⲓ
ⲥⲟⲩⲥⲟⲩ	ⲥⲟⲩⲥⲟⲩ
ⲥⲟⲩⲧⲉⲛ	ⲥⲟⲩⲧⲉⲛ
ⲥⲟⲩⲧⲱⲛ	ⲥⲟⲩⲧⲱⲛ
ⲥⲟⲩⲱⲛ	ⲥⲟⲩⲱⲛ
ⲥⲟⲫⲓⲁ	ⲥⲟⲫⲓⲁ
ⲥⲡⲓⲣⲁ	ⲥⲡⲓⲣⲁ
ⲥⲡⲟⲩⲇⲏ	ⲥⲡⲟⲩⲇⲏ
ⲥⲣⲉⲙⲣⲱⲙ	ⲥⲣⲉⲙⲣⲱⲙ
ⲥⲣⲟϥⲧ	ⲥⲣⲟϥⲧ
ⲥⲧⲁⲇⲓⲟⲛ	ⲥⲧⲁⲇⲓⲟⲛ
ⲥⲧⲁⲩⲣⲟⲥ	ⲥⲧⲁⲩⲣⲟⲥ
ⲥⲧⲉⲫⲁⲛⲁ	ⲥⲧⲉⲫⲁⲛⲁ
ⲥⲧⲟⲗⲏ	ⲥⲧⲟⲗⲏ
ⲥⲩⲅⲅⲉⲛⲏⲥ	ⲥⲩⲅⲅⲉⲛⲏⲥ
ⲥⲩⲅⲅⲉⲛⲓⲁ	ⲥⲩⲅⲅⲉⲛⲓⲁ
ⲥⲩⲙⲡⲟⲥⲓⲟⲛ	ⲥⲩⲙⲡⲟⲥⲓⲟⲛ
ⲥⲩⲛⲁⲅⲱⲅⲏ	ⲥⲩⲛⲁⲅⲱⲅⲏ
ⲥⲩⲛⲁⲝⲓⲥ	ⲥⲩⲛⲁⲝⲓⲥ
ⲥⲩⲛⲅⲛⲱⲙⲏ	ⲥⲩⲛⲅⲛⲱⲙⲏ
ⲥⲩⲛⲇⲟⲛⲓⲟⲛ	ⲥⲩⲛⲇⲟⲛⲓⲟⲛ
ⲥⲩⲛⲏⲇⲉⲥⲓⲥ	ⲥⲩⲛⲏⲇⲉⲥⲓⲥ
ⲥⲩⲛⲏⲑⲉⲓⲁ	ⲥⲩⲛⲏⲑⲉⲓⲁ
ⲥⲩⲛⲏⲑⲓⲁ	ⲥⲩⲛⲏⲑⲓⲁ
ⲥⲩⲛⲟⲩⲥⲓⲁ	ⲥⲩⲛⲟⲩⲥⲓⲁ
ⲥⲩⲛⲧⲉⲗⲓⲁ	ⲥⲩⲛⲧⲉⲗⲓⲁ
ⲥⲩⲣⲓⲁ	ⲥⲩⲣⲓⲁ
ⲥⲫⲟⲅⲅⲟⲥ	ⲥⲫⲟⲅⲅⲟⲥ
ⲥⲫⲟⲧⲟⲩ	ⲥⲫⲟⲧⲟⲩ
ⲥⲫⲣⲁⲅⲓⲥ	ⲥⲫⲣⲁⲅⲓⲥ
ⲥⲭⲁⲓ	ⲥⲭⲁⲓ
ⲥⲭⲉⲇⲟⲛ	ⲥⲭⲉⲇⲟⲛ
ⲥⲭⲏⲙⲁ	ⲥⲭⲏⲙⲁ
ⲥⲱ	ⲥⲱ
ⲥⲱϥ	ⲥⲱϥ
ⲥⲱϫⲡ	ⲥⲱϫⲡ
ⲥⲱϯ	ⲥⲱϯ
ⲥⲱⲃⲓ	ⲥⲱⲃⲓ
ⲥⲱⲓⲧ	ⲥⲱⲓⲧ
ⲥⲱⲕ	ⲥⲱⲕ
ⲥⲱⲗⲡ	ⲥⲱⲗⲡ
ⲥⲱⲙⲁ	ⲥⲱⲙⲁ
ⲥⲱⲛϩ	ⲥⲱⲛϩ
ⲥⲱⲛⲓ	ⲥⲱⲛⲓ
ⲥⲱⲛⲧ	ⲥⲱⲛⲧ
ⲥⲱⲟⲩⲃⲉⲛ	ⲥⲱⲟⲩⲃⲉⲛ
ⲥⲱⲟⲩⲛ	ⲥⲱⲟⲩⲛ
ⲥⲱⲟⲩⲧⲉⲛ	ⲥⲱⲟⲩⲧⲉⲛ
ⲥⲱⲣ	ⲥⲱⲣ
ⲥⲱⲣⲉⲙ	ⲥⲱⲣⲉⲙ
ⲥⲱⲥⲑⲉⲛⲏⲥ	ⲥⲱⲥⲑⲉⲛⲏⲥ
ⲥⲱⲧⲉⲙ	ⲥⲱⲧⲉⲙ
ⲥⲱⲧⲏⲣ	ⲥⲱⲧⲏⲣ
ⲥⲱⲧⲡ	ⲥⲱⲧⲡ
ⲧ	ⲧ
ⲧϧⲙⲟⲙ	ⲧ|ϧⲙⲟⲙ
ⲧϩⲉⲙⲕⲏⲟⲩⲧ	ⲧϩⲉⲙⲕⲏⲟⲩⲧ
ⲧϩⲉⲙⲥⲱ	ⲧϩⲉⲙⲥⲱ
ⲧϩⲟ	ⲧϩⲟ
ⲧϩⲱⲛ	ⲧϩⲱⲛ
ⲧⲁ	ⲧⲁ
ⲧⲁϩⲉ	ⲧⲁϩⲉ
ⲧⲁϩⲛⲟ	ⲧⲁϩⲛⲟ
ⲧⲁϩⲟ	ⲧⲁϩⲟ
ⲧⲁϩⲱ	ⲧⲁϩⲱ
ⲧⲁϫⲣⲉ	ⲧⲁϫⲣⲉ
ⲧⲁϫⲣⲏⲟⲩⲧ	ⲧⲁϫⲣⲏⲟⲩⲧ
ⲧⲁϫⲣⲟ	ⲧⲁϫⲣⲟ
ⲧⲁⲅⲙⲁ	ⲧⲁⲅⲙⲁ
ⲧⲁⲓ	ⲧⲁⲓ
ⲧⲁⲓⲏⲟⲧ	ⲧⲁⲓⲏⲟⲧ
ⲧⲁⲓⲏⲟⲩⲧ	ⲧⲁⲓⲏⲟⲩⲧ
ⲧⲁⲓⲟ	ⲧⲁⲓⲟ
ⲧⲁⲕⲉ	ⲧⲁⲕⲉ
ⲧⲁⲕⲟ	ⲧⲁⲕⲟ
ⲧⲁⲗϭⲟ	ⲧⲁⲗϭⲟ
ⲧⲁⲗⲉ	ⲧⲁⲗⲉ
ⲧⲁⲗⲉⲡⲱⲣⲓⲁ	ⲧⲁⲗⲉⲡⲱⲣⲓⲁ
ⲧⲁⲗⲏⲟⲩⲧ	ⲧⲁⲗⲏⲟⲩⲧ
ⲧⲁⲗⲓⲑⲁ	ⲧⲁⲗⲓⲑⲁ
ⲧⲁⲗⲟ	ⲧⲁⲗⲟ
ⲧⲁⲙⲉ	ⲧⲁⲙⲉ
ⲧⲁⲙⲉⲧⲣⲉⲙϩⲉ	ⲧⲁⲙⲉⲧⲣⲉⲙϩⲉ
ⲧⲁⲙⲟ	ⲧⲁⲙⲟ
ⲧⲁⲙⲱ	ⲧⲁⲙⲱ
ⲧⲁⲛϧⲟ	ⲧⲁⲛϧⲟ
ⲧⲁⲟⲩⲟ	ⲧⲁⲟⲩⲟ
ⲧⲁⲡⲁⲛⲏ	ⲧⲁⲡⲁⲛⲏ
ⲧⲁⲣⲕⲟ	ⲧⲁⲣⲕⲟ
ⲧⲁⲥⲑⲟ	ⲧⲁⲥⲑⲟ
ⲧⲁⲩⲧⲁ	ⲧⲁⲩⲧⲁ
ⲧⲁⲭⲁ	ⲧⲁⲭⲁ
ⲧⲉ	ⲧⲉ
ⲧⲉϥ	ⲧⲉϥ
ⲧⲉⲃⲛⲱⲟⲩⲓ	ⲧⲉⲃⲛⲱⲟⲩⲓ
ⲧⲉⲃⲧ	ⲧⲉⲃⲧ
ⲧⲉⲕ	ⲧⲉⲕ
ⲧⲉⲗⲓⲟⲛ	ⲧⲉⲗⲓⲟⲛ
ⲧⲉⲗⲱⲛⲏⲥ	ⲧⲉⲗⲱⲛⲏⲥ
ⲧⲉⲗⲱⲛⲓⲟⲛ	ⲧⲉⲗⲱⲛⲓⲟⲛ
ⲧⲉⲛ	ⲧⲉⲛ
ⲧⲉⲛϩ	ⲧⲉⲛϩ
ⲧⲉⲛϩⲟⲩⲧ	ⲧⲉⲛϩⲟⲩⲧ
ⲧⲉⲛⲉ	ⲧⲉⲛⲉ
ⲧⲉⲛⲑⲱⲛ	ⲧⲉⲛⲑⲱⲛ
ⲧⲉⲛⲑⲱⲛⲧ	ⲧⲉⲛⲑⲱⲛⲧ
ⲧⲉⲣ	ⲧⲉⲣ
ⲧⲉⲣⲉⲛⲟⲩϯ	ⲧⲉⲣⲉ|ⲛⲟⲩϯ
ⲧⲉⲥ	ⲧⲉⲥ
ⲧⲉⲧⲉⲛ	ⲧⲉⲧⲉⲛ
ⲧⲉⲧⲛ	ⲧⲉⲧⲛ
ⲧⲉⲩⲓⲛ	ⲧⲉⲩⲓⲛ
ⲧⲏ	ⲧⲏ
ⲧⲏⲃ	ⲧⲏⲃ
ⲧⲏⲓ	ⲧⲏⲓ
ⲧⲏⲓⲧ	ⲧⲏⲓⲧ
ⲧⲏⲣ	ⲧⲏⲣ
ⲧⲏⲣϥ	ⲧⲏⲣ|ϥ
ⲧⲓⲙⲉⲟⲥ	ⲧⲓⲙⲉⲟⲥ
ⲧⲓⲙⲏ	ⲧⲓⲙⲏ
ⲧⲓⲙⲓ	ⲧⲓⲙⲓ
ⲧⲓⲙⲟⲑⲉⲟⲥ	ⲧⲓⲙⲟⲑⲉⲟⲥ
ⲧⲛ	ⲧⲛ
ⲧⲟⲓ	ⲧⲟⲓ
ⲧⲟⲗⲟⲓⲡⲟⲛ	ⲧⲟⲗⲟⲓⲡⲟⲛ
ⲧⲟⲙ	ⲧⲟⲙ
ⲧⲟⲙⲓ	ⲧⲟⲙⲓ
ⲧⲟⲛ	ⲧⲟⲛ
ⲧⲟⲟⲩⲓ	ⲧⲟⲟⲩⲓ
ⲧⲟⲡⲟⲥ	ⲧⲟⲡⲟⲥ
ⲧⲟⲧ	ⲧⲟⲧ
ⲧⲟⲧⲉ	ⲧⲟⲧⲉ
ⲧⲟⲩ	ⲧⲟⲩ
ⲧⲟⲩϩⲟ	ⲧⲟⲩϩⲟ
ⲧⲟⲩⲃⲉ	ⲧⲟⲩⲃⲉ
ⲧⲟⲩⲃⲟ	ⲧⲟⲩⲃⲟ
ⲧⲟⲩⲃⲱ	ⲧⲟⲩⲃⲱ
ⲧⲟⲩⲛⲟⲥ	ⲧⲟⲩⲛⲟⲥ
ⲧⲟⲩⲧⲟ	ⲧⲟⲩⲧⲟ
ⲧⲣⲁⲡⲉⲍⲁ	ⲧⲣⲁⲡⲉⲍⲁ
ⲧⲣⲓⲁⲉ	ⲧⲣⲓⲁⲉ
ⲧⲥⲁⲃⲟ	ⲧⲥⲁⲃⲟ
ⲧⲥⲉ	ⲧⲥⲉ
ⲧⲥⲟ	ⲧⲥⲟ
ⲧⲩⲡⲟⲥ	ⲧⲩⲡⲟⲥ
ⲧⲩⲣⲁⲛⲛⲟⲥ	ⲧⲩⲣⲁⲛⲛⲟⲥ
ⲧⲩⲣⲟⲥ	ⲧⲩⲣⲟⲥ
ⲧⲫⲉ	ⲧⲫⲉ
ⲧⲫⲟ	ⲧⲫⲟ
ⲧⲱϫⲓ	ⲧⲱϫⲓ
ⲧⲱⲃϩ	ⲧⲱⲃϩ
ⲧⲱⲓⲥ	ⲧⲱⲓⲥ
ⲧⲱⲙⲓ	ⲧⲱⲙⲓ
ⲧⲱⲙⲛⲧ	ⲧⲱⲙⲛⲧ
ⲧⲱⲙⲧ	ⲧⲱⲙⲧ
ⲧⲱⲛ	ⲧⲱⲛ
ⲧⲱⲛϥ	ⲧⲱⲛ|ϥ
ⲧⲱⲟⲩ	ⲧⲱⲟⲩ
ⲧⲱⲟⲩⲛ	ⲧⲱⲟⲩⲛ
ⲧⲱⲟⲩⲛⲟⲩ	ⲧⲱⲟⲩⲛⲟⲩ
ⲩ	ⲩ
ⲫ	ⲫ
ⲫⲁ	ⲫⲁ
ⲫⲁϣ	ⲫⲁϣ
ⲫⲁϣⲓ	ⲫⲁϣⲓ
ⲫⲁϩⲟⲩ	ⲫⲁϩⲟⲩ
ⲫⲁⲓ	ⲫⲁⲓ
ⲫⲁⲣⲓⲥⲁⲓⲟⲥ	ⲫⲁⲣⲓⲥⲁⲓⲟⲥ
ⲫⲁⲣⲓⲥⲉⲟⲥ	ⲫⲁⲣⲓⲥⲉⲟⲥ
ⲫⲉ	ⲫⲉ
ⲫⲉϣ	ⲫⲉϣ
ⲫⲉϧ	ⲫⲉϧ
ⲫⲉⲣⲓⲱⲟⲩ	ⲫⲉⲣⲓⲱⲟⲩ
ⲫⲏ	ⲫⲏ
ⲫⲏϣ	ⲫⲏϣ
ⲫⲏⲟⲩⲓ	ⲫⲏⲟⲩⲓ
ⲫⲑⲟⲛⲟⲥ	ⲫⲑⲟⲛⲟⲥ
ⲫⲓ	ⲫⲓ
ⲫⲓⲗⲓⲡⲡⲉ	ⲫⲓⲗⲓⲡⲡⲉ
ⲫⲓⲗⲓⲡⲡⲟⲥ	ⲫⲓⲗⲓⲡⲡⲟⲥ
ⲫⲓⲗⲟⲑⲉⲟⲥ	ⲫⲓⲗⲟⲑⲉⲟⲥ
ⲫⲛⲟⲩϯ	ⲫⲛⲟⲩϯ
ⲫⲟϩ	ⲫⲟϩ
ⲫⲟⲓⲛⲓⲕⲏ	ⲫⲟⲓⲛⲓⲕⲏ
ⲫⲟⲗϩ	ⲫⲟⲗϩ
ⲫⲟⲛ	ⲫⲟⲛ
ⲫⲟⲛϩ	ⲫⲟⲛϩ
ⲫⲟⲟⲩ	ⲫⲟⲟⲩ
ⲫⲟⲣϣ	ⲫⲟⲣϣ
ⲫⲟⲣϫ	ⲫⲟⲣϫ
ⲫⲟⲣⲉⲓ	ⲫⲟⲣⲉⲓ
ⲫⲟⲣⲕ	ⲫⲟⲣⲕ
ⲫⲟⲣⲧⲟⲩⲛⲁⲧⲟⲥ	ⲫⲟⲣⲧⲟⲩⲛⲁⲧⲟⲥ
ⲫⲣⲱ	ⲫⲣⲱ
ⲫⲩⲥⲓⲥ	ⲫⲩⲥⲓⲥ
ⲫⲱϣ	ⲫⲱϣ
ⲫⲱϥ	ⲫⲱϥ
ⲫⲱϧ	ⲫⲱϧ
ⲫⲱⲓ	ⲫⲱⲓ
ⲫⲱⲣϣ	ⲫⲱⲣϣ
ⲫⲱⲣϫ	ⲫⲱⲣϫ
ⲫⲱⲧ	ⲫⲱⲧ
ⲫⲱⲧⲉⲛ	ⲫⲱⲧⲉⲛ
ⲫⲱⲧⲉⲧⲉⲛ	ⲫⲱⲧⲉⲧⲉⲛ
ⲭ	ⲭ
ⲭⲁ	ⲭⲁ
ⲭⲁϣⲏⲣⲓ	ⲭⲁ|ϣⲏⲣⲓ
ⲭⲁϩⲱⲃ	ⲭⲁ|ϩⲱⲃ
ⲭⲁϫⲓϫ	ⲭⲁ|ϫⲓϫ
ⲭⲁϫⲣⲟϫ	ⲭⲁ|ϫⲣⲟϫ
ⲭⲁⲏⲓ	ⲭⲁ|ⲏⲓ
ⲭⲁⲕⲓ	ⲭⲁⲕⲓ
ⲭⲁⲗⲇⲉⲟⲥ	ⲭⲁⲗⲇⲉⲟⲥ
ⲭⲁⲗⲕⲓⲛ	ⲭⲁⲗⲕⲓⲛ
ⲭⲁⲛⲟⲃⲓ	ⲭⲁ|ⲛⲟⲃⲓ
ⲭⲁⲣⲟ	ⲭⲁⲣⲟ
ⲭⲁⲣⲧⲟⲗⲁⲣⲓⲟⲥ	ⲭⲁⲣⲧⲟⲗⲁⲣⲓⲟⲥ
ⲭⲁⲣⲱ	ⲭⲁⲣⲱ
ⲭⲃⲁ	ⲭⲃⲁ
ⲭⲉϯ	ⲭⲉϯ
ⲭⲉⲣⲉ	ⲭⲉⲣⲉ
ⲭⲉⲣⲟⲩⲃⲓⲙ	ⲭⲉⲣⲟⲩⲃⲓⲙ
ⲭⲉⲧ	ⲭⲉⲧ
ⲭⲏ	ⲭⲏ
ⲭⲏⲙⲓ	ⲭⲏⲙⲓ
ⲭⲏⲣⲁ	ⲭⲏⲣⲁ
ⲭⲓⲗⲓⲁⲣⲭⲟⲥ	ⲭⲓⲗⲓⲁⲣⲭⲟⲥ
ⲭⲓⲱⲛ	ⲭⲓⲱⲛ
ⲭⲗⲟⲏⲥ	ⲭⲗⲟⲏⲥ
ⲭⲗⲟⲙ	ⲭⲗⲟⲙ
ⲭⲗⲟⲙⲗⲉⲙ	ⲭⲗⲟⲙⲗⲉⲙ
ⲭⲙⲁⲗⲱⲥⲓⲁ	ⲭⲙⲁⲗⲱⲥⲓⲁ
ⲭⲟϩ	ⲭⲟϩ
ⲭⲣⲁⲥⲑⲉ	ⲭⲣⲁⲥⲑⲉ
ⲭⲣⲉⲙⲣⲉⲙ	ⲭⲣⲉⲙⲣⲉⲙ
ⲭⲣⲏⲙⲁ	ⲭⲣⲏⲙⲁ
ⲭⲣⲓⲥⲧⲓⲁⲛⲟⲥ	ⲭⲣⲓⲥⲧⲓⲁⲛⲟⲥ
ⲭⲣⲓⲥⲧⲟⲥ	ⲭⲣⲓⲥⲧⲟⲥ
ⲭⲣⲟ	ⲭⲣⲟ
ⲭⲣⲟϥ	ⲭⲣⲟϥ
ⲭⲣⲟⲛⲟⲛ	ⲭⲣⲟⲛⲟⲛ
ⲭⲣⲟⲛⲟⲥ	ⲭⲣⲟⲛⲟⲥ
ⲭⲣⲱⲙ	ⲭⲣⲱⲙ
ⲭⲱ	ⲭⲱ
ⲭⲱⲗⲉⲙ	ⲭⲱⲗⲉⲙ
ⲭⲱⲟⲩⲛⲓ	ⲭⲱⲟⲩⲛⲓ
ⲭⲱⲣⲁ	ⲭⲱⲣⲁ
ⲭⲱⲣⲓⲥ	ⲭⲱⲣⲓⲥ
ⲭⲱⲣⲟⲥ	ⲭⲱⲣⲟⲥ
ⲯⲁⲗⲙⲟⲥ	ⲯⲁⲗⲙⲟⲥ
ⲯⲩⲭⲏ	ⲯⲩⲭⲏ
ⲯⲩⲭⲓⲕⲟⲛ	ⲯⲩⲭⲓⲕⲟⲛ
ⲯⲩⲭⲓⲕⲟⲥ	ⲯⲩⲭⲓⲕⲟⲥ
ⲱ	ⲱ
ⲱϣ	ⲱϣ
ⲱϣϯ	ⲱϣϯ
ⲱϥⲓ	ⲱϥⲓ
ⲱϫϩ	ⲱϫϩ
ⲱⲃϣ	ⲱⲃϣ
ⲱⲏⲣⲓ	ⲱⲏⲣⲓ
ⲱⲓⲕ	ⲱⲓⲕ
ⲱⲓⲙⲓ	ⲱⲓⲙⲓ
ⲱⲕⲉⲙ	ⲱⲕⲉⲙ
ⲱⲗⲓ	ⲱⲗⲓ
ⲱⲙⲕ	ⲱⲙⲕ
ⲱⲙⲥ	ⲱⲙⲥ
ⲱⲛϧ	ⲱⲛϧ
ⲱⲛⲓ	ⲱⲛⲓ
ⲱⲟⲩ	ⲱⲟⲩ
ⲱⲟⲩⲛⲓⲁⲧ	ⲟⲱⲩ|ⲛⲓⲁⲧ
ⲱⲡ	ⲱⲡ
ⲱⲣϥ	ⲱⲣϥ
ⲱⲣⲕ	ⲱⲣⲕ
ⲱⲥϧ	ⲱⲥϧ
ⲱⲥⲁⲛⲛⲁ	ⲱⲥⲁⲛⲛⲁ
