.	.
...	...
ϣ	ϣ
ϣϣⲏⲛ	ϣϣⲏⲛ
ϣϣⲟⲧ	ϣϣⲟⲧ
ϣϧⲉⲧϧⲱⲧϥ	ϣϧⲉⲧϧⲱⲧϥ
ϣϫⲉ	ϣϫⲉ
ϣϫⲉⲙϫⲟⲙ	ϣϫⲉⲙϫⲟⲙ
ϣϫⲟⲙ	ϣϫⲟⲙ
ϣϭⲛⲏⲛ	ϣϭⲛⲏⲛ
ϣⲁ	ϣⲁ
ϣⲁϥϣⲓⲏ	ϣⲁϥϣⲓⲏ
ϣⲁϥϣⲱⲟⲩⲓ	ϣⲁϥϣⲱⲟⲩⲓ
ϣⲁϥϧⲉⲧϧⲉⲧ	ϣⲁϥϧⲉⲧϧⲉⲧ
ϣⲁϥϩⲓⲧϥ	ϣⲁϥϩⲓⲧϥ
ϣⲁϥⲉ	ϣⲁϥⲉ
ϣⲁϥⲉⲛϥ	ϣⲁϥⲉⲛϥ
ϣⲁϥⲉⲣⲁⲧⲟⲩⲧⲁϩ	ϣⲁϥⲉⲣⲁⲧⲟⲩⲧⲁϩ
ϣⲁϥⲑⲣⲉⲡⲓⲟⲩⲱϣⲉⲙ	ϣⲁϥⲑⲣⲉⲡⲓⲟⲩⲱϣⲉⲙ
ϣⲁϥⲓ	ϣⲁϥⲓ
ϣⲁϥⲙⲟϩ	ϣⲁϥⲙⲟϩ
ϣⲁϥⲟⲩⲱⲣⲡ	ϣⲁϥⲟⲩⲱⲣⲡ
ϣⲁϥⲧⲱⲛϥ	ϣⲁϥⲧⲱⲛϥ
ϣⲁⲉϧⲟⲩⲛ	ϣⲁⲉϧⲟⲩⲛ
ϣⲁⲉⲛⲉϩ	ϣⲁⲉⲛⲉϩ
ϣⲁⲑⲛⲁⲩ	ϣⲁⲧⲛⲁⲩ
ϣⲁⲓ	ϣⲁⲓ
ϣⲁⲛ	ϣⲁⲛ
ϣⲁⲣ	ϣⲁⲣ
ϣⲁⲣⲉ	ϣⲁⲣⲉ
ϣⲁⲣⲉⲡⲓϫⲣⲟϫ	ϣⲁⲣⲉⲡⲓϫⲣⲟϫ
ϣⲁⲣⲉⲡⲓⲃⲉⲣⲓ	ϣⲁⲣⲉⲡⲓⲃⲉⲣⲓ
ϣⲁⲣⲉⲡⲓⲏⲣⲡ	ϣⲁⲣⲉⲡⲓⲏⲣⲡ
ϣⲁⲣⲉⲡⲓⲕⲁϩⲓ	ϣⲁⲣⲉⲡⲓⲕⲁϩⲓ
ϣⲁⲣⲉⲡⲧⲏⲣϥ	ϣⲁⲣⲉⲡⲧⲏⲣϥ
ϣⲁⲥϣⲱⲡⲓ	ϣⲁⲥϣⲱⲡⲓ
ϣⲁⲥⲓ	ϣⲁⲥⲓ
ϣⲁⲥⲓⲣⲓ	ϣⲁⲥⲓⲣⲓ
ϣⲁⲧ	ϣⲁⲧ
ϣⲁⲧⲉ	ϣⲁⲧⲉ
ϣⲁⲧⲉϥⲓ	ϣⲁⲧⲉϥⲓ
ϣⲁⲧⲉϥⲭⲁⲡⲓⲙⲏϣ	ϣⲁⲧⲉϥⲭⲁⲡⲓⲙⲏϣ
ϣⲁⲧⲉⲧⲉⲛⲓ	ϣⲁⲧⲉⲧⲛⲓ
ϣⲁⲧⲟⲩⲛⲁⲩ	ϣⲁⲧⲟⲩⲛⲁⲩ
ϣⲁⲧⲫⲁϣⲓ	ϣⲁⲧⲫⲁϣⲓ
ϣⲁⲩϣⲉ	ϣⲁⲩϣⲉ
ϣⲁⲩϣⲟⲡϥ	ϣⲁⲩϣⲟⲡϥ
ϣⲁⲩϩⲓⲏⲣⲡ	ϣⲁⲩϩⲓⲏⲣⲡ
ϣⲁⲩϩⲓⲧⲟⲩ	ϣⲁⲩϩⲓⲧⲟⲩ
ϣⲁⲩϭⲉⲣⲉⲟⲩϧⲏⲃⲥ	ϣⲁⲩϭⲉⲣⲉⲟⲩϧⲏⲃⲥ
ϣⲁⲩϭⲓⲧϥ	ϣⲁⲩϭⲓⲧϥ
ϣⲁⲩϯⲟⲩⲧⲁϩ	ϣⲁⲩϯⲟⲩⲧⲁϩ
ϣⲁⲩⲉⲣⲥⲕⲁⲛⲇⲁⲗⲓⲍⲉⲥⲑⲉ	ϣⲁⲩⲉⲣⲥⲕⲁⲛⲇⲁⲗⲓⲍⲉⲥⲑⲉ
ϣⲁⲩⲓ	ϣⲁⲩⲓ
ϣⲁⲩⲙⲟⲗϩϥ	ϣⲁⲩⲙⲟⲗϩϥ
ϣⲁⲩⲟⲗϥ	ϣⲁⲩⲟⲗϥ
ϣⲁⲩⲟⲩϫⲁⲓ	ϣⲁⲩⲟⲩϫⲁⲓ
ϣⲃⲱⲧ	ϣⲃⲱⲧ
ϣⲉ	ϣⲉ
ϣⲉⲃⲓⲱ	ϣⲉⲃⲓⲱ
ϣⲉⲗⲧⲁⲙ	ϣⲉⲗⲧⲁⲙ
ϣⲉⲙϣⲏⲧ	ϣⲉⲙϣⲏⲧ
ϣⲉⲙϣⲓ	ϣⲉⲙϣⲓ
ϣⲉⲙⲏⲣ	ϣⲉⲙⲏⲣ
ϣⲉⲛ	ϣⲉⲛ
ϣⲉⲛϥ	ϣⲉⲛϥ
ϣⲉⲛϩⲏⲧ	ϣⲉⲛϩⲏⲧ
ϣⲉⲡ	ϣⲉⲡ
ϣⲉⲡϩⲙⲟⲧ	ϣⲉⲡϩⲙⲟⲧ
ϣⲉⲣⲓ	ϣⲉⲣⲓ
ϣⲏϣ	ϣⲏϣ
ϣⲏⲕ	ϣⲏⲕ
ϣⲏⲗ	ϣⲏⲗ
ϣⲏⲣⲓ	ϣⲏⲣⲓ
ϣⲑⲉⲣⲑⲱⲣ	ϣⲑⲉⲣⲑⲱⲣ
ϣⲑⲏⲛ	ϣⲑⲏⲛ
ϣⲑⲟⲣⲧⲉⲣ	ϣⲑⲟⲣⲧⲉⲣ
ϣⲓ	ϣⲓ
ϣⲓⲏ	ϣⲓⲏ
ϣⲓⲛⲓ	ϣⲓⲛⲓ
ϣⲓⲡⲓ	ϣⲓⲡⲓ
ϣⲗⲏⲗⲟⲩⲓ	ϣⲗⲏⲗⲟⲩⲓ
ϣⲛⲉ	ϣⲛⲉ
ϣⲛⲏⲟⲩ	ϣⲛⲏⲟⲩ
ϣⲟ	ϣⲟ
ϣⲟϣ	ϣⲟϣ
ϣⲟⲃⲓ	ϣⲟⲃⲓ
ϣⲟⲃⲧ	ϣⲟⲃⲧ
ϣⲟⲗϩ	ϣⲟⲗϩ
ϣⲟⲡ	ϣⲟⲡ
ϣⲟⲡⲧ	ϣⲟⲡⲧ
ϣⲟⲣⲡ	ϣⲟⲣⲡ
ϣⲟⲩϣⲟⲩ	ϣⲟⲩϣⲟⲩ
ϣⲟⲩⲱⲟⲩ	ϣⲟⲩⲱⲟⲩ
ϣⲧⲁϯ	ϣⲧⲁϯ
ϣⲧⲉⲕⲟ	ϣⲧⲉⲕⲟ
ϣⲧⲉⲙ	ϣⲧⲉⲙ
ϣⲧⲉⲣⲑⲱⲣ	ϣⲧⲉⲣⲑⲱⲣ
ϣⲫⲏⲣ	ϣⲫⲏⲣ
ϣⲫⲏⲣⲓ	ϣⲫⲏⲣⲓ
ϣⲱⲓ	ϣⲱⲓ
ϣⲱⲓϣ	ϣⲱⲓϣ
ϣⲱⲕ	ϣⲱⲕ
ϣⲱⲕⲓ	ϣⲱⲕⲓ
ϣⲱⲙⲓ	ϣⲱⲙⲓ
ϣⲱⲛⲓ	ϣⲱⲛⲓ
ϣⲱⲟⲩⲓ	ϣⲱⲟⲩⲓ
ϣⲱⲡ	ϣⲱⲡ
ϣⲱⲡⲓ	ϣⲱⲡⲓ
ϣⲱⲧ	ϣⲱⲧ
ϥ	ϥ
ϥϧⲟⲧϧⲉⲧ	ϥϧⲟⲧϧⲉⲧ
ϥⲁⲓ	ϥⲁⲓ
ϥⲉϫϧⲉⲙⲥ	ϥⲉϫϧⲉⲙⲥ
ϥⲉⲛⲧ	ϥⲉⲛⲧ
ϥⲑⲏⲙ	ϥⲑⲏⲙ
ϥⲓⲁϩⲟⲙ	ϥⲓⲁϩⲟⲙ
ϥⲓⲧ	ϥⲓⲧ
ϥⲕⲱϯ	ϥⲕⲱϯ
ϥⲙⲟⲩϯ	ϥⲙⲟⲩϯ
ϥⲛⲁϣⲱⲡⲓ	ϥⲛⲁϣⲱⲡⲓ
ϥⲛⲁϫⲉⲙϩⲗⲓ	ϥⲛⲁϫⲉⲙϩⲗⲓ
ϥⲛⲁϫⲟⲥ	ϥⲛⲁϫⲟⲥ
ϥⲛⲁϭⲓ	ϥⲛⲁϭⲓ
ϥⲛⲁϯⲟⲥⲓ	ϥⲛⲁϯⲟⲥⲓ
ϥⲛⲁⲉⲙⲥⲑⲏⲛⲟⲩ	ϥⲛⲁⲉⲙⲥⲑⲏⲛⲟⲩ
ϥⲛⲁⲉⲣⲫⲁϧⲣⲓ	ϥⲛⲁⲉⲣⲫⲁϧⲣⲓ
ϥⲛⲁⲛⲟϩⲉⲙ	ϥⲛⲁⲛⲟϩⲉⲙ
ϥⲛⲁⲟⲩⲟⲛϩϥ	ϥⲛⲁⲟⲩⲟⲛϩϥ
ϥⲛⲁⲟⲩⲟⲣⲡϥ	ϥⲛⲁⲟⲩⲟⲣⲡϥ
ϥⲛⲁⲧⲫⲉ	ϥⲛⲁⲧⲫⲉ
ϥⲛⲁⲧⲱⲛϥ	ϥⲛⲁⲧⲱⲛϥ
ϥⲟϫ	ϥⲟϫ
ϥⲟⲓ	ϥⲟⲓ
ϥⲟⲩⲁϩⲥⲁϩⲛⲓ	ϥⲟⲩⲁϩⲥⲁϩⲛⲓ
ϥⲟⲩⲁⲃ	ϥⲟⲩⲁⲃ
ϥⲟⲩⲏⲟⲩ	ϥⲟⲩⲏⲟⲩ
ϥⲟⲩⲱⲙ	ϥⲟⲩⲱⲙ
ϥⲥⲁⲃⲟⲗ	ϥⲥⲁⲃⲟⲗ
ϥⲥⲙⲁⲣⲱⲟⲩⲧ	ϥⲥⲙⲁⲣⲱⲟⲩⲧ
ϥⲥⲱ	ϥⲥⲱ
ϥⲱϫⲓ	ϥⲱϫⲓ
ϥⲱⲓ	ϥⲱⲓ
ϧⲁ	ϧⲁ
ϧⲁϫⲱ	ϧⲁϫⲱ
ϧⲁϫⲱϥ	ϧⲁϫⲱϥ
ϧⲁϫⲱⲕ	ϧⲁϫⲱⲕ
ϧⲁϫⲱⲟⲩ	ϧⲁϫⲱⲟⲩ
ϧⲁⲉ	ϧⲁⲉ
ϧⲁⲉⲩ	ϧⲁⲉⲩ
ϧⲁⲛⲉϥϭⲁⲗⲁⲩϫ	ϧⲁⲛⲉϥϭⲁⲗⲁⲩϫ
ϧⲁⲛⲓϣⲟⲃⲓ	ϧⲁⲛⲓϣⲟⲃⲓ
ϧⲁⲛⲓⲁⲡⲟⲥⲧⲟⲗⲟⲥ	ϧⲁⲛⲓⲁⲡⲟⲥⲧⲟⲗⲟⲥ
ϧⲁⲟⲩⲧⲓⲙⲏ	ϧⲁⲟⲩⲧⲓⲙⲏ
ϧⲁⲡⲁⲓⲙⲏϣ	ϧⲁⲡⲁⲓⲙⲏϣ
ϧⲁⲡⲓϭⲗⲟϫ	ϧⲁⲡⲓϭⲗⲟϫ
ϧⲁⲡⲓⲙⲉⲛⲧ	ϧⲁⲡⲓⲙⲉⲛⲧ
ϧⲁⲣⲁⲃⲁⲓ	ϧⲁⲣⲁⲃⲁⲓ
ϧⲁⲣⲁⲧ	ϧⲁⲣⲁⲧ
ϧⲁⲣⲁⲧϥ	ϧⲁⲣⲁⲧϥ
ϧⲁⲣⲁⲧⲟⲩ	ϧⲁⲣⲁⲧⲟⲩ
ϧⲁⲣⲟ	ϧⲁⲣⲟ
ϧⲁⲣⲟϥ	ϧⲁⲣⲟϥ
ϧⲁⲣⲟⲓ	ϧⲁⲣⲟⲓ
ϧⲁⲣⲟⲥ	ϧⲁⲣⲟⲥ
ϧⲁⲣⲱ	ϧⲁⲣⲱ
ϧⲁⲣⲱⲟⲩ	ϧⲁⲣⲱⲟⲩ
ϧⲁⲧϩⲏ	ϧⲁⲧϩⲏ
ϧⲁⲧⲉϥϩⲏ	ϧⲁⲧⲉϥϩⲏ
ϧⲁⲧⲉⲛ	ϧⲁⲧⲉⲛ
ϧⲁⲧⲉⲛϩⲗⲓ	ϧⲁⲧⲉⲛϩⲗⲓ
ϧⲁⲧⲉⲛⲟⲩⲣⲟ	ϧⲁⲧⲉⲛⲟⲩⲣⲟ
ϧⲁⲧⲉⲛⲡⲓϫⲁϫⲣⲓⲙ	ϧⲁⲧⲉⲛⲡⲓϫⲁϫⲣⲓⲙ
ϧⲁⲧⲉⲛⲡⲓⲧⲱⲟⲩ	ϧⲁⲧⲉⲛⲡⲓⲧⲱⲟⲩ
ϧⲁⲧⲉⲛⲫⲓⲟⲙ	ϧⲁⲧⲉⲛⲫⲓⲟⲙ
ϧⲁⲧⲉⲥϧⲏⲓⲃⲓ	ϧⲁⲧⲉⲥϧⲏⲓⲃⲓ
ϧⲁⲧⲟⲧ	ϧⲁⲧⲟⲧ
ϧⲁⲧⲟⲧⲟⲩ	ϧⲁⲧⲟⲧⲟⲩ
ϧⲉⲙⲥ	ϧⲉⲙⲥ
ϧⲉⲛ	ϧⲉⲛ
ϧⲉⲛϩⲁⲛϫⲓϫ	ϧⲉⲛϩⲁⲛϫⲓϫ
ϧⲉⲛϩⲁⲛⲙⲉⲧⲁⲧϣⲉⲙⲏⲣ	ϧⲉⲛϩⲉⲛⲙⲉⲧⲁⲧϣⲉⲙⲏⲣ
ϧⲉⲛϩⲁⲛⲙⲉⲧⲣⲉϥϯⲥⲃⲱ	ϧⲉⲛϩⲁⲛⲙⲉⲧⲣⲉϥϯⲥⲃⲱ
ϧⲉⲛϩⲁⲛⲙⲱⲓⲧ	ϧⲉⲛϩⲁⲛⲙⲱⲓⲧ
ϧⲉⲛϩⲁⲛⲡⲁⲣⲁⲃⲟⲗⲏ	ϧⲉⲛϩⲁⲛⲡⲁⲣⲁⲃⲟⲗⲏ
ϧⲉⲛϩⲗⲓ	ϧⲉⲛϩⲗⲓ
ϧⲉⲛϯϭⲏⲡⲓ	ϧⲉⲛϯϭⲏⲡⲓ
ϧⲉⲛϯⲁⲅⲟⲣⲁ	ϧⲉⲛϯⲁⲅⲟⲣⲁ
ϧⲉⲛϯⲃⲁⲕⲓ	ϧⲉⲛϯⲃⲁⲕⲓ
ϧⲉⲛϯⲅⲁⲗⲓⲗⲉⲁ	ϧⲉⲛϯⲅⲁⲗⲓⲗⲉⲁ
ϧⲉⲛϯⲉⲕⲕⲗⲏⲥⲓⲁ	ϧⲉⲛϯⲉⲕⲕⲗⲏⲥⲓⲁ
ϧⲉⲛϯⲙⲁϩⲇ	ϧⲉⲛϯⲙⲁϩⲇ
ϧⲉⲛϯⲡⲉⲣⲓⲭⲱⲣⲟⲥ	ϧⲉⲛϯⲡⲉⲣⲓⲭⲱⲣⲟⲥ
ϧⲉⲛϯⲥⲩⲛⲁⲅⲱⲅⲏ	ϧⲉⲛϯⲥⲩⲛⲁⲅⲱⲅⲏ
ϧⲉⲛϯⲫⲟⲓⲛⲓⲕⲏ	ϧⲉⲛϯⲫⲟⲓⲛⲓⲕⲏ
ϧⲉⲛϯⲭⲱⲣⲁ	ϧⲉⲛϯⲭⲱⲣⲁ
ϧⲉⲛⲁϣ	ϧⲉⲛⲁϣ
ϧⲉⲛⲃⲁⲕⲓ	ϧⲉⲛⲃⲁⲕⲓ
ϧⲉⲛⲃⲏⲑⲁⲛⲓⲁ	ϧⲉⲛⲃⲏⲑⲁⲛⲓⲁ
ϧⲉⲛⲏⲥⲁⲓⲁⲥ	ϧⲉⲛⲏⲥⲁⲓⲁⲥ
ϧⲉⲛⲑⲏⲛⲟⲩ	ϧⲉⲛⲑⲏⲛⲟⲩ
ϧⲉⲛⲑⲙⲏϯ	ϧⲉⲛⲑⲙⲏϯ
ϧⲉⲛⲓⲃ	ϧⲉⲛⲓⲃ
ϧⲉⲛⲓⲉⲣⲓⲭⲱ	ϧⲉⲛⲓⲉⲣⲓⲭⲱ
ϧⲉⲛⲓⲉⲣⲟⲥⲁⲗⲏⲙ	ϧⲉⲛⲓⲉⲣⲟⲥⲁⲗⲏⲙ
ϧⲉⲛⲓⲗⲏⲙ	ϧⲉⲛϩⲓⲉⲣⲟⲩⲥⲁⲗⲏⲙ
ϧⲉⲛⲙⲁⲓ	ϧⲉⲛⲙⲁⲓ
ϧⲉⲛⲛⲁⲍⲁⲣⲉⲑ	ϧⲉⲛⲛⲁⲍⲁⲣⲉⲑ
ϧⲉⲛⲛⲁⲧⲩⲣⲟⲥ	ϧⲉⲛⲛⲁⲧⲩⲣⲟⲥ
ϧⲉⲛⲛⲉϥⲃⲁⲗ	ϧⲉⲛⲛⲉϥⲃⲁⲗ
ϧⲉⲛⲛⲉϥⲙⲁⲑⲏⲧⲏⲥ	ϧⲉⲛⲛⲉϥⲙⲁⲑⲏⲧⲏⲥ
ϧⲉⲛⲛⲉⲧⲉⲛϩⲏⲧ	ϧⲉⲛⲛⲉⲧⲛϩⲏⲧ
ϧⲉⲛⲛⲉⲧⲉⲛⲉⲣⲏⲟⲩ	ϧⲉⲛⲛⲉⲧⲛⲉⲣⲏⲩ
ϧⲉⲛⲛⲉⲧⲉⲛⲙⲟϫϧ	ϧⲉⲛⲛⲉⲧⲛⲙⲟϫϧ
ϧⲉⲛⲛⲉⲧⲉⲛⲥⲱⲙⲁ	ϧⲉⲛⲛⲉⲧⲉⲛⲥⲱⲙⲁ
ϧⲉⲛⲛⲏ	ϧⲉⲛⲛⲏ
ϧⲉⲛⲛⲓⲇⲓⲱⲅⲙⲟⲥ	ϧⲉⲛⲛⲓⲇⲓⲱⲅⲙⲟⲥ
ϧⲉⲛⲛⲓⲉϩⲟⲟⲩ	ϧⲉⲛⲛⲓⲉϩⲟⲟⲩ
ϧⲉⲛⲛⲓⲉⲕⲕⲗⲏⲥⲓⲁ	ϧⲉⲛⲛⲓⲉⲕⲕⲗⲏⲥⲓⲁ
ϧⲉⲛⲛⲓⲑⲟϣ	ϧⲉⲛⲛⲓⲑⲟϣ
ϧⲉⲛⲛⲓⲓⲟϩⲓ	ϧⲉⲛⲛⲓⲓⲟϩⲓ
ϧⲉⲛⲛⲓⲕⲉϩⲁⲗⲩⲥⲓⲥ	ϧⲉⲛⲛⲓⲕⲉϩⲁⲗⲩⲥⲓⲥ
ϧⲉⲛⲛⲓⲕⲉⲉⲑⲛⲟⲥ	ϧⲉⲛⲛⲓⲕⲉⲉⲑⲛⲟⲥ
ϧⲉⲛⲛⲓⲕⲉⲧⲉⲃⲧ	ϧⲉⲛⲛⲓⲕⲉⲧⲉⲃⲧ
ϧⲉⲛⲛⲓⲗⲉϥⲗⲓϥⲓ	ϧⲉⲛⲛⲓⲗⲉϥⲗⲓϥⲓ
ϧⲉⲛⲛⲓⲙϩⲁⲩ	ϧⲉⲛⲛⲓⲙϩⲁⲩ
ϧⲉⲛⲛⲓⲟⲓⲕⲟⲛⲟⲙⲟⲥ	ϧⲉⲛⲛⲓⲟⲓⲕⲟⲛⲟⲙⲟⲥ
ϧⲉⲛⲛⲓⲣⲱⲙⲓ	ϧⲉⲛⲛⲓⲣⲱⲙⲓ
ϧⲉⲛⲛⲓⲥⲁϧ	ϧⲉⲛⲛⲓⲥⲁϧ
ϧⲉⲛⲛⲓⲥⲁⲃⲃⲁⲧⲟⲛ	ϧⲉⲛⲛⲓⲥⲁⲃⲃⲁⲧⲟⲛ
ϧⲉⲛⲛⲓⲥⲩⲛⲁⲅⲱⲅⲏ	ϧⲉⲛⲛⲓⲥⲩⲛⲁⲅⲱⲅⲏ
ϧⲉⲛⲛⲓⲧⲱⲟⲩ	ϧⲉⲛⲛⲓⲧⲱⲟⲩ
ϧⲉⲛⲛⲓⲫⲏⲟⲩⲓ	ϧⲉⲛⲛⲓⲫⲏⲟⲩⲓ
ϧⲉⲛⲛⲟⲩⲑⲟϣ	ϧⲉⲛⲛⲟⲩⲑⲟϣ
ϧⲉⲛⲛⲟⲩⲥⲩⲛⲁⲅⲱⲅⲏ	ϧⲉⲛⲛⲟⲩⲥⲩⲛⲁⲅⲱⲅⲏ
ϧⲉⲛⲛⲟⲩⲥⲫⲟⲧⲟⲩ	ϧⲉⲛⲛⲟⲩⲥⲫⲟⲧⲟⲩ
ϧⲉⲛⲟⲩ	ϧⲉⲛⲟⲩ
ϧⲉⲛⲟⲩϣⲃⲱⲧ	ϧⲉⲛⲟⲩϣⲃⲱⲧ
ϧⲉⲛⲟⲩϣⲉⲙⲏⲣ	ϧⲉⲛⲟⲩϣⲉⲙⲏⲣ
ϧⲉⲛⲟⲩϩⲓⲣⲏⲛⲏ	ϧⲉⲛⲟⲩϩⲓⲣⲏⲛⲏ
ϧⲉⲛⲟⲩϫⲟⲙ	ϧⲉⲛⲟⲩϫⲟⲙ
ϧⲉⲛⲟⲩⲁⲅⲁⲡⲏ	ϧⲉⲛⲟⲩⲁⲅⲁⲡⲏ
ϧⲉⲛⲟⲩⲏⲓ	ϧⲉⲛⲟⲩⲏⲓ
ϧⲉⲛⲟⲩⲙϩⲁⲩ	ϧⲉⲛⲟⲩⲙϩⲁⲩ
ϧⲉⲛⲟⲩⲙⲃⲟⲛ	ϧⲉⲛⲟⲩⲙⲃⲟⲛ
ϧⲉⲛⲟⲩⲙⲉⲧⲁⲥⲑⲉⲛⲏⲥ	ϧⲉⲛⲟⲩⲙⲉⲧⲁⲥⲑⲉⲛⲏⲥ
ϧⲉⲛⲟⲩⲙⲏϣ	ϧⲉⲛⲟⲩⲙⲏϣ
ϧⲉⲛⲟⲩⲙⲩⲥⲧⲏⲣⲓⲟⲛ	ϧⲉⲛⲟⲩⲙⲩⲥⲧⲏⲣⲓⲟⲛ
ϧⲉⲛⲟⲩⲙⲱⲟⲩ	ϧⲉⲛⲟⲩⲙⲱⲟⲩ
ϧⲉⲛⲟⲩⲛⲓϣϯ	ϧⲉⲛⲟⲩⲛⲓϣϯ
ϧⲉⲛⲟⲩⲡⲁⲣⲣⲏⲥⲓⲁ	ϧⲉⲛⲟⲩⲡⲁⲣⲣⲏⲥⲓⲁ
ϧⲉⲛⲟⲩⲡⲛⲉⲩⲙⲁ	ϧⲉⲛⲟⲩⲡⲛⲉⲩⲙⲁ
ϧⲉⲛⲟⲩⲡⲣⲟⲥⲉⲩⲭⲏ	ϧⲉⲛⲟⲩⲡⲣⲟⲥⲉⲩⲭⲏ
ϧⲉⲛⲟⲩⲣⲁϣⲓ	ϧⲉⲛⲟⲩⲣⲁϣⲓ
ϧⲉⲛⲟⲩⲥⲟⲫⲓⲁ	ϧⲉⲛⲟⲩⲥⲟⲫⲓⲁ
ϧⲉⲛⲟⲩⲥⲡⲟⲩⲇⲏ	ϧⲉⲛⲟⲩⲥⲡⲟⲩⲇⲏ
ϧⲉⲛⲟⲩⲭⲣⲱⲙ	ϧⲉⲛⲟⲩⲭⲣⲱⲙ
ϧⲉⲛⲟⲩⲭⲱ	ϧⲉⲛⲟⲩⲭⲱ
ϧⲉⲛⲟⲩⲱⲛϩ	ϧⲉⲛⲟⲩⲱⲛϩ
ϧⲉⲛⲡϫⲓⲛⲑⲣⲉϥⲥⲓϯ	ϧⲉⲛⲡϫⲓⲛⲑⲣⲉϥⲥⲓϯ
ϧⲉⲛⲡϭⲟⲓⲥ	ϧⲉⲛⲡϭⲟⲓⲥ
ϧⲉⲛⲡⲁⲓϫⲱⲟⲩ	ϧⲉⲛⲡⲁⲓϫⲱⲟⲩ
ϧⲉⲛⲡⲁⲓⲉⲛⲉϩ	ϧⲉⲛⲡⲁⲓⲉⲛⲉϩ
ϧⲉⲛⲡⲁⲓⲕⲟⲥⲙⲟⲥ	ϧⲉⲛⲡⲁⲓⲕⲟⲥⲙⲟⲥ
ϧⲉⲛⲡⲁⲓⲥⲏⲟⲩ	ϧⲉⲛⲡⲁⲓⲥⲏⲟⲩ
ϧⲉⲛⲡⲁⲣⲁⲛ	ϧⲉⲛⲡⲁⲣⲁⲛ
ϧⲉⲛⲡⲉϥϩⲏⲧ	ϧⲉⲛⲡⲉϥϩⲏⲧ
ϧⲉⲛⲡⲉϥⲉϩⲟⲟⲩ	ϧⲉⲛⲡⲉϥⲉϩⲟⲟⲩ
ϧⲉⲛⲡⲉϥⲏⲓ	ϧⲉⲛⲡⲉϥⲏⲓ
ϧⲉⲛⲡⲉϥⲡⲛⲉⲩⲙⲁ	ϧⲉⲛⲡⲉϥⲡⲛⲉⲩⲙⲁ
ϧⲉⲛⲡⲉϩⲟⲟⲩ	ϧⲉⲛⲡⲉϩⲟⲟⲩ
ϧⲉⲛⲡⲉⲕⲣⲁⲛ	ϧⲉⲛⲡⲉⲕⲣⲁⲛ
ϧⲉⲛⲡⲉⲕⲱⲟⲩ	ϧⲉⲛⲡⲉⲕⲱⲟⲩ
ϧⲉⲛⲡⲉⲥⲥⲱⲙⲁ	ϧⲉⲛⲡⲉⲥⲥⲱⲙⲁ
ϧⲉⲛⲡⲓϣⲓ	ϧⲉⲛⲡⲓϣⲓ
ϧⲉⲛⲡⲓϣⲧⲉⲕⲟ	ϧⲉⲛⲡⲓϣⲧⲉⲕⲟ
ϧⲉⲛⲡⲓϩⲏⲧ	ϧⲉⲛⲡⲓϩⲏⲧ
ϧⲉⲛⲡⲓϫⲓⲛⲥⲱⲕ	ϧⲉⲛⲡⲓϫⲓⲛⲥⲱⲕ
ϧⲉⲛⲡⲓϫⲟⲓ	ϧⲉⲛⲡⲓϫⲟⲉⲓ
ϧⲉⲛⲡⲓⲉϩⲟⲟⲩ	ϧⲉⲛⲡⲓⲉϩⲟⲟⲩ
ϧⲉⲛⲡⲓⲉⲣⲫⲉⲓ	ϧⲉⲛⲡⲓⲉⲣⲫⲉⲓ
ϧⲉⲛⲡⲓⲉⲱⲛ	ϧⲉⲛⲡⲓⲉⲱⲛ
ϧⲉⲛⲡⲓⲏⲓ	ϧⲉⲛⲡⲓⲏⲓ
ϧⲉⲛⲡⲓⲓⲟⲣⲇⲁⲛⲏⲥ	ϧⲉⲛⲡⲓⲓⲟⲣⲇⲁⲛⲏⲥ
ϧⲉⲛⲡⲓⲙⲏϣ	ϧⲉⲛⲡⲓⲙⲏϣ
ϧⲉⲛⲡⲓⲙⲱⲓⲧ	ϧⲉⲛⲡⲓⲙⲱⲓⲧ
ϧⲉⲛⲡⲓⲙⲱⲟⲩ	ϧⲉⲛⲡⲓⲙⲱⲟⲩ
ϧⲉⲛⲡⲓⲡⲛⲉⲩⲙⲁ	ϧⲉⲛⲡⲓⲡⲛⲉⲩⲙⲁ
ϧⲉⲛⲡⲓⲣⲱⲙⲓ	ϧⲉⲛⲡⲓⲣⲱⲙⲓ
ϧⲉⲛⲡⲓⲥⲱⲙⲁ	ϧⲉⲛⲡⲓⲥⲱⲙⲁ
ϧⲉⲛⲡⲟⲩϩⲏⲧ	ϧⲉⲛⲡⲟⲩϩⲏⲧ
ϧⲉⲛⲡⲭⲣⲓⲥⲧⲟⲥ	ϧⲉⲛⲡⲭⲣⲓⲥⲧⲟⲥ
ϧⲉⲛⲡⲱⲟⲩ	ϧⲉⲛⲡⲱⲟⲩ
ϧⲉⲛⲣⲱϥ	ϧⲉⲛⲣⲱϥ
ϧⲉⲛⲧ	ϧⲉⲛⲧ
ϧⲉⲛⲧⲉϥⲃⲁⲕⲓ	ϧⲉⲛⲧⲉϥⲃⲁⲕⲓ
ϧⲉⲛⲧⲉϥⲥⲃⲱ	ϧⲉⲛⲧⲉϥⲥⲃⲱ
ϧⲉⲛⲧⲉⲧⲉⲛⲙⲏϯ	ϧⲉⲛⲧⲉⲧⲉⲛⲙⲏϯ
ϧⲉⲛⲧⲉⲧⲉⲛⲡⲁⲣⲁⲇⲟⲥⲓⲥ	ϧⲉⲛⲧⲉⲧⲛⲡⲁⲣⲁⲇⲟⲥⲓⲥ
ϧⲉⲛⲧⲟⲩⲙⲉⲧⲥⲉⲃ	ϧⲉⲛⲧⲟⲩⲙⲉⲧⲥⲉⲃ
ϧⲉⲛⲧⲟⲩⲙⲏϯ	ϧⲉⲛⲧⲟⲩϩⲙⲏϯ
ϧⲉⲛⲧⲫⲉ	ϧⲉⲛⲧⲫⲉ
ϧⲉⲛⲫⲁⲓ	ϧⲉⲛⲫⲁⲓ
ϧⲉⲛⲫⲓⲟⲙ	ϧⲉⲛⲡⲓⲟⲙ
ϧⲉⲛⲫⲛⲟⲩϯ	ϧⲉⲛⲫⲛⲟⲩϯ
ϧⲉⲛⲫⲣⲁⲛ	ϧⲉⲛⲫⲣⲁⲛ
ϧⲉⲧϧⲉⲧ	ϧⲉⲧϧⲉⲧ
ϧⲉⲧϧⲱⲧ	ϧⲉⲧϧⲱⲧ
ϧⲏⲃⲥ	ϧⲏⲃⲥ
ϧⲏⲓⲃⲓ	ϧⲏⲓⲃⲓ
ϧⲏⲙ	ϧⲏⲙ
ϧⲏⲧ	ϧⲏⲧ
ϧⲓⲣ	ϧⲓⲣ
ϧⲓⲥⲓ	ϧⲓⲥⲓ
ϧⲙⲟⲙ	ϧⲙⲟⲙ
ϧⲟⲑⲃⲉ	ϧⲟⲑⲃ
ϧⲟⲙϧⲉⲙ	ϧⲟⲙϧⲉⲙ
ϧⲟⲥⲓ	ϧⲟⲥⲓ
ϧⲟⲧϧⲉⲧ	ϧⲟⲧϧⲉⲧ
ϧⲣⲁϫⲣⲉϫ	ϧⲣⲁϫⲣⲉϫ
ϧⲣⲉ	ϧⲣⲉ
ϧⲣⲏⲓ	ϧⲣⲏⲓ
ϧⲣⲏⲟⲩⲓ	ϧⲣⲏⲟⲩⲓ
ϧⲣⲱⲟⲩ	ϧⲣⲱⲟⲩ
ϧⲱⲛⲧ	ϧⲱⲛⲧ
ϧⲱⲧⲉⲃ	ϧⲱⲧⲉⲃ
ϩⲁ	ϩⲁ
ϩⲁϯⲙⲁⲥⲧⲓⲅⲝ	ϩⲁϯⲙⲁⲥⲧⲓⲅⲝ
ϩⲁⲓ	ϩⲁⲓ
ϩⲁⲓⲏⲥⲟⲩⲥ	ϩⲁⲓⲏⲥⲟⲩⲥ
ϩⲁⲗⲁϯ	ϩⲁⲗⲁϯ
ϩⲁⲗⲩⲥⲓⲥ	ϩⲁⲗⲩⲥⲓⲥ
ϩⲁⲙⲛⲁⲓ	ϩⲁⲙⲛⲁⲓ
ϩⲁⲛ	ϩⲁⲛ
ϩⲁⲛϣⲫⲏⲣ	ϩⲁⲛϣⲫⲏⲣ
ϩⲁⲛϧⲁⲉⲩ	ϩⲁⲛϧⲁⲉⲩ
ϩⲁⲛϩⲃⲏⲟⲩⲓ	ϩⲁⲛϩⲃⲏⲟⲩⲓ
ϩⲁⲛϩⲩⲡⲉⲣⲉⲧⲏⲥ	ϩⲁⲛϩⲩⲡⲉⲣⲉⲧⲏⲥ
ϩⲁⲛϫⲱⲃ	ϩⲁⲛϫⲱⲃ
ϩⲁⲛϫⲱⲃⲓ	ϩⲁⲛϫⲱⲃⲓ
ϩⲁⲛϫⲱⲣⲓ	ϩⲁⲛϫⲱⲣⲓ
ϩⲁⲛⲁⲧⲕⲁϯ	ϩⲁⲛⲁⲧⲕⲁϯ
ϩⲁⲛⲁⲧⲟⲟⲩⲓ	ϩⲁⲛⲁⲧⲟⲟⲩⲓ
ϩⲁⲛⲃⲁⲗ	ϩⲁⲛⲃⲁⲗ
ϩⲁⲛⲇⲓⲁⲕⲱⲛ	ϩⲁⲛⲇⲓⲁⲕⲱⲛ
ϩⲁⲛⲏ	ϩⲁⲛⲏ
ϩⲁⲛⲏⲓ	ϩⲁⲛⲏⲓ
ϩⲁⲛⲓⲙⲁⲑⲏⲧⲏⲥ	ϩⲁⲛⲓⲙⲁⲑⲏⲧⲏⲥ
ϩⲁⲛⲕⲉⲕⲟⲩϫⲓ	ϩⲁⲛⲕⲉⲕⲟⲩϫⲓ
ϩⲁⲛⲕⲉⲙⲏϣ	ϩⲁⲛⲕⲉⲙⲏϣ
ϩⲁⲛⲕⲉⲟⲩⲟⲛ	ϩⲁⲛⲕⲉⲟⲩⲟⲛ
ϩⲁⲛⲕⲉⲭⲱⲟⲩⲛⲓ	ϩⲁⲛⲕⲉⲭⲱⲟⲩⲛⲓ
ϩⲁⲛⲙⲁϣϫ	ϩⲁⲛⲙⲁϣϫ
ϩⲁⲛⲙⲉⲗⲟⲥ	ϩⲁⲛⲙⲉⲗⲟⲥ
ϩⲁⲛⲙⲏϣ	ϩⲁⲛⲙⲏϣ
ϩⲁⲛⲟⲩⲟⲛ	ϩⲁⲛⲟⲩⲟⲛ
ϩⲁⲛⲡⲣⲟⲥⲟⲩⲥⲏⲟⲩ	ϩⲁⲛⲡⲣⲟⲥⲟⲩⲥⲏⲟⲩ
ϩⲁⲛⲣⲱⲙⲓ	ϩⲁⲛⲣⲱⲙⲓ
ϩⲁⲛⲥⲁϧ	ϩⲁⲛⲥⲁϧ
ϩⲁⲛⲥⲁⲃⲉⲩ	ϩⲁⲛⲥⲁⲃⲉⲩ
ϩⲁⲛⲥⲁⲣⲕⲓⲕⲟⲥ	ϩⲁⲛⲥⲁⲣⲕⲓⲕⲟⲥ
ϩⲁⲛⲥⲛⲏⲟⲩ	ϩⲁⲛⲥⲛⲏⲟⲩ
ϩⲁⲛⲥⲟϫ	ϩⲁⲛⲥⲟϫ
ϩⲁⲛⲥⲱⲛⲓ	ϩⲁⲛⲥⲱⲛⲓ
ϩⲁⲛⲱⲙⲥ	ϩⲁⲛⲱⲙⲥ
ϩⲁⲡ	ϩⲁⲡ
ϩⲁⲡϣⲉⲙⲏⲣ	ϩⲁⲡϣⲉⲙⲏⲣ
ϩⲁⲡⲓⲁⲣⲭⲏⲥⲩⲛⲁⲅⲱⲅⲟⲥ	ϩⲁⲡⲓⲁⲣⲭⲏⲥⲩⲛⲁⲅⲱⲅⲟⲥ
ϩⲁⲡⲓⲙⲏϣ	ϩⲁⲡⲓⲙⲏϣ
ϩⲁⲡⲟⲩⲣⲟ	ϩⲁⲡⲟⲩⲣⲟ
ϩⲁⲣⲁ	ϩⲁⲣⲁ
ϩⲁⲣⲟ	ϩⲁⲣⲟ
ϩⲁⲣⲟϥ	ϩⲁⲣⲟϥ
ϩⲁⲣⲟⲓ	ϩⲁⲣⲟⲓ
ϩⲁⲣⲟⲕ	ϩⲁⲣⲟⲕ
ϩⲁⲣⲟⲛ	ϩⲁⲣⲟⲛ
ϩⲁⲣⲱ	ϩⲁⲣⲱ
ϩⲁⲣⲱⲟⲩ	ϩⲁⲣⲱⲟⲩ
ϩⲁⲣⲱⲧⲉⲛ	ϩⲁⲣⲱⲧⲉⲛ
ϩⲁⲧ	ϩⲁⲧ
ϩⲁⲧⲉⲙⲁⲥⲧⲓⲅⲝ	ϩⲁⲧⲉⲙⲁⲥⲧⲓⲅⲝ
ϩⲁⲫⲓⲟⲙ	ϩⲁⲡⲓⲟⲙ
ϩⲃⲏⲟⲩⲓ	ϩⲃⲏⲟⲩⲓ
ϩⲃⲟⲥ	ϩⲃⲟⲥ
ϩⲃⲱⲥ	ϩⲃⲱⲥ
ϩⲉϫϩⲱϫ	ϩⲉϫϩⲱϫ
ϩⲉⲓ	ϩⲉⲓ
ϩⲉⲙⲥⲓ	ϩⲉⲙⲥⲓ
ϩⲉⲣⲓ	ϩⲉⲣⲓ
ϩⲏ	ϩⲏ
ϩⲏⲇⲉⲱⲥ	ϩⲏⲇⲉⲱⲥ
ϩⲏⲇⲏ	ϩⲏⲇⲏ
ϩⲏⲕⲓ	ϩⲏⲕⲓ
ϩⲏⲗ	ϩⲏⲗ
ϩⲏⲡ	ϩⲏⲡ
ϩⲏⲡⲡⲉ	ϩⲏⲡⲡⲉ
ϩⲏⲧ	ϩⲏⲧ
ϩⲑⲏ	ϩⲑⲏ
ϩⲓ	ϩⲓ
ϩⲓϩⲁⲛϭⲗⲟϫ	ϩⲓϩⲁⲛϭⲗⲟϫ
ϩⲓϫⲉⲛ	ϩⲓϫⲉⲛ
ϩⲓϫⲉⲛϯⲗⲩⲭⲛⲓⲁ	ϩⲓϫⲉⲛϯⲗⲩⲭⲛⲓⲁ
ϩⲓϫⲉⲛⲛⲓⲙⲁ	ϩⲓϫⲉⲛⲛⲓⲙⲁ
ϩⲓϫⲉⲛⲛⲓⲥⲟⲩⲣⲓ	ϩⲓϫⲉⲛⲛⲓⲥⲟⲩⲣⲓ
ϩⲓϫⲉⲛⲡⲓϣϣⲟⲧ	ϩⲓϫⲉⲛⲡⲓϣϣⲟⲧ
ϩⲓϫⲉⲛⲡⲓϭⲗⲟϫ	ϩⲓϫⲉⲛⲡⲓϭⲗⲟϫ
ϩⲓϫⲉⲛⲡⲓⲕⲁϩⲓ	ϩⲓϫⲉⲛⲡⲓⲕⲁϩⲓ
ϩⲓϫⲉⲛⲡⲓⲥⲓⲙ	ϩⲓϫⲉⲛⲡⲓⲥⲓⲙ
ϩⲓϫⲉⲛⲫⲓⲟⲙ	ϩⲓϫⲉⲛⲫⲓⲟⲙ
ϩⲓϫⲱ	ϩⲓϫⲱ
ϩⲓϫⲱϥ	ϩⲓϫⲱϥ
ϩⲓϫⲱⲟⲩ	ϩⲓϫⲱⲟⲩ
ϩⲓϯⲉⲡⲓⲥⲧⲟⲗⲏ	ϩⲓϯⲉⲡⲓⲥⲧⲟⲗⲏ
ϩⲓⲇⲁⲓⲙⲱⲛ	ϩⲓⲇⲁⲓⲙⲱⲛ
ϩⲓⲇⲉⲙⲱⲛ	ϩⲓⲇⲉⲙⲱⲛ
ϩⲓⲑⲁϥ	ϩⲓⲑⲁϥ
ϩⲓⲑⲏⲛⲟⲩ	ϩⲓⲑⲏⲛⲟⲩ
ϩⲓⲛⲁ	ϩⲓⲛⲁ
ϩⲓⲛⲓⲁⲅⲓⲟⲥ	ϩⲓⲛⲓϩⲁⲅⲓⲟⲥ
ϩⲓⲛⲓⲁⲅⲟⲣⲁ	ϩⲓⲛⲓⲁⲅⲟⲣⲁ
ϩⲓⲛⲓⲁⲑⲛⲁϩϯ	ϩⲓⲛⲓⲁⲑⲛⲁϩϯ
ϩⲓⲛⲓⲣⲉϥϭⲓ	ϩⲓⲛⲓⲣⲉϥϭⲓ
ϩⲓⲟⲩⲃⲓⲛⲁϫ	ϩⲓⲟⲩⲃⲓⲛⲁϫ
ϩⲓⲟⲩⲓ	ϩⲓⲟⲩⲓ
ϩⲓⲟⲩⲧⲱⲓⲥ	ϩⲓⲟⲩⲧⲱⲓⲥ
ϩⲓⲡϣⲁϥⲉ	ϩⲓⲡϣⲁϥⲉ
ϩⲓⲡⲓϫⲟⲓ	ϩⲓⲡⲓϫⲟⲉⲓ
ϩⲓⲡⲓⲃⲓⲛⲁϫ	ϩⲓⲡⲓⲃⲓⲛⲁϫ
ϩⲓⲡⲓⲙⲱⲓⲧ	ϩⲓⲡⲓⲙⲱⲓⲧ
ϩⲓⲡⲓⲧⲉⲗⲱⲛⲓⲟⲛ	ϩⲓⲡⲓⲧⲉⲗⲱⲛⲓⲟⲛ
ϩⲓⲡⲓⲧⲱⲟⲩ	ϩⲓⲡⲓⲧⲱⲟⲩ
ϩⲓⲡⲓⲭⲣⲟ	ϩⲓⲡⲓⲭⲣⲟ
ϩⲓⲡⲥⲁⲧⲁⲛⲁⲥ	ϩⲓⲡⲥⲁⲧⲁⲛⲁⲥ
ϩⲓⲣⲉⲛ	ϩⲓⲣⲉⲛ
ϩⲓⲣⲉⲛⲡⲓⲣⲟ	ϩⲓⲣⲉⲛⲡⲓⲣⲟ
ϩⲓⲣⲏⲛⲏ	ϩⲓⲣⲏⲛⲏ
ϩⲓⲥⲕⲉⲛ	ϩⲓⲥⲕⲉⲛ
ϩⲓⲧ	ϩⲓⲧ
ϩⲓⲧϥ	ϩⲓⲧϥ
ϩⲓⲧϩⲏ	ϩⲓⲧϩⲏ
ϩⲓⲧⲉϣⲉⲣⲓ	ϩⲓⲧⲉϣⲉⲣⲓ
ϩⲓⲧⲉⲛ	ϩⲓⲧⲉⲛ
ϩⲓⲧⲉⲛϯⲅⲁⲗⲓⲗⲉⲁ	ϩⲓⲧⲉⲛϯⲅⲁⲗⲓⲗⲉⲁ
ϩⲓⲧⲉⲛⲑⲏⲛⲟⲩ	ϩⲓⲧⲉⲛⲑⲏⲛⲟⲩ
ϩⲓⲧⲉⲛⲛⲉϥϫⲓϫ	ϩⲓⲧⲉⲛⲛⲉϥϫⲓϫ
ϩⲓⲧⲉⲛⲟⲩⲉϩⲟⲟⲩ	ϩⲓⲧⲉⲛⲟⲩⲉϩⲟⲟⲩ
ϩⲓⲧⲉⲛⲟⲩⲭⲣⲱⲙ	ϩⲓⲧⲉⲛⲟⲩⲭⲣⲱⲙ
ϩⲓⲧⲉⲛⲡⲓⲉⲣⲫⲉⲓ	ϩⲓⲧⲉⲛⲡⲓⲉⲣⲫⲉⲓ
ϩⲓⲧⲉⲛⲡⲓⲡⲛⲉⲩⲙⲁ	ϩⲓⲧⲉⲛⲡⲓⲡⲛⲉⲩⲙⲁ
ϩⲓⲧⲉⲛⲧⲉϥϫⲟⲙ	ϩⲓⲧⲉⲛⲧⲉϥϫⲟⲙ
ϩⲓⲧⲉⲛⲧⲥⲓⲇⲱⲛ	ϩⲓⲧⲉⲛⲧⲥⲓⲇⲱⲛ
ϩⲓⲧⲉⲛⲫⲛⲟⲩϯ	ϩⲓⲧⲉⲛⲫⲛⲟⲩϯ
ϩⲓⲧⲉⲛⲫⲟⲩⲱⲧⲉⲛ	ϩⲓⲧⲉⲛⲫⲟⲩⲱⲧⲉⲛ
ϩⲓⲧⲉⲥⲛⲟⲩⲛⲓ	ϩⲓⲧⲉⲥⲛⲟⲩⲛⲓ
ϩⲓⲧⲕ	ϩⲓⲧⲕ
ϩⲓⲧⲟⲧ	ϩⲓⲧⲟⲧ
ϩⲓⲧⲟⲧϥ	ϩⲓⲧⲟⲧϥ
ϩⲓⲧⲟⲧⲟⲩ	ϩⲓⲧⲟⲧⲟⲩ
ϩⲓⲧⲥ	ϩⲓⲧⲥ
ϩⲓⲫⲁϩⲟⲩ	ϩⲓⲫⲁϩⲟⲩ
ϩⲓⲫⲙⲱⲓⲧ	ϩⲓⲫⲙⲱⲓⲧ
ϩⲓⲫⲟⲩⲉⲓ	ϩⲓⲫⲟⲩⲉⲓ
ϩⲓⲱ	ϩⲓⲱ
ϩⲓⲱϯ	ϩⲓⲱϯ
ϩⲓⲱⲓϣ	ϩⲓⲱⲓϣ
ϩⲓⲱⲧ	ϩⲓⲱⲧ
ϩⲓⲱⲧϥ	ϩⲓⲱⲧϥ
ϩⲓⲱⲧⲥ	ϩⲓⲱⲧⲥ
ϩⲕⲟ	ϩⲕⲟ
ϩⲗⲓ	ϩⲗⲓ
ϩⲙⲟⲧ	ϩⲙⲟⲧ
ϩⲙⲟⲩ	ϩⲙⲟⲩ
ϩⲛⲉ	ϩⲛⲉ
ϩⲟ	ϩⲟ
ϩⲟϫϩⲉϫ	ϩⲟϫϩⲉϫ
ϩⲟϯ	ϩⲟϯ
ϩⲟⲕⲉⲣ	ϩⲟⲕⲉⲣ
ϩⲟⲗⲱⲥ	ϩⲟⲗⲱⲥ
ϩⲟⲙⲧ	ϩⲟⲙⲧ
ϩⲟⲛϩⲉⲛ	ϩⲟⲛϩⲉⲛ
ϩⲟⲟⲩ	ϩⲟⲟⲩ
ϩⲟⲣⲧϥ	ϩⲟⲣⲧϥ
ϩⲟⲥⲇⲉ	ϩⲟⲥⲇⲉ
ϩⲟⲧⲁⲛ	ϩⲟⲧⲁⲛ
ϩⲟⲧⲉ	ϩⲟⲧⲉ
ϩⲟⲩⲁϯ	ϩⲟⲩⲁϯ
ϩⲟⲩⲟ	ϩⲟⲩⲟ
ϩⲩⲇⲟⲩⲙⲉⲁ	ϩⲩⲇⲟⲩⲙⲉⲁ
ϩⲩⲡⲉⲣⲉⲧⲏⲥ	ϩⲩⲡⲉⲣⲉⲧⲏⲥ
ϩⲱ	ϩⲱ
ϩⲱϥ	ϩⲱϥ
ϩⲱϯ	ϩⲱϯ
ϩⲱⲃ	ϩⲱⲃ
ϩⲱⲕ	ϩⲱⲕ
ϩⲱⲗ	ϩⲱⲗ
ϩⲱⲗⲉⲙ	ϩⲱⲗⲉⲙ
ϩⲱⲛ	ϩⲱⲛ
ϩⲱⲟⲩ	ϩⲱⲟⲩ
ϩⲱⲟⲩϣ	ϩⲱⲟⲩϣ
ϩⲱⲟⲩⲧ	ϩⲱⲟⲩⲧ
ϩⲱⲥ	ϩⲱⲥ
ϩⲱⲥⲧⲉ	ϩⲱⲥⲧⲉ
ϩⲱⲧⲉⲛ	ϩⲱⲧⲉⲛ
ϩⲱⲧⲡ	ϩⲱⲧⲡ
ϫⲁϫⲣⲓⲙ	ϫⲁϫⲣⲓⲙ
ϫⲁϭⲏ	ϫⲁϭⲏ
ϫⲁⲗ	ϫⲁⲗ
ϫⲁⲙⲏ	ϫⲁⲙⲏ
ϫⲉ	ϫⲉ
ϫⲉϣⲥⲫⲏⲓϯ	ϫⲉϣⲥⲫⲏⲓϯ
ϫⲉϥⲉⲙⲙⲁⲩ	ϫⲉϥⲉⲙⲙⲁⲩ
ϫⲉϥⲓⲧⲕ	ϫⲉϥⲓⲧⲕ
ϫⲉϥⲛϧⲟⲩⲛ	ϫⲉϥⲛϧⲟⲩⲛ
ϫⲉϥⲛⲁϭⲱⲣⲡ	ϫⲉϥⲛⲁϭⲱⲣⲡ
ϫⲉϥⲛⲏⲟⲩ	ϫⲉϥⲛⲏⲟⲩ
ϫⲉϥⲟⲩⲱⲙ	ϫⲉϥⲟⲩⲱⲙ
ϫⲉϧⲁⲧⲉⲛⲛⲓⲣⲱⲙⲓ	ϫⲉϧⲁⲧⲉⲛⲛⲓⲣⲱⲙⲓ
ϫⲉϧⲉⲛⲟⲩⲉⲣϣⲓϣⲓ	ϫⲉϧⲉⲛⲟⲩⲉⲣϣⲓϣⲓ
ϫⲉϧⲉⲛⲡⲁⲣⲭⲱⲛ	ϫⲉϧⲉⲛⲡⲁⲣⲭⲱⲛ
ϫⲉϩⲁⲛⲉⲫⲗⲏⲟⲩ	ϫⲉϩⲉⲛⲉⲫⲗⲏⲟⲩ
ϫⲉϩⲁⲣⲁ	ϫⲉϩⲁⲣⲁ
ϫⲉϩⲏⲡⲡⲉ	ϫⲉϩⲏⲡⲡⲉ
ϫⲉϩⲓⲛⲁ	ϫⲉϩⲓⲛⲁ
ϫⲉϩⲱϯ	ϫⲉϩⲱϯ
ϫⲉϩⲱⲃ	ϫⲉϩⲱⲃ
ϫⲉϫⲉⲙⲛⲟⲙϯ	ϫⲉϫⲉⲙⲛⲟⲙϯ
ϫⲉϯϣⲉⲛϩⲏⲧ	ϫⲉϯϣⲉⲛϩⲏⲧ
ϫⲉϯⲁⲗⲟⲩ	ϫⲉϯⲁⲗⲟⲩ
ϫⲉϯⲛⲁϣⲉⲛⲑⲏⲛⲟⲩ	ϫⲉϯⲛⲁϣⲉⲛⲑⲏⲛⲟⲩ
ϫⲉϯⲛⲁϩϯ	ϫⲉϯⲛⲁϩϯ
ϫⲉϯⲛⲁⲩ	ϫⲉϯⲛⲁⲩ
ϫⲉϯⲟⲩⲱϣ	ϫⲉϯⲟⲩⲱϣ
ϫⲉⲁϥϫⲱⲕ	ϫⲉⲁϥϫⲱⲕ
ϫⲉⲁϥⲕⲱⲧ	ϫⲉⲁϥⲕⲱⲧ
ϫⲉⲁϥⲙⲟⲩ	ϫⲉⲁϥⲙⲟⲩ
ϫⲉⲁϥⲟⲩⲁϩⲥⲁϩⲛⲓ	ϫⲉⲁϥⲟⲩⲁϩⲥⲁϩⲛⲓ
ϫⲉⲁϧⲟ	ϫⲉⲁϧⲟ
ϫⲉⲁϧⲟⲕ	ϫⲉⲁϧⲟⲕ
ϫⲉⲁϧⲱⲧⲉⲛ	ϫⲉⲁϧⲱⲧⲉⲛ
ϫⲉⲁⲓⲓⲣⲓ	ϫⲉⲁⲓⲓⲣⲓ
ϫⲉⲁⲕⲓⲣⲓ	ϫⲉⲁⲕⲓⲣⲓ
ϫⲉⲁⲙⲏⲛ	ϫⲉⲁⲙⲏⲛ
ϫⲉⲁⲙⲟⲩ	ϫⲉⲁⲙⲟⲩ
ϫⲉⲁⲙⲱⲓⲛⲓ	ϫⲉⲁⲙⲱⲓⲛⲓ
ϫⲉⲁⲛ	ϫⲉⲁⲛ
ϫⲉⲁⲛϣⲁⲛϫⲟⲥ	ϫⲉⲁⲛϣⲁⲛϫⲟⲥ
ϫⲉⲁⲛⲁⲩ	ϫⲉⲁⲛⲁⲩ
ϫⲉⲁⲛⲉⲣⲑⲉⲁⲧⲣⲟⲛ	ϫⲉⲁⲛⲉⲣⲑⲉⲁⲧⲣⲟⲛ
ϫⲉⲁⲛⲛⲁⲧⲉⲛⲑⲱⲛ	ϫⲉⲁⲛⲛⲁⲧⲉⲛⲑⲱⲛ
ϫⲉⲁⲛⲟⲕ	ϫⲉⲁⲛⲟⲕ
ϫⲉⲁⲟⲩⲱⲛ	ϫⲉⲁⲟⲩⲱⲛ
ϫⲉⲁⲡⲉϥϩⲏⲧ	ϫⲉⲁⲡⲉϥϩⲏⲧ
ϫⲉⲁⲣⲉϣⲁⲛⲟⲩⲣⲱⲙⲓ	ϫⲉⲁⲣⲉϣⲁⲛⲟⲩⲣⲱⲙⲓ
ϫⲉⲁⲣⲉⲛⲓⲣⲱⲙⲓ	ϫⲉⲁⲣⲉⲛⲓⲣⲱⲙⲓ
ϫⲉⲁⲣⲉⲧⲉⲛϭⲓ	ϫⲉⲁⲣⲉⲧⲉⲛϭⲓ
ϫⲉⲁⲣⲉⲧⲉⲛⲕⲱϯ	ϫⲉⲁⲣⲉⲧⲉⲛⲕⲱϯ
ϫⲉⲁⲣⲓⲉⲧⲓⲛ	ϫⲉⲁⲣⲓⲉⲧⲓⲛ
ϫⲉⲁⲣⲓⲧⲓⲙⲁⲛ	ϫⲉⲁⲣⲓⲧⲓⲙⲁⲛ
ϫⲉⲁⲥⲟⲩϫⲁⲓ	ϫⲉⲁⲥⲟⲩϫⲁⲓ
ϫⲉⲁⲧⲁϣⲉⲣⲓ	ϫⲉⲁⲧⲁϣⲉⲣⲓ
ϫⲉⲁⲧⲉⲕϣⲉⲣⲓ	ϫⲉⲁⲧⲉⲕϣⲉⲣⲓ
ϫⲉⲁⲧⲉⲧⲉⲛⲉⲗⲟⲩⲏⲣ	ϫⲉⲁⲧⲉⲧⲉⲛⲉⲗⲟⲩⲏⲣ
ϫⲉⲁⲩϧⲟⲧϧⲉⲧ	ϫⲉⲁⲩϧⲟⲧϧⲉⲧ
ϫⲉⲁⲩⲛⲁⲧⲁⲕⲟϥ	ϫⲉⲁⲩⲛⲁⲧⲁⲕⲟϥ
ϫⲉⲃⲉⲗⲍⲉⲃⲟⲩⲗ	ϫⲉⲃⲉⲗⲍⲉⲃⲟⲩⲗ
ϫⲉⲃⲟⲁⲛⲏⲣⲅⲉⲥ	ϫⲉⲃⲟⲁⲛⲏⲣⲅⲉⲥ
ϫⲉⲉ	ϫⲉⲉ
ϫⲉⲉϣⲱⲡ	ϫⲉⲉϣⲱⲡ
ϫⲉⲉϧⲟⲩⲛ	ϫⲉⲉϧⲟⲩⲛ
ϫⲉⲉⲑⲃⲉⲟⲩ	ϫⲉⲉⲑⲃⲉⲟⲩ
ϫⲉⲉⲑⲃⲉⲡⲁⲓⲥⲁϫⲓ	ϫⲉⲉⲑⲃⲉⲡⲁⲓⲥⲁϫⲓ
ϫⲉⲉⲑⲃⲉⲧⲉⲧⲉⲛⲙⲉⲧⲛⲁϣⲧϩⲏⲧ	ϫⲉⲉⲑⲃⲉⲧⲉⲧⲉⲛⲙⲉⲧⲛⲁϣⲧϩⲏⲧ
ϫⲉⲉⲛⲛⲁϯϩⲁⲡ	ϫⲉⲉⲛⲛⲁϯϩⲁⲡ
ϫⲉⲉⲡⲫⲁⲑⲁ	ϫⲉⲉⲡⲫⲁⲑⲁ
ϫⲉⲉⲧⲁⲡⲓⲥⲁⲃⲃⲁⲧⲟⲛ	ϫⲉⲉⲧⲁⲡⲓⲥⲁⲃⲃⲁⲧⲟⲛ
ϫⲉⲉⲧⲁⲥϣⲱⲡⲓ	ϫⲉⲉⲧⲁⲥϣⲱⲡⲓ
ϫⲉⲉⲧⲁⲫⲁⲓ	ϫⲉⲉⲧⲁⲫⲁⲓ
ϫⲉⲉⲧⲁⲫⲛⲟⲩϯ	ϫⲉⲉⲧⲁⲫⲛⲟⲩϯ
ϫⲉⲍ	ϫⲉⲍ
ϫⲉⲏⲗⲓⲁⲥ	ϫⲉⲏⲗⲓⲁⲥ
ϫⲉⲑⲱⲙ	ϫⲉⲑⲱⲙ
ϫⲉⲓⲃ	ϫⲉⲓⲃ
ϫⲉⲓⲏⲥⲟⲩⲥ	ϫⲉⲓⲏⲥⲟⲩⲥ
ϫⲉⲓⲥ	ϫⲉⲓⲥ
ϫⲉⲓⲥϫⲉⲛⲧⲉϥⲙⲉⲧⲁⲗⲟⲩ	ϫⲉⲓⲥϫⲉⲛⲧⲉϥⲙⲉⲧⲁⲗⲟⲩ
ϫⲉⲓⲱⲁⲛⲛⲏⲥ	ϫⲉⲓⲱⲁⲛⲛⲏⲥ
ϫⲉⲕⲁⲗⲱⲥ	ϫⲉⲕⲁⲗⲱⲥ
ϫⲉⲕⲁⲛ	ϫⲉⲕⲁⲛ
ϫⲉⲕⲉⲙ	ϫⲉⲕⲉⲙ
ϫⲉⲕⲉⲟⲩⲁⲓ	ϫⲉⲕⲉⲟⲩⲁⲓ
ϫⲉⲕⲟⲣⲃⲁⲛ	ϫⲉⲕⲟⲣⲃⲁⲛ
ϫⲉⲗⲉⲅⲓⲱⲛ	ϫⲉⲗⲉⲅⲓⲱⲛ
ϫⲉⲙ	ϫⲉⲙ
ϫⲉⲙϩⲏⲟⲩ	ϫⲉⲙϩⲏⲟⲩ
ϫⲉⲙϫⲟⲙ	ϫⲉⲙϫⲟⲙ
ϫⲉⲙϯⲡⲓ	ϫⲉⲙϯⲡⲓ
ϫⲉⲙⲁϣⲉ	ϫⲉⲙⲁϣⲉ
ϫⲉⲙⲁⲣⲉⲛⲥⲓⲛⲓ	ϫⲉⲙⲁⲣⲉⲛⲥⲓⲛⲓ
ϫⲉⲙⲁⲣⲟⲛ	ϫⲉⲙⲁⲣⲟⲛ
ϫⲉⲙⲉⲩⲕⲉⲣⲓⲁ	ϫⲉⲙⲉⲩⲕⲉⲣⲓⲁ
ϫⲉⲙⲏⲓⲥ	ϫⲉⲙⲏⲓⲥ
ϫⲉⲙⲏⲧⲓ	ϫⲉⲙⲏⲧⲓ
ϫⲉⲙⲙⲟⲛ	ϫⲉⲙⲙⲟⲛ
ϫⲉⲙⲛⲁⲓ	ϫⲉⲙⲛⲁⲓ
ϫⲉⲙⲛⲟⲙϯ	ϫⲉⲙⲛⲟⲙϯ
ϫⲉⲙⲟϣⲓ	ϫⲉⲙⲟϣⲓ
ϫⲉⲙⲟⲓ	ϫⲉⲙⲟⲓ
ϫⲉⲙⲟⲩϯ	ϫⲉⲙⲟⲩϯ
ϫⲉⲙⲟⲩⲧⲁϩ	ϫⲉⲙⲟⲩⲧⲁϩ
ϫⲉⲙⲡⲉⲛⲛⲁⲩ	ϫⲉⲙⲡⲉⲛⲛⲁⲩ
ϫⲉⲙⲡⲉⲣϣⲉ	ϫⲉⲙⲡⲉⲣϣⲉ
ϫⲉⲙⲡⲉⲣⲉⲣϩⲟϯ	ϫⲉⲙⲡⲉⲣⲉⲣϩⲟϯ
ϫⲉⲙⲡⲉⲣⲧⲁϩⲛⲟ	ϫⲉⲙⲡⲉⲣⲧⲁϩⲛⲟ
ϫⲉⲙⲡⲉⲧⲉⲛⲱϣ	ϫⲉⲙⲡⲉⲧⲉⲛⲱϣ
ϫⲉⲛϥⲟⲩⲉϩ	ϫⲉⲛϥⲟⲩⲉϩ
ϫⲉⲛϩⲁⲛⲕⲟⲩϫⲓ	ϫⲉⲛϩⲁⲛⲕⲟⲩϫⲓ
ϫⲉⲛⲁϣⲏⲣⲓ	ϫⲉⲛⲁϣⲏⲣⲓ
ϫⲉⲛⲁⲧⲓⲁⲧⲟⲧⲟⲩ	ϫⲉⲛⲁⲧⲓⲁⲧⲟⲧⲟⲩ
ϫⲉⲛⲁⲩϫⲱ	ϫⲉⲛⲁⲩϫⲱ
ϫⲉⲛⲁⲩⲟⲓ	ϫⲉⲛⲁⲩⲟⲓ
ϫⲉⲛⲉⲕⲛⲟⲃⲓ	ϫⲉⲛⲉⲕⲛⲟⲃⲓ
ϫⲉⲛⲉⲧⲉⲛⲥⲱⲙⲁ	ϫⲉⲛⲉⲧⲛⲥⲱⲙⲁ
ϫⲉⲛⲉⲫⲱⲣ	ϫⲉⲛⲉⲫⲱⲣ
ϫⲉⲛⲏ	ϫⲉⲛⲏ
ϫⲉⲛⲑⲟⲕ	ϫⲉⲛⲑⲟⲕ
ϫⲉⲛⲑⲱⲧⲉⲛ	ϫⲉⲛⲑⲱⲧⲉⲛ
ϫⲉⲛⲓϣⲏⲣⲓ	ϫⲉⲛⲓϣⲏⲣⲓ
ϫⲉⲛⲓⲁⲅⲓⲟⲥ	ϫⲉⲛⲓϩⲁⲅⲓⲟⲥ
ϫⲉⲛⲓⲁⲡⲟⲥⲧⲟⲗⲟⲥ	ϫⲉⲛⲓⲁⲡⲟⲥⲧⲟⲗⲟⲥ
ϫⲉⲛⲓⲑⲏⲟⲩ	ϫⲉⲛⲓⲑⲏⲟⲩ
ϫⲉⲛⲓⲙ	ϫⲉⲛⲓⲙ
ϫⲉⲛⲓⲣⲉϥϭⲓ	ϫⲉⲛⲓⲣⲉϥϭⲓ
ϫⲉⲛⲛⲉϥⲧⲁⲕⲟ	ϫⲉⲛⲛⲉϥⲧⲁⲕⲟ
ϫⲉⲛⲛⲉϩⲗⲓ	ϫⲉⲛⲛⲉϩⲗⲓ
ϫⲉⲛⲛⲉⲟⲩⲁⲓ	ϫⲉⲛⲛⲉⲟⲩⲁⲓ
ϫⲉⲛⲧⲉϥϣⲉ	ϫⲉⲛⲧⲉϥϣⲉ
ϫⲉⲛⲧⲉⲧⲉⲛⲉⲙⲓ	ϫⲉⲛⲧⲉⲧⲉⲛⲉⲙⲓ
ϫⲉⲟⲛⲧⲱⲥ	ϫⲉⲟⲛⲧⲱⲥ
ϫⲉⲟⲩ	ϫⲉⲟⲩ
ϫⲉⲟⲩϩⲟⲣⲧϥ	ϫⲉⲟⲩϩⲟⲣⲧϥ
ϫⲉⲟⲩⲁ	ϫⲉⲟⲩⲁ
ϫⲉⲟⲩⲁϣ	ϫⲉⲟⲩⲁϣ
ϫⲉⲟⲩⲁⲓ	ϫⲉⲟⲩⲁⲓ
ϫⲉⲟⲩⲇⲉ	ϫⲉⲟⲩⲇⲉ
ϫⲉⲟⲩⲉⲃⲟⲗ	ϫⲉⲟⲩⲉⲃⲟⲗ
ϫⲉⲟⲩⲏⲓ	ϫⲉⲟⲩⲏⲓ
ϫⲉⲟⲩⲕⲟⲩϫⲓ	ϫⲉⲟⲩⲕⲟⲩϫⲓ
ϫⲉⲟⲩⲟⲛ	ϫⲉⲟⲩⲟⲛ
ϫⲉⲟⲩⲟⲛⲧⲉⲧⲉⲛ	ϫⲉⲟⲩⲟⲛⲧⲉⲧⲉⲛ
ϫⲉⲟⲩⲟⲣⲡⲧⲉⲛ	ϫⲉⲟⲩⲟⲣⲡⲧⲉⲛ
ϫⲉⲟⲩⲡⲣⲟⲫⲏⲧⲏⲥ	ϫⲉⲟⲩⲡⲣⲟⲫⲏⲧⲏⲥ
ϫⲉⲟⲩⲣⲱⲙⲓ	ϫⲉⲟⲩⲣⲱⲙⲓ
ϫⲉⲟⲩⲥⲁⲃⲉ	ϫⲉⲟⲩⲥⲁⲃⲉ
ϫⲉⲡϣⲏⲣⲓ	ϫⲉⲡϣⲏⲣⲓ
ϫⲉⲡϭⲟⲓⲥ	ϫⲉⲡϭⲟⲓⲥ
ϫⲉⲡⲁϣⲏⲣⲓ	ϫⲉⲡⲁϣⲏⲣⲓ
ϫⲉⲡⲁⲏⲓ	ϫⲉⲡⲁⲏⲓ
ϫⲉⲡⲁⲓⲅⲉⲛⲟⲥ	ϫⲉⲡⲁⲓⲅⲉⲛⲟⲥ
ϫⲉⲡⲁⲓⲗⲁⲟⲥ	ϫⲉⲡⲁⲓⲗⲁⲟⲥ
ϫⲉⲡⲁⲓⲣⲏϯ	ϫⲉⲡⲁⲓⲣⲏϯ
ϫⲉⲡⲉⲑⲛⲏⲟⲩ	ϫⲉⲡⲉⲑⲛⲏⲟⲩ
ϫⲉⲡⲉⲣϣⲓϣⲓ	ϫⲉⲡⲉⲣϣⲓϣⲓ
ϫⲉⲡⲉⲧⲉⲧⲉⲛⲟⲩⲁϣϥ	ϫⲉⲡⲉⲧⲉⲧⲉⲛⲟⲩⲁϣϥ
ϫⲉⲡⲉⲧⲣⲟⲥ	ϫⲉⲡⲉⲧⲣⲟⲥ
ϫⲉⲡⲓⲁⲅⲁⲑⲟⲥ	ϫⲉⲡⲓⲁⲅⲁⲑⲟⲥ
ϫⲉⲡⲓⲁⲧⲥⲁϫⲓ	ϫⲉⲡⲓⲁⲧⲥⲁϫⲓ
ϫⲉⲡⲓⲁⲫⲟⲧ	ϫⲉⲡⲓⲁⲫⲟⲧ
ϫⲉⲡⲓⲙⲁ	ϫⲉⲡⲓⲙⲁ
ϫⲉⲡⲓⲙⲏϣ	ϫⲉⲡⲓⲙⲏϣ
ϫⲉⲡⲭⲣⲓⲥⲧⲟⲥ	ϫⲉⲡⲭⲣⲓⲥⲧⲟⲥ
ϫⲉⲡⲱⲥ	ϫⲉⲡⲱⲥ
ϫⲉⲣⲁⲃⲃⲓ	ϫⲉⲣⲁⲃⲃⲓ
ϫⲉⲣⲁⲃⲃⲟⲩⲛⲓ	ϫⲉⲣⲁⲃⲃⲟⲩⲛⲓ
ϫⲉⲣⲉ	ϫⲉⲣⲉ
ϫⲉⲥϣⲉ	ϫⲉⲥϣⲉ
ϫⲉⲥⲉ	ϫⲉⲥⲉ
ϫⲉⲥⲉⲃⲧⲉⲫⲙⲱⲓⲧ	ϫⲉⲥⲉⲃⲧⲉⲫⲙⲱⲓⲧ
ϫⲉⲥⲉⲉⲣⲭⲣⲓⲁ	ϫⲉⲥⲉⲣⲭⲣⲉⲓⲁ
ϫⲉⲥⲉⲕⲱϯ	ϫⲉⲥⲉⲕⲱϯ
ϫⲉⲥⲉⲙⲟⲕⲙⲉⲕ	ϫⲉⲥⲉⲙⲟⲕⲙⲉⲕ
ϫⲉⲥⲉⲛⲁ	ϫⲉⲥⲉⲛⲁ
ϫⲉⲥⲉⲟⲓ	ϫⲉⲥⲉⲟⲓ
ϫⲉⲥⲉⲟⲩⲱⲙ	ϫⲉⲥⲉⲟⲩⲱⲙ
ϫⲉⲥⲟⲛ	ϫⲉⲥⲟⲛ
ϫⲉⲥⲥϧⲏⲟⲩⲧ	ϫⲉⲥⲥϧⲏⲟⲩⲧ
ϫⲉⲥⲱⲧⲉⲙ	ϫⲉⲥⲱⲧⲉⲙ
ϫⲉⲧⲁϣⲉⲣⲓ	ϫⲉⲧⲁϣⲉⲣⲓ
ϫⲉⲧⲁⲗⲓⲑⲁ	ϫⲉⲧⲁⲗⲓⲑⲁ
ϫⲉⲧⲁⲫⲉ	ϫⲉⲧⲁⲫⲉ
ϫⲉⲧⲉⲛⲉⲙⲓ	ϫⲉⲧⲉⲛⲉⲙⲓ
ϫⲉⲧⲉⲛⲉⲣⲟⲩⲙⲏϣ	ϫⲉⲧⲉⲛⲉⲣⲟⲩⲙⲏϣ
ϫⲉⲧⲉⲛⲛⲁϣⲉ	ϫⲉⲧⲉⲛⲛⲁϣⲉ
ϫⲉⲧⲉⲛⲛⲁⲧⲁⲕⲟ	ϫⲉⲧⲉⲛⲛⲁⲧⲁⲕⲟ
ϫⲉⲧⲉⲧⲉⲛⲉⲙⲓ	ϫⲉⲧⲉⲧⲉⲛⲉⲙⲓ
ϫⲉⲧⲱⲛⲕ	ϫⲉⲧⲱⲛⲕ
ϫⲉⲫⲁⲓ	ϫⲉⲫⲁⲓ
ϫⲉⲫⲏ	ϫⲉⲫⲏ
ϫⲉⲫⲣⲉϥϯⲥⲃⲱ	ϫⲉⲫⲣⲉϥϯⲥⲃⲱ
ϫⲉⲭⲁⲛⲓⲁⲗⲱⲟⲩⲓ	ϫⲉⲭⲁⲛⲓⲁⲗⲱⲟⲩⲓ
ϫⲉⲭⲁⲟⲩⲛⲁϩϯ	ϫⲉⲭⲁⲟⲩⲛⲁϩϯ
ϫⲉⲭⲁⲣⲱⲕ	ϫⲉⲭⲁⲣⲱⲕ
ϫⲉⲭⲁⲥ	ϫⲉⲭⲁⲥ
ϫⲉⲭⲙⲉⲩⲓ	ϫⲉⲭⲙⲉⲩⲓ
ϫⲉⲭⲛⲁⲩ	ϫⲉⲭⲛⲁⲩ
ϫⲉⲱⲡⲓϫⲱⲟⲩ	ϫⲉⲱⲡⲓϫⲱⲟⲩ
ϫⲉⲱⲥⲁⲛⲛⲁ	ϫⲉⲱⲥⲁⲛⲛⲁ
ϫⲏⲕ	ϫⲏⲕ
ϫⲓϫ	ϫⲓϫ
ϫⲓⲙⲓ	ϫⲓⲙⲓ
ϫⲓⲛⲑⲣⲉϥⲥⲓϯ	ϫⲓⲛⲑⲣⲉϥⲥⲓϯ
ϫⲓⲛⲥⲱⲕ	ϫⲓⲛⲥⲱⲕ
ϫⲟ	ϫⲟ
ϫⲟϫ	ϫⲟϫ
ϫⲟϫⲥ	ϫⲟϫⲥ
ϫⲟⲃⲥ	ϫⲟⲃⲥ
ϫⲟⲓ	ϫⲟⲉⲓ
ϫⲟⲗ	ϫⲟⲗ
ϫⲟⲙ	ϫⲟⲙ
ϫⲟⲛⲥ	ϫⲟⲛⲥ
ϫⲟⲣ	ϫⲟⲣ
ϫⲟⲥ	ϫⲟⲥ
ϫⲟⲩϣⲧ	ϫⲟⲩϣⲧ
ϫⲣⲟϫ	ϫⲣⲟϫ
ϫⲫⲉ	ϫⲫⲉ
ϫⲫⲓⲟ	ϫⲫⲓⲟ
ϫⲫⲟ	ϫⲫⲟ
ϫⲱ	ϫⲱ
ϫⲱⲃ	ϫⲱⲃ
ϫⲱⲃⲓ	ϫⲱⲃⲓ
ϫⲱⲓⲧ	ϫⲱⲓⲧ
ϫⲱⲕ	ϫⲱⲕ
ϫⲱⲙ	ϫⲱⲙ
ϫⲱⲟⲩ	ϫⲱⲟⲩ
ϫⲱⲣⲓ	ϫⲱⲣⲓ
ϭⲁⲗⲁⲩϫ	ϭⲁⲗⲁⲩϫ
ϭⲁⲗⲉ	ϭⲁⲗⲉ
ϭⲁⲗⲟϫ	ϭⲁⲗⲟϫ
ϭⲁⲙⲟⲩⲗ	ϭⲁⲙⲟⲩⲗ
ϭⲁⲩⲙⲱⲓⲧ	ϭⲁⲩⲙⲱⲓⲧ
ϭⲉ	ϭⲉ
ϭⲉⲛⲟ	ϭⲉⲛⲟ
ϭⲉⲣⲉ	ϭⲉⲣⲉ
ϭⲏⲡⲓ	ϭⲏⲡⲓ
ϭⲓ	ϭⲓ
ϭⲓϣⲉⲙⲏⲣ	ϭⲓϣⲉⲙⲏⲣ
ϭⲓϩⲁⲡ	ϭⲓϩⲁⲡ
ϭⲓⲟⲩⲓ	ϭⲓⲟⲩⲓ
ϭⲓⲟⲩⲙⲏϣ	ϭⲓⲟⲩⲙⲏϣ
ϭⲓⲥⲁⲛⲓⲥ	ϭⲓⲥⲁⲛⲓⲥ
ϭⲓⲥⲃⲱ	ϭⲓⲥⲃⲱ
ϭⲓⲥⲓ	ϭⲓⲥⲓ
ϭⲓⲧ	ϭⲓⲧ
ϭⲓⲱⲓⲕ	ϭⲓⲱⲓⲕ
ϭⲓⲱⲙⲥ	ϭⲓⲱⲙⲥ
ϭⲗⲟϫ	ϭⲗⲟϫ
ϭⲟϫⲓ	ϭⲟϫⲓ
ϭⲟⲓⲥ	ϭⲟⲓⲥ
ϭⲟⲣⲡ	ϭⲟⲣⲡ
ϭⲟⲥϫⲉⲥ	ϭⲟⲥϫⲉⲥ
ϭⲟⲥⲓ	ϭⲟⲥⲓ
ϭⲣⲟⲙⲡⲓ	ϭⲣⲟⲙⲡⲓ
ϭⲥ	ϭⲟⲉⲓⲥ
ϭⲱⲣⲡ	ϭⲱⲣⲡ
ϯ	ϯ
ϯϣⲓⲡⲓ	ϯϣⲓⲡⲓ
ϯϧⲓⲥⲓ	ϯϧⲓⲥⲓ
ϯϩⲁⲡ	ϯϩⲁⲡ
ϯϩⲟ	ϯϩⲟ
ϯϫⲱ	ϯϫⲱ
ϯϭⲗⲁⲕ	ϯϭⲗⲁⲕ
ϯϯϩⲟ	ϯϯϩⲟ
ϯⲃⲁⲕⲓ	ϯⲃⲁⲕⲓ
ϯⲃⲱ	ϯⲃⲱ
ϯⲉⲣϣⲓϣⲓ	ϯⲉⲣϣⲓϣⲓ
ϯⲕⲉϩ	ϯⲕⲉϩ
ϯⲙⲁϯ	ϯⲙⲁϯ
ϯⲙⲉⲧⲟⲩⲣⲟ	ϯⲙⲉⲧⲟⲩⲣⲟ
ϯⲙⲉⲩⲓ	ϯⲙⲉⲩⲓ
ϯⲙⲓ	ϯⲙⲓ
ϯⲛⲁϣⲱⲡⲓ	ϯⲛⲁϣⲱⲡⲓ
ϯⲛⲁϫⲟⲥ	ϯⲛⲁϫⲟⲥ
ϯⲛⲁϯ	ϯⲛⲁϯ
ϯⲛⲁⲉⲣⲁⲛⲉⲭⲉⲥⲑⲉ	ϯⲛⲁⲉⲣⲁⲛⲉⲭⲉⲥⲑⲉ
ϯⲛⲁⲛⲟϩⲉⲙ	ϯⲛⲁⲛⲟϩⲉⲙ
ϯⲛⲁⲟⲩⲱⲣⲡ	ϯⲛⲁⲟⲩⲱⲣⲡ
ϯⲛⲉϫⲓ	ϯⲛⲉϫⲓ
ϯⲛⲉⲙⲱⲧⲉⲛ	ϯⲛⲉⲙⲱⲧⲉⲛ
ϯⲛⲟⲩ	ϯⲛⲟⲩ
ϯⲟⲥⲓ	ϯⲟⲥⲓ
ϯⲟⲩⲛⲟⲩ	ϯⲟⲩⲛⲟⲩ
ϯⲟⲩⲧⲁϩ	ϯⲟⲩⲧⲁϩ
ϯⲟⲩⲱ	ϯⲟⲩⲱ
ϯⲟⲩⲱⲙ	ϯⲟⲩⲱⲙ
ϯⲡⲓ	ϯⲡⲓ
ϯⲣⲁⲛ	ϯⲣⲁⲛ
ϯⲥϩⲓⲙⲓ	ϯⲥϩⲓⲙⲓ
ϯⲥⲃⲱ	ϯⲥⲃⲱ
ϯⲧⲁⲣⲕⲟ	ϯⲧⲁⲣⲕⲟ
ϯⲱⲙⲥ	ϯⲱⲙⲥ
ϯⲱⲟⲩ	ϯⲱⲟⲩ
ⲁ	ⲁ
ⲁϣ	ⲁϣ
ⲁϥϣⲁⲛ	ⲁϥϣⲁⲛ
ⲁϥϣⲁⲛϫⲉⲙϩⲏⲟⲩ	ⲁϥϣⲁⲛϫⲉⲙϩⲏⲟⲩ
ⲁϥϣⲁⲛⲓ	ⲁϥϣⲁⲛⲓ
ⲁϥϣⲁⲛⲫⲟϩ	ⲁϥϣⲁⲛⲫⲟϩ
ⲁϥϣⲉ	ⲁϥϣⲉ
ⲁϥϣⲉⲛ	ⲁϥϣⲉⲛ
ⲁϥϣⲉⲛϩⲏⲧ	ⲁϥϣⲉⲛϩⲏⲧ
ⲁϥϣⲉⲛⲟⲩ	ⲁϥϣⲉⲛⲟⲩ
ⲁϥϣⲉⲡϩⲙⲟⲧ	ⲁϥϣⲉⲡϩⲙⲟⲧ
ⲁϥϣⲟⲃⲧϥ	ⲁϥϣⲟⲃⲧϥ
ⲁϥϣⲟⲡ	ⲁϥϣⲟⲡ
ⲁϥϣⲧⲉⲙϭⲓⲧⲟⲩ	ⲁϥϣⲧⲉⲙϭⲓⲧⲟⲩ
ⲁϥϣⲧⲉⲙⲟⲩⲱⲛϩ	ⲁϥϣⲧⲉⲙⲟⲩⲱⲛϩ
ⲁϥϣⲧⲉⲣⲑⲱⲣϥ	ⲁϥϣⲧⲉⲣⲑⲱⲣϥ
ⲁϥϣⲱⲟⲩⲓ	ⲁϥϣⲱⲟⲩⲓ
ⲁϥϣⲱⲡ	ⲁϥϣⲱⲡ
ⲁϥϣⲱⲡⲓ	ⲁϥϣⲱⲡⲓ
ⲁϥϥⲓⲁϩⲟⲙ	ⲁϥϥⲓⲁϩⲟⲙ
ⲁϥϩⲉⲓ	ⲁϥϩⲉⲓ
ⲁϥϩⲉⲙⲥⲓ	ⲁϥϩⲉⲙⲥⲓ
ⲁϥϩⲉⲣⲓ	ⲁϥϩⲉⲣⲓ
ⲁϥϩⲓ	ⲁϥϩⲓ
ⲁϥϩⲓⲛⲉϥⲧⲏⲃ	ⲁϥϩⲓⲛⲉϥⲧⲏⲃ
ⲁϥϩⲓⲟⲩⲓ	ⲁϥϩⲓⲟⲩⲓ
ⲁϥϩⲓⲧϥ	ⲁϥϩⲓⲧϥ
ⲁϥϩⲕⲟ	ⲁϥϩⲕⲟ
ⲁϥϩⲟⲛϩⲉⲛ	ⲁϥϩⲟⲛϩⲉⲛ
ⲁϥϩⲱⲗ	ⲁϥϩⲱⲗ
ⲁϥϫⲟⲥ	ⲁϥϫⲟⲥ
ⲁϥϫⲟⲩϣⲧ	ⲁϥϫⲟⲩϣⲧ
ⲁϥϭⲓ	ⲁϥϭⲓ
ⲁϥϭⲓⲱⲙⲥ	ⲁϥϭⲓⲱⲙⲥ
ⲁϥϭⲟϫⲓ	ⲁϥϭⲟϫⲓ
ⲁϥϭⲟⲣⲡⲟⲩ	ⲁϥϭⲟⲣⲡⲟⲩ
ⲁϥϯ	ⲁϥϯ
ⲁϥϯⲉⲣϣⲓϣⲓ	ⲁϥϯⲉⲣϣⲓϣⲓ
ⲁϥϯⲟⲩⲱ	ⲁϥϯⲟⲩⲱ
ⲁϥⲁⲓⲧⲟⲩ	ⲁϥⲁⲓⲧⲟⲩ
ⲁϥⲁⲗⲏⲓ	ⲁϥⲁⲗⲏⲓ
ⲁϥⲁⲙⲟⲛⲓ	ⲁϥⲁⲙⲟⲛⲓ
ⲁϥⲉⲙⲓ	ⲁϥⲉⲙⲓ
ⲁϥⲉⲛϥ	ⲁϥⲉⲛϥ
ⲁϥⲉⲛⲗ	ⲁϥⲉⲛⲗ
ⲁϥⲉⲣϣⲫⲏⲣⲓ	ⲁϥⲉⲣϣⲫⲏⲣⲓ
ⲁϥⲉⲣϩⲏⲧⲥ	ⲁϥⲉⲣϩⲏⲧⲥ
ⲁϥⲉⲣϩⲟϯ	ⲁϥⲉⲣϩⲟϯ
ⲁϥⲉⲣⲁⲛⲁⲅⲕⲁⲍⲓⲛ	ⲁϥⲉⲣⲁⲛⲁⲅⲕⲁⲍⲓⲛ
ⲁϥⲉⲣⲉⲡⲓⲧⲓⲙⲁⲛ	ⲁϥⲉⲣⲉⲡⲓⲧⲓⲙⲁⲛ
ⲁϥⲉⲣⲉⲩⲑⲏⲛⲓⲛ	ⲁϥⲉⲣⲉⲩⲑⲏⲛⲓⲛ
ⲁϥⲉⲣⲕⲁⲩⲙⲁ	ⲁϥⲉⲣⲕⲁⲩⲙⲁ
ⲁϥⲉⲣⲙⲫⲣⲏϯ	ⲁϥⲉⲣⲙⲫⲣⲏϯ
ⲁϥⲉⲣⲛⲟⲃⲓ	ⲁϥⲉⲣⲛⲟⲃⲓ
ⲁϥⲉⲣⲟⲩⲱ	ⲁϥⲉⲣⲟⲩⲱ
ⲁϥⲉⲣⲡⲣⲟⲫⲏⲧⲉⲩⲓⲛ	ⲁϥⲉⲣⲡⲣⲟⲫⲏⲧⲉⲩⲓⲛ
ⲁϥⲉⲣⲫⲁϧⲣⲓ	ⲁϥⲉⲣⲫⲁϧⲣⲓ
ⲁϥⲑⲁⲙⲓⲉⲓⲃ	ⲁϥⲑⲁⲙⲓⲉⲓⲃ
ⲁϥⲑⲣⲟⲩⲁⲓⲁⲓ	ⲁϥⲑⲣⲟⲩⲁⲓⲁⲓ
ⲁϥⲑⲱⲟⲩϯ	ⲁϥⲑⲱⲟⲩϯ
ⲁϥⲓ	ⲁϥⲓ
ⲁϥⲓⲛⲓ	ⲁϥⲓⲛⲓ
ⲁϥⲕⲏⲛ	ⲁϥⲕⲏⲛ
ⲁϥⲙⲉⲛⲣⲓⲧϥ	ⲁϥⲙⲉⲛⲣⲓⲧϥ
ⲁϥⲙⲟϣⲓ	ⲁϥⲙⲟϣⲓ
ⲁϥⲙⲟⲩϣϯ	ⲁϥⲙⲟⲩϣϯ
ⲁϥⲙⲟⲩϯ	ⲁϥⲙⲟⲩϯ
ⲁϥⲛⲁⲩ	ⲁϥⲛⲁⲩ
ⲁϥⲟⲗϥ	ⲁϥⲟⲗϥ
ⲁϥⲟⲗⲟⲩ	ⲁϥⲟⲗⲟⲩ
ⲁϥⲟⲩϫⲁⲓ	ⲁϥⲟⲩϫⲁⲓ
ⲁϥⲟⲩⲁϩⲥⲁϩⲛⲓ	ⲁϥⲟⲩⲁϩⲥⲁϩⲛⲓ
ⲁϥⲟⲩⲟⲙⲟⲩ	ⲁϥⲟⲩⲟⲙⲟⲩ
ⲁϥⲟⲩⲟⲛϩϥ	ⲁϥⲟⲩⲟⲛϩϥ
ⲁϥⲟⲩⲟⲣⲡϥ	ⲁϥⲟⲩⲟⲣⲡϥ
ⲁϥⲟⲩⲱϣ	ⲁϥⲟⲩⲱϣ
ⲁϥⲟⲩⲱϣⲧ	ⲁϥⲟⲩⲱϣⲧ
ⲁϥⲟⲩⲱⲣⲡ	ⲁϥⲟⲩⲱⲣⲡ
ⲁϥⲣⲱⲧ	ⲁϥⲣⲱⲧ
ⲁϥⲥϧⲉⲧⲁⲓⲉⲛⲧⲟⲗⲏ	ⲁϥⲥϧⲉⲧⲁⲓⲉⲛⲧⲟⲗⲏ
ⲁϥⲥⲁϫⲓ	ⲁϥⲥⲁϫⲓ
ⲁϥⲥⲓϯ	ⲁϥⲥⲓϯ
ⲁϥⲥⲙⲟⲩ	ⲁϥⲥⲙⲟⲩ
ⲁϥⲥⲟⲛϩϥ	ⲁϥⲥⲟⲛϩϥ
ⲁϥⲥⲟⲥⲟⲩ	ⲁϥⲥⲟⲥⲟⲩ
ⲁϥⲥⲟⲩⲧⲉⲛ	ⲁϥⲥⲟⲩⲧⲉⲛ
ⲁϥⲥⲱⲧⲉⲙ	ⲁϥⲥⲱⲧⲉⲙ
ⲁϥⲧⲁϩⲟϥ	ⲁϥⲧⲁϩⲟϥ
ⲁϥⲧⲏⲓⲥ	ⲁϥⲧⲏⲓⲥ
ⲁϥⲧⲟⲩⲃⲟ	ⲁϥⲧⲟⲩⲃⲟ
ⲁϥⲧⲟⲩⲛⲟⲥ	ⲁϥⲧⲟⲩⲛⲟⲥ
ⲁϥⲧⲟⲩⲛⲟⲥϥ	ⲁϥⲧⲟⲩⲛⲟⲥϥ
ⲁϥⲧⲟⲩⲛⲟⲥⲥ	ⲁϥⲧⲟⲩⲛⲟⲥⲥ
ⲁϥⲧⲥⲟ	ⲁϥⲧⲥⲟ
ⲁϥⲧⲱⲛϥ	ⲁϥⲧⲱⲛϥ
ⲁϥⲫⲁϣⲟⲩ	ⲁϥⲫⲁϣⲟⲩ
ⲁϥⲫⲱϣ	ⲁϥⲫⲱϣ
ⲁϥⲭⲁϫⲓϫ	ⲁϥⲭⲁϫⲓϫ
ⲁϥⲭⲁⲛⲉϥϫⲓϫ	ⲁϥⲭⲁⲛⲉϥϫⲓϫ
ⲁϥⲭⲁⲥ	ⲁϥⲭⲁⲥ
ⲁϥⲭⲁⲩ	ⲁϥⲭⲁⲩ
ⲁϥⲱϣ	ⲁϥⲱϣ
ⲁϥⲱⲗⲓ	ⲁϥⲱⲗⲓ
ⲁϥⲱⲣⲕ	ⲁϥⲱⲣⲕ
ⲁϧⲟ	ⲁϧⲟ
ⲁϧⲱ	ⲁϧⲱ
ⲁϩⲁⲛⲟⲩⲟⲛ	ⲁϩⲁⲛⲟⲩⲟⲛ
ⲁϩⲟ	ⲁϩⲟ
ⲁϫⲟ	ⲁϫⲟ
ⲁϫⲟⲥ	ⲁϫⲟⲥ
ⲁϯⲁⲗⲟⲩ	ⲁϯⲁⲗⲟⲩ
ⲁⲃⲓⲁⲑⲁⲣ	ⲁⲃⲓⲁⲑⲁⲣ
ⲁⲅⲁⲑⲟⲥ	ⲁⲅⲁⲑⲟⲥ
ⲁⲅⲁⲡⲏ	ⲁⲅⲁⲡⲏ
ⲁⲅⲅⲉⲗⲟⲥ	ⲁⲅⲅⲉⲗⲟⲥ
ⲁⲅⲉⲗⲏ	ⲁⲅⲉⲗⲏ
ⲁⲅⲓⲟⲥ	ϩⲁⲅⲓⲟⲥ
ⲁⲅⲟⲣⲁ	ⲁⲅⲟⲣⲁ
ⲁⲑⲛⲁϩϯ	ⲁⲑⲛⲁϩϯ
ⲁⲓ	ⲁⲓ
ⲁⲓϣⲁⲛ	ⲁⲓϣⲁⲛ
ⲁⲓϣⲁⲛϭⲓ	ⲁⲓϣⲁⲛϭⲓ
ⲁⲓϣⲁⲛⲭⲁⲩ	ⲁⲓϣⲁⲛⲭⲁⲩ
ⲁⲓϣⲟⲡⲧⲟⲩ	ⲁⲓϣⲟⲡⲧⲟⲩ
ⲁⲓϫⲉ	ⲁⲓϫⲉ
ⲁⲓϫⲟⲥ	ⲁⲓϫⲟⲥ
ⲁⲓϫⲫⲉⲑⲏⲛⲟⲩ	ⲁⲓϫⲫⲉⲑⲏⲛⲟⲩ
ⲁⲓⲁⲓ	ⲁⲓⲁⲓ
ⲁⲓⲁⲣⲉϩ	ⲁⲓⲁⲣⲉϩ
ⲁⲓⲉⲛⲡⲁϣⲏⲣⲓ	ⲁⲓⲉⲛⲡⲁϣⲏⲣⲓ
ⲁⲓⲏⲥⲟⲩⲥ	ⲁⲓⲏⲥⲟⲩⲥ
ⲁⲓⲓ	ⲁⲓⲓ
ⲁⲓⲟⲩⲱⲣⲡ	ⲁⲓⲟⲩⲱⲣⲡ
ⲁⲓⲥϧⲁⲓ	ⲁⲓⲥϧⲁⲓ
ⲁⲓⲧ	ⲁⲓⲧ
ⲁⲓⲧⲁⲙⲟ	ⲁⲓⲧⲁⲙⲟ
ⲁⲓⲧⲟⲩ	ⲁⲓⲧⲟⲩ
ⲁⲓⲧⲥⲉⲑⲏⲛⲟⲩ	ⲁⲓⲧⲥⲉⲑⲏⲛⲟⲩ
ⲁⲓⲧⲱϫⲓ	ⲁⲓⲧⲱϫⲓ
ⲁⲓⲭⲱ	ⲁⲓⲭⲱ
ⲁⲕϣⲁⲛ	ⲁⲕϣⲁⲛ
ⲁⲕϣⲁⲛϫⲉⲙϩⲏⲟⲩ	ⲁⲕϣⲁⲛϫⲉⲙϩⲏⲟⲩ
ⲁⲕⲁⲑⲁⲣⲧⲟⲛ	ⲁⲕⲁⲑⲁⲣⲧⲟⲛ
ⲁⲕⲁⲑⲣⲧⲟⲛ	ⲁⲕⲁⲑⲣⲧⲟⲛ
ⲁⲕⲉⲣⲡⲕⲉϭⲓ	ⲁⲕⲉⲣⲡⲕⲉϭⲓ
ⲁⲗⲏⲓ	ⲁⲗⲏⲓ
ⲁⲗⲓⲟⲩⲓ	ⲁⲗⲓⲟⲩⲓ
ⲁⲗⲗⲁ	ⲁⲗⲗⲁ
ⲁⲗⲟⲩ	ⲁⲗⲟⲩ
ⲁⲗⲫⲉⲟⲥ	ⲁⲗⲫⲉⲟⲥ
ⲁⲗⲱⲟⲩⲓ	ⲁⲗⲱⲟⲩⲓ
ⲁⲙϣⲉ	ⲁⲙϣⲉ
ⲁⲙⲁϩⲓ	ⲁⲙⲁϩⲓ
ⲁⲙⲏⲛ	ⲁⲙⲏⲛ
ⲁⲙⲟⲓ	ⲁⲙⲟⲓ
ⲁⲙⲟⲛⲓ	ⲁⲙⲟⲛⲓ
ⲁⲙⲟⲩ	ⲁⲙⲟⲩ
ⲁⲙⲱⲓⲛⲓ	ⲁⲙⲱⲓⲛⲓ
ⲁⲛ	ⲁⲛ
ⲁⲛϣⲁⲛ	ⲁⲛϣⲁⲛ
ⲁⲛⲁ	ⲁⲛⲁ
ⲁⲛⲁⲙⲏⲓ	ⲁⲛⲁⲙⲏⲓ
ⲁⲛⲁⲩ	ⲁⲛⲁⲩ
ⲁⲛⲁⲩϣ	ⲁⲛⲁⲩϣ
ⲁⲛⲇⲣⲉⲁⲥ	ⲁⲛⲇⲣⲉⲁⲥ
ⲁⲛⲉϥⲙⲁⲑⲏⲧⲏⲥ	ⲁⲛⲉϥⲙⲁⲑⲏⲧⲏⲥ
ⲁⲛⲉⲣ	ⲁⲛⲉⲣ
ⲁⲛⲉⲣϣⲃⲉ	ⲁⲛⲉⲣϣⲃⲉ
ⲁⲛⲓⲙⲁⲑⲏⲧⲏⲥ	ⲁⲛⲓⲙⲁⲑⲏⲧⲏⲥ
ⲁⲛⲓⲟⲩⲓ	ⲁⲛⲓⲟⲩⲓ
ⲁⲛⲓⲧ	ⲁⲛⲓⲧ
ⲁⲛⲓⲧϥ	ⲁⲛⲓⲧϥ
ⲁⲛⲛⲁⲩ	ⲁⲛⲛⲁⲩ
ⲁⲛⲛⲁⲭⲁⲥ	ⲁⲛⲛⲁⲭⲁⲥ
ⲁⲛⲟⲕ	ⲁⲛⲟⲕ
ⲁⲛⲟⲛ	ⲁⲛⲟⲛ
ⲁⲛⲟⲩⲁϩⲧⲉⲛ	ⲁⲛⲟⲩⲁϩⲧⲉⲛ
ⲁⲛⲧⲁϩⲛⲟ	ⲁⲛⲧⲁϩⲛⲟ
ⲁⲛⲭⲁⲡⲧⲏⲣϥ	ⲁⲛⲭⲁⲡⲧⲏⲣϥ
ⲁⲟⲩⲙⲏϣ	ⲁⲟⲩⲙⲏϣ
ⲁⲟⲩⲛⲓϣϯ	ⲁⲟⲩⲛⲓϣϯ
ⲁⲟⲩⲱⲛ	ⲁⲟⲩⲱⲛ
ⲁⲡⲁⲥ	ⲁⲡⲁⲥ
ⲁⲡⲁⲧⲏ	ⲁⲡⲁⲧⲏ
ⲁⲡⲉϥϩⲏⲧ	ⲁⲡⲉϥϩⲏⲧ
ⲁⲡⲓⲡⲛⲉⲩⲙⲁ	ⲁⲡⲓⲡⲛⲉⲩⲙⲁ
ⲁⲡⲓⲥⲉϩⲧ	ⲁⲡⲓⲥⲉϩⲧ
ⲁⲡⲟⲗⲗⲱ	ⲁⲡⲟⲗⲗⲱ
ⲁⲡⲟⲥⲧⲟⲗⲟⲥ	ⲁⲡⲟⲥⲧⲟⲗⲟⲥ
ⲁⲣⲉ	ⲁⲣⲉ
ⲁⲣⲉϣⲁⲛ	ⲁⲣⲉϣⲁⲛ
ⲁⲣⲉϣⲁⲛⲟⲩϩⲟϫϩⲉϫ	ⲁⲣⲉϣⲁⲛⲟⲩϩⲟϫϩⲉϫ
ⲁⲣⲉϩ	ⲁⲣⲉϩ
ⲁⲣⲉⲧⲉⲛϣⲁⲛ	ⲁⲣⲉⲧⲉⲛϣⲁⲛ
ⲁⲣⲉⲧⲉⲛϣⲁⲛⲟϩⲓ	ⲁⲣⲉⲧⲉⲛϣⲁⲛⲟϩⲓ
ⲁⲣⲉⲧⲉⲛⲁⲓϥ	ⲁⲣⲉⲧⲉⲛⲁⲓϥ
ⲁⲣⲉⲧⲉⲛⲉⲣⲟⲩⲣⲟ	ⲁⲣⲉⲧⲉⲛⲉⲣⲟⲩⲣⲟ
ⲁⲣⲓϩⲓⲣⲏⲛⲏ	ⲁⲣⲓϩⲓⲣⲏⲛⲏ
ⲁⲣⲓⲃⲟⲏⲑⲓⲛ	ⲁⲣⲓⲃⲟⲏⲑⲓⲛ
ⲁⲣⲓⲉⲧⲓⲛ	ⲁⲣⲓⲉⲧⲓⲛ
ⲁⲣⲓⲙⲉⲧⲁⲛⲟⲉⲓⲛ	ⲁⲣⲓⲙⲉⲧⲁⲛⲟⲉⲓⲛ
ⲁⲣⲓⲙⲉⲧⲁⲛⲟⲓⲛ	ⲁⲣⲓⲙⲉⲧⲁⲛⲟⲉⲓⲛ
ⲁⲣⲓⲟⲩⲱ	ⲁⲣⲓⲟⲩⲱ
ⲁⲣⲓⲧⲓⲙⲁⲛ	ⲁⲣⲓⲧⲓⲙⲁⲛ
ⲁⲣⲭⲉⲟⲥ	ⲁⲣⲭⲉⲟⲥ
ⲁⲣⲭⲏ	ⲁⲣⲭⲏ
ⲁⲣⲭⲏⲇⲉⲕⲧⲱⲛ	ⲁⲣⲭⲏⲇⲉⲕⲧⲱⲛ
ⲁⲣⲭⲏⲥⲩⲛⲁⲅⲱⲅⲟⲥ	ⲁⲣⲭⲏⲥⲩⲛⲁⲅⲱⲅⲟⲥ
ⲁⲣⲭⲓⲉⲣⲉⲩⲥ	ⲁⲣⲭⲓⲉⲣⲉⲩⲥ
ⲁⲣⲭⲱⲛ	ⲁⲣⲭⲱⲛ
ⲁⲥϣⲱⲟⲩⲓ	ⲁⲥϣⲱⲟⲩⲓ
ⲁⲥϣⲱⲡⲓ	ⲁⲥϣⲱⲡⲓ
ⲁⲥϧⲉⲛⲟⲩϫⲟⲙ	ⲁⲥϧⲉⲛⲟⲩϫⲟⲙ
ⲁⲥϧⲱⲛⲧ	ⲁⲥϧⲱⲛⲧ
ⲁⲥϩⲉⲓ	ⲁⲥϩⲉⲓ
ⲁⲥϩⲓⲧⲥ	ⲁⲥϩⲓⲧⲥ
ⲁⲥϫⲉϯⲙⲉⲑⲙⲏⲓ	ⲁⲥϫⲉϯⲙⲉⲑⲙⲏⲓ
ⲁⲥϫⲓⲙⲓ	ⲁⲥϫⲓⲙⲓ
ⲁⲥϭⲉ	ⲁⲥϭⲉ
ⲁⲥϭⲓ	ⲁⲥϭⲓ
ⲁⲥⲉⲙⲓ	ⲁⲥⲉⲙⲓ
ⲁⲥⲉⲣⲉⲧⲓⲛ	ⲁⲥⲉⲣⲉⲧⲓⲛ
ⲁⲥⲉⲣⲓⲃ	ⲁⲥⲉⲣⲓⲃ
ⲁⲥⲉⲣⲟⲩⲱ	ⲁⲥⲉⲣⲟⲩⲱ
ⲁⲥⲑⲱⲟⲩϯ	ⲁⲥⲑⲱⲟⲩϯ
ⲁⲥⲓ	ⲁⲥⲓ
ⲁⲥⲕⲟⲥ	ⲁⲥⲕⲟⲥ
ⲁⲥⲙⲟϣⲓ	ⲁⲥⲙⲟϣⲓ
ⲁⲥⲙⲫⲣⲏϯ	ⲁⲥⲙⲫⲣⲏϯ
ⲁⲥⲛⲕⲟⲧ	ⲁⲥⲛⲕⲟⲧ
ⲁⲥⲟⲩϫⲁⲓ	ⲁⲥⲟⲩϫⲁⲓ
ⲁⲥⲣⲁⲛⲁϥ	ⲁⲥⲣⲁⲛⲁϥ
ⲁⲥⲥⲑⲉⲣⲧⲉⲣ	ⲁⲥⲥⲑⲉⲣⲧⲉⲣ
ⲁⲥⲥⲓⲛⲓ	ⲁⲥⲥⲓⲛⲓ
ⲁⲥⲥⲱⲧⲉⲙ	ⲁⲥⲥⲱⲧⲉⲙ
ⲁⲥⲧϩⲟ	ⲁⲥⲧϩⲟ
ⲁⲥⲧⲱⲛⲥ	ⲁⲥⲧⲱⲛⲥ
ⲁⲧϣⲉⲙⲏⲣ	ⲁⲧϣⲉⲙⲏⲣ
ⲁⲧϭⲉⲛⲟ	ⲁⲧϭⲉⲛⲟ
ⲁⲧϭⲛⲟⲩ	ⲁⲧϭⲛⲟⲩ
ⲁⲧϭⲛⲟⲩⲛ	ⲁⲧϭⲛⲟⲩⲛ
ⲁⲧⲉϥⲥⲙⲏ	ⲁⲧⲉϥⲥⲙⲏ
ⲁⲧⲉⲙⲓ	ⲁⲧⲉⲙⲓ
ⲁⲧⲉⲧⲉⲛⲉⲣⲣⲁⲙⲁⲟ	ⲁⲧⲉⲧⲉⲛⲉⲣⲣⲁⲙⲁⲟ
ⲁⲧⲉⲧⲉⲛⲙⲟϣⲓ	ⲁⲧⲉⲧⲉⲛⲙⲟϣⲓ
ⲁⲧⲉⲧⲉⲛⲥⲓ	ⲁⲧⲉⲧⲉⲛⲥⲓ
ⲁⲧⲓⲁⲧⲟⲧⲟⲩ	ⲁⲧⲓⲁⲧⲟⲧⲟⲩ
ⲁⲧⲕⲁϯ	ⲁⲧⲕⲁϯ
ⲁⲧⲟⲟⲩⲓ	ⲁⲧⲟⲟⲩⲓ
ⲁⲧⲟⲩⲱⲙ	ⲁⲧⲟⲩⲱⲙ
ⲁⲧⲥⲁϫⲓ	ⲁⲧⲥⲁϫⲓ
ⲁⲩϣⲁⲛ	ⲁⲩϣⲁⲛ
ⲁⲩϣⲁⲛⲱⲗⲓ	ⲁⲩϣⲁⲛⲱⲗⲓ
ⲁⲩϣⲁⲧϥ	ⲁⲩϣⲁⲧϥ
ⲁⲩϣⲉ	ⲁⲩϣⲉ
ⲁⲩϣⲉⲛϥ	ⲁⲩϣⲉⲛϥ
ⲁⲩϣⲉⲡ	ⲁⲩϣⲉⲡ
ⲁⲩϣⲑⲟⲣⲧⲉⲣ	ⲁⲩϣⲑⲟⲣⲧⲉⲣ
ⲁⲩϣⲧⲉⲙⲓⲁⲧⲟⲧⲟⲩ	ⲁⲩϣⲧⲉⲙⲓⲁⲧⲟⲧⲟⲩ
ⲁⲩϣⲧⲉⲙⲟⲙⲥⲟⲩ	ⲁⲩϣⲧⲉⲙⲟⲙⲥⲟⲩ
ⲁⲩϣⲱⲡⲓ	ⲁⲩϣⲱⲡⲓ
ⲁⲩϩⲉⲓ	ⲁⲩϩⲉⲓ
ⲁⲩϩⲓⲟⲩⲙⲏϣ	ⲁⲩϩⲓⲟⲩⲙⲏϣ
ⲁⲩϩⲓⲱⲓϣ	ⲁⲩϩⲓⲱⲓϣ
ⲁⲩϫⲉⲕⲉⲙⲑⲏⲛⲟⲩ	ⲁⲩϫⲉⲕⲉⲙⲑⲏⲛⲟⲩ
ⲁⲩϫⲓⲙⲓ	ⲁⲩϫⲓⲙⲓ
ⲁⲩϫⲟⲥ	ⲁⲩϫⲟⲥ
ⲁⲩϭⲟϫⲓ	ⲁⲩϭⲟϫⲓ
ⲁⲩϭⲱⲣⲡ	ⲁⲩϭⲱⲣⲡ
ⲁⲩϯϩⲟ	ⲁⲩϯϩⲟ
ⲁⲩϯⲟⲩⲧⲁϩ	ⲁⲩϯⲟⲩⲧⲁϩ
ⲁⲩϯⲟⲩⲱ	ⲁⲩϯⲟⲩⲱ
ⲁⲩⲁϣϥ	ⲁⲩⲁϣϥ
ⲁⲩⲁⲙⲟⲛⲓ	ⲁⲩⲁⲙⲟⲛⲓ
ⲁⲩⲉⲣϣⲟⲣⲡ	ⲁⲩⲉⲣϣⲟⲣⲡ
ⲁⲩⲉⲣϩⲏⲧⲥ	ⲁⲩⲉⲣϩⲏⲧⲥ
ⲁⲩⲉⲣϩⲟϯ	ⲁⲩⲉⲣϩⲟϯ
ⲁⲩⲉⲣⲁⲛⲁⲭⲱⲣⲓⲛ	ⲁⲩⲉⲣⲁⲛⲁⲭⲱⲣⲓⲛ
ⲁⲩⲉⲣⲁⲥⲡⲁⲍⲉⲥⲑⲉ	ⲁⲩⲉⲣⲁⲥⲡⲁⲍⲉⲥⲑⲉ
ⲁⲩⲉⲣⲉⲡⲓⲧⲓⲙⲁⲛ	ⲁⲩⲉⲣⲉⲡⲓⲧⲓⲙⲁⲛ
ⲁⲩⲉⲣⲟⲩⲱ	ⲁⲩⲉⲣⲟⲩⲱ
ⲁⲩⲉⲣⲡⲱⲃϣ	ⲁⲩⲉⲣⲡⲱⲃϣ
ⲁⲩⲑⲙⲁⲓⲉⲑⲏⲛⲟⲩ	ⲁⲩⲑⲙⲁⲓⲉⲑⲏⲛⲟⲩ
ⲁⲩⲑⲱⲟⲩϯ	ⲁⲩⲑⲱⲟⲩϯ
ⲁⲩⲓ	ⲁⲩⲓ
ⲁⲩⲓⲛⲓ	ⲁⲩⲓⲛⲓ
ⲁⲩⲓⲣⲓ	ⲁⲩⲓⲣⲓ
ⲁⲩⲕⲱⲣϫ	ⲁⲩⲕⲱⲣϫ
ⲁⲩⲙⲟϣⲓ	ⲁⲩⲙⲟϣⲓ
ⲁⲩⲙⲟⲛⲓ	ⲁⲩⲙⲟⲛⲓ
ⲁⲩⲙⲟⲩϯ	ⲁⲩⲙⲟⲩϯ
ⲁⲩⲛⲁⲩ	ⲁⲩⲛⲁⲩ
ⲁⲩⲛⲉϩⲥⲓ	ⲁⲩⲛⲉϩⲥⲓ
ⲁⲩⲟϩⲓ	ⲁⲩⲟϩⲓ
ⲁⲩⲟϫϩϥ	ⲁⲩⲟϫϩϥ
ⲁⲩⲟⲗϥ	ⲁⲩⲟⲗϥ
ⲁⲩⲟⲩⲟⲙϥ	ⲁⲩⲟⲩⲟⲙϥ
ⲁⲩⲟⲩⲟⲛϩⲟⲩ	ⲁⲩⲟⲩⲟⲛϩⲟⲩ
ⲁⲩⲟⲩⲱⲙ	ⲁⲩⲟⲩⲱⲙ
ⲁⲩⲟⲩⲱⲛ	ⲁⲩⲟⲩⲱⲛ
ⲁⲩⲟⲩⲱⲣⲡ	ⲁⲩⲟⲩⲱⲣⲡ
ⲁⲩⲣⲱⲧⲉⲃ	ⲁⲩⲣⲱⲧⲉⲃ
ⲁⲩⲥⲁϫⲓ	ⲁⲩⲥⲁϫⲓ
ⲁⲩⲥⲓ	ⲁⲩⲥⲓ
ⲁⲩⲥⲟⲩⲱⲛϥ	ⲁⲩⲥⲟⲩⲱⲛϥ
ⲁⲩⲥⲱⲟⲩⲛⲟⲩ	ⲁⲩⲥⲱⲟⲩⲛⲟⲩ
ⲁⲩⲥⲱⲧⲉⲙ	ⲁⲩⲥⲱⲧⲉⲙ
ⲁⲩⲧⲁⲗⲉⲛⲟⲩϩⲃⲱⲥ	ⲁⲩⲧⲁⲗⲉⲛⲟⲩϩⲃⲱⲥ
ⲁⲩⲧⲁⲙⲟϥ	ⲁⲩⲧⲁⲙⲟϥ
ⲁⲩⲧⲟⲩⲃⲉⲑⲏⲛⲟⲩ	ⲁⲩⲧⲟⲩⲃⲉⲑⲏⲛⲟⲩ
ⲁⲩⲫⲱⲣϣ	ⲁⲩⲫⲱⲣϣ
ⲁⲩⲫⲱⲧ	ⲁⲩⲫⲱⲧ
ⲁⲩⲭⲁ	ⲁⲩⲭⲁ
ⲁⲩⲭⲁϥ	ⲁⲩⲭⲁϥ
ⲁⲩⲭⲁⲛⲓϣⲛⲏⲟⲩ	ⲁⲩⲭⲁⲛⲓϣⲛⲏⲟⲩ
ⲁⲩⲭⲁⲣⲱⲟⲩ	ⲁⲩⲭⲁⲣⲱⲟⲩ
ⲁⲩⲭⲁⲩ	ⲁⲩⲭⲁⲩ
ⲁⲩⲭⲏ	ⲁⲩⲭⲏ
ⲁⲩⲭⲱ	ⲁⲩⲭⲱ
ⲁⲩⲱϣ	ⲁⲩⲱϣ
ⲁⲩⲱⲗⲓ	ⲁⲩⲱⲗⲓ
ⲁⲫⲉ	ⲁⲫⲉ
ⲁⲫⲟⲧ	ⲁⲫⲟⲧ
ⲃ	ⲃ
ⲃⲁⲕⲓ	ⲃⲁⲕⲓ
ⲃⲁⲗ	ⲃⲁⲗ
ⲃⲁⲣⲑⲟⲗⲟⲙⲉⲟⲥ	ⲃⲁⲣⲑⲟⲗⲟⲙⲉⲟⲥ
ⲃⲁⲣⲧⲓⲙⲉⲟⲥ	ⲃⲁⲣⲧⲓⲙⲉⲟⲥ
ⲃⲉⲗⲍⲉⲃⲟⲩⲗ	ⲃⲉⲗⲍⲉⲃⲟⲩⲗ
ⲃⲉⲗⲗⲉ	ⲃⲉⲗⲗⲉ
ⲃⲉⲣⲓ	ⲃⲉⲣⲓ
ⲃⲉⲭⲉ	ⲃⲉⲭⲉ
ⲃⲏϣ	ⲃⲏϣ
ⲃⲏⲃ	ⲃⲏⲃ
ⲃⲏⲑⲁⲛⲓⲁ	ⲃⲏⲑⲁⲛⲓⲁ
ⲃⲏⲑⲥⲁⲓⲇⲁ	ⲃⲏⲑⲥⲁⲓⲇⲁ
ⲃⲏⲑⲫⲁⲅⲏ	ⲃⲏⲑⲫⲁⲅⲏ
ⲃⲓⲛⲁϫ	ⲃⲓⲛⲁϫ
ⲃⲓⲟⲥ	ⲃⲓⲟⲥ
ⲃⲓⲣ	ⲃⲓⲣ
ⲃⲟⲁⲛⲏⲣⲅⲉⲥ	ⲃⲟⲁⲛⲏⲣⲅⲉⲥ
ⲃⲟⲗ	ⲃⲟⲗ
ⲃⲱ	ⲃⲱ
ⲃⲱⲗ	ⲃⲱⲗ
ⲅ	ⲅ
ⲅⲁⲗⲓⲗⲉⲁ	ⲅⲁⲗⲓⲗⲉⲁ
ⲅⲁⲣ	ⲅⲁⲣ
ⲅⲉ	ⲅⲉ
ⲅⲉⲉⲛⲛⲁ	ⲅⲉⲉⲛⲛⲁ
ⲅⲉⲛⲛⲏⲥⲁⲣⲉⲑ	ⲅⲉⲛⲛⲏⲥⲁⲣⲉⲑ
ⲅⲉⲛⲟⲥ	ⲅⲉⲛⲟⲥ
ⲅⲉⲣⲅⲉⲥⲏⲛⲟⲥ	ⲅⲉⲣⲅⲉⲥⲏⲛⲟⲥ
ⲇ	ⲇ
ⲇⲁⲗⲙⲁⲛⲟⲩⲑⲁ	ⲇⲁⲗⲙⲁⲛⲟⲩⲑⲁ
ⲇⲁⲩⲓⲇ	ⲇⲁⲩⲓⲇ
ⲇⲉ	ⲇⲉ
ⲇⲉⲙⲱⲛ	ⲇⲁⲓⲙⲱⲛ
ⲇⲓⲁⲕⲱⲛ	ⲇⲓⲁⲕⲱⲛ
ⲇⲓⲕⲉⲟⲥ	ⲇⲓⲕⲉⲟⲥ
ⲇⲓⲡⲛⲟⲛ	ⲇⲓⲡⲛⲟⲛ
ⲇⲓⲱⲅⲙⲟⲥ	ⲇⲓⲱⲅⲙⲟⲥ
ⲇⲱⲣⲟⲛ	ⲇⲱⲣⲟⲛ
ⲉ	ⲉ
ⲉϣ	ⲉϣ
ⲉϣⲁϥϣⲉ	ⲉϣⲁϥϣⲉ
ⲉϣⲁⲩ	ⲉϣⲁⲩ
ⲉϣⲁⲩϭⲓ	ⲉϣⲁⲩϭⲓ
ⲉϣⲁⲩⲙⲟⲗϩϥ	ⲉϣⲁⲩⲙⲟⲗϩϥ
ⲉϣⲁⲩⲥⲱⲧⲉⲙ	ⲉϣⲁⲩⲥⲱⲧⲉⲙ
ⲉϣⲉⲙϣⲓ	ⲉϣⲉⲙϣⲓ
ⲉϣⲉⲛϥ	ⲉϣⲉⲛϥ
ⲉϣⲧⲉⲙⲉⲗϩⲗⲓ	ⲉϣⲧⲉⲙⲉⲗϩⲗⲓ
ⲉϣⲧⲉⲙⲉⲣ	ⲉϣⲧⲉⲙⲉⲣ
ⲉϣⲧⲉⲙⲙⲟⲩϫⲧ	ⲉϣⲧⲉⲙⲙⲟⲩϫⲧ
ⲉϣⲱⲡ	ⲉϣⲱⲡ
ⲉϥϣⲏϣ	ⲉϥϣⲏϣ
ⲉϥϣⲏⲗ	ⲉϥϣⲏⲗ
ⲉϥϣⲟⲡ	ⲉϥϣⲟⲡ
ⲉϥϣⲱⲧ	ⲉϥϣⲱⲧ
ⲉϥϧⲉⲛⲟⲩⲡⲛⲉⲩⲙⲁ	ⲉϥϧⲉⲛⲟⲩⲡⲛⲉⲩⲙⲁ
ⲉϥϧⲣⲁϫⲣⲉϫ	ⲉϥϧⲣⲁϫⲣⲉϫ
ⲉϥϩⲉⲙⲥⲓ	ⲉϥϩⲉⲙⲥⲓ
ⲉϥϩⲏⲡ	ⲉϥϩⲏⲡ
ⲉϥϩⲓⲇⲉⲙⲱⲛ	ⲉϥϩⲓⲇⲉⲙⲱⲛ
ⲉϥϩⲓⲟⲩⲓ	ⲉϥϩⲓⲟⲩⲓ
ⲉϥϩⲓⲱⲓϣ	ⲉϥϩⲓⲱⲓϣ
ⲉϥϩⲟϫϩⲉϫ	ⲉϥϩⲟϫϩϫ
ⲉϥϩⲱⲟⲩ	ⲉϥϩⲱⲟⲩ
ⲉϥϫⲱ	ⲉϥϫⲱ
ⲉϥϭⲓϩⲁⲡ	ⲉϥϭⲓϩⲁⲡ
ⲉϥϭⲟⲥⲓ	ⲉϥϭⲟⲥⲓ
ⲉϥϯϩⲟ	ⲉϥϯϩⲟ
ⲉϥϯⲥⲃⲱ	ⲉϥϯⲥⲃⲱ
ⲉϥⲉ	ⲉϥⲉ
ⲉϥⲉϣⲱⲡⲓ	ⲉϥⲉϣⲱⲡⲓ
ⲉϥⲉϫϧⲉⲙⲥ	ⲉϥⲉϫϧⲉⲙⲥ
ⲉϥⲉϯϩⲁⲡ	ⲉϥⲉϯϩⲁⲡ
ⲉϥⲉⲉⲣϧⲁⲉ	ⲉϥⲉⲉⲣϧⲁⲉ
ⲉϥⲉⲉⲣⲃⲱⲕ	ⲉϥⲉⲉⲣⲃⲱⲕ
ⲉϥⲉⲉⲣⲇⲓⲁⲕⲱⲛ	ⲉϥⲉⲉⲣⲇⲓⲁⲕⲱⲛ
ⲉϥⲉⲛϩⲟⲧ	ⲉϥⲉⲛϩⲟⲧ
ⲉϥⲉⲛⲁϩⲙⲉⲥ	ⲉϥⲉⲛⲁϩⲙⲉⲥ
ⲉϥⲉⲟⲩⲱⲛϩ	ⲉϥⲉⲟⲩⲱⲛϩ
ⲉϥⲉⲣⲡⲓⲣⲁⲍⲓⲛ	ⲉϥⲉⲣⲡⲓⲣⲁⲍⲓⲛ
ⲉϥⲉⲧⲁⲕⲟⲥ	ⲉϥⲉⲧⲁⲕⲟⲥ
ⲉϥⲉⲧⲟⲙϥ	ⲉϥⲉⲧⲟⲙϥ
ⲉϥⲉⲧⲟⲩⲛⲟⲥⲧⲉⲛ	ⲉϥⲉⲧⲟⲩⲛⲟⲥⲧⲉⲛ
ⲉϥⲙⲏⲣ	ⲉϥⲙⲏⲣ
ⲉϥⲙⲟϣⲓ	ⲉϥⲙⲟϣⲓ
ⲉϥⲙⲟⲕϩ	ⲉϥⲙⲟⲕϩ
ⲉϥⲛⲁ	ⲉϥⲛⲁ
ⲉϥⲛⲉⲙⲱⲟⲩ	ⲉϥⲛⲉⲙⲱⲟⲩ
ⲉϥⲛⲏⲟⲩ	ⲉϥⲛⲏⲟⲩ
ⲉϥⲟϣ	ⲉϥⲟϣ
ⲉϥⲟϫⲥ	ⲉϥⲟϫⲥ
ⲉϥⲟⲩⲁⲃ	ⲉϥⲟⲩⲁⲃ
ⲉϥⲟⲩⲱⲛϩ	ⲉϥⲟⲩⲱⲛϩ
ⲉϥⲣⲟⲧⲉⲃ	ⲉϥⲣⲟⲧⲉⲃ
ⲉϥⲥⲁϫⲓ	ⲉϥⲥⲁϫⲓ
ⲉϥⲥⲓⲛⲓⲱⲟⲩ	ⲉϥⲥⲓⲛⲓⲱⲟⲩ
ⲉϥⲥⲟⲛϩ	ⲉϥⲥⲟⲛϩ
ⲉϥⲥⲟⲩⲧⲱⲛ	ⲉϥⲥⲟⲩⲧⲱⲛ
ⲉϥⲥⲱⲟⲩⲛ	ⲉϥⲥⲱⲟⲩⲛ
ⲉϥⲧⲟⲩⲃⲟ	ⲉϥⲧⲟⲩⲃⲟ
ⲉϥⲭⲏ	ⲉϥⲭⲏ
ⲉϥⲱϣ	ⲉϥⲱϣ
ⲉϧⲏⲧϥ	ⲉϧⲏⲧϥ
ⲉϧⲟⲑⲃⲉϥ	ⲉϧⲟⲑⲃⲉϥ
ⲉϧⲟⲑⲃⲉⲥ	ⲉϧⲟⲑⲃⲥ
ⲉϧⲟⲩⲛ	ⲉϧⲟⲩⲛ
ⲉϧⲣⲏⲓ	ⲉϧⲣⲏⲓ
ⲉϩⲁⲛϫⲱⲃⲓ	ⲉϩⲁⲛϫⲱⲃⲓ
ⲉϩⲁⲛⲁⲅⲅⲉⲗⲟⲥ	ⲉϩⲁⲛⲁⲅⲅⲉⲗⲟⲥ
ⲉϩⲁⲛⲙⲏϣ	ⲉϩⲁⲛⲙⲏϣ
ⲉϩⲁⲛⲟⲩⲟⲛ	ⲉϩⲁⲛⲟⲩⲟⲛ
ⲉϩⲁⲛⲭⲣⲏⲙⲁ	ⲉϩⲁⲛⲭⲣⲏⲙⲁ
ⲉϩⲓⲇⲉⲙⲱⲛ	ⲉϩⲓⲇⲁⲓⲙⲱⲛ
ⲉϩⲓⲧⲉϥⲥϩⲓⲙⲓ	ⲉϩⲓⲧⲉϥⲥϩⲓⲙⲓ
ⲉϩⲓⲱⲓϣ	ⲉϩⲓⲱⲓϣ
ⲉϩⲗⲓ	ⲉϩⲗⲓ
ⲉϩⲟⲟⲩ	ⲉϩⲟⲟⲩ
ⲉϩⲟⲧⲉ	ⲉϩⲟⲧⲉ
ⲉϩⲟⲧⲉⲣⲟ	ⲉϩⲟⲧⲉⲣⲟ
ⲉϩⲟⲧⲉⲣⲟⲓ	ⲉϩⲟⲧⲉⲣⲟⲓ
ⲉϩⲣⲁ	ⲉϩⲣⲁ
ⲉϩⲣⲁϥ	ⲉϩⲣⲁϥ
ⲉϩⲣⲁⲥ	ⲉϩⲣⲁⲥ
ⲉϩⲣⲁⲩ	ⲉϩⲣⲁⲩ
ⲉϩⲣⲉⲛ	ⲉϩⲣⲉⲛ
ⲉϩⲣⲉⲛⲡⲓⲇ	ⲉϩⲣⲉⲛⲡⲓⲇ
ⲉϩⲣⲉⲛⲡⲓⲉ	ⲉϩⲣⲉⲛⲡⲓⲉ
ⲉϩⲣⲏⲓ	ⲉϩⲣⲏⲓ
ⲉϩⲱⲃ	ⲉϩⲱⲃ
ⲉϫⲉⲛ	ⲉϫⲉⲛ
ⲉϫⲉⲛⲛⲉϥⲃⲁⲗ	ⲉϫⲉⲛⲛⲉϥⲃⲁⲗ
ⲉϫⲉⲛⲛⲉϥⲕⲉⲗⲓ	ⲉϫⲉⲛⲛⲉϥⲕⲉⲗⲓ
ⲉϫⲉⲛⲛⲓⲡⲛⲉⲩⲙⲁ	ⲉϫⲉⲛⲛⲓⲡⲛⲉⲩⲙⲁ
ⲉϫⲉⲛⲛⲓⲥⲟⲩⲣⲓ	ⲉϫⲉⲛⲛⲓⲥⲟⲩⲣⲓ
ⲉϫⲉⲛⲛⲓⲱⲓⲕ	ⲉϫⲉⲛⲛⲓⲱⲓⲕ
ⲉϫⲉⲛⲟⲩⲕⲁϩⲓ	ⲉϫⲉⲛⲟⲩⲕⲁϩⲓ
ⲉϫⲉⲛⲟⲩⲧⲱⲟⲩ	ⲉϫⲉⲛⲟⲩⲧⲱⲟⲩ
ⲉϫⲉⲛⲡϣⲏⲣⲓ	ⲉϫⲉⲛⲡϣⲏⲣⲓ
ⲉϫⲉⲛⲡϩⲏⲧ	ⲉϫⲉⲛⲡϩⲏⲧ
ⲉϫⲉⲛⲡϫⲉⲛⲉⲫⲱⲣ	ⲉϫⲉⲛⲡϫⲉⲛⲉⲫⲱⲣ
ⲉϫⲉⲛⲡⲁⲣⲁⲛ	ⲉϫⲉⲛⲡⲁⲣⲁⲛ
ⲉϫⲉⲛⲡⲉϥϣⲫⲏⲣ	ⲉϫⲉⲛⲡⲉϥϣⲫⲏⲣ
ⲉϫⲉⲛⲡⲉⲕⲧⲟⲩⲃⲟ	ⲉϫⲉⲛⲡⲉⲕⲧⲟⲩⲃⲟ
ⲉϫⲉⲛⲡⲓⲑⲱⲙ	ⲉϫⲉⲛⲡⲓⲑⲱⲙ
ⲉϫⲉⲛⲡⲓⲕⲁϩⲓ	ⲉϫⲉⲛⲡⲓⲕⲁϩⲓ
ⲉϫⲉⲛⲡⲓⲙⲁ	ⲉϫⲉⲛⲡⲓⲙⲁ
ⲉϫⲉⲛⲡⲓⲥⲁϫⲓ	ⲉϫⲉⲛⲡⲓⲥⲁϫⲓ
ⲉϫⲉⲛⲡⲓⲧⲱⲟⲩ	ⲉϫⲉⲛⲡⲓⲧⲱⲟⲩ
ⲉϫⲉⲛⲡⲕⲁϩⲓ	ⲉϫⲉⲛⲡⲕⲁϩⲓ
ⲉϫⲉⲛⲧⲁⲓⲥⲉⲛϯ	ⲉϫⲉⲛⲧⲁⲓⲥⲉⲛϯ
ⲉϫⲉⲛⲧⲉϥϯⲡⲓ	ⲉϫⲉⲛⲧⲉϥϯⲡⲓ
ⲉϫⲉⲛⲧⲉϥⲥⲃⲱ	ⲉϫⲉⲛⲧⲉϥⲥⲃⲱ
ⲉϫⲏⲟⲩ	ⲉϫⲏⲟⲩ
ⲉϫⲟⲃⲥⲧ	ⲉϫⲟⲃⲥⲧ
ⲉϫⲟⲥ	ⲉϫⲟⲥ
ⲉϫⲱ	ⲉϫⲱ
ⲉϫⲱϥ	ⲉϫⲱϥ
ⲉϫⲱⲛ	ⲉϫⲱⲛ
ⲉϫⲱⲟⲩ	ⲉϫⲱⲟⲩ
ⲉϫⲱⲣϩ	ⲉϫⲱⲣϩ
ⲉϫⲱⲥ	ⲉϫⲱⲥ
ⲉϭⲓϩⲁⲡ	ⲉϭⲓϩⲁⲡ
ⲉϭⲓⲧⲥϩⲓⲙⲓ	ⲉϭⲓⲧⲥϩⲓⲙⲓ
ⲉϭⲓⲱⲓⲕ	ⲉϭⲓⲱⲓⲕ
ⲉϯ	ⲉϯ
ⲉϯϩⲁⲡ	ⲉϯϩⲁⲡ
ⲉϯϫⲟⲙ	ⲉϯϫⲟⲙ
ⲉϯϯⲥⲃⲱ	ⲉϯϯⲥⲃⲱ
ⲉϯⲃⲱ	ⲉϯⲃⲱ
ⲉϯⲅⲁⲗⲓⲗⲉⲁ	ⲉϯⲅⲁⲗⲓⲗⲉⲁ
ⲉϯⲅⲉⲉⲛⲛⲁ	ⲉϯⲅⲉⲉⲛⲛⲁ
ⲉϯⲙⲉⲧⲟⲩⲣⲟ	ⲉϯⲙⲉⲧⲟⲩⲣⲟ
ⲉϯⲟⲩⲱ	ⲉϯⲟⲩⲱ
ⲉϯⲡⲁⲣⲁⲃⲟⲗⲏ	ⲉϯⲡⲁⲣⲁⲃⲟⲗⲏ
ⲉϯⲡⲟⲣⲛⲏ	ⲉϯⲡⲟⲣⲛⲏ
ⲉϯⲥⲱ	ⲉϯⲥⲱ
ⲉϯⲱⲙⲥ	ⲉϯⲱⲙⲥ
ⲉⲁϥⲁⲙⲟⲛⲓ	ⲉⲁϥⲁⲙⲟⲛⲓ
ⲉⲁϥⲛⲁⲓ	ⲉⲁϥⲛⲁⲓ
ⲉⲁϥⲭⲁϫⲓϫ	ⲉⲁϥⲭⲁϫⲓϫ
ⲉⲁϥⲭⲁⲏⲓ	ⲉⲁϥⲭⲁⲏⲓ
ⲉⲁⲓⲁⲓ	ⲉⲁⲓⲁⲓ
ⲉⲁⲕϣⲉⲛϩⲏⲧ	ⲉⲁⲕϣⲉⲛϩⲏⲧ
ⲉⲁⲗⲏⲓ	ⲉⲁⲗⲏⲓ
ⲉⲁⲙⲟⲛⲓ	ⲉⲁⲙⲟⲛⲓ
ⲉⲁⲣⲉⲧⲉⲛⲛⲁϩϯ	ⲉⲁⲣⲉⲧⲉⲛⲛⲁϩϯ
ⲉⲁⲥⲕⲟⲥ	ⲉⲁⲥⲕⲟⲥ
ⲉⲁⲧⲉⲧⲉⲛⲭⲁϯⲉⲛⲧⲟⲗⲏ	ⲉⲁⲧⲉⲧⲛⲭⲁϯⲉⲛⲧⲟⲗⲏ
ⲉⲁⲩϭⲓⲧⲟⲩ	ⲉⲁⲩϭⲓⲧⲟⲩ
ⲉⲁⲩⲁⲙⲟⲛⲓ	ⲉⲁⲩⲁⲙⲟⲛⲓ
ⲉⲁⲩⲓ	ⲉⲁⲩⲓ
ⲉⲁⲩⲫⲱϧ	ⲉⲁⲩⲫⲱϧ
ⲉⲃⲁⲕⲓ	ⲉⲃⲁⲕⲓ
ⲉⲃⲏⲑⲁⲛⲓⲁ	ⲉⲃⲏⲑⲁⲛⲓⲁ
ⲉⲃⲏⲑⲥⲁⲓⲇⲁ	ⲉⲃⲏⲑⲥⲁⲓⲇⲁ
ⲉⲃⲏⲑⲫⲁⲅⲏ	ⲉⲃⲏⲑⲫⲁⲅⲏ
ⲉⲃⲏⲗ	ⲉⲃⲏⲗ
ⲉⲃⲓⲱ	ⲉⲃⲓⲱ
ⲉⲃⲟ	ⲉⲃⲟ
ⲉⲃⲟⲗ	ⲉⲃⲟⲗ
ⲉⲅⲉⲛⲛⲏⲥⲁⲣⲉⲑ	ⲉⲅⲉⲛⲛⲏⲥⲁⲣⲉⲑ
ⲉⲉϣⲟⲩⲱⲛⲓ	ⲉⲉϣⲟⲩⲱⲛⲓ
ⲉⲉⲗⲡⲱⲓⲕ	ⲉⲉⲗⲡⲱⲓⲕ
ⲉⲉⲙⲓ	ⲉⲉⲙⲓ
ⲉⲉⲣϩⲗⲓ	ⲉⲉⲣϩⲗⲓ
ⲉⲉⲣϩⲟⲩⲓⲧ	ⲉⲉⲣϩⲟⲩⲓⲧ
ⲉⲉⲣϩⲱⲃ	ⲉⲉⲣϩⲱⲃ
ⲉⲉⲣⲇⲓⲁⲕⲣⲓⲛⲓⲛ	ⲉⲉⲣⲇⲓⲁⲕⲣⲓⲛⲓⲛ
ⲉⲉⲣⲛⲏⲥⲧⲉⲩⲓⲛ	ⲉⲉⲣⲛⲏⲥⲧⲉⲩⲓⲛ
ⲉⲉⲣⲛⲓϣϯ	ⲉⲉⲣⲛⲓϣϯ
ⲉⲉⲣⲡⲉⲑⲛⲁⲛⲉϥ	ⲉⲉⲣⲡⲉⲑⲛⲁⲛⲉϥ
ⲉⲉⲣⲡⲉⲧϩⲱⲟⲩ	ⲉⲉⲣⲡⲉⲧϩⲱⲟⲩ
ⲉⲉⲣⲡⲕⲉⲟⲩⲱⲙ	ⲉⲉⲣⲡⲕⲉⲟⲩⲱⲙ
ⲉⲉⲣⲡⲣⲟⲥⲉⲩⲭⲉⲥⲑⲉ	ⲉⲉⲣⲡⲣⲟⲥⲉⲩⲭⲉⲥⲑⲉ
ⲉⲑ	ⲉⲑ
ⲉⲑⲁϩⲉⲙⲛⲓⲑⲙⲏⲓ	ⲉⲑⲁϩⲉⲙⲛⲓⲑⲙⲏⲓ
ⲉⲑⲃⲉ	ⲉⲑⲃⲉ
ⲉⲑⲃⲉϫⲉ	ⲉⲑⲃⲉϫⲉ
ⲉⲑⲃⲉϫⲉⲙⲙⲟⲛⲧⲉϥ	ⲉⲑⲃⲉϫⲉⲙⲙⲟⲛⲧⲉϥ
ⲉⲑⲃⲉⲏⲣⲱⲇⲓⲁⲥ	ⲉⲑⲃⲉⲏⲣⲱⲇⲓⲁⲥ
ⲉⲑⲃⲉⲑⲏⲛⲟⲩ	ⲉⲑⲃⲉⲑⲏⲛⲟⲩ
ⲉⲑⲃⲉⲓⲁⲕⲱⲃⲟⲥ	ⲉⲑⲃⲉⲓⲁⲕⲱⲃⲟⲥ
ⲉⲑⲃⲉⲓⲏⲥⲟⲩⲥ	ⲉⲑⲃⲉⲓⲏⲥⲟⲩⲥ
ⲉⲑⲃⲉⲛⲓⲁⲛⲁⲩϣ	ⲉⲑⲃⲉⲛⲓⲁⲛⲁⲩϣ
ⲉⲑⲃⲉⲛⲓⲡⲁⲣⲁⲃⲟⲗⲏ	ⲉⲑⲃⲉⲛⲓⲡⲁⲣⲁⲃⲟⲗⲏ
ⲉⲑⲃⲉⲟⲩ	ⲉⲑⲃⲉⲟⲩ
ⲉⲑⲃⲉⲟⲩⲁⲓ	ⲉⲑⲃⲉⲟⲩⲁⲓ
ⲉⲑⲃⲉⲡϩⲁⲓ	ⲉⲑⲃⲉⲡϩⲁⲓ
ⲉⲑⲃⲉⲡⲓⲙⲏϣ	ⲉⲑⲃⲉⲡⲓⲙⲏϣ
ⲉⲑⲃⲉⲡⲓⲣⲱⲙⲓ	ⲉⲑⲃⲉⲡⲓⲣⲱⲙⲓ
ⲉⲑⲃⲉⲡⲓⲥⲁϫⲓ	ⲉⲑⲃⲉⲡⲓⲥⲁϫⲓ
ⲉⲑⲃⲉⲡⲓⲥⲁⲃⲃⲁⲧⲟⲛ	ⲉⲑⲃⲉⲡⲓⲥⲁⲃⲃⲁⲧⲟⲛ
ⲉⲑⲃⲉⲡⲭⲣⲓⲥⲧⲟⲥ	ⲉⲑⲃⲉⲡⲭⲣⲓⲥⲧⲟⲥ
ⲉⲑⲃⲉⲧⲟⲩⲙⲉⲧⲁⲑⲛⲁϩϯ	ⲉⲑⲃⲉⲧⲟⲩⲙⲉⲧⲁⲑⲛⲁϩϯ
ⲉⲑⲃⲉⲫⲁⲓ	ⲉⲑⲃⲉⲫⲁⲓ
ⲉⲑⲃⲏ	ⲉⲑⲃⲏ
ⲉⲑⲃⲏⲧ	ⲉⲑⲃⲏⲧ
ⲉⲑⲃⲏⲧϥ	ⲉⲑⲃⲏⲧϥ
ⲉⲑⲃⲏⲧⲥ	ⲉⲑⲃⲏⲧⲥ
ⲉⲑⲏ	ⲉⲑⲏ
ⲉⲑⲙⲉⲩⲓ	ⲉⲑⲙⲉⲩⲓ
ⲉⲑⲙⲱⲟⲩⲧ	ⲉⲧⲙⲱⲟⲩⲧ
ⲉⲑⲛⲁ	ⲉⲑⲛⲁ
ⲉⲑⲛⲁϣⲉⲡϯⲙⲉⲧⲟⲩⲣⲟ	ⲉⲧⲛⲁϣⲉⲡϯⲙⲉⲧⲟⲩⲣⲟ
ⲉⲑⲛⲁϣⲉⲡⲟⲩⲁⲓ	ⲉⲧⲛⲁϣⲉⲡⲟⲩⲁⲓ
ⲉⲑⲛⲁϣⲓⲡⲓ	ⲉⲑⲛⲁϣⲓⲡⲓ
ⲉⲑⲛⲁϣⲛⲟϩⲉⲙ	ⲉⲧⲛⲁϣⲛⲟϩⲉⲙ
ⲉⲑⲛⲁϣⲧⲥⲁⲃⲟϥ	ⲉⲑⲛⲁϣⲧⲥⲁⲃⲟϥ
ⲉⲑⲛⲁϣⲱⲡⲓ	ⲉⲑⲛⲁϣⲱⲡⲓ
ⲉⲑⲛⲁϩϯ	ⲉⲑⲛⲁϩϯ
ⲉⲑⲛⲁϫⲉⲟⲩⲁ	ⲉⲑⲛⲁϫⲉⲟⲩⲁ
ⲉⲑⲛⲁϫⲟⲥ	ⲉⲧⲛⲁϫⲟⲥ
ⲉⲑⲛⲁϯϩⲁⲡ	ⲉⲑⲛⲁϯϩⲁⲡ
ⲉⲑⲛⲁⲉⲣⲥⲕⲁⲛⲇⲁⲗⲓⲍⲉⲥⲑⲉ	ⲉⲧⲛⲁⲉⲣⲥⲕⲁⲛⲇⲁⲗⲓⲍⲉⲥⲑⲉ
ⲉⲑⲛⲁⲑⲣⲉⲛⲏ	ⲉⲑⲛⲁⲑⲣⲉⲛⲏ
ⲉⲑⲛⲁⲑⲣⲉⲧⲉⲛⲉⲣⲫⲙⲉⲩⲓ	ⲉⲑⲛⲁⲑⲣⲉⲧⲉⲛⲉⲣⲫⲙⲉⲩⲓ
ⲉⲑⲛⲁⲓⲣⲓ	ⲉⲑⲛⲁⲓⲣⲓ
ⲉⲑⲛⲁⲕⲱⲣϥ	ⲉⲑⲛⲁⲕⲱⲣϥ
ⲉⲑⲛⲁⲙⲉⲛⲣⲓⲧϥ	ⲉⲑⲛⲁⲙⲉⲛⲣⲓⲧϥ
ⲉⲑⲛⲁⲛⲉϥ	ⲉⲑⲛⲁⲛⲉϥ
ⲉⲑⲛⲁⲟⲩⲱϣ	ⲉⲧⲛⲁⲟⲩⲱϣ
ⲉⲑⲛⲁⲥⲁϫⲓ	ⲉⲑⲛⲁⲥⲁϫⲓ
ⲉⲑⲛⲁⲥⲉϥ	ⲉⲑⲛⲁⲥⲉϥ
ⲉⲑⲛⲁⲥⲟⲃϯ	ⲉⲑⲛⲁⲥⲟⲃϯ
ⲉⲑⲛⲁⲧⲁⲕⲟ	ⲉⲑⲛⲁⲧⲁⲕⲟ
ⲉⲑⲛⲁⲧⲥⲉⲑⲏⲛⲟⲩ	ⲉⲧⲛⲁⲧⲥⲉⲑⲏⲛⲟⲩ
ⲉⲑⲛⲁⲭⲁⲧⲉϥⲥϩⲓⲙⲓ	ⲉⲧⲛⲁⲭⲁⲧⲉϥⲥϩⲓⲙⲓ
ⲉⲑⲛⲉⲙⲁϥ	ⲉⲑⲛⲉⲙⲁϥ
ⲉⲑⲛⲏⲟⲩ	ⲉⲑⲛⲏⲟⲩ
ⲉⲑⲛⲟⲥ	ⲉⲑⲛⲟⲥ
ⲉⲑⲟⲩⲁⲃ	ⲉⲑⲟⲩⲁⲃ
ⲉⲑⲟⲩⲉⲧⲟⲩⲱⲧ	ⲉⲑⲟⲩⲉⲧⲟⲩⲱⲧ
ⲉⲑⲟⲩⲱϣ	ⲉⲑⲟⲩⲱϣ
ⲉⲑⲣⲉⲛⲁⲓ	ⲉⲑⲣⲉⲛⲁⲓ
ⲉⲑⲣⲉⲛⲉⲛϣⲏⲣⲓ	ⲉⲑⲣⲉⲛⲉⲛϣⲏⲣⲓ
ⲉⲑⲣⲉⲟⲩⲟⲛ	ⲉⲑⲣⲉⲟⲩⲟⲛ
ⲉⲑⲣⲉⲡⲉⲣϣⲓϣⲓ	ⲉⲑⲣⲉⲡⲉⲣϣⲓϣⲓ
ⲉⲑⲣⲟⲧⲉⲃ	ⲉⲑⲣⲟⲧⲉⲃ
ⲉⲑⲣⲟⲩϣⲉⲙϣⲏⲧϥ	ⲉⲑⲣⲟⲩϣⲉⲙϣⲏⲧϥ
ⲉⲑⲣⲟⲩⲭⲱ	ⲉⲑⲣⲟⲩⲭⲱ
ⲉⲓ	ⲉⲓ
ⲉⲓϫⲱ	ⲉⲓϫⲱ
ⲉⲓϯϩⲁⲡ	ⲉⲓϯϩⲁⲡ
ⲉⲓϯⲥⲃⲱ	ⲉⲓϯⲥⲃⲱ
ⲉⲓⲁⲕⲱⲃⲟⲥ	ⲉⲓⲁⲕⲱⲃⲟⲥ
ⲉⲓⲉ	ⲉⲓⲉ
ⲉⲓⲉⲉⲙⲓ	ⲉⲓⲉⲉⲙⲓ
ⲉⲓⲉⲓ	ⲉⲓⲉⲓ
ⲉⲓⲉⲣⲓⲭⲱ	ⲉⲓⲉⲣⲓⲭⲱ
ⲉⲓⲉⲣⲟⲥⲁⲗⲏⲙ	ⲉⲓⲉⲣⲟⲥⲁⲗⲏⲙ
ⲉⲓⲏⲥⲟⲩⲥ	ⲉⲓⲏⲥⲟⲩⲥ
ⲉⲓⲗⲏⲙ	ⲉϩⲓⲉⲣⲟⲩⲥⲁⲗⲏⲙ
ⲉⲓⲛⲉⲙⲱⲧⲉⲛ	ⲉⲓⲛⲉⲙⲱⲧⲉⲛ
ⲉⲓⲣⲓ	ⲉⲓⲣⲓ
ⲉⲓⲥϧⲁⲓ	ⲉⲓⲥϧⲁⲓ
ⲉⲕϣⲟⲩϣⲟⲩ	ⲉⲕϣⲟⲩϣⲟⲩ
ⲉⲕϯϧⲓⲥⲓ	ⲉⲕϯϧⲓⲥⲓ
ⲉⲕⲁⲫⲁⲣⲛⲁⲟⲩⲙ	ⲉⲕⲁⲫⲁⲣⲛⲁⲟⲩⲙ
ⲉⲕⲉ	ⲉⲕⲉ
ⲉⲕⲉϫⲫⲟ	ⲉⲕⲉϫⲫⲟ
ⲉⲕⲉⲙⲁ	ⲉⲕⲉⲙⲁ
ⲉⲕⲕⲗⲏⲥⲓⲁ	ⲉⲕⲕⲗⲏⲥⲓⲁ
ⲉⲕⲟⲓ	ⲉⲕⲟⲓ
ⲉⲗ	ⲉⲗ
ⲉⲗⲉⲩⲓ	ⲉⲗⲉⲩⲓ
ⲉⲗⲡⲓⲙⲟϩ	ⲉⲗⲡⲓⲙⲟϩ
ⲉⲙⲁϣⲱ	ⲉⲙⲁϣⲱ
ⲉⲙⲁⲩ	ⲙⲙⲁⲩ
ⲉⲙⲏⲣ	ⲉⲙⲏⲣ
ⲉⲙⲓ	ⲉⲙⲓ
ⲉⲙⲙⲁⲩ	ⲉⲙⲙⲁⲩ
ⲉⲙⲙⲟⲛ	ⲉⲙⲙⲟⲛ
ⲉⲙⲥ	ⲉⲙⲥ
ⲉⲛ	ⲉⲛ
ⲉⲛϩⲟⲧ	ⲉⲛϩⲟⲧ
ⲉⲛⲁϣⲱϥ	ⲉⲛⲁϣⲱϥ
ⲉⲛⲁϥⲓⲣⲓ	ⲉⲛⲁϥⲓⲣⲓ
ⲉⲛⲁϥⲛⲏⲟⲩ	ⲉⲛⲁϥⲛⲏⲟⲩ
ⲉⲛⲁϥⲟⲓ	ⲉⲛⲁϥⲟⲓ
ⲉⲛⲁϥⲟⲩⲁϣⲟⲩ	ⲉⲛⲁϥⲟⲩⲁϣⲟⲩ
ⲉⲛⲁϩⲙⲉⲥ	ⲉⲛⲁϩⲙⲉⲥ
ⲉⲛⲁⲓ	ⲉⲛⲁⲓ
ⲉⲛⲁⲛⲓⲣⲱⲙⲓ	ⲉⲛⲁⲛⲓⲣⲱⲙⲓ
ⲉⲛⲁⲣⲉϩⲁⲛⲙⲁⲥⲧⲓⲅⲝ	ⲉⲛⲁⲣⲉϩⲁⲛⲙⲁⲥⲧⲓⲅⲝ
ⲉⲛⲁⲣⲉϯⲁⲗⲟⲩ	ⲉⲛⲁⲣⲉϯⲁⲗⲟⲩ
ⲉⲛⲁⲣⲉⲛⲓⲇⲉⲙⲱⲛ	ⲉⲛⲁⲣⲉⲛⲓⲇⲁⲓⲙⲱⲛ
ⲉⲛⲁⲣⲉⲡⲉϥⲙⲁ	ⲉⲛⲁⲣⲉⲡⲉϥⲙⲁ
ⲉⲛⲁⲣⲉⲧⲉⲛⲙⲟⲕⲙⲉⲕ	ⲉⲛⲁⲣⲉⲧⲉⲛⲙⲟⲕⲙⲉⲕ
ⲉⲛⲁⲩ	ⲉⲛⲁⲩ
ⲉⲛⲁⲩϣϫⲉⲙϫⲟⲙ	ⲉⲛⲁⲩϣϫⲉⲙϫⲟⲙ
ⲉⲛⲁⲩⲉⲣⲁⲕⲟⲗⲟⲩⲑⲓⲛ	ⲉⲛⲁⲩⲉⲣⲁⲕⲟⲗⲟⲩⲑⲓⲛ
ⲉⲛⲁⲩⲙⲟϣⲓ	ⲉⲛⲁⲩⲙⲟϣⲓ
ⲉⲛⲁⲩⲙⲟⲛⲓ	ⲉⲛⲁⲩⲙⲟⲛⲓ
ⲉⲛⲁⲩⲟⲩⲱⲙ	ⲉⲛⲁⲩⲟⲩⲱⲙ
ⲉⲛⲁⲩⲭⲏ	ⲉⲛⲁⲩⲭⲏ
ⲉⲛⲁⲫⲛⲟⲩϯ	ⲉⲛⲁⲫⲛⲟⲩϯ
ⲉⲛⲉ	ⲉⲛⲉ
ⲉⲛⲉϥⲙⲁϣϫ	ⲉⲛⲉϥⲙⲁϣϫ
ⲉⲛⲉϥⲙⲁⲑⲏⲧⲏⲥ	ⲉⲛⲉϥⲙⲁⲑⲏⲧⲏⲥ
ⲉⲛⲉϩ	ⲉⲛⲉϩ
ⲉⲛⲉⲁⲩⲥⲟⲩⲱⲛⲥ	ⲉⲛⲉⲁⲩⲥⲟⲩⲱⲛⲥ
ⲉⲛⲉⲛϫⲓϫ	ⲉⲛⲉⲛϫⲓϫ
ⲉⲛⲉⲣϩⲱⲃ	ⲉⲛⲉⲣϩⲱⲃ
ⲉⲛⲉⲣⲥⲩⲛⲕⲣⲓⲛⲓⲛ	ⲉⲛⲉⲣⲥⲩⲛⲕⲣⲓⲛⲓⲛ
ⲉⲛⲏ	ⲉⲛⲏ
ⲉⲛⲑⲏⲛⲟⲩ	ⲉⲛⲑⲏⲛⲟⲩ
ⲉⲛⲓϫⲣⲟϫ	ⲉⲛⲓϫⲣⲟϫ
ⲉⲛⲓϯⲙⲓ	ⲉⲛⲓϯⲙⲓ
ⲉⲛⲓⲉϣⲁⲩ	ⲉⲛⲓⲉϣⲁⲩ
ⲉⲛⲓⲉⲑⲛⲟⲥ	ⲉⲛⲓⲉⲑⲛⲟⲥ
ⲉⲛⲓⲑⲟϣ	ⲉⲛⲓⲑⲟϣ
ⲉⲛⲓⲓⲟϩⲓ	ⲉⲛⲓⲓⲟϩⲓ
ⲉⲛⲓⲕⲱⲙⲟⲡⲟⲗⲓⲥ	ⲉⲛⲓⲕⲱⲙⲟⲡⲟⲗⲓⲥ
ⲉⲛⲓⲙⲁ	ⲉⲛⲓⲙⲁ
ⲉⲛⲓⲙⲁⲑⲏⲧⲏⲥ	ⲉⲛⲓⲙⲁⲑⲏⲧⲏⲥ
ⲉⲛⲓⲟⲩⲏⲃ	ⲉⲛⲓⲟⲩⲏⲃ
ⲉⲛⲓⲟⲩⲟϯ	ⲉⲛⲓⲟⲩⲟϯ
ⲉⲛⲓⲣⲓⲣ	ⲉⲛⲓⲣⲓⲣ
ⲉⲛⲓⲣⲱⲙⲓ	ⲉⲛⲓⲣⲱⲙⲓ
ⲉⲛⲓⲥⲁ	ⲉⲛⲓⲥⲁ
ⲉⲛⲓⲫⲏⲟⲩⲓ	ⲉⲛⲓⲫⲏⲟⲩⲓ
ⲉⲛⲟϩⲉⲙ	ⲉⲛⲟϩⲉⲙ
ⲉⲛⲟⲭⲟⲥ	ⲉⲛⲟⲭⲟⲥ
ⲉⲛⲧⲟⲗⲏ	ⲉⲛⲧⲟⲗⲏ
ⲉⲛⲭⲁⲓ	ⲉⲛⲭⲁⲓ
ⲉⲝⲁⲡⲓⲛⲁ	ⲉⲝⲁⲡⲓⲛⲁ
ⲉⲝⲉⲥⲧⲓⲛ	ⲉⲝⲉⲥⲧⲓⲛ
ⲉⲟϩⲓ	ⲉⲟϩⲓ
ⲉⲟⲩ	ⲉⲟⲩ
ⲉⲟⲩϣⲃⲱⲧ	ⲉⲟⲩϣⲃⲱⲧ
ⲉⲟⲩϩⲃⲟⲥ	ⲉⲟⲩϩⲃⲟⲥ
ⲉⲟⲩⲁⲓ	ⲉⲟⲩⲁⲓ
ⲉⲟⲩⲃⲁⲗ	ⲉⲟⲩⲃⲁⲗ
ⲉⲟⲩⲃⲉⲗⲗⲉ	ⲉⲟⲩⲃⲉⲗⲗⲉ
ⲉⲟⲩⲃⲱ	ⲉⲟⲩⲃⲱ
ⲉⲟⲩⲉⲙⲱⲓⲕ	ⲉⲟⲩⲉⲙⲱⲓⲕ
ⲉⲟⲩⲏⲓ	ⲉⲟⲩⲏⲓ
ⲉⲟⲩⲕⲟⲩϫⲓ	ⲉⲟⲩⲕⲟⲩϫⲓ
ⲉⲟⲩⲙⲁ	ⲉⲟⲩⲙⲁ
ⲉⲟⲩⲙⲏϣ	ⲉⲟⲩⲙⲏϣ
ⲉⲟⲩⲙⲱⲓⲧ	ⲉⲟⲩⲙⲱⲓⲧ
ⲉⲟⲩⲟϩ	ⲉⲟⲩⲟϩ
ⲉⲟⲩⲟⲙⲟⲩ	ⲉⲟⲩⲟⲙⲟⲩ
ⲉⲟⲩⲟⲛ	ⲉⲟⲩⲟⲛ
ⲉⲟⲩⲟⲛϩⲧ	ⲉⲟⲩⲟⲛϩⲧ
ⲉⲟⲩⲟⲛⲟⲩⲭⲟϩ	ⲉⲟⲩⲟⲛⲟⲩⲭⲟϩ
ⲉⲟⲩⲟⲛⲧⲉϥ	ⲉⲟⲩⲟⲛⲧⲉϥ
ⲉⲟⲩⲟⲛⲧⲱⲧⲉⲛ	ⲉⲟⲩⲟⲛⲧⲱⲧⲉⲛ
ⲉⲟⲩⲟⲩϫⲁⲓ	ⲉⲟⲩⲟⲩϫⲁⲓ
ⲉⲟⲩⲡⲟⲣⲛⲓⲁ	ⲉⲟⲩⲡⲟⲣⲛⲉⲓⲁ
ⲉⲟⲩⲡⲟⲣⲛⲟⲥ	ⲉⲟⲩⲡⲟⲣⲛⲟⲥ
ⲉⲟⲩⲥⲁϫⲓ	ⲉⲟⲩⲥⲁϫⲓ
ⲉⲟⲩⲱⲓⲕ	ⲉⲟⲩⲱⲓⲕ
ⲉⲟⲩⲱⲙ	ⲉⲟⲩⲱⲙ
ⲉⲡϣⲁϥⲉ	ⲉⲡϣⲁϥⲉ
ⲉⲡϣⲱⲓ	ⲉⲡϣⲱⲓ
ⲉⲡϩⲏⲧ	ⲉⲡϩⲏⲧ
ⲉⲡϭⲟⲓⲥ	ⲉⲡϭⲟⲓⲥ
ⲉⲡⲁⲓϩⲱⲃ	ⲉⲡⲁⲓϩⲱⲃ
ⲉⲡⲁⲓϯⲙⲓ	ⲉⲡⲁⲓϯⲙⲓ
ⲉⲡⲁⲣⲁⲛ	ⲉⲡⲁⲣⲁⲛ
ⲉⲡⲉϥϩⲏⲧ	ⲉⲡⲉϥϩⲏⲧ
ⲉⲡⲉϥⲏⲓ	ⲉⲡⲉϥⲏⲓ
ⲉⲡⲉϥⲣⲁⲛ	ⲉⲡⲉϥⲣⲁⲛ
ⲉⲡⲉϥⲣⲁⲥϯ	ⲉⲡⲉϥⲣⲁⲥϯ
ⲉⲡⲉϥⲥⲱⲙⲁ	ⲉⲡⲉϥⲥⲱⲙⲁ
ⲉⲡⲉⲕⲏⲓ	ⲉⲡⲉⲕⲏⲓ
ⲉⲡⲉⲥⲏⲓ	ⲉⲡⲉⲥⲏⲓ
ⲉⲡⲉⲥⲏⲧ	ⲉⲡⲉⲥⲏⲧ
ⲉⲡⲉⲧⲣⲟⲥ	ⲉⲡⲉⲧⲣⲟⲥ
ⲉⲡⲏⲓ	ⲉⲡⲏⲓ
ⲉⲡⲓϫⲟⲓ	ⲉⲡⲓϫⲟⲉⲓ
ⲉⲡⲓϯⲙⲓ	ⲉⲡⲓϯⲙⲓ
ⲉⲡⲓⲉⲣⲫⲉⲓ	ⲉⲡⲓⲉⲣⲫⲉⲓ
ⲉⲡⲓⲉⲩⲁⲅⲅⲗⲓⲟⲛ	ⲉⲡⲓⲉⲩⲁⲅⲅⲉⲗⲓⲟⲛ
ⲉⲡⲓⲏⲓ	ⲉⲡⲓⲏⲓ
ⲉⲡⲓⲑⲁⲛⲁⲧⲓⲟⲥ	ⲉⲡⲓⲑⲁⲛⲁⲧⲓⲟⲥ
ⲉⲡⲓⲑⲩⲙⲓⲁ	ⲉⲡⲓⲑⲩⲙⲓⲁ
ⲉⲡⲓⲓⲃ	ⲉⲡⲓⲓⲃ
ⲉⲡⲓⲕⲁⲑⲉⲣⲙⲁ	ⲉⲡⲓⲕⲁⲑⲉⲣⲙⲁ
ⲉⲡⲓⲕⲟⲥⲙⲟⲥ	ⲉⲡⲓⲕⲟⲥⲙⲟⲥ
ⲉⲡⲓⲙⲁ	ⲉⲡⲓⲙⲁ
ⲉⲡⲓⲙⲏϣ	ⲉⲡⲓⲙⲏϣ
ⲉⲡⲓⲙⲩⲥⲧⲏⲣⲓⲟⲛ	ⲉⲡⲓⲙⲩⲥⲧⲏⲣⲓⲟⲛ
ⲉⲡⲓⲟⲩⲁⲓ	ⲉⲡⲓⲟⲩⲁⲓ
ⲉⲡⲓⲡⲛⲉⲩⲙⲁ	ⲉⲡⲓⲡⲛⲉⲩⲙⲁ
ⲉⲡⲓⲥⲁϫⲓ	ⲉⲡⲓⲥⲁϫⲓ
ⲉⲡⲓⲥⲧⲟⲗⲏ	ⲉⲡⲓⲥⲧⲟⲗⲏ
ⲉⲡⲓⲧⲱⲟⲩ	ⲉⲡⲓⲧⲱⲟⲩ
ⲉⲡⲓⲭⲣⲱⲙ	ⲉⲡⲓⲭⲣⲱⲙ
ⲉⲡⲓⲱⲛϧ	ⲉⲡⲓⲱⲛϧ
ⲉⲡⲟⲩⲏⲓ	ⲉⲡⲟⲩⲏⲓ
ⲉⲡⲟⲩⲛⲁϩϯ	ⲉⲡⲟⲩⲛⲁϩϯ
ⲉⲡⲥⲁϫⲓ	ⲉⲡⲥⲁϫⲓ
ⲉⲡⲧⲁⲕⲟ	ⲉⲡⲧⲁⲕⲟ
ⲉⲡⲧⲏⲣϥ	ⲉⲡⲧⲏⲣϥ
ⲉⲡⲧⲱⲟⲩ	ⲉⲡⲧⲱⲟⲩ
ⲉⲡⲫⲁⲑⲁ	ⲉⲡⲫⲁⲑⲁ
ⲉⲣ	ⲉⲣ
ⲉⲣϣⲁⲓ	ⲉⲣϣⲁⲓ
ⲉⲣϣⲃⲉ	ⲉⲣϣⲃⲉ
ⲉⲣϣⲓϣⲓ	ⲉⲣϣⲓϣⲓ
ⲉⲣϣⲟⲣⲡ	ⲉⲣϣⲟⲣⲡ
ⲉⲣϣⲫⲏⲣ	ⲉⲣϣⲫⲏⲣ
ⲉⲣϣⲫⲏⲣⲓ	ⲉⲣϣⲫⲏⲣⲓ
ⲉⲣϧⲁⲉ	ⲉⲣϧⲁⲉ
ⲉⲣϧⲏⲓⲃⲓ	ⲉⲣϧⲏⲓⲃⲓ
ⲉⲣϩⲁⲗ	ⲉⲣϩⲁⲗ
ⲉⲣϩⲏⲃⲓ	ⲉⲣϩⲏⲃⲓ
ⲉⲣϩⲟϯ	ⲉⲣϩⲟϯ
ⲉⲣϩⲟⲩⲓⲧ	ⲉⲣϩⲟⲩⲓⲧ
ⲉⲣϩⲱⲃ	ⲉⲣϩⲱⲃ
ⲉⲣϫⲓⲛⲓⲟⲣ	ⲉⲣϫⲓⲛⲓⲟⲣ
ⲉⲣⲁⲑⲉⲧⲓⲛ	ⲉⲣⲁⲑⲉⲧⲓⲛ
ⲉⲣⲁⲕⲟⲗⲟⲩⲑⲓⲛ	ⲉⲣⲁⲕⲟⲗⲟⲩⲑⲓⲛ
ⲉⲣⲁⲛⲁⲅⲕⲁⲍⲓⲛ	ⲉⲣⲁⲛⲁⲅⲕⲁⲍⲓⲛ
ⲉⲣⲁⲛⲁⲭⲱⲣⲓⲛ	ⲉⲣⲁⲛⲁⲭⲱⲣⲓⲛ
ⲉⲣⲁⲛⲉⲭⲉⲥⲑⲉ	ⲉⲣⲁⲛⲉⲭⲉⲥⲑⲉ
ⲉⲣⲁⲡⲟⲧⲁⲍⲉⲥⲑⲉ	ⲉⲣⲁⲡⲟⲧⲁⲍⲉⲥⲑⲉ
ⲉⲣⲁⲥⲡⲁⲍⲉⲥⲑⲉ	ⲉⲣⲁⲥⲡⲁⲍⲉⲥⲑⲉ
ⲉⲣⲁⲧ	ⲉⲣⲁⲧ
ⲉⲣⲁⲧϥ	ⲉⲣⲁⲧϥ
ⲉⲣⲁⲧϩⲙⲟⲩ	ⲉⲣⲁⲧϩⲙⲟⲩ
ⲉⲣⲁⲧⲟⲩ	ⲉⲣⲁⲧⲟⲩ
ⲉⲣⲁⲧⲟⲩⲧⲁϩ	ⲉⲣⲁⲧⲟⲩⲧⲁϩ
ⲉⲣⲁⲧⲥ	ⲉⲣⲁⲧⲥ
ⲉⲣⲃⲱⲕ	ⲉⲣⲃⲱⲕ
ⲉⲣⲇⲁⲙⲁⲍⲓⲛ	ⲉⲣⲇⲁⲙⲁⲍⲓⲛ
ⲉⲣⲇⲓⲁⲕⲣⲓⲛⲓⲛ	ⲉⲣⲇⲓⲁⲕⲣⲓⲛⲓⲛ
ⲉⲣⲇⲓⲁⲕⲱⲛ	ⲉⲣⲇⲓⲁⲕⲱⲛ
ⲉⲣⲇⲟⲕⲓⲙⲁⲍⲓⲛ	ⲉⲣⲇⲟⲕⲓⲙⲁⲍⲓⲛ
ⲉⲣⲉ	ⲉⲣⲉ
ⲉⲣⲉϩⲁⲛⲥⲁⲛⲇⲁⲗⲓⲟⲛ	ⲉⲣⲉϩⲁⲛⲥⲁⲛⲇⲁⲗⲓⲟⲛ
ⲉⲣⲉϫⲓϫ	ⲉⲣⲉϫⲓϫ
ⲉⲣⲉⲓⲁⲕⲱⲃⲟⲥ	ⲉⲣⲉⲓⲁⲕⲱⲃⲟⲥ
ⲉⲣⲉⲛⲉϥϩⲃⲱⲥ	ⲉⲣⲉⲛⲉϥϩⲃⲱⲥ
ⲉⲣⲉⲛⲟⲩϫⲓϫ	ⲉⲣⲉⲛⲟⲩϫⲓϫ
ⲉⲣⲉⲟⲩⲟⲛ	ⲉⲣⲉⲟⲩⲟⲛ
ⲉⲣⲉⲡⲉϥϩⲏⲧ	ⲉⲣⲉⲡⲉϥϩⲏⲧ
ⲉⲣⲉⲡⲉϥⲉⲣϣⲓϣⲓ	ⲉⲣⲉⲡⲉϥⲉⲣϣⲓϣⲓ
ⲉⲣⲉⲡⲓⲣⲱⲙⲓ	ⲉⲣⲉⲡⲓⲣⲱⲙⲓ
ⲉⲣⲉⲡⲓⲧⲓⲙⲁⲛ	ⲉⲣⲉⲡⲓⲧⲓⲙⲁⲛ
ⲉⲣⲉⲡⲧⲁⲓⲟ	ⲉⲣⲉⲡⲧⲁⲓⲟ
ⲉⲣⲉⲣⲱϥ	ⲉⲣⲉⲣⲱϥ
ⲉⲣⲉⲧⲉϥϫⲓϫ	ⲉⲣⲉⲧⲉϥϫⲓϫ
ⲉⲣⲉⲧⲉⲛϯⲟⲩⲱ	ⲉⲣⲉⲧⲉⲛϯⲟⲩⲱ
ⲉⲣⲉⲧⲉⲛⲉϫⲓⲙⲓ	ⲉⲣⲉⲧⲉⲛⲉϫⲓⲙⲓ
ⲉⲣⲉⲧⲉⲛⲉⲉⲙⲥⲑⲏⲛⲟⲩ	ⲉⲣⲉⲧⲉⲛⲉⲉⲙⲥⲑⲏⲛⲟⲩ
ⲉⲣⲉⲧⲉⲛⲉⲥⲟϥ	ⲉⲣⲉⲧⲉⲛⲉⲥⲟϥ
ⲉⲣⲉⲧⲉⲛⲕⲱⲣϥ	ⲉⲣⲉⲧⲉⲛⲕⲱⲣϥ
ⲉⲣⲉⲧⲉⲛⲛⲁϣⲉ	ⲉⲣⲉⲧⲉⲛⲛⲁϣⲉ
ⲉⲣⲉⲧⲉⲛⲛⲏⲟⲩ	ⲉⲣⲉⲧⲉⲛⲛⲏⲟⲩ
ⲉⲣⲉⲧⲉⲛⲟⲛⲓ	ⲉⲣⲉⲧⲉⲛⲟⲛⲓ
ⲉⲣⲉⲧⲓⲛ	ⲉⲣⲉⲧⲓⲛ
ⲉⲣⲉⲩⲑⲏⲛⲓⲛ	ⲉⲣⲉⲩⲑⲏⲛⲓⲛ
ⲉⲣⲏⲟⲩ	ⲉⲣⲏⲩ
ⲉⲣⲏⲩ	ⲉⲣⲏⲩ
ⲉⲣⲑⲉⲁⲧⲣⲟⲛ	ⲉⲣⲑⲉⲁⲧⲣⲟⲛ
ⲉⲣⲕⲁⲧⲏⲅⲟⲣⲓⲛ	ⲉⲣⲕⲁⲧⲏⲅⲟⲣⲓⲛ
ⲉⲣⲕⲁⲩⲙⲁ	ⲉⲣⲕⲁⲩⲙⲁ
ⲉⲣⲕⲗⲏⲣⲟⲛⲟⲙⲓⲛ	ⲉⲣⲕⲗⲏⲣⲟⲛⲟⲙⲓⲛ
ⲉⲣⲕⲗⲏⲣⲟⲛⲟⲙⲟⲥ	ⲉⲣⲕⲗⲏⲣⲟⲛⲟⲙⲟⲥ
ⲉⲣⲙⲁⲥⲧⲓⲅⲅⲟⲓⲛ	ⲉⲣⲙⲁⲥⲧⲓⲅⲅⲟⲓⲛ
ⲉⲣⲙⲉⲗⲓⲛ	ⲉⲣⲙⲉⲗⲓⲛ
ⲉⲣⲙⲉⲧⲁⲛⲟⲓⲛ	ⲉⲣⲙⲉⲧⲁⲛⲟⲓⲛ
ⲉⲣⲛⲏⲥⲧⲉⲩⲓⲛ	ⲉⲣⲛⲏⲥⲧⲉⲩⲓⲛ
ⲉⲣⲛⲓϣϯ	ⲉⲣⲛⲓϣϯ
ⲉⲣⲛⲟϥⲣⲓ	ⲉⲣⲛⲟϥⲣⲓ
ⲉⲣⲛⲟⲃⲓ	ⲉⲣⲛⲟⲃⲓ
ⲉⲣⲛⲱⲓⲕ	ⲉⲣⲛⲱⲓⲕ
ⲉⲣⲟ	ⲉⲣⲟ
ⲉⲣⲟϥ	ⲉⲣⲟϥ
ⲉⲣⲟⲓ	ⲉⲣⲟⲓ
ⲉⲣⲟⲕ	ⲉⲣⲟⲕ
ⲉⲣⲟⲛ	ⲉⲣⲟⲛ
ⲉⲣⲟⲥ	ⲉⲣⲟⲥ
ⲉⲣⲟⲩ	ⲉⲣⲟⲩ
ⲉⲣⲟⲩⲣⲟ	ⲉⲣⲟⲩⲣⲟ
ⲉⲣⲟⲩⲱ	ⲉⲣⲟⲩⲱ
ⲉⲣⲟⲩⲱⲓⲛⲓ	ⲉⲣⲟⲩⲱⲓⲛⲓ
ⲉⲣⲡⲓⲣⲁⲍⲓⲛ	ⲉⲣⲡⲓⲣⲁⲍⲓⲛ
ⲉⲣⲡⲣⲟⲥⲉⲩⲭⲉⲥⲑⲉ	ⲉⲣⲡⲣⲟⲥⲉⲩⲭⲉⲥⲑⲉ
ⲉⲣⲡⲣⲟⲫⲏⲧⲉⲩⲓⲛ	ⲉⲣⲡⲣⲟⲫⲏⲧⲉⲩⲓⲛ
ⲉⲣⲣⲁⲙⲁⲟ	ⲉⲣⲣⲁⲙⲁⲟ
ⲉⲣⲥⲁⲃⲉ	ⲉⲣⲥⲁⲃⲉ
ⲉⲣⲥⲉⲃⲉⲥⲑⲉ	ⲉⲣⲥⲉⲃⲉⲥⲑⲉ
ⲉⲣⲥⲕⲁⲛⲇⲁⲗⲓⲍⲉⲥⲑⲉ	ⲉⲣⲥⲕⲁⲛⲇⲁⲗⲓⲍⲉⲥⲑⲉ
ⲉⲣⲥⲟϫ	ⲉⲣⲥⲟϫ
ⲉⲣⲥⲩⲛⲕⲣⲓⲛⲓⲛ	ⲉⲣⲥⲩⲛⲕⲣⲓⲛⲓⲛ
ⲉⲣⲧⲓⲙⲁⲛ	ⲉⲣⲧⲓⲙⲁⲛ
ⲉⲣⲧⲟⲗⲙⲁⲛ	ⲉⲣⲧⲟⲗⲙⲁⲛ
ⲉⲣⲫⲁϧⲣⲓ	ⲉⲣⲫⲁϧⲣⲓ
ⲉⲣⲫⲉⲓ	ⲉⲣⲫⲉⲓ
ⲉⲣⲭⲣⲓⲁ	ⲉⲣⲭⲣⲓⲁ
ⲉⲣⲱ	ⲉⲣⲱ
ⲉⲣⲱϥ	ⲉⲣⲱϥ
ⲉⲣⲱϯ	ⲉⲣⲱϯ
ⲉⲣⲱⲟⲩ	ⲉⲣⲱⲟⲩ
ⲉⲣⲱⲧⲉⲛ	ⲉⲣⲱⲧⲉⲛ
ⲉⲥϧⲉⲟⲩϫⲱⲙ	ⲉⲥϧⲉⲟⲩϫⲱⲙ
ⲉⲥϧⲏⲙ	ⲉⲥϧⲏⲙ
ⲉⲥϫⲱ	ⲉⲥϫⲱ
ⲉⲥⲁϫⲓ	ⲉⲥⲁϫⲓ
ⲉⲥⲉ	ⲉⲥⲉ
ⲉⲥⲉϣⲱⲡⲓ	ⲉⲥⲉϣⲱⲡⲓ
ⲉⲥⲉⲙⲓ	ⲉⲥⲉⲙⲓ
ⲉⲥⲉⲛⲟⲩ	ⲉⲥⲉⲛⲟⲩ
ⲉⲥⲉⲣϧⲏⲓⲃⲓ	ⲉⲥⲉⲣϧⲏⲓⲃⲓ
ⲉⲥⲉⲣⲡⲉϥⲥⲁϫⲓ	ⲉⲥⲉⲣⲡⲉϥⲥⲁϫⲓ
ⲉⲥⲏⲧ	ⲉⲥⲏⲧ
ⲉⲥⲓⲙⲱⲛ	ⲉⲥⲓⲙⲱⲛ
ⲉⲥⲓⲛⲓ	ⲉⲥⲓⲛⲓ
ⲉⲥⲕⲉⲛ	ⲉⲥⲕⲉⲛ
ⲉⲥⲕⲉⲛⲡⲓⲙⲱⲓⲧ	ⲉⲥⲕⲉⲛⲡⲓⲙⲱⲓⲧ
ⲉⲥⲕⲉⲛⲫⲓⲟⲙ	ⲉⲥⲕⲉⲛⲫⲓⲟⲙ
ⲉⲥⲙⲟⲛⲓ	ⲉⲥⲙⲟⲛⲓ
ⲉⲥⲟϣ	ⲉⲥⲟϣ
ⲉⲥⲟϥϥ	ⲉⲥⲟϥϥ
ⲉⲥⲟⲓ	ⲉⲥⲟⲓ
ⲉⲥⲟⲛϩϥ	ⲉⲥⲟⲛϩϥ
ⲉⲥⲱⲟⲩ	ⲉⲥⲱⲟⲩ
ⲉⲥⲱⲧⲉⲙ	ⲉⲥⲱⲧⲉⲙ
ⲉⲧ	ⲉⲧ
ⲉⲧϣⲏϣ	ⲉⲧϣⲏϣ
ⲉⲧϣⲏⲕ	ⲉⲧϣⲏⲕ
ⲉⲧϣⲏⲗ	ⲉⲧϣⲏⲗ
ⲉⲧϣⲟⲡ	ⲉⲧϣⲟⲡ
ⲉⲧϣⲱⲛⲓ	ⲉⲧϣⲱⲛⲓ
ⲉⲧϣⲱⲡ	ⲉⲧϣⲱⲡ
ⲉⲧϥⲱϫⲓ	ⲉⲧϥⲱϫⲓ
ⲉⲧϧⲉⲛⲛⲓⲫⲏⲟⲩⲓ	ⲉⲧϧⲉⲛⲛⲓⲫⲏⲟⲩⲓ
ⲉⲧϧⲉⲛⲡⲓϧⲉⲙⲥ	ⲉⲧϧⲉⲛⲡⲓϧⲉⲙⲥ
ⲉⲧϧⲉⲛⲧ	ⲉⲧϧⲉⲛⲧ
ⲉⲧϩⲉⲙⲥⲓ	ⲉⲧϩⲉⲙⲥⲓ
ⲉⲧϩⲏ	ⲉⲧϩⲏ
ⲉⲧϩⲏⲡ	ⲉⲧϩⲏⲡ
ⲉⲧϩⲓϫⲉⲛⲡⲓⲕⲁϩⲓ	ⲉⲧϩⲓϫⲉⲛⲡⲓⲕⲁϩⲓ
ⲉⲧϩⲓⲥⲕⲉⲛⲡⲓⲙⲱⲓⲧ	ⲉⲧϩⲓⲥⲕⲉⲛⲡⲓⲙⲱⲓⲧ
ⲉⲧϩⲱⲟⲩ	ⲉⲧϩⲱⲟⲩ
ⲉⲧϫⲏⲕ	ⲉⲧϫⲏⲕ
ⲉⲧϫⲟⲣ	ⲉⲧϫⲟⲣ
ⲉⲧϭⲓ	ⲉⲧϭⲓ
ⲉⲧϭⲟⲥⲓ	ⲉⲧϭⲟⲥⲓ
ⲉⲧϯ	ⲉⲧϯ
ⲉⲧⲁ	ⲉⲧⲁ
ⲉⲧⲁϥϣⲁⲓ	ⲉⲧⲁϥϣⲁⲓ
ⲉⲧⲁϥϣⲉ	ⲉⲧⲁϥϣⲉ
ⲉⲧⲁϥϣⲧⲉⲣⲑⲱⲣϥ	ⲉⲧⲁϥϣⲧⲉⲣⲑⲱⲣϥ
ⲉⲧⲁϥϣⲱⲡⲓ	ⲉⲧⲁϥϣⲱⲡⲓ
ⲉⲧⲁϥϥⲓⲁϩⲟⲙ	ⲉⲧⲁϥϥⲓⲁϩⲟⲙ
ⲉⲧⲁϥϥⲟϫϥ	ⲉⲧⲁϥϥⲟϫϥ
ⲉⲧⲁϥϧⲱⲛⲧ	ⲉⲧⲁϥϧⲱⲛⲧ
ⲉⲧⲁϥϩⲉⲓ	ⲉⲧⲁϥϩⲉⲓ
ⲉⲧⲁϥϩⲉⲙⲥⲓ	ⲉⲧⲁϥϩⲉⲙⲥⲓ
ⲉⲧⲁϥϩⲓ	ⲉⲧⲁϥϩⲓ
ⲉⲧⲁϥϩⲓⲑⲁϥ	ⲉⲧⲁϥϩⲓⲑⲁϥ
ⲉⲧⲁϥϩⲓⲧⲟⲧϥ	ⲉⲧⲁϥϩⲓⲧⲟⲧϥ
ⲉⲧⲁϥϩⲕⲟ	ⲉⲧⲁϥϩⲕⲟ
ⲉⲧⲁϥϫⲟⲥ	ⲉⲧⲁϥϫⲟⲥ
ⲉⲧⲁϥϫⲟⲩϣⲧ	ⲉⲧⲁϥϫⲟⲩϣⲧ
ⲉⲧⲁϥϭⲓ	ⲉⲧⲁϥϭⲓ
ⲉⲧⲁϥϯⲣⲉⲛⲟⲩ	ⲉⲧⲁϥϯⲣⲉⲛⲟⲩ
ⲉⲧⲁϥⲁⲙⲟⲛⲓ	ⲉⲧⲁϥⲁⲙⲟⲛⲓ
ⲉⲧⲁϥⲉⲙⲓ	ⲉⲧⲁϥⲉⲙⲓ
ⲉⲧⲁϥⲉⲣϣⲟⲣⲡ	ⲉⲧⲁϥⲉⲣϣⲟⲣⲡ
ⲉⲧⲁϥⲉⲣⲁⲡⲟⲧⲁⲍⲉⲥⲑⲉ	ⲉⲧⲁϥⲉⲣⲁⲡⲟⲧⲁⲍⲉⲥⲑⲉ
ⲉⲧⲁϥⲉⲣⲟⲩⲱ	ⲉⲧⲁϥⲉⲣⲟⲩⲱ
ⲉⲧⲁϥⲉⲣⲫⲙⲉⲩⲓ	ⲉⲧⲁϥⲉⲣⲫⲙⲉⲩⲓ
ⲉⲧⲁϥⲉⲣⲭⲣⲓⲁ	ⲉⲧⲁϥⲣⲭⲣⲉⲓⲁ
ⲉⲧⲁϥⲑⲣⲉⲛⲓⲕⲟⲩⲣ	ⲉⲧⲁϥⲑⲣⲉⲛⲓⲕⲟⲩⲣ
ⲉⲧⲁϥⲓ	ⲉⲧⲁϥⲓ
ⲉⲧⲁϥⲓⲣⲓ	ⲉⲧⲁϥⲓⲣⲓ
ⲉⲧⲁϥⲕⲟⲧϥ	ⲉⲧⲁϥⲕⲟⲧϥ
ⲉⲧⲁϥⲙⲟϣⲓ	ⲉⲧⲁϥⲙⲟϣⲓ
ⲉⲧⲁϥⲙⲟⲩϯ	ⲉⲧⲁϥⲙⲟⲩϯ
ⲉⲧⲁϥⲛⲁⲩ	ⲉⲧⲁϥⲛⲁⲩ
ⲉⲧⲁϥⲟϩⲓ	ⲉⲧⲁϥⲟϩⲓ
ⲉⲧⲁϥⲥⲉⲃⲧⲱⲧϥ	ⲉⲧⲁϥⲥⲉⲃⲧⲱⲧϥ
ⲉⲧⲁϥⲥⲉⲧⲡⲉϥϩⲃⲟⲥ	ⲉⲧⲁϥⲥⲉⲧⲡⲉϥϩⲃⲟⲥ
ⲉⲧⲁϥⲥⲓⲛⲓ	ⲉⲧⲁϥⲥⲓⲛⲓ
ⲉⲧⲁϥⲥⲟⲙⲥ	ⲉⲧⲁϥⲥⲟⲙⲥ
ⲉⲧⲁϥⲥⲟⲩⲧⲱⲛⲥ	ⲉⲧⲁϥⲥⲟⲩⲧⲱⲛⲥ
ⲉⲧⲁϥⲥⲣⲉⲙⲣⲱⲙϥ	ⲉⲧⲁϥⲥⲣⲉⲙⲣⲱⲙϥ
ⲉⲧⲁϥⲥⲱⲧⲉⲙ	ⲉⲧⲁϥⲥⲱⲧⲉⲙ
ⲉⲧⲁϥⲧⲁⲟⲩⲟⲓ	ⲉⲧⲁϥⲧⲁⲟⲩⲟⲓ
ⲉⲧⲁϥⲧⲏⲓϥ	ⲉⲧⲁϥⲧⲏⲓϥ
ⲉⲧⲁϥⲧⲱⲛϥ	ⲉⲧⲁϥⲧⲱⲛϥ
ⲉⲧⲁϥⲫⲟⲛϩϥ	ⲉⲧⲁϥⲫⲟⲛϩϥ
ⲉⲧⲁϥⲭⲁⲩ	ⲉⲧⲁϥⲭⲁⲩ
ⲉⲧⲁϥⲱϣ	ⲉⲧⲁϥⲱϣ
ⲉⲧⲁϥⲱⲕⲉⲙ	ⲉⲧⲁϥⲱⲕⲉⲙ
ⲉⲧⲁⲏⲣⲱⲇⲏⲥ	ⲉⲧⲁⲏⲣⲱⲇⲏⲥ
ⲉⲧⲁⲓϯⲙⲁϯ	ⲉⲧⲁⲓϯⲙⲁϯ
ⲉⲧⲁⲓϯⲱⲙⲥ	ⲉⲧⲁⲓϯⲱⲙⲥ
ⲉⲧⲁⲓⲉⲗⲧⲉϥⲛⲁϩⲃⲓ	ⲉⲧⲁⲓⲉⲗⲧⲉϥⲛⲁϩⲃⲓ
ⲉⲧⲁⲓⲓ	ⲉⲧⲁⲓⲓ
ⲉⲧⲁⲓⲟⲩⲛⲟⲩ	ⲉⲧⲁⲓⲟⲩⲛⲟⲩ
ⲉⲧⲁⲓⲡⲁⲣⲁⲃⲟⲗⲏ	ⲉⲧⲁⲓⲡⲁⲣⲁⲃⲟⲗⲏ
ⲉⲧⲁⲓⲫⲁϣⲟⲩ	ⲉⲧⲁⲓⲫⲁϣⲟⲩ
ⲉⲧⲁⲕⲓ	ⲉⲧⲁⲕⲓ
ⲉⲧⲁⲕⲟⲛ	ⲉⲧⲁⲕⲟⲛ
ⲉⲧⲁⲕⲥⲁϩⲟⲩⲓ	ⲉⲧⲁⲕⲥⲁϩⲟⲩⲓ
ⲉⲧⲁⲙⲁϩⲓ	ⲉⲧⲁⲙⲁϩⲓ
ⲉⲧⲁⲙⲉⲧⲁⲑⲛⲁϩϯ	ⲉⲧⲁⲙⲉⲧⲁⲑⲛⲁϩϯ
ⲉⲧⲁⲙⲱⲩⲥⲏⲥ	ⲉⲧⲁⲙⲱⲩⲥⲏⲥ
ⲉⲧⲁⲟⲩⲉϩⲟⲟⲩ	ⲉⲧⲁⲟⲩⲉϩⲟⲟⲩ
ⲉⲧⲁⲡϩⲏⲧ	ⲉⲧⲁⲡϩⲏⲧ
ⲉⲧⲁⲡϭⲟⲓⲥ	ⲉⲧⲁⲡϭⲟⲓⲥ
ⲉⲧⲁⲣⲉⲧⲉⲛϭⲓⲧϥ	ⲉⲧⲁⲣⲉⲧⲉⲛϭⲓⲧϥ
ⲉⲧⲁⲣⲉⲧⲉⲛⲧⲏⲓⲥ	ⲉⲧⲁⲣⲉⲧⲉⲛⲧⲏⲓⲥ
ⲉⲧⲁⲣⲟⲩϩⲓ	ⲉⲧⲁⲣⲟⲩϩⲓ
ⲉⲧⲁⲥϣⲉ	ⲉⲧⲁⲥϣⲉ
ⲉⲧⲁⲥϭⲟⲥϫⲉⲥ	ⲉⲧⲁⲥϭⲟⲥϫⲉⲥ
ⲉⲧⲁⲥⲉⲣϩⲟϯ	ⲉⲧⲁⲥⲉⲣϩⲟϯ
ⲉⲧⲁⲥⲉⲣⲫⲁⲓ	ⲉⲧⲁⲥⲉⲣⲫⲁⲓ
ⲉⲧⲁⲥⲓ	ⲉⲧⲁⲥⲓ
ⲉⲧⲁⲥⲥⲱⲧⲉⲙ	ⲉⲧⲁⲥⲥⲱⲧⲉⲙ
ⲉⲧⲁⲩϣⲁⲛⲥⲁⲧⲥ	ⲉⲧⲁⲩϣⲁⲛⲥⲁⲧⲥ
ⲉⲧⲁⲩϣⲁⲛⲥⲱⲧⲉⲙ	ⲉⲧⲁⲩϣⲁⲛⲥⲱⲧⲉⲙ
ⲉⲧⲁⲩϣⲱⲕⲓ	ⲉⲧⲁⲩϣⲱⲕⲓ
ⲉⲧⲁⲩϫⲉⲙϥ	ⲉⲧⲁⲩϫⲉⲙϥ
ⲉⲧⲁⲩϫⲟⲩϣⲧ	ⲉⲧⲁⲩϫⲟⲩϣⲧ
ⲉⲧⲁⲩϭⲓⲥⲓ	ⲉⲧⲁⲩϭⲓⲥⲓ
ⲉⲧⲁⲩϭⲟϫⲓ	ⲉⲧⲁⲩϭⲟϫⲓ
ⲉⲧⲁⲩϯⲥⲃⲱ	ⲉⲧⲁⲩϯⲥⲃⲱ
ⲉⲧⲁⲩⲁⲓϥ	ⲉⲧⲁⲩⲁⲓϥ
ⲉⲧⲁⲩⲉⲙⲓ	ⲉⲧⲁⲩⲉⲙⲓ
ⲉⲧⲁⲩⲉⲣϫⲓⲛⲓⲟⲣ	ⲉⲧⲁⲩⲉⲣϫⲓⲛⲓⲟⲣ
ⲉⲧⲁⲩⲉⲣⲟⲩⲱ	ⲉⲧⲁⲩⲉⲣⲟⲩⲱ
ⲉⲧⲁⲩⲓ	ⲉⲧⲁⲩⲓ
ⲉⲧⲁⲩⲛⲁⲩ	ⲉⲧⲁⲩⲛⲁⲩ
ⲉⲧⲁⲩⲥⲁⲧϥ	ⲉⲧⲁⲩⲥⲁⲧϥ
ⲉⲧⲁⲩⲥⲁⲧⲟⲩ	ⲉⲧⲁⲩⲥⲁⲧⲟⲩ
ⲉⲧⲁⲩⲥⲓϯ	ⲉⲧⲁⲩⲥⲓϯ
ⲉⲧⲁⲩⲥⲱⲧⲉⲙ	ⲉⲧⲁⲩⲥⲱⲧⲉⲙ
ⲉⲧⲁⲩⲧⲏⲓⲥ	ⲉⲧⲁⲩⲧⲏⲓⲥ
ⲉⲧⲁⲩⲭⲁⲡⲓⲙⲏϣ	ⲉⲧⲁⲩⲭⲁⲡⲓⲙⲏϣ
ⲉⲧⲁⲫϯ	ⲉⲧⲁⲫⲛⲟⲩϯ
ⲉⲧⲁⲫⲛⲟⲩϯ	ⲉⲧⲁⲫⲛⲟⲩϯ
ⲉⲧⲁⲫⲣⲏ	ⲉⲧⲁⲡⲣⲏ
ⲉⲧⲉ	ⲉⲧⲉ
ⲉⲧⲉϥϫⲱ	ⲉⲧⲉϥϫⲱ
ⲉⲧⲉϥⲃⲁⲕⲓ	ⲉⲧⲉϥⲃⲁⲕⲓ
ⲉⲧⲉϥⲛⲁⲧⲁϩⲟϥ	ⲉⲧⲉϥⲛⲁⲧⲁϩⲟϥ
ⲉⲧⲉϥⲥϩⲓⲙⲓ	ⲉⲧⲉϥⲥϩⲓⲙⲓ
ⲉⲧⲉϩⲑⲏⲟⲩ	ⲉⲧⲉϩⲑⲏⲟⲩ
ⲉⲧⲉⲓⲏⲥⲟⲩⲥ	ⲉⲧⲉⲓⲏⲥⲟⲩⲥ
ⲉⲧⲉⲙⲙⲁⲩ	ⲉⲧⲉⲙⲙⲁⲩ
ⲉⲧⲉⲙⲙⲟⲛⲙⲏϣ	ⲉⲧⲉⲙⲙⲟⲛⲙⲏϣ
ⲉⲧⲉⲙⲡⲁⲣⲉⲡⲟⲩϥⲉⲛⲧ	ⲉⲧⲉⲙⲡⲁⲣⲉⲡⲟⲩϥⲉⲛⲧ
ⲉⲧⲉⲙⲡⲁⲧⲉϩⲗⲓ	ⲉⲧⲉⲙⲡⲁⲧⲉϩⲗⲓ
ⲉⲧⲉⲙⲡⲉϩⲗⲓ	ⲉⲧⲉⲙⲡⲉϩⲗⲓ
ⲉⲧⲉⲙⲡⲉϭⲓⲧ	ⲉⲧⲉⲙⲡⲉϭⲓⲧ
ⲉⲧⲉⲙⲡⲉⲃⲁⲗ	ⲉⲧⲉⲙⲡⲉⲃⲁⲗ
ⲉⲧⲉⲙⲡⲕⲱϯ	ⲉⲧⲉⲙⲡⲕⲱϯ
ⲉⲧⲉⲙⲡⲟⲩϣϫⲉⲙϫⲟⲙ	ⲉⲧⲉⲙⲡⲟⲩϣϫⲉⲙϫⲟⲙ
ⲉⲧⲉⲛ	ⲉⲧⲉⲛ
ⲉⲧⲉⲛϥⲛⲁϣⲉⲡⲑⲏⲛⲟⲩ	ⲉⲧⲉⲛϥⲛⲁϣⲉⲡⲑⲏⲛⲟⲩ
ⲉⲧⲉⲛϥⲟⲩⲃⲏⲛ	ⲉⲧⲉⲛϥⲟⲩⲃⲏⲛ
ⲉⲧⲉⲛϯⲙⲡϣⲁ	ⲉⲧⲉⲛϯⲙⲡϣⲁ
ⲉⲧⲉⲛⲁⲓ	ⲉⲧⲉⲛⲁⲓ
ⲉⲧⲉⲛⲑⲱⲧⲉⲛ	ⲉⲧⲉⲛⲑⲱⲧⲉⲛ
ⲉⲧⲉⲛⲓⲇⲉⲙⲱⲛ	ⲉⲧⲉⲛⲓⲇⲁⲓⲙⲱⲛ
ⲉⲧⲉⲛⲓⲙⲩⲥⲧⲏⲣⲓⲟⲛ	ⲉⲧⲉⲛⲓⲙⲩⲥⲧⲏⲣⲓⲟⲛ
ⲉⲧⲉⲛⲛⲁⲉⲣⲉⲧⲓⲛ	ⲉⲧⲉⲛⲛⲁⲉⲣⲉⲧⲓⲛ
ⲉⲧⲉⲛⲟⲩϥ	ⲉⲧⲉⲛⲟⲩϥ
ⲉⲧⲉⲛⲟⲩⲕ	ⲉⲧⲛⲟⲩⲕ
ⲉⲧⲉⲛⲥϣⲟⲡ	ⲉⲧⲉⲛⲥϣⲟⲡ
ⲉⲧⲉⲛⲥⲁϫⲓ	ⲉⲧⲉⲛⲥⲁϫⲓ
ⲉⲧⲉⲟⲩⲟⲛ	ⲉⲧⲉⲟⲩⲟⲛ
ⲉⲧⲉⲟⲩⲧⲁⲓⲟ	ⲉⲧⲉⲟⲩⲧⲁⲓⲟ
ⲉⲧⲉⲡⲁϣⲏⲣⲓ	ⲉⲧⲉⲡⲁϣⲏⲣⲓ
ⲉⲧⲉⲡⲉϥϩⲱⲃ	ⲉⲧⲉⲡⲉϥϩⲱⲃ
ⲉⲧⲉⲡⲓⲣⲱⲙⲓ	ⲉⲧⲉⲡⲓⲣⲱⲙⲓ
ⲉⲧⲉⲣⲁⲉⲣⲉⲧⲓⲛ	ⲉⲧⲉⲣⲁⲉⲣⲉⲧⲓⲛ
ⲉⲧⲉⲣⲟⲕ	ⲉⲧⲉⲣⲟⲕ
ⲉⲧⲉⲣⲡⲟⲣⲛⲉⲩⲓⲛ	ⲉⲧⲉⲣⲡⲟⲣⲛⲉⲩⲓⲛ
ⲉⲧⲉⲧⲉϥⲥⲩⲛⲏⲑⲓⲁ	ⲉⲧⲉⲧⲉϥⲥⲩⲛⲏⲑⲓⲁ
ⲉⲧⲉⲧⲉⲛⲓⲣⲓ	ⲉⲧⲉⲧⲉⲛⲓⲣⲓ
ⲉⲧⲉⲧⲉⲛⲛⲁϣⲉ	ⲉⲧⲉⲧⲛⲛⲁϣⲉ
ⲉⲧⲉⲧⲉⲛⲛⲁϣⲓ	ⲉⲧⲉⲧⲉⲛⲛⲁϣⲓ
ⲉⲧⲉⲧⲉⲛⲛⲁⲉⲣⲉⲧⲓⲛ	ⲉⲧⲉⲧⲉⲛⲛⲁⲉⲣⲉⲧⲓⲛ
ⲉⲧⲉⲧⲉⲛⲟⲓ	ⲉⲧⲉⲧⲉⲛⲟⲓ
ⲉⲧⲉⲧⲉⲛⲡⲁⲣⲁⲇⲟⲥⲓⲥ	ⲉⲧⲉⲧⲉⲛⲡⲁⲣⲁⲇⲟⲥⲓⲥ
ⲉⲧⲉⲫⲁⲓ	ⲉⲧⲉⲫⲁⲓ
ⲉⲧⲉⲫⲏ	ⲉⲧⲉⲫⲏ
ⲉⲧⲏⲓϥ	ⲉⲧⲏⲓϥ
ⲉⲧⲑⲣⲟ	ⲉⲧⲑⲣⲟ
ⲉⲧⲓ	ⲉⲧⲓ
ⲉⲧⲕⲱϯ	ⲉⲧⲕⲱϯ
ⲉⲧⲟϩⲓ	ⲉⲧⲟϩⲓ
ⲉⲧⲟⲧ	ⲉⲧⲟⲧ
ⲉⲧⲟⲧϥ	ⲉⲧⲟⲧϥ
ⲉⲧⲟⲧⲟⲩ	ⲉⲧⲟⲧⲟⲩ
ⲉⲧⲟⲩϫⲟⲙ	ⲉⲧⲟⲩϫⲟⲙ
ⲉⲧⲟⲩϫⲱ	ⲉⲧⲟⲩϫⲱ
ⲉⲧⲟⲩⲃⲟⲓ	ⲉⲧⲟⲩⲃⲟⲓ
ⲉⲧⲟⲩⲛⲁϫⲉⲟⲩⲁ	ⲉⲧⲟⲩⲛⲁϫⲉⲟⲩⲁ
ⲉⲧⲟⲩⲥⲩⲛⲁⲅⲱⲅⲏ	ⲉⲧⲟⲩⲥⲩⲛⲁⲅⲱⲅⲏ
ⲉⲧⲥϧⲏⲟⲩⲧ	ⲉⲧⲥϧⲏⲟⲩⲧ
ⲉⲧⲥⲁϧⲟⲩⲛ	ⲉⲧⲥⲁϧⲟⲩⲛ
ⲉⲧⲥⲁⲃⲟⲗ	ⲉⲧⲥⲁⲃⲟⲗ
ⲉⲧⲥⲁⲉϧⲣⲏⲓ	ⲉⲧⲥⲁⲉϧⲣⲏⲓ
ⲉⲧⲥⲓϯ	ⲉⲧⲥⲓϯ
ⲉⲧⲥⲟ	ⲉⲧⲥⲟ
ⲉⲧⲥⲱϥ	ⲉⲧⲥⲱϥ
ⲉⲧⲥⲱⲟⲩⲛ	ⲉⲧⲥⲱⲟⲩⲛ
ⲉⲧⲧϩⲉⲙⲕⲏⲟⲩⲧ	ⲉⲧⲧϩⲉⲙⲕⲏⲟⲩⲧ
ⲉⲧⲧⲟⲓ	ⲉⲧⲧⲟⲓ
ⲉⲧⲧⲥⲟ	ⲉⲧⲧⲥⲟ
ⲉⲧⲧⲱϫⲓ	ⲉⲧⲧⲱϫⲓ
ⲉⲧⲧⲱⲙⲓ	ⲉⲧⲧⲱⲙⲓ
ⲉⲧⲫⲉ	ⲉⲧⲫⲉ
ⲉⲧⲭⲏ	ⲉⲧⲭⲏ
ⲉⲧⲭⲱⲣⲁ	ⲉⲧⲭⲱⲣⲁ
ⲉⲩϣⲑⲉⲣⲑⲱⲣ	ⲉⲩϣⲑⲉⲣⲑⲱⲣ
ⲉⲩϣⲗⲏⲗⲟⲩⲓ	ⲉⲩϣⲗⲏⲗⲟⲩⲓ
ⲉⲩϥⲁⲓ	ⲉⲩϥⲁⲓ
ⲉⲩϩⲉⲙⲥⲓ	ⲉⲩϩⲉⲙⲥⲓ
ⲉⲩϩⲏⲗ	ⲉⲩϩⲏⲗ
ⲉⲩϩⲓϣⲛⲉ	ⲉⲩϩⲓϣⲛⲉ
ⲉⲩϩⲓⲡⲓϫⲟⲓ	ⲉⲩϩⲓⲡⲓϫⲟⲉⲓ
ⲉⲩϫⲉⲟⲩⲁ	ⲉⲩϫⲉⲟⲩⲁ
ⲉⲩϫⲫⲓⲟ	ⲉⲩϫⲫⲓⲟ
ⲉⲩϫⲱ	ⲉⲩϫⲱ
ⲉⲩϭⲟϫⲓ	ⲉⲩϭⲟϫⲓ
ⲉⲩϯⲣⲁⲛ	ⲉⲩϯⲣⲁⲛ
ⲉⲩϯⲥⲃⲱ	ⲉⲩϯⲥⲃⲱ
ⲉⲩⲁⲅⲅⲉⲗⲓⲟⲛ	ⲉⲩⲁⲅⲅⲉⲗⲓⲟⲛ
ⲉⲩⲁⲅⲅⲗⲓⲟⲛ	ⲉⲩⲁⲅⲅⲉⲗⲓⲟⲛ
ⲉⲩⲁⲙⲟⲛⲓ	ⲉⲩⲁⲙⲟⲛⲓ
ⲉⲩⲉ	ⲉⲩⲉ
ⲉⲩⲉϣⲱⲡⲓ	ⲉⲩⲉϣⲱⲡⲓ
ⲉⲩⲉϯ	ⲉⲩⲉϯ
ⲉⲩⲉⲉⲣϧⲁⲉ	ⲉⲩⲉⲉⲣϧⲁⲉ
ⲉⲩⲉⲙⲟⲩϯ	ⲉⲩⲉⲙⲟⲩϯ
ⲉⲩⲉⲣϣⲟ	ⲉⲩⲉⲣϣⲟ
ⲉⲩⲉⲣⲡⲓⲣⲁⲍⲓⲛ	ⲉⲩⲉⲣⲡⲓⲣⲁⲍⲓⲛ
ⲉⲩⲉⲣⲥⲉⲃⲉⲥⲑⲉ	ⲉⲩⲉⲣⲥⲉⲃⲉⲥⲑⲉ
ⲉⲩⲉⲭⲁⲩ	ⲉⲩⲉⲭⲁⲩ
ⲉⲩⲑⲟⲗⲉⲃ	ⲉⲩⲑⲟⲗⲉⲃ
ⲉⲩⲕⲉⲣⲓⲁ	ⲉⲩⲕⲉⲣⲓⲁ
ⲉⲩⲕⲱϯ	ⲉⲩⲕⲱϯ
ⲉⲩⲙⲁ	ⲉⲩⲙⲁ
ⲉⲩⲙⲉϩ	ⲉⲩⲙⲉϩ
ⲉⲩⲙⲉⲧⲙⲉⲑⲣⲉ	ⲉⲩⲙⲉⲧⲙⲉⲑⲣⲉ
ⲉⲩⲙⲟϣⲓ	ⲉⲩⲙⲟϣⲓ
ⲉⲩⲙⲟⲩϯ	ⲉⲩⲙⲟⲩϯ
ⲉⲩⲛⲁϣⲓ	ⲉⲩⲛⲁϣⲓ
ⲉⲩⲛⲁϯϩⲁⲡ	ⲉⲩⲛⲁϯϩⲁⲡ
ⲉⲩⲛⲁⲉⲣϣⲟⲣⲡ	ⲉⲩⲛⲁⲉⲣϣⲟⲣⲡ
ⲉⲩⲛⲁⲩ	ⲉⲩⲛⲁⲩ
ⲉⲩⲛⲏⲟⲩ	ⲉⲩⲛⲏⲟⲩ
ⲉⲩⲟⲛⲓ	ⲉⲩⲟⲛⲓ
ⲉⲩⲟⲩⲟⲃϣ	ⲉⲩⲟⲩⲟⲃϣ
ⲉⲩⲟⲩⲱⲛϩ	ⲉⲩⲟⲩⲱⲛϩ
ⲉⲩⲣⲓⲙⲓ	ⲉⲩⲣⲓⲙⲓ
ⲉⲩⲥⲁⲣⲝ	ⲉⲩⲥⲁⲣⲝ
ⲉⲩⲥⲓⲛⲓⲱⲟⲩ	ⲉⲩⲥⲓⲛⲓⲱⲟⲩ
ⲉⲩⲥⲟⲃϯ	ⲉⲩⲥⲟⲃϯ
ⲉⲩⲥⲱⲧⲉⲙ	ⲉⲩⲥⲱⲧⲉⲙ
ⲉⲩⲧϩⲉⲙⲕⲏⲟⲩⲧ	ⲉⲩⲧϩⲉⲙⲕⲏⲟⲩⲧ
ⲉⲩⲫⲟⲣⲓ	ⲉⲩⲫⲟⲣⲉⲓ
ⲉⲩⲱⲟⲩ	ⲉⲩⲱⲟⲩ
ⲉⲫⲁⲓ	ⲉⲫⲁⲓ
ⲉⲫⲏ	ⲉⲫⲏ
ⲉⲫⲓⲟⲙ	ⲉⲫⲓⲟⲙ
ⲉⲫⲗⲏⲟⲩ	ⲉⲫⲗⲏⲟⲩ
ⲉⲫⲙⲟⲩ	ⲉⲫⲙⲟⲩ
ⲉⲫⲛⲟⲩϯ	ⲉⲫⲛⲟⲩϯ
ⲉⲫⲟⲩⲱϣ	ⲉⲫⲟⲩⲱϣ
ⲉⲭⲁⲛⲟⲃⲓ	ⲉⲭⲁⲛⲟⲃⲓ
ⲉⲭⲱ	ⲉⲭⲱ
ⲉⲱⲛ	ⲉⲱⲛ
ⲋ	ⲋ
ⲍ	ⲍ
ⲍⲉⲃⲉⲇⲉⲟⲥ	ⲍⲉⲃⲉⲇⲉⲟⲥ
ⲏ	ϩⲏ
ⲏⲓ	ⲏⲓ
ⲏⲗⲓⲁⲥ	ⲏⲗⲓⲁⲥ
ⲏⲣⲡ	ⲏⲣⲡ
ⲏⲣⲱⲇⲏⲥ	ⲏⲣⲱⲇⲏⲥ
ⲏⲣⲱⲇⲓⲁⲛⲟⲥ	ⲏⲣⲱⲇⲓⲁⲛⲟⲥ
ⲏⲣⲱⲇⲓⲁⲥ	ⲏⲣⲱⲇⲓⲁⲥ
ⲏⲥⲁⲓⲁⲥ	ⲏⲥⲁⲓⲁⲥ
ⲑ	ⲧ
ⲑⲁ	ⲑⲁ
ⲑⲁϣ	ⲑⲁϣ
ⲑⲁϩⲉⲙ	ⲑⲁϩⲉⲙ
ⲑⲁⲇⲇⲉⲟⲥ	ⲑⲁⲇⲇⲉⲟⲥ
ⲑⲁⲓ	ⲑⲁⲓ
ⲑⲁⲙⲓⲉ	ⲑⲁⲙⲓⲉ
ⲑⲁⲙⲓⲉⲟⲩⲇⲓⲡⲛⲟⲛ	ⲑⲁⲙⲓⲉⲟⲩⲇⲓⲡⲛⲟⲛ
ⲑⲁⲙⲓⲟ	ⲑⲁⲙⲓⲟ
ⲑⲁⲛⲁⲓ	ⲑⲁⲛⲁⲓ
ⲑⲃⲁ	ⲑⲃⲁ
ⲑⲉⲃⲓⲟ	ⲑⲉⲃⲓⲟ
ⲑⲏ	ⲑⲏ
ⲑⲏⲙ	ⲑⲏⲙ
ⲑⲏⲛⲓ	ⲑⲏⲛⲓ
ⲑⲏⲛⲟⲩ	ⲑⲏⲛⲟⲩ
ⲑⲏⲟⲩ	ⲑⲏⲟⲩ
ⲑⲏⲣⲓⲟⲛ	ⲑⲏⲣⲓⲟⲛ
ⲑⲙⲁⲓⲉ	ⲑⲙⲁⲓⲉ
ⲑⲙⲁⲓⲏⲟⲩⲧ	ⲑⲙⲁⲓⲏⲟⲩⲧ
ⲑⲙⲏⲓ	ⲑⲙⲏⲓ
ⲑⲟϣ	ⲑⲟϣ
ⲑⲟⲗⲉⲃ	ⲑⲟⲗⲉⲃ
ⲑⲣ	ⲑⲣ
ⲑⲣⲉ	ⲑⲣⲉ
ⲑⲣⲟ	ⲑⲣⲟ
ⲑⲣⲟⲩ	ⲑⲣⲟⲩ
ⲑⲱϩⲥ	ⲑⲱϩⲥ
ⲑⲱⲗⲉⲃ	ⲑⲱⲗⲉⲃ
ⲑⲱⲙ	ⲑⲱⲙ
ⲑⲱⲙⲁⲥ	ⲑⲱⲙⲁⲥ
ⲑⲱⲛ	ⲑⲱⲛ
ⲑⲱⲟⲩϯ	ⲑⲱⲟⲩϯ
ⲑⲱⲟⲩⲓ	ⲑⲱⲟⲩⲓ
ⲑⲱⲣⲡ	ⲑⲱⲣⲡ
ⲑⲱⲧ	ⲑⲱⲧ
ⲓ	ⲓ
ⲓⲁ	ⲓⲁ
ⲓⲁⲓⲣⲟⲥ	ⲓⲁⲓⲣⲟⲥ
ⲓⲁⲕⲱⲃⲟⲥ	ⲓⲁⲕⲱⲃⲟⲥ
ⲓⲁⲣⲟ	ⲓⲁⲣⲟ
ⲓⲃ	ⲓⲃ
ⲓⲉ	ⲓⲉ
ⲓⲉⲣⲓⲭⲱ	ⲓⲉⲣⲓⲭⲱ
ⲓⲉⲣⲟⲥⲁⲗⲏⲙ	ⲓⲉⲣⲟⲥⲁⲗⲏⲙ
ⲓⲉⲫⲟⲩⲱⲓ	ⲓⲉⲫⲟⲩⲱⲓ
ⲓⲏⲥⲟⲩⲥ	ⲓⲏⲥⲟⲩⲥ
ⲓⲗⲏⲙ	ϩⲓⲉⲣⲟⲩⲥⲁⲗⲏⲙ
ⲓⲛⲓ	ⲓⲛⲓ
ⲓⲟϩⲓ	ⲓⲟϩⲓ
ⲓⲟⲙ	ⲓⲟⲙ
ⲓⲟⲣⲇⲁⲛⲏⲥ	ⲓⲟⲣⲇⲁⲛⲏⲥ
ⲓⲟⲩⲇⲁⲓ	ⲓⲟⲩⲇⲁⲓ
ⲓⲟⲩⲇⲁⲥ	ⲓⲟⲩⲇⲁⲥ
ⲓⲟⲩⲇⲉⲁ	ⲓⲟⲩⲇⲉⲁ
ⲓⲣⲓ	ⲓⲣⲓ
ⲓⲥ	ⲓⲥ
ⲓⲥϫⲉ	ⲓⲥϫⲉ
ⲓⲥϫⲉⲛ	ⲓⲥϫⲉⲛ
ⲓⲥϫⲉⲛϩⲓⲫⲟⲩⲉⲓ	ⲓⲥϫⲉⲛϩⲓⲫⲟⲩⲉⲓ
ⲓⲥϫⲉⲛⲉⲧⲁⲫⲁⲓ	ⲓⲥϫⲉⲛⲉⲧⲁⲫⲁⲓ
ⲓⲥϫⲉⲛⲧⲁⲙⲉⲧⲁⲗⲟⲩ	ⲓⲥϫⲉⲛⲧⲁⲙⲉⲧⲁⲗⲟⲩ
ⲓⲥϫⲉⲛⲧⲁⲣⲭⲏ	ⲓⲥϫⲉⲛⲧⲁⲣⲭⲏ
ⲓⲥϫⲉⲟⲩⲟⲛ	ⲓⲥϫⲉⲟⲩⲟⲛ
ⲓⲧⲁ	ⲓⲧⲁ
ⲓⲧⲉ	ⲓⲧⲉ
ⲓⲱⲁⲛⲛⲏⲥ	ⲓⲱⲁⲛⲛⲏⲥ
ⲓⲱⲥⲏⲧⲟⲥ	ⲓⲱⲥⲏⲧⲟⲥ
ⲓⲱⲧ	ⲓⲱⲧ
ⲕ	ⲕ
ⲕϫⲱ	ⲕϫⲱ
ⲕⲁϩⲓ	ⲕⲁϩⲓ
ⲕⲁϯ	ⲕⲁϯ
ⲕⲁⲑⲉⲇⲣⲁ	ⲕⲁⲑⲉⲇⲣⲁ
ⲕⲁⲕⲓⲁ	ⲕⲁⲕⲓⲁ
ⲕⲁⲕⲥⲉϩⲧ	ⲕⲁⲕⲥⲉϩⲧ
ⲕⲁⲗⲱⲥ	ⲕⲁⲗⲱⲥ
ⲕⲁⲛ	ⲕⲁⲛ
ⲕⲁⲛⲁⲛⲉⲟⲥ	ⲕⲁⲛⲁⲛⲉⲟⲥ
ⲕⲁⲧⲁ	ⲕⲁⲧⲁ
ⲕⲁⲧⲁϯⲡⲁⲣⲁⲇⲟⲥⲓⲥ	ⲕⲁⲧⲁϯⲡⲁⲣⲁⲇⲟⲥⲓⲥ
ⲕⲁⲧⲁⲟⲩϭⲓⲥⲓ	ⲕⲁⲧⲁⲟⲩϭⲓⲥⲓ
ⲕⲁⲧⲁⲡⲉϥϧⲓⲥⲓ	ⲕⲁⲧⲁⲡⲉϥϧⲓⲥⲓ
ⲕⲁⲧⲁⲡⲓϩⲙⲟⲧ	ⲕⲁⲧⲁⲡⲓϩⲙⲟⲧ
ⲕⲁⲧⲁⲣ	ⲕⲁⲧⲁⲣ
ⲕⲁⲧⲁⲣⲱⲙⲓ	ⲕⲁⲧⲁⲣⲱⲙⲓ
ⲕⲁⲧⲁⲫⲣⲏϯ	ⲕⲁⲧⲁⲫⲣⲏϯ
ⲕⲁⲫⲁⲣⲛⲁⲟⲩⲙ	ⲕⲁⲫⲁⲣⲛⲁⲟⲩⲙ
ⲕⲉ	ⲕⲉ
ⲕⲉⲓ	ⲕⲉⲓ
ⲕⲉⲗⲓ	ⲕⲉⲗⲓ
ⲕⲉⲛⲧⲉ	ⲕⲉⲛⲧⲉ
ⲕⲉⲟⲩⲁⲓ	ⲕⲉⲟⲩⲁⲓ
ⲕⲉⲥⲁⲣⲓⲁ	ⲕⲉⲥⲁⲣⲓⲁ
ⲕⲉⲥⲉⲛϯ	ⲕⲉⲥⲉⲛϯ
ⲕⲉⲧⲁⲩⲧⲁ	ⲕⲉⲧⲁⲩⲧⲁ
ⲕⲏⲛ	ⲕⲏⲛ
ⲕⲏⲫⲁ	ⲕⲏⲫⲁ
ⲕⲟⲓ	ⲕⲟⲓ
ⲕⲟⲗⲩⲃⲓⲥⲧⲏⲥ	ⲕⲟⲗⲩⲃⲓⲥⲧⲏⲥ
ⲕⲟⲣϥ	ⲕⲟⲣϥ
ⲕⲟⲣⲃⲁⲛ	ⲕⲟⲣⲃⲁⲛ
ⲕⲟⲥⲙⲟⲥ	ⲕⲟⲥⲙⲟⲥ
ⲕⲟⲧ	ⲕⲟⲧ
ⲕⲟⲩϫⲓ	ⲕⲟⲩϫⲓ
ⲕⲟⲩⲙ	ⲕⲟⲩⲙ
ⲕⲟⲩⲣ	ⲕⲟⲩⲣ
ⲕⲥⲱⲟⲩⲛ	ⲕⲥⲱⲟⲩⲛ
ⲕⲱϯ	ⲕⲱϯ
ⲕⲱⲃ	ⲕⲱⲃ
ⲕⲱⲙⲟⲡⲟⲗⲓⲥ	ⲕⲱⲙⲟⲡⲟⲗⲓⲥ
ⲕⲱⲣϥ	ⲕⲱⲣϥ
ⲕⲱⲣϫ	ⲕⲱⲣϫ
ⲕⲱⲧ	ⲕⲱⲧ
ⲗ	ⲗ
ⲗⲁⲕϩ	ⲗⲁⲕϩ
ⲗⲁⲟⲥ	ⲗⲁⲟⲥ
ⲗⲁⲥ	ⲗⲁⲥ
ⲗⲉϥⲗⲓϥⲓ	ⲗⲉϥⲗⲓϥⲓ
ⲗⲉⲅⲓⲱⲛ	ⲗⲉⲅⲓⲱⲛ
ⲗⲉⲩⲓ	ⲗⲉⲩⲓ
ⲗⲏⲟⲩ	ⲗⲏⲟⲩ
ⲗⲟⲓⲡⲟⲛ	ⲗⲟⲓⲡⲟⲛ
ⲗⲩⲭⲛⲓⲁ	ⲗⲩⲭⲛⲓⲁ
ⲙ	ⲙ
ⲙϥⲁⲓ	ⲙϥⲁⲓ
ⲙϩⲁⲩ	ⲙϩⲁⲩ
ⲙⲁ	ⲙⲁ
ⲙⲁϣϫ	ⲙⲁϣϫ
ⲙⲁϣⲉ	ⲙⲁϣⲉ
ⲙⲁϩⲁⲡ	ⲙⲁϩⲁⲡ
ⲙⲁϩⲇ	ⲙⲁϩⲇ
ⲙⲁϯⲟⲩⲱ	ⲙⲁϯⲟⲩⲱ
ⲙⲁⲑⲏⲧⲏⲥ	ⲙⲁⲑⲏⲧⲏⲥ
ⲙⲁⲓ	ⲙⲁⲓ
ⲙⲁⲗⲁⲕⲟⲥ	ⲙⲁⲗⲁⲕⲟⲥ
ⲙⲁⲗⲗⲟⲛ	ⲙⲁⲗⲗⲟⲛ
ⲙⲁⲛϯϩⲁⲡ	ⲙⲁⲛϯϩⲁⲡ
ⲙⲁⲛⲉⲥⲱⲟⲩ	ⲙⲁⲛⲉⲥⲱⲟⲩ
ⲙⲁⲣ	ⲙⲁⲣ
ⲙⲁⲣⲉ	ⲙⲁⲣⲉ
ⲙⲁⲣⲉϥϫⲟⲗϥ	ⲙⲁⲣⲉϥϫⲟⲗϥ
ⲙⲁⲣⲉϥⲉⲣⲥⲟϫ	ⲙⲁⲣⲉϥⲉⲣⲥⲟϫ
ⲙⲁⲣⲉϥⲙⲟⲩ	ⲙⲁⲣⲉϥⲙⲟⲩ
ⲙⲁⲣⲉϥⲥⲟⲙⲥ	ⲙⲁⲣⲉϥⲥⲟⲙⲥ
ⲙⲁⲣⲉϥⲥⲱⲧⲉⲙ	ⲙⲁⲣⲉϥⲥⲱⲧⲉⲙ
ⲙⲁⲣⲉϩⲙⲟⲩ	ⲙⲁⲣⲉϩⲙⲟⲩ
ⲙⲁⲣⲉⲛⲉⲣϣⲁⲓ	ⲙⲁⲣⲉⲛⲉⲣϣⲁⲓ
ⲙⲁⲣⲓⲁ	ⲙⲁⲣⲓⲁ
ⲙⲁⲣⲟ	ⲙⲁⲣⲟ
ⲙⲁⲣⲟⲩⲙⲉⲩⲓ	ⲙⲁⲣⲟⲩⲙⲉⲩⲓ
ⲙⲁⲣⲟⲩⲟⲩⲱⲙ	ⲙⲁⲣⲟⲩⲟⲩⲱⲙ
ⲙⲁⲥⲧⲓⲅⲝ	ⲙⲁⲥⲧⲓⲅⲝ
ⲙⲁⲧϩⲉⲙⲥⲱⲟⲩ	ⲙⲁⲧϩⲉⲙⲥⲱⲟⲩ
ⲙⲁⲧⲁⲙⲉ	ⲙⲁⲧⲁⲙⲉ
ⲙⲁⲧⲁⲙⲉⲡⲓⲟⲩⲏⲃ	ⲙⲁⲧⲁⲙⲉⲡⲓⲟⲩⲏⲃ
ⲙⲁⲧⲁⲙⲱⲟⲩ	ⲙⲁⲧⲁⲙⲱⲟⲩ
ⲙⲁⲧⲑⲉⲟⲥ	ⲙⲁⲧⲑⲉⲟⲥ
ⲙⲁⲧⲟⲩⲃⲉⲡⲓϣⲉⲙⲏⲣ	ⲙⲁⲧⲟⲩⲃⲉⲡⲓϣⲉⲙⲏⲣ
ⲙⲁⲧⲟⲩⲃⲟ	ⲙⲁⲧⲟⲩⲃⲟ
ⲙⲁⲩ	ⲙⲁⲩ
ⲙⲁⲱⲟⲩ	ⲙⲁⲱⲟⲩ
ⲙⲃⲁⲕⲓ	ⲙⲃⲁⲕⲓ
ⲙⲃⲉⲣⲓ	ⲙⲃⲉⲣⲓ
ⲙⲃⲏⲃ	ⲙⲃⲏⲃ
ⲙⲃⲓⲣ	ⲙⲃⲓⲣ
ⲙⲃⲟⲗ	ⲙⲃⲟⲗ
ⲙⲃⲟⲛ	ⲙⲃⲟⲛ
ⲙⲉϩ	ⲙⲉϩ
ⲙⲉⲑⲙⲏⲓ	ⲙⲉⲑⲙⲏⲓ
ⲙⲉⲑⲣⲉ	ⲙⲉⲑⲣⲉ
ⲙⲉⲗⲟⲥ	ⲙⲉⲗⲟⲥ
ⲙⲉⲛ	ⲙⲉⲛ
ⲙⲉⲛⲉⲛⲥⲁ	ⲙⲉⲛⲉⲛⲥⲁ
ⲙⲉⲛⲉⲛⲥⲁϩⲁⲛⲉϩⲟⲟⲩ	ⲙⲉⲛⲉⲛⲥⲁϩⲁⲛⲉϩⲟⲟⲩ
ⲙⲉⲛⲉⲛⲥⲁⲅ	ⲙⲉⲛⲉⲛⲥⲁⲅ
ⲙⲉⲛⲉⲛⲥⲁⲋ	ⲙⲉⲛⲉⲛⲥⲁⲋ
ⲙⲉⲛⲉⲛⲥⲁⲑⲣⲟⲩϯ	ⲙⲉⲛⲉⲛⲥⲁⲑⲣⲟⲩϯ
ⲙⲉⲛⲉⲛⲥⲱ	ⲙⲉⲛⲉⲛⲥⲱ
ⲙⲉⲛⲉⲛⲥⲱⲓ	ⲙⲉⲛⲉⲛⲥⲱⲓ
ⲙⲉⲛⲣⲓⲧ	ⲙⲉⲛⲣⲓⲧ
ⲙⲉⲛⲧ	ⲙⲉⲛⲧ
ⲙⲉⲧϭⲓⲛϫⲟⲛⲥ	ⲙⲉⲧϭⲓⲛϫⲟⲛⲥ
ⲙⲉⲧⲁⲑⲛⲁϩϯ	ⲙⲉⲧⲁⲑⲛⲁϩϯ
ⲙⲉⲧⲁⲗⲟⲩ	ⲙⲉⲧⲁⲗⲟⲩ
ⲙⲉⲧⲁⲛⲟⲓⲁ	ⲙⲉⲧⲁⲛⲟⲓⲁ
ⲙⲉⲧⲁⲥⲑⲉⲛⲏⲥ	ⲙⲉⲧⲁⲥⲑⲉⲛⲏⲥ
ⲙⲉⲧⲁⲧϣⲉⲙⲏⲣ	ⲙⲉⲧⲁⲧϣⲉⲙⲏⲣ
ⲙⲉⲧⲁⲧϫⲟⲙ	ⲙⲉⲧⲁⲧϫⲟⲙ
ⲙⲉⲧⲁⲧⲕⲁϯ	ⲙⲉⲧⲁⲧⲕⲁϯ
ⲙⲉⲧⲇⲟⲗⲟⲥ	ⲙⲉⲧⲇⲟⲗⲟⲥ
ⲙⲉⲧⲕⲟⲩϫⲓ	ⲙⲉⲧⲕⲟⲩϫⲓ
ⲙⲉⲧⲙⲉⲑⲣⲉ	ⲙⲉⲧⲙⲉⲑⲣⲉ
ⲙⲉⲧⲛⲁϣⲧϩⲏⲧ	ⲙⲉⲧⲛⲁϣⲧϩⲏⲧ
ⲙⲉⲧⲛⲱⲓⲕ	ⲙⲉⲧⲛⲱⲓⲕ
ⲙⲉⲧⲟⲩⲣⲟ	ⲙⲉⲧⲟⲩⲣⲟ
ⲙⲉⲧⲡⲉⲧϩⲱⲟⲩ	ⲙⲉⲧⲡⲉⲧϩⲱⲟⲩ
ⲙⲉⲧⲣⲁⲙⲁⲟ	ⲙⲉⲧⲣⲁⲙⲁⲟ
ⲙⲉⲧⲣⲉϥϯⲥⲃⲱ	ⲙⲉⲧⲣⲉϥϯⲥⲃⲱ
ⲙⲉⲧⲣⲉⲙⲣⲁⲩϣ	ⲙⲉⲧⲣⲉⲙⲣⲁⲩϣ
ⲙⲉⲧⲣⲱⲙⲓ	ⲙⲉⲧⲣⲱⲙⲓ
ⲙⲉⲧⲥⲉⲃ	ⲙⲉⲧⲥⲉⲃ
ⲙⲉⲧⲥⲟϫ	ⲙⲉⲧⲥⲟϫ
ⲙⲉⲩⲓ	ⲙⲉⲩⲓ
ⲙⲏ	ⲙⲏ
ⲙⲏϣ	ⲙⲏϣ
ⲙⲏϯ	ⲙⲏϯ
ⲙⲏⲓ	ⲙⲏⲓ
ⲙⲏⲓⲛⲓ	ⲙⲏⲓⲛⲓ
ⲙⲏⲓⲧ	ⲙⲏⲓⲧ
ⲙⲏⲓⲧⲟⲩ	ⲙⲏⲓⲧⲟⲩ
ⲙⲏⲡⲟⲧⲉ	ⲙⲏⲡⲟⲧⲉ
ⲙⲏⲣ	ⲙⲏⲣ
ⲙⲏⲧⲓ	ⲙⲏⲧⲓ
ⲙⲑⲟ	ⲙⲑⲟ
ⲙⲓⲃ	ⲙⲓⲃ
ⲙⲓⲥⲑⲱⲧⲏⲥ	ⲙⲓⲥⲑⲱⲧⲏⲥ
ⲙⲓⲥⲓ	ⲙⲓⲥⲓ
ⲙⲕⲁϩ	ⲙⲕⲁϩ
ⲙⲙⲁ	ⲙⲙⲁ
ⲙⲙⲁⲣⲓⲁ	ⲙⲙⲁⲣⲓⲁ
ⲙⲙⲁⲩ	ⲙⲙⲁⲩ
ⲙⲙⲁⲩⲁⲧ	ⲙⲙⲁⲩⲁⲧ
ⲙⲙⲁⲩⲁⲧϥ	ⲙⲙⲁⲩⲁⲧϥ
ⲙⲙⲁⲩⲁⲧⲟⲩ	ⲙⲙⲁⲩⲁⲧⲟⲩ
ⲙⲙⲁⲩⲁⲩⲧ	ⲙⲙⲁⲩⲁⲧ
ⲙⲙⲁⲩⲁⲩⲧϥ	ⲙⲙⲁⲩⲁⲧϥ
ⲙⲙⲉⲗⲟⲥ	ⲙⲙⲉⲗⲟⲥ
ⲙⲙⲉⲛⲣⲓⲧ	ⲙⲙⲉⲛⲣⲓⲧ
ⲙⲙⲉⲧⲁⲛⲟⲓⲁ	ⲙⲙⲉⲧⲁⲛⲟⲓⲁ
ⲙⲙⲉⲧⲣⲉⲙⲣⲁⲩϣ	ⲙⲙⲉⲧⲣⲉⲙⲣⲁⲩϣ
ⲙⲙⲓⲛ	ⲙⲙⲓⲛ
ⲙⲙⲓⲛⲙⲙⲟ	ⲙⲙⲓⲛⲙⲙⲟ
ⲙⲙⲓⲛⲙⲙⲟϥ	ⲙⲙⲓⲛⲙⲙⲟϥ
ⲙⲙⲓⲛⲙⲙⲟⲛ	ⲙⲙⲓⲛⲙⲙⲟⲛ
ⲙⲙⲓⲥⲓ	ⲙⲙⲓⲥⲓ
ⲙⲙⲟ	ⲙⲙⲟ
ⲙⲙⲟϥ	ⲙⲙⲟϥ
ⲙⲙⲟⲓ	ⲙⲙⲟⲓ
ⲙⲙⲟⲕ	ⲙⲙⲟⲕ
ⲙⲙⲟⲛ	ⲙⲙⲟⲛ
ⲙⲙⲟⲛϣϫⲟⲙ	ⲙⲙⲟⲛϣϫⲟⲙ
ⲙⲙⲟⲛⲛⲟⲩⲛⲓ	ⲙⲙⲟⲛⲛⲟⲩⲛⲓ
ⲙⲙⲟⲛⲛⲧⲁ	ⲙⲙⲟⲛⲛⲧⲁ
ⲙⲙⲟⲛⲛⲧⲁϥ	ⲙⲙⲟⲛⲛⲧⲁϥ
ⲙⲙⲟⲛⲧ	ⲙⲙⲟⲛⲧ
ⲙⲙⲟⲛⲧⲉ	ⲙⲙⲟⲛⲧⲉ
ⲙⲙⲟⲛⲧⲟⲩ	ⲙⲙⲟⲛⲧⲟⲩ
ⲙⲙⲟⲥ	ⲙⲙⲟⲥ
ⲙⲙⲟⲩ	ⲙⲙⲟⲩ
ⲙⲙⲟⲩⲗⲟⲛ	ⲙⲙⲟⲩⲗⲟⲛ
ⲙⲙⲱ	ⲙⲙⲱ
ⲙⲙⲱⲟⲩ	ⲙⲙⲱⲟⲩ
ⲙⲙⲱⲧⲉⲛ	ⲙⲙⲱⲧⲉⲛ
ⲙⲙⲱⲩⲥⲏⲥ	ⲙⲙⲱⲩⲥⲏⲥ
ⲙⲛ	ⲛ
ⲙⲛⲁⲓ	ⲙⲛⲁⲓ
ⲙⲟϣⲓ	ⲙⲟϣⲓ
ⲙⲟϩ	ⲙⲟϩ
ⲙⲟϫϧ	ⲙⲟϫϧ
ⲙⲟⲓ	ⲙⲟⲓ
ⲙⲟⲕϩ	ⲙⲟⲕϩ
ⲙⲟⲕⲙⲉⲕ	ⲙⲟⲕⲙⲉⲕ
ⲙⲟⲗϩ	ⲙⲟⲗϩ
ⲙⲟⲛⲓ	ⲙⲟⲛⲓ
ⲙⲟⲛⲟⲛ	ⲙⲟⲛⲟⲛ
ⲙⲟⲧⲉⲛ	ⲙⲟⲧⲉⲛ
ⲙⲟⲩ	ⲙⲟⲩ
ⲙⲟⲩϣϯ	ⲙⲟⲩϣϯ
ⲙⲟⲩϫⲧ	ⲙⲟⲩϫⲧ
ⲙⲟⲩϯ	ⲙⲟⲩϯ
ⲙⲟⲩⲗⲟⲛ	ⲙⲟⲩⲗⲟⲛ
ⲙⲟⲩⲙⲓ	ⲙⲟⲩⲙⲓ
ⲙⲟⲩⲛ	ⲙⲟⲩⲛ
ⲙⲟⲩⲥⲉⲣ	ⲙⲟⲩⲥⲉⲣ
ⲙⲡ	ⲙⲡ
ⲙⲡϣⲁ	ⲙⲡϣⲁ
ⲙⲡϭⲟⲓⲥ	ⲙⲡϭⲟⲓⲥ
ⲙⲡϭⲥ	ⲙⲡϭⲟⲉⲓⲥ
ⲙⲡⲁ	ⲙⲡⲁ
ⲙⲡⲁϥϣⲉⲡ	ⲙⲡⲁϥϣⲉⲡ
ⲙⲡⲁϥϣⲱⲡⲓ	ⲙⲡⲁϥϣⲱⲡⲓ
ⲙⲡⲁϥϭⲉⲛⲟ	ⲙⲡⲁϥϭⲉⲛⲟ
ⲙⲡⲁⲅⲅⲉⲗⲟⲥ	ⲙⲡⲁⲅⲅⲉⲗⲟⲥ
ⲙⲡⲁⲉⲣϣⲓϣⲓ	ⲙⲡⲁⲧⲉⲣϣⲓϣⲓ
ⲙⲡⲁⲓϩⲱⲃ	ⲙⲡⲁⲓϩⲱⲃ
ⲙⲡⲁⲓϫⲱⲟⲩ	ⲙⲡⲁⲓϫⲱⲟⲩ
ⲙⲡⲁⲓⲉⲣϣⲓϣⲓ	ⲙⲡⲁⲓⲉⲣϣⲓϣⲓ
ⲙⲡⲁⲓⲕⲟⲥⲙⲟⲥ	ⲙⲡⲁⲓⲕⲟⲥⲙⲟⲥ
ⲙⲡⲁⲓⲙⲁ	ⲙⲡⲁⲓⲙⲁ
ⲙⲡⲁⲓⲣⲏϯ	ⲙⲡⲁⲓⲣⲏϯ
ⲙⲡⲁⲓⲧⲱⲟⲩ	ⲙⲡⲁⲓⲧⲱⲟⲩ
ⲙⲡⲁⲣⲁⲃⲟⲗⲏ	ⲙⲡⲁⲣⲁⲃⲟⲗⲏ
ⲙⲡⲁⲣⲉ	ⲙⲡⲁⲣⲉ
ⲙⲡⲁⲣⲉϩⲗⲓ	ⲙⲡⲁⲣⲉϩⲗⲓ
ⲙⲡⲁⲧⲉ	ⲙⲡⲁⲧⲉ
ⲙⲡⲁⲧⲉⲛⲁϩϯ	ⲙⲡⲁⲧⲉⲛⲁϩϯ
ⲙⲡⲁⲧⲉⲧⲉⲛϣϫⲉⲙϫⲟⲙ	ⲙⲡⲁⲧⲉⲧⲉⲛϣϫⲉⲙϫⲟⲙ
ⲙⲡⲁⲧⲉⲧⲉⲛⲉⲙⲓ	ⲙⲡⲁⲧⲉⲧⲉⲛⲉⲙⲓ
ⲙⲡⲁⲩϩⲓⲏⲣⲡ	ⲙⲡⲁⲩϩⲓⲏⲣⲡ
ⲙⲡⲁⲩⲟⲩⲱⲙ	ⲙⲡⲁⲩⲟⲩⲱⲙ
ⲙⲡⲃ	ⲙⲡⲃ
ⲙⲡⲉ	ⲙⲡⲉ
ⲙⲡⲉϥϣϫⲉⲙϫⲟⲙ	ⲙⲡⲉϥϣϫⲉⲙϫⲟⲙ
ⲙⲡⲉϥϫⲉⲙϩⲗⲓ	ⲙⲡⲉϥϫⲉⲙϩⲗⲓ
ⲙⲡⲉϥϫⲣⲟϫ	ⲙⲡⲉϥϫⲣⲟϫ
ⲙⲡⲉϥϭⲗⲟϫ	ⲙⲡⲉϥϭⲗⲟϫ
ⲙⲡⲉϥϯⲟⲩⲧⲁϩ	ⲙⲡⲉϥϯⲟⲩⲧⲁϩ
ⲙⲡⲉϥⲃⲉⲭⲉ	ⲙⲡⲉϥⲃⲉⲭⲉ
ⲙⲡⲉϥⲏⲓ	ⲙⲡⲉϥⲏⲓ
ⲙⲡⲉϥⲓⲱⲧ	ⲙⲡⲉϥⲓⲱⲧ
ⲙⲡⲉϥⲕⲱϯ	ⲙⲡⲉϥⲕⲱϯ
ⲙⲡⲉϥⲟⲩⲱϣ	ⲙⲡⲉϥⲟⲩⲱϣ
ⲙⲡⲉϥⲥⲧⲁⲩⲣⲟⲥ	ⲙⲡⲉϥⲥⲧⲁⲩⲣⲟⲥ
ⲙⲡⲉϥⲭⲁϥ	ⲙⲡⲉϥⲭⲁϥ
ⲙⲡⲉϥⲭⲁϩⲗⲓ	ⲙⲡⲉϥⲭⲁϩⲗⲓ
ⲙⲡⲉϩⲗⲓ	ⲙⲡⲉϩⲗⲓ
ⲙⲡⲉⲕϩⲟ	ⲙⲡⲉⲕϩⲟ
ⲙⲡⲉⲕϭⲓ	ⲙⲡⲉⲕϭⲓ
ⲙⲡⲉⲕϭⲗⲟϫ	ⲙⲡⲉⲕϭⲗⲟϫ
ⲙⲡⲉⲕⲓⲱⲧ	ⲙⲡⲉⲕⲉⲓⲱⲧ
ⲙⲡⲉⲕⲙⲱⲓⲧ	ⲙⲡⲉⲕⲙⲱⲓⲧ
ⲙⲡⲉⲕⲥⲟⲛ	ⲙⲡⲉⲕⲥⲟⲛ
ⲙⲡⲉⲙⲁϣϫ	ⲙⲡⲉⲙⲁϣϫ
ⲙⲡⲉⲙⲑⲟ	ⲙⲡⲉⲙⲑⲟ
ⲙⲡⲉⲛϣϫⲉⲙϫⲟⲙ	ⲙⲡⲉⲛϣϫⲉⲙϫⲟⲙ
ⲙⲡⲉⲛϭⲟⲓⲥ	ⲙⲡⲉⲛϭⲟⲓⲥ
ⲙⲡⲉⲛⲑⲣⲉ	ⲙⲡⲉⲛⲑⲣⲉ
ⲙⲡⲉⲛⲑⲣⲉϩⲗⲓ	ⲙⲡⲉⲛⲑⲣⲉϩⲗⲓ
ⲙⲡⲉⲛⲑⲣⲉⲫⲣⲱⲙⲓ	ⲙⲡⲉⲛⲑⲣⲉⲫⲣⲱⲙⲓ
ⲙⲡⲉⲣ	ⲙⲡⲉⲣ
ⲙⲡⲉⲣϣⲉ	ⲙⲡⲉⲣϣⲉ
ⲙⲡⲉⲣϥⲱϫⲓ	ⲙⲡⲉⲣϥⲱϫⲓ
ⲙⲡⲉⲣϧⲱⲧⲉⲃ	ⲙⲡⲉⲣϧⲱⲧⲉⲃ
ⲙⲡⲉⲣϭⲓⲟⲩⲓ	ⲙⲡⲉⲣϭⲓⲟⲩⲓ
ⲙⲡⲉⲣϯϣⲑⲏⲛ	ⲙⲡⲉⲣϯϣⲑⲏⲛ
ⲙⲡⲉⲣϯϩⲁⲡ	ⲙⲡⲉⲣϯϩⲁⲡ
ⲙⲡⲉⲣϯϭⲗⲁⲕ	ⲙⲡⲉⲣϯϭⲗⲁⲕ
ⲙⲡⲉⲣⲉⲣϣⲫⲏⲣ	ⲙⲡⲉⲣⲉⲣϣⲫⲏⲣ
ⲙⲡⲉⲣⲉⲣϩⲟϯ	ⲙⲡⲉⲣⲉⲣϩⲟϯ
ⲙⲡⲉⲣⲉⲣⲙⲉⲑⲣⲉ	ⲙⲡⲉⲣⲉⲣⲙⲉⲑⲣⲉ
ⲙⲡⲉⲣⲉⲣⲛⲱⲓⲕ	ⲙⲡⲉⲣⲉⲣⲛⲱⲓⲕ
ⲙⲡⲉⲣⲥⲱⲣⲉⲙ	ⲙⲡⲉⲣⲥⲱⲣⲉⲙ
ⲙⲡⲉⲣⲧⲁϩⲛⲟ	ⲙⲡⲉⲣⲧⲁϩⲛⲟ
ⲙⲡⲉⲣⲧⲁⲙⲉ	ⲙⲡⲉⲣⲧⲁⲙⲉ
ⲙⲡⲉⲥϫⲉⲙϩⲏⲟⲩ	ⲙⲡⲉⲥϫⲉⲙϩⲏⲟⲩ
ⲙⲡⲉⲥⲙⲟⲩ	ⲙⲡⲉⲥⲙⲟⲩ
ⲙⲡⲉⲧⲁϥⲁⲓϥ	ⲙⲡⲉⲧⲁϥⲁⲓϥ
ⲙⲡⲉⲧⲁⲩⲛⲁⲩ	ⲙⲡⲉⲧⲁⲩⲛⲁⲩ
ⲙⲡⲉⲧⲉϩⲛⲉⲫⲛⲟⲩϯ	ⲙⲡⲉⲧⲉϩⲛⲉⲡⲛⲟⲩϯ
ⲙⲡⲉⲧⲉⲛⲉⲣϩⲏⲃⲓ	ⲙⲡⲉⲧⲉⲛⲉⲣϩⲏⲃⲓ
ⲙⲡⲉⲧⲉⲛⲕⲁϯ	ⲙⲡⲉⲧⲉⲛⲕⲁϯ
ⲙⲡⲉⲧⲉⲛⲙⲑⲟ	ⲙⲡⲉⲧⲉⲛⲙⲑⲟ
ⲙⲡⲉⲧⲉⲛⲛⲁϩϯ	ⲙⲡⲉⲧⲉⲛⲛⲁϩϯ
ⲙⲡⲉⲧⲉⲛⲡⲁⲣⲁⲡⲧⲱⲙⲁ	ⲙⲡⲉⲧⲉⲛⲡⲁⲣⲁⲡⲧⲱⲙⲁ
ⲙⲡⲉⲧⲉⲟⲩⲁϣϥ	ⲙⲡⲉⲧⲉⲟⲩⲁϣϥ
ⲙⲡⲉⲧⲉⲟⲩⲟⲛ	ⲙⲡⲉⲧⲉⲟⲩⲟⲛ
ⲙⲡⲉⲧⲟⲩⲛⲁⲟⲩⲟⲙϥ	ⲙⲡⲉⲧⲟⲩⲛⲁⲟⲩⲟⲙϥ
ⲙⲡⲉⲧⲟⲩⲟⲩⲁϣϥ	ⲙⲡⲉⲧⲟⲩⲟⲩⲁϣϥ
ⲙⲡⲉⲧⲣⲁ	ⲙⲡⲉⲧⲣⲁ
ⲙⲡⲉⲧⲣⲟⲥ	ⲙⲡⲉⲧⲣⲟⲥ
ⲙⲡⲉⲧⲱϣ	ⲙⲡⲉⲧⲱϣ
ⲙⲡⲓϣϫⲉⲙϫⲟⲙ	ⲙⲡⲓϣϫⲉⲙϫⲟⲙ
ⲙⲡⲓϧⲓⲣ	ⲙⲡⲓϧⲓⲣ
ⲙⲡⲓϫⲱⲣⲓ	ⲙⲡⲓϫⲱⲣⲓ
ⲙⲡⲓϭⲗⲟϫ	ⲙⲡⲓϭⲗⲟϫ
ⲙⲡⲓϯϩⲁⲡ	ⲙⲡⲓϯϩⲁⲡ
ⲙⲡⲓϯⲙⲓ	ⲙⲡⲓϯⲙⲓ
ⲙⲡⲓⲁⲗⲟⲩ	ⲙⲡⲓⲁⲗⲟⲩ
ⲙⲡⲓⲁⲣⲭⲏⲥⲩⲛⲁⲅⲱⲅⲟⲥ	ⲙⲡⲓⲁⲣⲭⲏⲥⲩⲛⲁⲅⲱⲅⲟⲥ
ⲙⲡⲓⲃⲉⲗⲗⲉ	ⲙⲡⲓⲃⲉⲗⲗⲉ
ⲙⲡⲓⲇⲱⲣⲟⲛ	ⲙⲡⲓⲇⲱⲣⲟⲛ
ⲙⲡⲓⲉ	ⲙⲡⲓⲉ
ⲙⲡⲓⲉϫⲱⲣϩ	ⲙⲡⲓⲉϫⲱⲣϩ
ⲙⲡⲓⲉⲩⲁⲅⲅⲉⲗⲓⲟⲛ	ⲙⲡⲓⲉⲩⲁⲅⲅⲉⲗⲓⲟⲛ
ⲙⲡⲓⲍ	ⲙⲡⲓⲍ
ⲙⲡⲓⲑⲏⲟⲩ	ⲙⲡⲓⲑⲏⲟⲩ
ⲙⲡⲓⲓⲃ	ⲙⲡⲓⲓⲃ
ⲙⲡⲓⲓⲟⲣⲇⲁⲛⲏⲥ	ⲙⲡⲓⲓⲟⲣⲇⲁⲛⲏⲥ
ⲙⲡⲓⲕⲟⲥⲙⲟⲥ	ⲙⲡⲓⲕⲟⲥⲙⲟⲥ
ⲙⲡⲓⲙⲏϣ	ⲙⲡⲓⲙⲏϣ
ⲙⲡⲓⲟⲥϧ	ⲙⲡⲓⲟⲥϧ
ⲙⲡⲓⲟⲩⲁⲓ	ⲙⲡⲓⲟⲩⲁⲓ
ⲙⲡⲓⲡⲁⲧϣⲉⲗⲉⲧ	ⲙⲡⲓⲡⲁⲧϣⲉⲗⲉⲧ
ⲙⲡⲓⲡⲉⲧϩⲱⲟⲩ	ⲙⲡⲓⲡⲉⲧϩⲱⲟⲩ
ⲙⲡⲓⲡⲛⲉⲩⲙⲁ	ⲙⲡⲓⲡⲛⲉⲩⲙⲁ
ⲙⲡⲓⲣⲉϥϯⲥⲃⲱ	ⲙⲡⲓⲣⲉϥϯⲥⲃⲱ
ⲙⲡⲓⲣⲱⲓⲙⲓ	ⲙⲡⲓⲣⲱⲓⲙⲓ
ⲙⲡⲓⲣⲱⲙⲓ	ⲙⲡⲓⲣⲱⲙⲓ
ⲙⲡⲓⲥⲁϫⲓ	ⲙⲡⲓⲥⲁϫⲓ
ⲙⲡⲓⲥⲁⲃⲃⲁⲧⲟⲛ	ⲙⲡⲓⲥⲁⲃⲃⲁⲧⲟⲛ
ⲙⲡⲓⲥⲏϫ	ⲙⲡⲓⲥⲏϫ
ⲙⲡⲓⲥⲏⲓⲛⲓ	ⲙⲡⲓⲥⲏⲓⲛⲓ
ⲙⲡⲓⲥⲏⲟⲩ	ⲙⲡⲓⲥⲏⲟⲩ
ⲙⲡⲓⲥⲧⲟⲥ	ⲙⲡⲓⲥⲧⲟⲥ
ⲙⲡⲓⲥⲱⲙⲁ	ⲙⲡⲓⲥⲱⲙⲁ
ⲙⲡⲓⲥⲱⲛⲧ	ⲙⲡⲓⲥⲱⲛⲧ
ⲙⲡⲓⲭⲣⲱⲙ	ⲙⲡⲓⲭⲣⲱⲙ
ⲙⲡⲓⲱⲓⲕ	ⲙⲡⲓⲱⲓⲕ
ⲙⲡⲛⲉⲩⲙⲁ	ⲙⲡⲛⲉⲩⲙⲁ
ⲙⲡⲟⲣⲛⲏ	ⲙⲡⲟⲣⲛⲏ
ⲙⲡⲟⲩϣϫⲉⲙϫⲟⲙ	ⲙⲡⲟⲩϣϫⲉⲙϫⲟⲙ
ⲙⲡⲟⲩϣⲉ	ⲙⲡⲟⲩϣⲉ
ⲙⲡⲟⲩⲕⲁϯ	ⲙⲡⲟⲩⲕⲁϯ
ⲙⲡⲟⲩⲕⲱϯ	ⲙⲡⲟⲩⲕⲱϯ
ⲙⲡⲟⲩⲙⲑⲟ	ⲙⲡⲟⲩⲙⲑⲟ
ⲙⲡⲟⲩⲛⲁⲩ	ⲙⲡⲟⲩⲛⲁⲩ
ⲙⲡⲟⲩⲣⲟ	ⲙⲡⲟⲩⲣⲟ
ⲙⲡⲣⲟⲥⲉⲩⲭⲏ	ⲙⲡⲣⲟⲥⲉⲩⲭⲏ
ⲙⲡⲥⲁⲧⲁⲛⲁⲥ	ⲙⲡⲥⲁⲧⲁⲛⲁⲥ
ⲙⲡⲧⲏⲣϥ	ⲙⲡⲧⲏⲣϥ
ⲙⲡⲭⲣⲓⲥⲧⲟⲥ	ⲙⲡⲭⲣⲓⲥⲧⲟⲥ
ⲙⲧⲟⲛ	ⲙⲧⲟⲛ
ⲙⲩⲥⲧⲏⲣⲓⲟⲛ	ⲙⲩⲥⲧⲏⲣⲓⲟⲛ
ⲙⲫϯ	ⲙⲫⲛⲟⲩϯ
ⲙⲫⲁⲓ	ⲙⲫⲁⲓ
ⲙⲫⲏ	ⲙⲫⲏ
ⲙⲫⲓⲗⲓⲡⲡⲟⲥ	ⲙⲫⲓⲗⲓⲡⲡⲟⲥ
ⲙⲫⲓⲟⲙ	ⲙⲫⲓⲟⲙ
ⲙⲫⲓⲱⲧ	ⲙⲫⲓⲱⲧ
ⲙⲫⲙⲉⲩⲓ	ⲙⲫⲙⲉⲩⲓ
ⲙⲫⲙⲟⲩ	ⲙⲫⲙⲟⲩ
ⲙⲫⲛⲟⲩϯ	ⲙⲫⲛⲟⲩϯ
ⲙⲫⲣⲏϯ	ⲙⲫⲣⲏϯ
ⲙⲫⲣⲱⲙⲓ	ⲙⲫⲣⲱⲙⲓ
ⲙⲫⲱⲓ	ⲙⲫⲱⲓ
ⲙⲱⲓⲧ	ⲙⲱⲓⲧ
ⲙⲱⲟⲩ	ⲙⲱⲟⲩ
ⲙⲱⲟⲩⲧ	ⲙⲱⲟⲩⲧ
ⲙⲱⲩⲥⲏⲥ	ⲙⲱⲩⲥⲏⲥ
ⲛ	ⲛ
ⲛϣϣⲏⲛ	ⲛϣϣⲏⲛ
ⲛϣⲁϥⲉ	ⲛϣⲁϥⲉ
ⲛϣⲁⲣ	ⲛϣⲁⲣ
ⲛϣⲉⲃⲓⲱ	ⲛϣⲉⲃⲓⲱ
ⲛϣⲉⲗⲧⲁⲙ	ⲛϣⲉⲗⲧⲁⲙ
ⲛϣⲉⲙⲏⲣ	ⲛϣⲉⲙⲏⲣ
ⲛϣⲟ	ⲛϣⲟ
ⲛϣⲟⲣⲡ	ⲛϣⲟⲣⲡ
ⲛϣⲫⲏⲣⲓ	ⲛϣⲫⲏⲣⲓ
ⲛϣⲱⲛⲓ	ⲛϣⲱⲛⲓ
ⲛϣⲱⲡⲓ	ⲛϣⲱⲡⲓ
ⲛϥⲉⲙⲓ	ⲛϥⲉⲙⲓ
ⲛϧⲏⲧ	ⲛϧⲏⲧ
ⲛϧⲏⲧϥ	ⲛϧⲏⲧϥ
ⲛϧⲏⲧⲉⲛ	ⲛϧⲏⲧⲉⲛ
ⲛϧⲏⲧⲟⲩ	ⲛϧⲏⲧⲟⲩ
ⲛϧⲓⲥⲓ	ⲛϧⲓⲥⲓ
ⲛϧⲟⲩⲛ	ⲛϧⲟⲩⲛ
ⲛϧⲣⲏⲓ	ⲛϧⲣⲏⲓ
ⲛϧⲣⲱⲟⲩ	ⲛϧⲣⲱⲟⲩ
ⲛϩⲁⲛϣϣⲏⲛ	ⲛϩⲁⲛϣϣⲏⲛ
ⲛϩⲁⲛϣⲏⲣⲓ	ⲛϩⲁⲛϣⲏⲣⲓ
ⲛϩⲁⲛϧⲁⲉⲩ	ⲛϩⲁⲛϧⲁⲉⲩ
ⲛϩⲁⲛϫⲁⲗ	ⲛϩⲁⲛϫⲁⲗ
ⲛϩⲁⲛⲁⲗⲱⲟⲩⲓ	ⲛϩⲁⲛⲁⲗⲱⲟⲩⲓ
ⲛϩⲁⲛⲁⲧⲟⲟⲩⲓ	ⲛϩⲁⲛⲁⲧⲟⲟⲩⲓ
ⲛϩⲁⲛⲉⲡⲓⲑⲁⲛⲁⲧⲓⲟⲥ	ⲛϩⲁⲛⲉⲡⲓⲑⲁⲛⲁⲧⲓⲟⲥ
ⲛϩⲁⲛⲉⲡⲓⲕⲁⲑⲉⲣⲙⲁ	ⲛϩⲁⲛⲉⲡⲓⲕⲁⲑⲉⲣⲙⲁ
ⲛϩⲁⲛⲉⲥⲱⲟⲩ	ⲛϩⲁⲛⲉⲥⲱⲟⲩ
ⲛϩⲁⲛⲕⲟⲩϫⲓ	ⲛϩⲁⲛⲕⲟⲩϫⲓ
ⲛϩⲁⲛⲙⲁⲛϯϩⲁⲡ	ⲛϩⲁⲛⲙⲁⲛϯϩⲁⲡ
ⲛϩⲁⲛⲙⲏϣ	ⲛϩⲁⲛⲙⲏϣ
ⲛϩⲁⲛⲛⲓϣϯ	ⲛϩⲁⲛⲛⲓϣϯ
ⲛϩⲁⲛⲟⲩⲟϩⲓ	ⲛϩⲁⲛⲟⲩⲟϩⲓ
ⲛϩⲁⲛⲡⲁⲣⲁⲃⲟⲗⲏ	ⲛϩⲁⲛⲡⲁⲣⲁⲃⲟⲗⲏ
ⲛϩⲁⲛⲡⲉⲇⲏⲥ	ⲛϩⲁⲛⲡⲉⲇⲏⲥ
ⲛϩⲁⲛⲡⲛⲁⲧⲓⲕⲟⲛ	ⲛϩⲁⲛⲡⲛⲁⲧⲓⲕⲟⲛ
ⲛϩⲁⲛⲡⲛⲁⲧⲓⲕⲱⲥ	ⲛϩⲁⲛⲡⲛⲉⲩⲙⲁⲧⲓⲕⲱⲥ
ⲛϩⲁⲛⲣⲁⲛ	ⲛϩⲁⲛⲣⲁⲛ
ⲛϩⲁⲛⲥⲁⲣⲕⲓⲕⲱⲥ	ⲛϩⲁⲛⲥⲁⲣⲕⲓⲕⲱⲥ
ⲛϩⲁⲛⲥⲃⲱ	ⲛϩⲁⲛⲥⲃⲱ
ⲛϩⲁⲛⲱⲛⲓ	ⲛϩⲁⲛⲱⲛⲓ
ⲛϩⲉⲙⲥⲓ	ⲛϩⲉⲙⲥⲓ
ⲛϩⲏⲧ	ⲛϩⲏⲧ
ⲛϩⲑⲏⲟⲩ	ⲛϩⲑⲏⲟⲩ
ⲛϩⲓⲟⲩⲓ	ⲛϩⲓⲟⲩⲓ
ⲛϩⲓⲧϥ	ⲛϩⲓⲧϥ
ⲛϩⲓⲱⲓϣ	ⲛϩⲓⲱⲓϣ
ⲛϩⲗⲓ	ⲛϩⲗⲓ
ⲛϩⲙⲟⲧ	ⲛϩⲙⲟⲧ
ⲛϩⲟϯ	ⲛϩⲟϯ
ⲛϩⲟⲛϩⲉⲛ	ⲛϩⲟⲛϩⲉⲛ
ⲛϩⲟⲩⲟ	ⲛϩⲟⲩⲟ
ⲛϩⲣⲏⲓ	ⲛϩⲣⲏⲓ
ⲛϫⲁϭⲏ	ⲛϫⲁϭⲏ
ⲛϫⲁⲗ	ⲛϫⲁⲗ
ⲛϫⲁⲙⲏ	ⲛϫⲁⲙⲏ
ⲛϫⲉ	ⲛϫⲉ
ⲛϫⲉϩⲁⲛⲉϩⲟⲟⲩ	ⲛϫⲉϩⲁⲛⲉϩⲟⲟⲩ
ⲛϫⲉϩⲁⲛⲙⲏϣ	ⲛϫⲉϩⲁⲛⲙⲏϣ
ⲛϫⲉϩⲁⲛⲫⲁⲣⲓⲥⲉⲟⲥ	ⲛϫⲉϩⲁⲛⲫⲁⲣⲓⲥⲉⲟⲥ
ⲛϫⲉϯⲁⲅⲉⲗⲏ	ⲛϫⲉϯⲁⲅⲉⲗⲏ
ⲛϫⲉϯⲁⲗⲟⲩ	ⲛϫⲉϯⲁⲗⲟⲩ
ⲛϫⲉϯⲙⲉⲧⲟⲩⲣⲟ	ⲛϫⲉϯⲙⲉⲧⲟⲩⲣⲟ
ⲛϫⲉϯⲙⲟⲩⲙⲓ	ⲛϫⲉϯⲙⲟⲩⲙⲓ
ⲛϫⲉⲇ	ⲛϫⲉⲇ
ⲛϫⲉⲇⲁⲩⲓⲇ	ⲛϫⲉⲇⲁⲩⲓⲇ
ⲛϫⲉⲏⲗⲓⲁⲥ	ⲛϫⲉⲏⲗⲓⲁⲥ
ⲛϫⲉⲏⲣⲱⲇⲏⲥ	ⲛϫⲉⲏⲣⲱⲇⲏⲥ
ⲛϫⲉⲏⲥⲁⲓⲁⲥ	ⲛϫⲉⲏⲥⲁⲓⲁⲥ
ⲛϫⲉⲓⲁⲕⲱⲃⲟⲥ	ⲛϫⲉⲓⲁⲕⲱⲃⲟⲥ
ⲛϫⲉⲓⲏⲥⲟⲩⲥ	ⲛϫⲉⲓⲏⲥⲟⲩⲥ
ⲛϫⲉⲓⲱⲁⲛⲛⲏⲥ	ⲛϫⲉⲓⲱⲁⲛⲛⲏⲥ
ⲛϫⲉⲙⲱⲩⲥⲏⲥ	ⲛϫⲉⲙⲱⲩⲥⲏⲥ
ⲛϫⲉⲛⲁϯⲓⲟⲩⲇⲉⲁ	ⲛϫⲉⲛⲁϯⲓⲟⲩⲇⲉⲁ
ⲛϫⲉⲛⲉϥⲙⲁϣϫ	ⲛϫⲉⲛⲉϥⲙⲁϣϫ
ⲛϫⲉⲛⲉϥⲙⲁⲑⲏⲧⲏⲥ	ⲛϫⲉⲛⲉϥⲙⲁⲑⲏⲧⲏⲥ
ⲛϫⲉⲛⲉⲕⲙⲁⲑⲏⲧⲏⲥ	ⲛϫⲉⲛⲉⲕⲙⲁⲑⲏⲧⲏⲥ
ⲛϫⲉⲛⲏ	ⲛϫⲉⲛⲏ
ⲛϫⲉⲛⲏⲉⲧϫⲟⲣ	ⲛϫⲉⲛⲏⲉⲧϫⲟⲣ
ⲛϫⲉⲛⲓϣⲏⲣⲓ	ⲛϫⲉⲛⲓϣⲏⲣⲓ
ⲛϫⲉⲛⲓϩⲁⲗⲁϯ	ⲛϫⲉⲛⲓϩⲁⲗⲁϯ
ⲛϫⲉⲛⲓⲁⲡⲟⲥⲧⲟⲗⲟⲥ	ⲛϫⲉⲛⲓⲁⲡⲟⲥⲧⲟⲗⲟⲥ
ⲛϫⲉⲛⲓⲁⲣⲭⲓⲉⲣⲉⲩⲥ	ⲛϫⲉⲛⲓⲁⲣⲭⲓⲉⲣⲉⲩⲥ
ⲛϫⲉⲛⲓⲙⲁⲑⲏⲧⲏⲥ	ⲛϫⲉⲛⲓⲙⲁⲑⲏⲧⲏⲥ
ⲛϫⲉⲛⲓⲡⲉⲇⲏⲥ	ⲛϫⲉⲛⲓⲡⲉⲇⲏⲥ
ⲛϫⲉⲛⲓⲡⲛⲉⲩⲙⲁ	ⲛϫⲉⲛⲓⲡⲛⲉⲩⲙⲁ
ⲛϫⲉⲛⲓⲣⲱⲙⲓ	ⲛϫⲉⲛⲓⲣⲱⲙⲓ
ⲛϫⲉⲛⲓⲥⲁϧ	ⲛϫⲉⲛⲓⲥⲁϧ
ⲛϫⲉⲛⲓⲥⲟⲩⲣⲓ	ⲛϫⲉⲛⲓⲥⲟⲩⲣⲓ
ⲛϫⲉⲛⲓⲫⲁⲣⲓⲥⲉⲟⲥ	ⲛϫⲉⲛⲓⲫⲁⲣⲓⲥⲁⲓⲟⲥ
ⲛϫⲉⲟⲩϭⲏⲡⲓ	ⲛϫⲉⲟⲩϭⲏⲡⲓ
ⲛϫⲉⲟⲩⲁⲓ	ⲛϫⲉⲟⲩⲁⲓ
ⲛϫⲉⲟⲩⲕⲁⲕⲥⲉϩⲧ	ⲛϫⲉⲟⲩⲕⲁⲕⲥⲉϩⲧ
ⲛϫⲉⲟⲩⲙⲏϣ	ⲛϫⲉⲟⲩⲙⲏϣ
ⲛϫⲉⲟⲩⲛⲓϣϯ	ⲛϫⲉⲟⲩⲛⲓϣϯ
ⲛϫⲉⲟⲩⲟⲛ	ⲛϫⲉⲟⲩⲟⲛ
ⲛϫⲉⲟⲩⲣⲱⲙⲓ	ⲛϫⲉⲟⲩⲣⲱⲙⲓ
ⲛϫⲉⲟⲩⲥϩⲓⲙⲓ	ⲛϫⲉⲟⲩⲥϩⲓⲙⲓ
ⲛϫⲉⲟⲩⲥⲁⲃⲃⲁⲧⲟⲛ	ⲛϫⲉⲟⲩⲥⲁⲃⲃⲁⲧⲟⲛ
ⲛϫⲉⲟⲩⲥⲙⲏ	ⲛϫⲉⲟⲩⲥⲙⲏ
ⲛϫⲉⲡϭⲟⲓⲥ	ⲛϫⲉⲡϭⲟⲓⲥ
ⲛϫⲉⲡⲉϥⲃⲉⲭⲉ	ⲛϫⲉⲡⲉϥⲃⲉⲭⲉ
ⲛϫⲉⲡⲉⲑⲛⲏⲟⲩ	ⲛϫⲉⲡⲉⲧⲛⲏⲟⲩ
ⲛϫⲉⲡⲉⲧⲉⲛϩⲏⲧ	ⲛϫⲉⲡⲉⲧⲉⲛϩⲏⲧ
ⲛϫⲉⲡⲉⲧⲉⲛⲣⲉϥϯⲥⲃⲱ	ⲛϫⲉⲡⲉⲧⲉⲛⲣⲉϥϯⲥⲃⲱ
ⲛϫⲉⲡⲉⲧⲣⲟⲥ	ⲛϫⲉⲡⲉⲧⲣⲟⲥ
ⲛϫⲉⲡⲓϧⲙⲟⲙ	ⲛϫⲉⲡⲓϧⲙⲟⲙ
ⲛϫⲉⲡⲓϫⲟⲓ	ⲛϫⲉⲡⲓϫⲟⲉⲓ
ⲛϫⲉⲡⲓⲇⲉⲙⲱⲛ	ⲛϫⲉⲡⲓⲇⲁⲓⲙⲱⲛ
ⲛϫⲉⲡⲓⲏⲓ	ⲛϫⲉⲡⲓⲏⲓ
ⲛϫⲉⲡⲓⲑⲏⲟⲩ	ⲛϫⲉⲡⲓⲑⲏⲟⲩ
ⲛϫⲉⲡⲓⲕⲉⲓ	ⲛϫⲉⲡⲓⲕⲉⲓ
ⲛϫⲉⲡⲓⲙⲏϣ	ⲛϫⲉⲡⲓⲙⲏϣ
ⲛϫⲉⲡⲓⲙⲟⲕⲙⲉⲕ	ⲛϫⲉⲡⲓⲙⲟⲕⲙⲉⲕ
ⲛϫⲉⲡⲓⲟⲩⲧⲁϩ	ⲛϫⲉⲡⲓⲟⲩⲧⲁϩ
ⲛϫⲉⲡⲓⲡⲁⲧϣⲉⲗⲉⲧ	ⲛϫⲉⲡⲓⲡⲁⲧϣⲉⲗⲉⲧ
ⲛϫⲉⲡⲓⲡⲛⲉⲩⲙⲁ	ⲛϫⲉⲡⲓⲡⲛⲉⲩⲙⲁ
ⲛϫⲉⲡⲓⲥⲏⲟⲩ	ⲛϫⲉⲡⲓⲥⲏⲟⲩ
ⲛϫⲉⲡⲓⲥⲛⲁϩ	ⲛϫⲉⲡⲓⲥⲛⲁϩ
ⲛϫⲉⲡⲓⲱⲥϧ	ⲛϫⲉⲡⲓⲱⲥϧ
ⲛϫⲉⲡⲟⲩⲣⲟ	ⲛϫⲉⲡⲟⲩⲣⲟ
ⲛϫⲉⲡⲥⲁⲧⲁⲛⲁⲥ	ⲛϫⲉⲡⲥⲁⲧⲁⲛⲁⲥ
ⲛϫⲉⲥⲓⲙⲱⲛ	ⲛϫⲉⲥⲓⲙⲱⲛ
ⲛϫⲉⲧϣⲉⲣⲓ	ⲛϫⲉⲧϣⲉⲣⲓ
ⲛϫⲉⲧⲉϥϫⲓϫ	ⲛϫⲉⲧⲉϥϫⲓϫ
ⲛϫⲉⲧⲉϥⲙⲁⲩ	ⲛϫⲉⲧⲉϥⲙⲁⲩ
ⲛϫⲉⲫⲏ	ⲛϫⲉⲫⲏ
ⲛϫⲉⲫⲓⲱⲧ	ⲛϫⲉⲫⲓⲱⲧ
ⲛϫⲉⲫⲛⲟⲩϯ	ⲛϫⲉⲫⲛⲟⲩϯ
ⲛϫⲉⲫⲣⲏ	ⲛϫⲉⲡⲣⲏ
ⲛϫⲟⲙ	ⲛϫⲟⲙ
ⲛϫⲟⲛⲥ	ⲛϫⲟⲛⲥ
ⲛϫⲟⲥ	ⲛϫⲟⲥ
ⲛϫⲫⲟ	ⲛϫⲫⲟ
ⲛϭⲁⲗⲉ	ⲛϭⲁⲗⲉ
ⲛϭⲁⲙⲟⲩⲗ	ⲛϭⲁⲙⲟⲩⲗ
ⲛϭⲁⲩⲙⲱⲓⲧ	ⲛϭⲁⲩⲙⲱⲓⲧ
ⲛϭⲟⲓⲥ	ⲛϭⲟⲓⲥ
ⲛϯϩⲁⲡ	ⲛϯϩⲁⲡ
ⲛϯϩⲟ	ⲛϯϩⲟ
ⲛϯϯϩⲁⲡ	ⲛϯϯϩⲁⲡ
ⲛϯⲁⲗⲟⲩ	ⲛϯⲁⲗⲟⲩ
ⲛϯⲃⲁⲕⲓ	ⲛϯⲃⲁⲕⲓ
ⲛϯⲉⲛⲧⲟⲗⲏ	ⲛϯⲉⲛⲧⲟⲗⲏ
ⲛϯⲑⲙⲁⲓⲏⲟⲩⲧ	ⲛϯⲑⲙⲁⲓⲏⲟⲩⲧ
ⲛϯⲛⲉϫⲓ	ⲛϯⲛⲉϫⲓ
ⲛϯⲛⲉⲙⲱⲧⲉⲛ	ⲛϯⲛⲉⲙⲱⲧⲉⲛ
ⲛϯⲛⲏⲟⲩ	ⲛϯⲛⲏⲟⲩ
ⲛϯⲟⲩⲁϩⲥⲟⲓ	ⲛϯⲟⲩⲁϩⲥⲟⲓ
ⲛϯⲡⲁⲣⲁⲇⲟⲥⲓⲥ	ⲛϯⲡⲁⲣⲁⲇⲟⲥⲓⲥ
ⲛϯⲡⲟⲣⲛⲓⲁ	ⲛϯⲡⲟⲣⲛⲉⲓⲁ
ⲛϯⲥⲃⲱ	ⲛϯⲥⲃⲱ
ⲛϯⲥⲱⲟⲩⲛ	ⲛϯⲥⲱⲟⲩⲛ
ⲛϯⲧⲣⲁⲡⲉⲍⲁ	ⲛϯⲧⲣⲁⲡⲉⲍⲁ
ⲛϯⲭⲱⲣⲁ	ⲛϯⲭⲱⲣⲁ
ⲛⲁ	ⲛⲁ
ⲛⲁϣ	ⲛⲁϣ
ⲛⲁϣⲱ	ⲛⲁϣⲱ
ⲛⲁϥ	ⲛⲁϥ
ⲛⲁϥϣⲓⲛⲓ	ⲛⲁϥϣⲓⲛⲓ
ⲛⲁϥϣⲟⲗϩ	ⲛⲁϥϣⲟⲗϩ
ⲛⲁϥϣⲟⲡ	ⲛⲁϥϣⲟⲡ
ⲛⲁϥϧⲉⲛϩⲁⲛⲑⲱⲧ	ⲛⲁϥϧⲉⲛϩⲁⲛⲑⲱⲧ
ⲛⲁϥϩⲉⲙⲥⲓ	ⲛⲁϥϩⲉⲙⲥⲓ
ⲛⲁϥϩⲏⲗ	ⲛⲁϥϩⲏⲗ
ⲛⲁϥϩⲓⲱⲓϣ	ⲛⲁϥϩⲓⲱⲓϣ
ⲛⲁϥϩⲟⲛϩⲉⲛ	ⲛⲁϥϩⲟⲛϩⲉⲛ
ⲛⲁϥϫⲟⲩϣⲧ	ⲛⲁϥϫⲟⲩϣⲧ
ⲛⲁϥϫⲱ	ⲛⲁϥϫⲱ
ⲛⲁϥϭⲟϫⲓ	ⲛⲁϥϭⲟϫⲓ
ⲛⲁϥϯϩⲟ	ⲛⲁϥϯϩⲟ
ⲛⲁϥϯⲥⲃⲱ	ⲛⲁϥϯⲥⲃⲱ
ⲛⲁϥⲁⲣⲉϩ	ⲛⲁϥⲁⲣⲉϩ
ⲛⲁϥⲃⲱⲗ	ⲛⲁϥⲃⲱⲗ
ⲛⲁϥⲉⲙⲓ	ⲛⲁϥⲉⲙⲓ
ⲛⲁϥⲉⲣⲉⲡⲓⲧⲓⲙⲁⲛ	ⲛⲁϥⲉⲣⲉⲡⲓⲧⲓⲙⲁⲛ
ⲛⲁϥⲉⲣⲡⲣⲟⲥⲉⲩⲭⲉⲥⲑⲉ	ⲛⲁϥⲉⲣⲡⲣⲟⲥⲉⲩⲭⲉⲥⲑⲉ
ⲛⲁϥⲉⲣⲫⲁϧⲣⲓ	ⲛⲁϥⲉⲣⲫⲁϧⲣⲓ
ⲛⲁϥⲙⲟϣⲓ	ⲛⲁϥⲙⲟϣⲓ
ⲛⲁϥⲛⲕⲟⲧ	ⲛⲁϥⲛⲕⲟⲧ
ⲛⲁϥⲟⲩⲉⲙϣϫⲉ	ⲛⲁϥⲟⲩⲉⲙϣϫⲉ
ⲛⲁϥⲟⲩⲱϣ	ⲛⲁϥⲟⲩⲱϣ
ⲛⲁϥⲥⲁϫⲓ	ⲛⲁϥⲥⲁϫⲓ
ⲛⲁϥⲥⲑⲉⲣⲧⲉⲣ	ⲛⲁϥⲥⲑⲉⲣⲧⲉⲣ
ⲛⲁϥⲥⲓⲛⲓ	ⲛⲁϥⲥⲓⲛⲓ
ⲛⲁϥⲥⲓⲛⲓⲱⲟⲩ	ⲛⲁϥⲥⲓⲛⲓⲱⲟⲩ
ⲛⲁϥⲥⲱⲧⲉⲙ	ⲛⲁϥⲥⲱⲧⲉⲙ
ⲛⲁϥⲭⲏ	ⲛⲁϥⲭⲏ
ⲛⲁϥⲭⲱ	ⲛⲁϥⲭⲱ
ⲛⲁϥⲱϣ	ⲛⲁϥⲱϣ
ⲛⲁϩϯ	ⲛⲁϩϯ
ⲛⲁϩⲃⲓ	ⲛⲁϩⲃⲓ
ⲛⲁϩⲙ	ⲛⲁϩⲙ
ⲛⲁϩⲙⲉ	ⲛⲁϩⲙⲉ
ⲛⲁϩⲣⲁ	ⲛⲁϩⲣⲁ
ⲛⲁϩⲣⲁϥ	ⲛⲁϩⲣⲁϥ
ⲛⲁϩⲣⲁⲩ	ⲛⲁϩⲣⲁⲩ
ⲛⲁϩⲣⲉⲛ	ⲛⲁϩⲣⲉⲛ
ⲛⲁϩⲣⲉⲛⲡⲓⲙⲏϣ	ⲛⲁϩⲣⲉⲛⲡⲓⲙⲏϣ
ⲛⲁϩⲣⲉⲛⲫⲛⲟⲩϯ	ⲛⲁϩⲣⲉⲛⲫⲛⲟⲩϯ
ⲛⲁϫϩⲓ	ⲛⲁϫϩⲓ
ⲛⲁϫⲉⲙϩⲏⲟⲩ	ⲛⲁϫⲉⲙϩⲏⲟⲩ
ⲛⲁϯϣⲓⲡⲓ	ⲛⲁϯϣⲓⲡⲓ
ⲛⲁⲁⲓϥ	ⲛⲁⲁⲓϥ
ⲛⲁⲃⲓⲁⲑⲁⲣ	ⲛⲁⲃⲓⲁⲑⲁⲣ
ⲛⲁⲅⲁⲑⲟⲥ	ⲛⲁⲅⲁⲑⲟⲥ
ⲛⲁⲉⲣⲇⲟⲕⲓⲙⲁⲍⲓⲛ	ⲛⲁⲉⲣⲇⲟⲕⲓⲙⲁⲍⲓⲛ
ⲛⲁⲉⲣⲧⲟⲗⲙⲁⲛ	ⲛⲁⲉⲣⲧⲟⲗⲙⲁⲛ
ⲛⲁⲍⲁⲣⲉⲑ	ⲛⲁⲍⲁⲣⲉⲑ
ⲛⲁⲑⲛⲁϩϯ	ⲛⲁⲑⲛⲁϩϯ
ⲛⲁⲓ	ⲛⲁⲓ
ⲛⲁⲓϥ	ⲛⲁⲓϥ
ⲛⲁⲓϫⲉⲣⲉ	ⲛⲁⲓϫⲉⲣⲉ
ⲛⲁⲓϫⲫⲓⲟ	ⲛⲁⲓϫⲫⲓⲟ
ⲛⲁⲕ	ⲛⲁⲕ
ⲛⲁⲕⲁⲑⲁⲣⲧⲟⲛ	ⲛⲁⲕⲁⲑⲁⲣⲧⲟⲛ
ⲛⲁⲕⲁⲑⲣⲧⲟⲛ	ⲛⲁⲕⲁⲑⲣⲧⲟⲛ
ⲛⲁⲕⲟⲣϥⲟⲩ	ⲛⲁⲕⲟⲣϥⲟⲩ
ⲛⲁⲗⲱⲟⲩⲓ	ⲛⲁⲗⲱⲟⲩⲓ
ⲛⲁⲛ	ⲛⲁⲛ
ⲛⲁⲛⲉ	ⲛⲁⲛⲉ
ⲛⲁⲛⲉⲡⲉⲧⲉⲛϣⲟⲩϣⲟⲩ	ⲛⲁⲛⲉⲡⲉⲧⲉⲛϣⲟⲩϣⲟⲩ
ⲛⲁⲛⲉⲥ	ⲛⲁⲛⲉⲥ
ⲛⲁⲟϩⲓ	ⲛⲁⲟϩⲓ
ⲛⲁⲡⲁⲥ	ⲛⲁⲡⲁⲥ
ⲛⲁⲡⲓⲡⲛⲉⲩⲙⲁ	ⲛⲁⲡⲓⲡⲛⲉⲩⲙⲁ
ⲛⲁⲡⲭⲣⲓⲥⲧⲟⲥ	ⲛⲁⲡⲭⲣⲓⲥⲧⲟⲥ
ⲛⲁⲣⲉ	ⲛⲁⲣⲉ
ⲛⲁⲣⲉϩⲁⲛϥⲱⲓ	ⲛⲁⲣⲉϩⲁⲛϥⲱⲓ
ⲛⲁⲣⲉϩⲁⲛⲕⲉⲉϫⲏⲟⲩ	ⲛⲁⲣⲉϩⲁⲛⲕⲉⲉϫⲏⲟⲩ
ⲛⲁⲣⲉⲓⲱⲁⲛⲛⲏⲥ	ⲛⲁⲣⲉⲓⲱⲁⲛⲛⲏⲥ
ⲛⲁⲣⲉⲛⲓⲙⲁⲑⲏⲧⲏⲥ	ⲛⲁⲣⲉⲛⲓⲙⲁⲑⲏⲧⲏⲥ
ⲛⲁⲣⲉⲛⲓⲥⲁϧ	ⲛⲁⲣⲉⲛⲓⲥⲁϧ
ⲛⲁⲣⲉⲛⲓⲫⲁⲣⲓⲥⲉⲟⲥ	ⲛⲁⲣⲉⲛⲓⲫⲁⲣⲓⲥⲉⲟⲥ
ⲛⲁⲣⲉⲟⲩⲙⲏϣ	ⲛⲁⲣⲉⲟⲩⲙⲏϣ
ⲛⲁⲣⲉⲡⲓϫⲟⲓ	ⲛⲁⲣⲉⲡⲓϫⲟⲉⲓ
ⲛⲁⲣⲉⲡⲓⲑⲏⲟⲩ	ⲛⲁⲣⲉⲡⲓⲑⲏⲟⲩ
ⲛⲁⲣⲉⲡⲓⲙⲏϣ	ⲛⲁⲣⲉⲡⲓⲙⲏϣ
ⲛⲁⲣⲉⲡⲟⲩϩⲏⲧ	ⲛⲁⲣⲉⲡⲟⲩϩⲏⲧ
ⲛⲁⲣⲉⲧⲉⲛⲙⲡϣⲁ	ⲛⲁⲣⲉⲧⲉⲛⲙⲡϣⲁ
ⲛⲁⲣⲭⲉⲟⲥ	ⲛⲁⲣⲭⲉⲟⲥ
ⲛⲁⲣⲭⲏⲇⲉⲕⲧⲱⲛ	ⲛⲁⲣⲭⲏⲇⲉⲕⲧⲱⲛ
ⲛⲁⲣⲭⲱⲛ	ⲛⲁⲣⲭⲱⲛ
ⲛⲁⲣⲱⲕϩ	ⲛⲁⲣⲱⲕϩ
ⲛⲁⲥ	ⲛⲁⲥ
ⲛⲁⲥϣϫⲉⲙϫⲟⲙ	ⲛⲁⲥϣϫⲉⲙϫⲟⲙ
ⲛⲁⲥϣⲉⲙϣⲓ	ⲛⲁⲥϣⲉⲙϣⲓ
ⲛⲁⲥϣⲱⲡⲓ	ⲛⲁⲥϣⲱⲡⲓ
ⲛⲁⲥϧⲉⲛⲡⲥⲁϫⲓ	ⲛⲁⲥϧⲉⲛⲡⲥⲁϫⲓ
ⲛⲁⲥϫⲱ	ⲛⲁⲥϫⲱ
ⲛⲁⲥϯϩⲟ	ⲛⲁⲥϯϩⲟ
ⲛⲁⲥⲙⲃⲟⲛ	ⲛⲁⲥⲙⲃⲟⲛ
ⲛⲁⲥⲙⲡϣⲁ	ⲛⲁⲥⲙⲡϣⲁ
ⲛⲁⲥⲛⲏⲟⲩ	ⲛⲁⲥⲛⲏⲟⲩ
ⲛⲁⲥⲛⲕⲟⲧ	ⲛⲁⲥⲛⲕⲟⲧ
ⲛⲁⲥⲟⲩⲱϣ	ⲛⲁⲥⲟⲩⲱϣ
ⲛⲁⲧϣⲉⲙⲏⲣ	ⲛⲁⲧϣⲉⲙⲏⲣ
ⲛⲁⲧϭⲉⲛⲟ	ⲛⲁⲧϭⲉⲛⲟ
ⲛⲁⲧⲁⲕⲟϥ	ⲛⲁⲧⲁⲕⲟϥ
ⲛⲁⲧⲉⲙⲓ	ⲛⲁⲧⲉⲙⲓ
ⲛⲁⲧⲏⲓϥ	ⲛⲁⲧⲏⲓϥ
ⲛⲁⲧⲟⲩⲱⲙ	ⲛⲁⲧⲟⲩⲱⲙ
ⲛⲁⲧⲥⲁϫⲓ	ⲛⲁⲧⲥⲁϫⲓ
ⲛⲁⲩ	ⲛⲁⲩ
ⲛⲁⲩϣⲉⲙϣⲓ	ⲛⲁⲩϣⲉⲙϣⲓ
ⲛⲁⲩϣⲓⲛⲓ	ⲛⲁⲩϣⲓⲛⲓ
ⲛⲁⲩϩⲁⲙⲛⲁⲓ	ⲛⲁⲩϩⲁⲙⲛⲁⲓ
ⲛⲁⲩϩⲓ	ⲛⲁⲩϩⲓ
ⲛⲁⲩϩⲓⲟⲩⲓ	ⲛⲁⲩϩⲓⲟⲩⲓ
ⲛⲁⲩϩⲓⲫⲟⲩⲉⲓ	ⲛⲁⲩϩⲓⲫⲟⲩⲉⲓ
ⲛⲁⲩϩⲓⲱⲓϣ	ⲛⲁⲩϩⲓⲱⲓϣ
ⲛⲁⲩϩⲟϫϩⲉϫ	ⲛⲁⲩϩⲟϫϩⲉϫ
ⲛⲁⲩϫⲉⲙⲉⲩⲕⲉⲣⲓⲁ	ⲛⲁⲩϫⲉⲙⲉⲩⲕⲉⲣⲓⲁ
ⲛⲁⲩϫⲱ	ⲛⲁⲩϫⲱ
ⲛⲁⲩϭⲓⲱⲙⲥ	ⲛⲁⲩϭⲓⲱⲙⲥ
ⲛⲁⲩϯ	ⲛⲁⲩϯ
ⲛⲁⲩϯϩⲟ	ⲛⲁⲩϯϩⲟ
ⲛⲁⲩⲉⲣϣⲫⲏⲣⲓ	ⲛⲁⲩⲉⲣϣⲫⲏⲣⲓ
ⲛⲁⲩⲉⲣϩⲟϯ	ⲛⲁⲩⲉⲣϩⲟϯ
ⲛⲁⲩⲉⲣⲉⲛϣⲟ	ⲛⲁⲩⲉⲣⲛϣⲟ
ⲛⲁⲩⲉⲣⲉⲡⲓⲧⲓⲙⲁⲛ	ⲛⲁⲩⲉⲣⲉⲡⲓⲧⲓⲙⲁⲛ
ⲛⲁⲩⲉⲣⲥⲕⲁⲛⲇⲁⲗⲓⲍⲉⲥⲑⲉ	ⲛⲁⲩⲉⲣⲥⲕⲁⲛⲇⲁⲗⲓⲍⲉⲥⲑⲉ
ⲛⲁⲩⲉⲣⲫⲁϧⲣⲓ	ⲛⲁⲩⲉⲣⲫⲁϧⲣⲓ
ⲛⲁⲩⲑⲱϩⲥ	ⲛⲁⲩⲑⲱϩⲥ
ⲛⲁⲩⲓⲣⲓ	ⲛⲁⲩⲓⲣⲓ
ⲛⲁⲩⲕⲱϯ	ⲛⲁⲩⲕⲱϯ
ⲛⲁⲩⲙⲉⲩⲓ	ⲛⲁⲩⲙⲉⲩⲓ
ⲛⲁⲩⲙⲟϣⲓ	ⲛⲁⲩⲙⲟϣⲓ
ⲛⲁⲩⲙⲟⲕⲙⲉⲕ	ⲛⲁⲩⲙⲟⲕⲙⲉⲕ
ⲛⲁⲩⲛⲁⲉϣ	ⲛⲁⲩⲛⲁⲉϣ
ⲛⲁⲩⲛⲏⲟⲩ	ⲛⲁⲩⲛⲏⲟⲩ
ⲛⲁⲩⲟϣ	ⲛⲁⲩⲟϣ
ⲛⲁⲩⲟⲓ	ⲛⲁⲩⲟⲓ
ⲛⲁⲩⲣⲟⲧⲉⲃ	ⲛⲁⲩⲣⲟⲧⲉⲃ
ⲛⲁⲩⲥⲁϫⲓ	ⲛⲁⲩⲥⲁϫⲓ
ⲛⲁⲩⲥⲱⲃⲓ	ⲛⲁⲩⲥⲱⲃⲓ
ⲛⲁⲩⲥⲱⲟⲩⲛ	ⲛⲁⲩⲥⲱⲟⲩⲛ
ⲛⲁⲩⲥⲱⲧⲉⲙ	ⲛⲁⲩⲥⲱⲧⲉⲙ
ⲛⲁⲩⲧⲱⲙⲧ	ⲛⲁⲩⲧⲱⲙⲧ
ⲛⲁⲩⲫⲱⲣϣ	ⲛⲁⲩⲫⲱⲣϣ
ⲛⲁⲩⲭⲱ	ⲛⲁⲩⲭⲱ
ⲛⲁⲩⲱϣ	ⲛⲁⲩⲱϣ
ⲛⲁⲩⲱϫϩ	ⲛⲁⲩⲱϫϩ
ⲛⲁⲫⲛⲟⲩϯ	ⲛⲁⲫⲛⲟⲩϯ
ⲛⲁⲫⲣⲓ	ⲛⲁⲫⲣⲓ
ⲛⲃ	ⲛⲃ
ⲛⲅ	ⲛⲅ
ⲛⲇ	ⲛⲇ
ⲛⲇⲁⲩⲓⲇ	ⲛⲇⲁⲩⲓⲇ
ⲛⲇⲉⲙⲱⲛ	ⲛⲇⲁⲓⲙⲱⲛ
ⲛⲇⲓⲕⲉⲟⲥ	ⲛⲇⲓⲕⲉⲟⲥ
ⲛⲉ	ⲛⲉ
ⲛⲉϣ	ⲛⲉϣ
ⲛⲉϥ	ⲛⲉϥ
ⲛⲉϥϩⲃⲱⲥ	ⲛⲉϥϩⲃⲱⲥ
ⲛⲉϥⲙⲁⲑⲏⲧⲏⲥ	ⲛⲉϥⲙⲁⲑⲏⲧⲏⲥ
ⲛⲉϥⲥⲱⲛⲓ	ⲛⲉϥⲥⲱⲛⲓ
ⲛⲉϩ	ⲛⲉϩ
ⲛⲉϩⲁⲛⲟⲩⲟϩⲓ	ⲛⲉϩⲁⲛⲟⲩⲟϩⲓ
ⲛⲉϩⲟⲟⲩ	ⲛⲉϩⲟⲟⲩ
ⲛⲉϩⲡϣⲱⲓϣ	ⲛⲉϩⲡϣⲱⲓϣ
ⲛⲉϩⲥⲓ	ⲛⲉϩⲥⲓ
ⲛⲉϫⲓ	ⲛⲉϫⲓ
ⲛⲉⲁϥϭⲓⲧⲥ	ⲛⲉⲁϥϭⲓⲧⲥ
ⲛⲉⲁϥⲁⲙⲟⲛⲓ	ⲛⲉⲁϥⲁⲙⲟⲛⲓ
ⲛⲉⲁⲣⲉⲧⲉⲛⲉⲣⲟⲩⲣⲟ	ⲛⲉⲁⲣⲉⲧⲉⲛⲉⲣⲟⲩⲣⲟ
ⲛⲉⲁⲩⲛⲁⲩ	ⲛⲉⲁⲩⲛⲁⲩ
ⲛⲉⲁⲩⲥⲟⲛϩϥ	ⲛⲉⲁⲩⲥⲟⲛϩϥ
ⲛⲉⲃⲟ	ⲛⲉⲃⲟ
ⲛⲉⲉⲧⲉⲛⲥⲁϫⲓ	ⲛⲉⲉⲧⲉⲛⲥⲁϫⲓ
ⲛⲉⲕ	ⲛⲉⲕ
ⲛⲉⲕⲛⲟⲃⲓ	ⲛⲉⲕⲛⲟⲃⲓ
ⲛⲉⲙ	ⲛⲉⲙ
ⲛⲉⲙϧⲉⲛⲡⲓⲡⲛⲉⲩⲙⲁ	ⲛⲉⲙϧⲉⲛⲡⲓⲡⲛⲉⲩⲙⲁ
ⲛⲉⲙϧⲉⲛⲧⲕⲟⲓ	ⲛⲉⲙϧⲉⲛⲧⲕⲟⲓ
ⲛⲉⲙϩⲁⲛϣⲏⲣⲓ	ⲛⲉⲙϩⲁⲛϣⲏⲣⲓ
ⲛⲉⲙϩⲁⲛϩⲁⲗⲩⲥⲓⲥ	ⲛⲉⲙϩⲁⲛϩⲁⲗⲩⲥⲓⲥ
ⲛⲉⲙϩⲁⲛⲓⲟϩⲓ	ⲛⲉⲙϩⲁⲛⲓⲟϩⲓ
ⲛⲉⲙϩⲁⲛⲓⲱⲧ	ⲛⲉⲙϩⲁⲛⲓⲱⲧ
ⲛⲉⲙϩⲁⲛⲙⲁⲩ	ⲛⲉⲙϩⲁⲛⲙⲁⲩ
ⲛⲉⲙϩⲁⲛⲝⲉⲥⲧⲏⲥ	ⲛⲉⲙϩⲁⲛⲝⲉⲥⲧⲏⲥ
ⲛⲉⲙϩⲁⲛⲟⲓⲕⲟⲛⲟⲙⲟⲥ	ⲛⲉⲙϩⲁⲛⲟⲓⲕⲟⲛⲟⲙⲟⲥ
ⲛⲉⲙϩⲁⲛⲟⲩⲟⲛ	ⲛⲉⲙϩⲁⲛⲟⲩⲟⲛ
ⲛⲉⲙϩⲁⲛⲣⲉϥⲉⲣⲛⲟⲃⲓ	ⲛⲉⲙϩⲁⲛⲣⲉϥⲉⲣⲛⲟⲃⲓ
ⲛⲉⲙϩⲁⲛⲥⲛⲏⲟⲩ	ⲛⲉⲙϩⲁⲛⲥⲛⲏⲟⲩ
ⲛⲉⲙϩⲁⲛⲥⲱⲛⲓ	ⲛⲉⲙϩⲁⲛⲥⲱⲛⲓ
ⲛⲉⲙϩⲁⲛⲭⲁⲗⲕⲓⲛ	ⲛⲉⲙϩⲁⲛⲭⲁⲗⲕⲓⲛ
ⲛⲉⲙϩⲓⲙⲏⲣ	ⲛⲉⲙϩⲓⲙⲏⲣ
ⲛⲉⲙϩⲱⲟⲩⲧ	ⲛⲉⲙϩⲱⲟⲩⲧ
ⲛⲉⲙϯϩⲩⲇⲟⲩⲙⲉⲁ	ⲛⲉⲙϯϩⲩⲇⲟⲩⲙⲉⲁ
ⲛⲉⲙϯϫⲟⲙ	ⲛⲉⲙϯϫⲟⲙ
ⲛⲉⲙϯⲁⲡⲁⲧⲏ	ⲛⲉⲙϯⲁⲡⲁⲧⲏ
ⲛⲉⲙϯⲓⲟⲩⲇⲉⲁ	ⲛⲉⲙϯⲓⲟⲩⲇⲉⲁ
ⲛⲉⲙⲁ	ⲛⲉⲙⲁ
ⲛⲉⲙⲁϥ	ⲛⲉⲙⲁϥ
ⲛⲉⲙⲁⲛ	ⲛⲉⲙⲁⲛ
ⲛⲉⲙⲁⲛⲇⲣⲉⲁⲥ	ⲛⲉⲙⲁⲛⲇⲣⲉⲁⲥ
ⲛⲉⲙⲁⲡⲟⲗⲗⲱ	ⲛⲉⲙⲁⲡⲟⲗⲗⲱ
ⲛⲉⲙⲃⲏⲑⲁⲛⲓⲁ	ⲛⲉⲙⲃⲏⲑⲁⲛⲓⲁ
ⲛⲉⲙⲇⲓⲁⲕⲱⲛ	ⲛⲉⲙⲇⲓⲁⲕⲱⲛ
ⲛⲉⲙⲉⲃⲓⲱ	ⲛⲉⲙⲉⲃⲓⲱ
ⲛⲉⲙⲉⲃⲟⲗ	ⲛⲉⲙⲉⲃⲟⲗ
ⲛⲉⲙⲉⲑⲃⲉⲛⲓⲣⲓⲣ	ⲛⲉⲙⲉⲑⲃⲉⲛⲓⲣⲓⲣ
ⲛⲉⲙⲉⲑⲃⲉⲡⲓⲉⲩⲁⲅⲅⲉⲗⲓⲟⲛ	ⲛⲉⲙⲉⲑⲃⲉⲡⲓⲉⲩⲁⲅⲅⲉⲗⲓⲟⲛ
ⲛⲉⲙⲏ	ⲛⲉⲙⲏ
ⲛⲉⲙⲏⲓ	ⲛⲉⲙⲏⲓ
ⲛⲉⲙⲑⲁⲇⲇⲉⲟⲥ	ⲛⲉⲙⲑⲁⲇⲇⲉⲟⲥ
ⲛⲉⲙⲑⲱⲙⲁⲥ	ⲛⲉⲙⲑⲱⲙⲁⲥ
ⲛⲉⲙⲓⲁⲕⲱⲃⲟⲥ	ⲛⲉⲙⲓⲁⲕⲱⲃⲟⲥ
ⲛⲉⲙⲓⲉⲣⲟⲥⲁⲗⲏⲙ	ⲛⲉⲙⲓⲉⲣⲟⲥⲁⲗⲏⲙ
ⲛⲉⲙⲓⲏⲥⲟⲩⲥ	ⲛⲉⲛⲓⲏⲥⲟⲩⲥ
ⲛⲉⲙⲓⲟⲩⲇⲁⲥ	ⲛⲉⲙⲓⲟⲩⲇⲁⲥ
ⲛⲉⲙⲓⲱⲁⲛⲛⲏⲥ	ⲛⲉⲙⲓⲱⲁⲛⲛⲏⲥ
ⲛⲉⲙⲓⲱⲥⲏⲧⲟⲥ	ⲛⲉⲙⲓⲱⲥⲏⲧⲟⲥ
ⲛⲉⲙⲕⲁⲧⲁⲛ	ⲛⲉⲙⲕⲁⲧⲁⲛ
ⲛⲉⲙⲕⲉⲙⲏϣ	ⲛⲉⲙⲕⲉⲙⲏϣ
ⲛⲉⲙⲙⲁⲧⲑⲉⲟⲥ	ⲛⲉⲙⲙⲁⲧⲑⲉⲟⲥ
ⲛⲉⲙⲙⲟⲛ	ⲛⲉⲙⲙⲟⲛ
ⲛⲉⲙⲙⲱⲩⲥⲏⲥ	ⲛⲉⲙⲙⲱⲩⲥⲏⲥ
ⲛⲉⲙⲛⲁϩⲃⲱⲥ	ⲛⲉⲙⲛⲁϩⲃⲱⲥ
ⲛⲉⲙⲛⲁⲓⲉⲣⲟⲥⲁⲗⲏⲙ	ⲛⲉⲙⲛⲁⲓⲉⲣⲟⲥⲁⲗⲏⲙ
ⲛⲉⲙⲛⲁⲓⲕⲉϫⲟⲙ	ⲛⲉⲙⲛⲁⲓⲕⲉϫⲟⲙ
ⲛⲉⲙⲛⲁⲛⲓⲫⲁⲣⲓⲥⲉⲟⲥ	ⲛⲉⲛⲛⲁⲛⲓⲫⲁⲣⲓⲥⲉⲟⲥ
ⲛⲉⲙⲛⲁⲥⲁϫⲓ	ⲛⲉⲙⲛⲁⲥⲁϫⲓ
ⲛⲉⲙⲛⲁⲥⲛⲏⲟⲩ	ⲛⲉⲙⲛⲁⲥⲛⲏⲟⲩ
ⲛⲉⲙⲛⲉϥϩⲃⲱⲥ	ⲛⲉⲙⲛⲉϥϩⲃⲱⲥ
ⲛⲉⲙⲛⲉϥⲁⲅⲅⲉⲗⲟⲥ	ⲛⲉⲙⲛⲉϥⲁⲅⲅⲉⲗⲟⲥ
ⲛⲉⲙⲛⲉϥⲙⲁⲑⲏⲧⲏⲥ	ⲛⲉⲙⲛⲉϥⲙⲁⲑⲏⲧⲏⲥ
ⲛⲉⲙⲛⲉϥⲥⲛⲏⲟⲩ	ⲛⲉⲙⲛⲉϥⲥⲛⲏⲟⲩ
ⲛⲉⲙⲛⲉϫⲱⲣϩ	ⲛⲉⲙⲛⲉϫⲱⲣϩ
ⲛⲉⲙⲛⲉⲕⲥⲛⲏⲟⲩ	ⲛⲉⲙⲛⲉⲕⲥⲛⲏⲟⲩ
ⲛⲉⲙⲛⲉⲧⲉⲛⲉⲣⲏⲟⲩ	ⲛⲉⲙⲛⲉⲧⲉⲛⲉⲣⲏⲟⲩ
ⲛⲉⲙⲛⲏ	ⲛⲉⲙⲛⲏ
ⲛⲉⲙⲛⲓϩⲟⲩⲁϯ	ⲛⲉⲙⲛⲓϩⲟⲩⲁϯ
ⲛⲉⲙⲛⲓϫⲉⲟⲩⲁ	ⲛⲉⲙⲛⲓϫⲉⲟⲩⲁ
ⲛⲉⲙⲛⲓϯⲙⲓ	ⲛⲉⲙⲛⲓϯⲙⲓ
ⲛⲉⲙⲛⲓⲁⲅⲅⲉⲗⲟⲥ	ⲛⲉⲙⲛⲓⲁⲅⲅⲉⲗⲟⲥ
ⲛⲉⲙⲛⲓⲁⲣⲭⲓⲉⲣⲉⲩⲥ	ⲛⲉⲙⲛⲓⲁⲣⲭⲓⲉⲣⲉⲩⲥ
ⲛⲉⲙⲛⲓⲁⲥⲕⲟⲥ	ⲛⲉⲛⲛⲓⲁⲥⲕⲟⲥ
ⲛⲉⲙⲛⲓⲉⲡⲓⲑⲩⲙⲓⲁ	ⲛⲉⲙⲛⲓⲉⲡⲓⲑⲩⲙⲓⲁ
ⲛⲉⲙⲛⲓⲏⲣⲱⲇⲓⲁⲛⲟⲥ	ⲛⲉⲙⲛⲓⲏⲣⲱⲇⲓⲁⲛⲟⲥ
ⲛⲉⲙⲛⲓⲑⲏⲣⲓⲟⲛ	ⲛⲉⲙⲛⲓⲑⲏⲣⲓⲟⲛ
ⲛⲉⲙⲛⲓⲓⲟⲩⲇⲁⲓ	ⲛⲉⲙⲛⲓⲓⲟⲩⲇⲁⲓ
ⲛⲉⲙⲛⲓⲕⲁⲑⲉⲇⲣⲁ	ⲛⲉⲙⲛⲓⲕⲁⲑⲉⲇⲣⲁ
ⲛⲉⲙⲛⲓⲕⲉⲧⲉⲃⲧ	ⲛⲉⲙⲛⲓⲕⲉⲧⲉⲃⲧ
ⲛⲉⲙⲛⲓⲕⲉⲭⲱⲟⲩⲛⲓ	ⲛⲉⲙⲛⲓⲕⲉⲭⲱⲟⲩⲛⲓ
ⲛⲉⲙⲛⲓⲙⲓⲥⲑⲱⲧⲏⲥ	ⲛⲉⲙⲛⲓⲙⲓⲥⲑⲱⲧⲏⲥ
ⲛⲉⲙⲛⲓⲡⲟⲣⲛⲟⲥ	ⲛⲉⲙⲛⲓⲡⲟⲣⲛⲟⲥ
ⲛⲉⲙⲛⲓⲡⲣⲉⲥⲃⲩⲧⲉⲣⲟⲥ	ⲛⲉⲙⲛⲓⲡⲣⲉⲥⲃⲩⲧⲉⲣⲟⲥ
ⲛⲉⲙⲛⲓⲣⲉϥⲉⲣⲛⲟⲃⲓ	ⲛⲉⲛⲛⲓⲣⲉϥⲉⲣⲛⲟⲃⲓ
ⲛⲉⲙⲛⲓⲣⲱⲙⲓ	ⲛⲉⲙⲛⲓⲣⲱⲙⲓ
ⲛⲉⲙⲛⲓⲥⲁϧ	ⲛⲉⲙⲛⲓⲥⲁϧ
ⲛⲉⲙⲛⲓⲧⲉⲃⲧ	ⲛⲉⲙⲛⲓⲧⲉⲃⲧ
ⲛⲉⲙⲛⲓⲧⲉⲗⲱⲛⲏⲥ	ⲛⲉⲛⲛⲓⲧⲉⲗⲱⲛⲏⲥ
ⲛⲉⲙⲛⲓⲫⲁⲣⲓⲥⲉⲟⲥ	ⲛⲉⲛⲛⲓⲫⲁⲣⲓⲥⲉⲟⲥ
ⲛⲉⲙⲛⲓⲭⲓⲗⲓⲁⲣⲭⲟⲥ	ⲛⲉⲙⲛⲓⲭⲓⲗⲓⲁⲣⲭⲟⲥ
ⲛⲉⲙⲛⲟⲩⲉⲣⲏⲟⲩ	ⲛⲉⲙⲛⲟⲩⲉⲣⲏⲟⲩ
ⲛⲉⲙⲟⲩϣϭⲛⲏⲛ	ⲛⲉⲙⲟⲩϣϭⲛⲏⲛ
ⲛⲉⲙⲟⲩϩⲟϯ	ⲛⲉⲙⲟⲩϩⲟϯ
ⲛⲉⲙⲟⲩϫⲟⲙ	ⲛⲉⲙⲟⲩϫⲟⲙ
ⲛⲉⲙⲟⲩⲓ	ⲛⲉⲙⲟⲩⲓ
ⲛⲉⲙⲟⲩⲙⲉⲑⲙⲏⲓ	ⲛⲉⲙⲟⲩⲙⲉⲑⲙⲏⲓ
ⲛⲉⲙⲟⲩⲙⲏϣ	ⲛⲉⲙⲟⲩⲙⲏϣ
ⲛⲉⲙⲟⲩⲛⲏⲥⲧⲓⲁ	ⲛⲉⲙⲟⲩⲛⲏⲥⲧⲓⲁ
ⲛⲉⲙⲟⲩⲥⲑⲉⲣⲧⲉⲣ	ⲛⲉⲙⲟⲩⲥⲑⲉⲣⲧⲉⲣ
ⲛⲉⲙⲟⲩⲥⲟⲛ	ⲛⲉⲙⲟⲩⲥⲟⲛ
ⲛⲉⲙⲡϣⲉⲙⲏⲣ	ⲛⲉⲙⲡϣⲉⲙⲏⲣ
ⲛⲉⲙⲡⲁⲡⲛⲉⲩⲙⲁ	ⲛⲉⲙⲡⲁⲡⲛⲉⲩⲙⲁ
ⲛⲉⲙⲡⲁⲧⲉⲧⲉⲛϣϫⲉⲙϫⲟⲙ	ⲛⲉⲙⲡⲁⲧⲉⲧⲉⲛϣϫⲉⲙϫⲟⲙ
ⲛⲉⲙⲡⲉϥϣⲫⲏⲣ	ⲛⲉⲙⲡⲉϥϣⲫⲏⲣ
ⲛⲉⲙⲡⲉϥϩⲃⲟⲥ	ⲛⲉⲙⲡⲉϥϩⲃⲟⲥ
ⲛⲉⲙⲡⲉϥⲏⲓ	ⲛⲉⲙⲡⲉϥⲏⲓ
ⲛⲉⲙⲡⲉϥⲗⲁⲥ	ⲛⲉⲙⲡⲉϥⲗⲁⲥ
ⲛⲉⲙⲡⲓϣⲧⲁϯ	ⲛⲉⲙⲡⲓϣⲧⲁϯ
ⲛⲉⲙⲡⲓⲉϩⲟⲟⲩ	ⲛⲉⲙⲡⲓⲉϩⲟⲟⲩ
ⲛⲉⲙⲡⲓⲓⲃ	ⲛⲉⲙⲡⲓⲓⲃ
ⲛⲉⲙⲡⲓⲙⲱⲟⲩ	ⲛⲉⲙⲡⲓⲙⲱⲟⲩ
ⲛⲉⲙⲡⲟⲛⲏⲣⲓⲁ	ⲛⲉⲙⲡⲟⲛⲏⲣⲓⲁ
ⲛⲉⲙⲥϩⲓⲙⲓ	ⲛⲉⲙⲥϩⲓⲙⲓ
ⲛⲉⲙⲥⲓⲙⲱⲛ	ⲛⲉⲙⲥⲓⲙⲱⲛ
ⲛⲉⲙⲧⲁⲙⲁⲩ	ⲛⲉⲙⲧⲁⲙⲁⲩ
ⲛⲉⲙⲧⲁⲥⲱⲛⲓ	ⲛⲉⲙⲧⲁⲥⲱⲛⲓ
ⲛⲉⲙⲧⲉϥⲙⲁⲩ	ⲛⲉⲙⲧⲉϥⲙⲁⲩ
ⲛⲉⲙⲧⲉϥⲥⲩⲅⲅⲉⲛⲓⲁ	ⲛⲉⲙⲧⲉϥⲥⲩⲅⲅⲉⲛⲓⲁ
ⲛⲉⲙⲧⲉⲃⲧ	ⲛⲉⲙⲧⲉⲃⲧ
ⲛⲉⲙⲧⲉⲕⲙⲁⲩ	ⲛⲉⲙⲧⲉⲕⲙⲁⲩ
ⲛⲉⲙⲧⲉⲥϣⲉⲣⲓ	ⲛⲉⲙⲧⲉⲥϣⲉⲣⲓ
ⲛⲉⲙⲧⲉⲥⲙⲁⲩ	ⲛⲉⲙⲧⲉⲥⲙⲁⲩ
ⲛⲉⲙⲧⲥⲓⲇⲱⲛ	ⲛⲉⲙⲧⲥⲓⲇⲱⲛ
ⲛⲉⲙⲫⲏ	ⲛⲉⲙⲫⲏ
ⲛⲉⲙⲫⲓⲗⲓⲡⲡⲟⲥ	ⲛⲉⲙⲫⲓⲗⲓⲡⲡⲟⲥ
ⲛⲉⲙⲫⲓⲟⲙ	ⲛⲉⲙⲫⲓⲟⲙ
ⲛⲉⲙⲱ	ⲛⲉⲙⲱ
ⲛⲉⲙⲱⲟⲩ	ⲛⲉⲙⲱⲟⲩ
ⲛⲉⲙⲱⲧⲉⲛ	ⲛⲉⲙⲱⲧⲉⲛ
ⲛⲉⲛ	ⲛⲉⲛ
ⲛⲉⲛϥ	ⲛⲉⲛϥ
ⲛⲉⲛⲉϩ	ⲛⲉⲛⲉϩ
ⲛⲉⲛⲟⲭⲟⲥ	ⲛⲉⲛⲟⲭⲟⲥ
ⲛⲉⲛⲭⲁⲓ	ⲛⲉⲛⲭⲁⲓ
ⲛⲉⲟⲩⲉⲃⲟⲗ	ⲛⲉⲟⲩⲉⲃⲟⲗ
ⲛⲉⲟⲩⲉⲓⲛⲓⲛ	ⲛⲉⲟⲩⲉⲓⲛⲓⲛ
ⲛⲉⲟⲩⲟⲛ	ⲛⲉⲟⲩⲟⲛ
ⲛⲉⲟⲩⲡⲣⲟⲫⲏⲧⲏⲥ	ⲛⲉⲟⲩⲡⲣⲟⲫⲏⲧⲏⲥ
ⲛⲉⲡⲥⲏⲟⲩ	ⲛⲉⲡⲥⲏⲟⲩ
ⲛⲉⲣϣⲓϣⲓ	ⲛⲉⲣϣⲓϣⲓ
ⲛⲉⲣⲉⲡⲓⲧⲓⲙⲁⲛ	ⲛⲉⲣⲉⲡⲓⲧⲓⲙⲁⲛ
ⲛⲉⲧⲁϥⲓ	ⲛⲉⲧⲁϥⲓ
ⲛⲉⲧⲁⲓⲓ	ⲛⲉⲧⲁⲓⲓ
ⲛⲉⲧⲉⲛ	ⲛⲉⲧⲉⲛ
ⲛⲉⲧⲉⲛⲥϣⲉ	ⲛⲉⲧⲉⲛⲥϣⲉ
ⲛⲉⲧⲉⲛⲧⲁⲥ	ⲛⲉⲧⲉⲛⲧⲁⲥ
ⲛⲉⲩⲕⲉⲣⲓⲁ	ⲛⲉⲩⲕⲉⲣⲓⲁ
ⲛⲍⲉⲃⲉⲇⲉⲟⲥ	ⲛⲍⲉⲃⲉⲇⲉⲟⲥ
ⲛⲏ	ⲛⲏ
ⲛⲏⲉⲑⲙⲟⲕϩ	ⲛⲏⲉⲧⲙⲟⲕϩ
ⲛⲏⲓ	ⲛⲏⲓ
ⲛⲏⲗⲓⲁⲥ	ⲛⲏⲗⲓⲁⲥ
ⲛⲏⲟⲩ	ⲛⲏⲟⲩ
ⲛⲏⲣⲱⲇⲏⲥ	ⲛⲏⲣⲱⲇⲏⲥ
ⲛⲏⲣⲱⲇⲓⲁⲥ	ⲛⲏⲣⲱⲇⲓⲁⲥ
ⲛⲏⲥⲧⲓⲁ	ⲛⲏⲥⲧⲓⲁ
ⲛⲑⲁϣⲥ	ⲛⲑⲁϣⲥ
ⲛⲑⲁⲛⲓⲁⲣⲭⲱⲛ	ⲛⲑⲁⲛⲓⲁⲣⲭⲱⲛ
ⲛⲑⲁⲡⲁⲓⲉⲛⲉϩ	ⲛⲑⲁⲡⲁⲓⲉⲛⲉϩ
ⲛⲑⲏ	ⲛⲑⲏ
ⲛⲑⲏⲟⲩ	ⲛⲑⲏⲟⲩ
ⲛⲑⲟϥ	ⲛⲑⲟϥ
ⲛⲑⲟⲕ	ⲛⲑⲟⲕ
ⲛⲑⲟⲥ	ⲛⲑⲟⲥ
ⲛⲑⲱⲟⲩ	ⲛⲑⲱⲟⲩ
ⲛⲑⲱⲣⲡ	ⲛⲑⲱⲣⲡ
ⲛⲑⲱⲧⲉⲛ	ⲛⲑⲱⲧⲉⲛ
ⲛⲓ	ⲛⲓ
ⲛⲓϣϯ	ⲛⲓϣϯ
ⲛⲓϧⲣⲏⲟⲩⲓ	ⲛⲓϧⲣⲏⲟⲩⲓ
ⲛⲓϧⲱⲧⲉⲃ	ⲛⲓϧⲱⲧⲉⲃ
ⲛⲓϫⲉⲟⲩⲁ	ⲛⲓϫⲉⲟⲩⲁ
ⲛⲓϫⲟⲗ	ⲛⲓϫⲟⲗ
ⲛⲓϫⲟⲙ	ⲛⲓϫⲟⲙ
ⲛⲓϭⲓⲟⲩⲓ	ⲛⲓϭⲓⲟⲩⲓ
ⲛⲓⲁⲅⲅⲉⲗⲟⲥ	ⲛⲓⲁⲅⲅⲉⲗⲟⲥ
ⲛⲓⲁⲕⲱⲃⲟⲥ	ⲛⲓⲁⲕⲱⲃⲟⲥ
ⲛⲓⲁⲣⲟ	ⲛⲓⲁⲣⲟ
ⲛⲓⲁⲥⲕⲟⲥ	ⲛⲓⲁⲥⲕⲟⲥ
ⲛⲓⲁⲧⲥⲁϫⲓ	ⲛⲓⲁⲧⲥⲁϫⲓ
ⲛⲓⲃⲁⲕⲓ	ⲛⲓⲃⲁⲕⲓ
ⲛⲓⲃⲁⲗ	ⲛⲓⲃⲁⲗ
ⲛⲓⲃⲉⲛ	ⲛⲓⲃⲉⲛ
ⲛⲓⲇⲉⲙⲱⲛ	ⲛⲓⲇⲁⲓⲙⲱⲛ
ⲛⲓⲉⲛⲧⲟⲗⲏ	ⲛⲓⲉⲛⲧⲟⲗⲏ
ⲛⲓⲏⲥⲟⲩⲥ	ⲛⲓⲏⲥⲟⲩⲥ
ⲛⲓⲑⲟϣ	ⲛⲓⲑⲟϣ
ⲛⲓⲓⲟϩⲓ	ⲛⲓⲓⲟϩⲓ
ⲛⲓⲕⲉⲟⲩϩⲱⲣ	ⲛⲓⲕⲉⲟⲩϩⲱⲣ
ⲛⲓⲕⲉⲡⲁⲣⲁⲃⲟⲗⲏ	ⲛⲓⲕⲉⲡⲁⲣⲁⲃⲟⲗⲏ
ⲛⲓⲙ	ⲛⲓⲙ
ⲛⲓⲙⲁⲑⲏⲧⲏⲥ	ⲛⲓⲙⲁⲑⲏⲧⲏⲥ
ⲛⲓⲙⲉⲧϭⲓⲛϫⲟⲛⲥ	ⲛⲓⲙⲉⲧϭⲓⲛϫⲟⲛⲥ
ⲛⲓⲙⲉⲧⲇⲟⲗⲟⲥ	ⲛⲓⲙⲉⲧⲇⲟⲗⲟⲥ
ⲛⲓⲙⲉⲧⲛⲱⲓⲕ	ⲛⲓⲙⲉⲧⲛⲱⲓⲕ
ⲛⲓⲙⲉⲧⲡⲉⲧϩⲱⲟⲩ	ⲛⲓⲙⲉⲧⲡⲉⲧϩⲱⲟⲩ
ⲛⲓⲛⲟⲃⲓ	ⲛⲓⲛⲟⲃⲓ
ⲛⲓⲡⲛⲉⲩⲙⲁ	ⲛⲓⲡⲛⲉⲩⲙⲁ
ⲛⲓⲡⲟⲣⲛⲓⲁ	ⲛⲓⲡⲟⲣⲛⲓⲁ
ⲛⲓⲡⲟⲣⲛⲟⲥ	ⲛⲓⲡⲟⲣⲛⲟⲥ
ⲛⲓⲣⲉϥϣⲁⲙϣⲉⲓⲇⲱⲗⲟⲛ	ⲛⲓⲣⲉϥϣⲁⲙϣⲉⲓⲇⲱⲗⲟⲛ
ⲛⲓⲣⲉϥϩⲱⲗⲉⲙ	ⲛⲓⲣⲉϥϩⲱⲗⲉⲙ
ⲛⲓⲣⲉϥϭⲓⲛϫⲟⲛⲥ	ⲛⲓⲣⲉϥϭⲓⲛϫⲟⲛⲥ
ⲛⲓⲣⲉϥⲉⲣⲛⲟⲃⲓ	ⲛⲓⲣⲉϥⲉⲣⲛⲟⲃⲓ
ⲛⲓⲥⲁϧ	ⲛⲓⲥⲁϧ
ⲛⲓⲥⲱϥ	ⲛⲓⲥⲱϥ
ⲛⲓⲧⲣⲁⲡⲉⲍⲁ	ⲛⲓⲧⲣⲁⲡⲉⲍⲁ
ⲛⲓⲫⲁⲣⲓⲥⲉⲟⲥ	ⲛⲓⲫⲁⲣⲓⲥⲁⲓⲟⲥ
ⲛⲓⲭⲣⲏⲙⲁ	ⲛⲓⲭⲣⲏⲙⲁ
ⲛⲓⲱⲁⲛⲛⲏⲥ	ⲛⲓⲱⲁⲛⲛⲏⲥ
ⲛⲓⲱⲓⲕ	ⲛⲓⲱⲓⲕ
ⲛⲓⲱⲧ	ⲛⲓⲱⲧ
ⲛⲕⲁϩⲓ	ⲛⲕⲁϩⲓ
ⲛⲕⲁⲕⲓⲁ	ⲛⲕⲁⲕⲓⲁ
ⲛⲕⲉⲕⲟⲩϫⲓ	ⲛⲕⲉⲕⲟⲩϫⲓ
ⲛⲕⲉⲛⲧⲉ	ⲛⲕⲉⲛⲧⲉ
ⲛⲕⲉⲟⲩⲁⲓ	ⲛⲕⲉⲟⲩⲁⲓ
ⲛⲕⲉⲟⲩⲓ	ⲛⲕⲉⲟⲩⲓ
ⲛⲕⲟⲧ	ⲛⲕⲟⲧ
ⲛⲕⲟⲩⲣ	ⲛⲕⲟⲩⲣ
ⲛⲕⲱϯ	ⲛⲕⲱϯ
ⲛⲕⲱⲃ	ⲛⲕⲱⲃ
ⲛⲗ	ⲛⲗ
ⲛⲗⲁⲕϩ	ⲛⲗⲁⲕϩ
ⲛⲙ	ⲛⲙ
ⲛⲙⲟϣⲓ	ⲛⲙⲟϣⲓ
ⲛⲛⲁⲓ	ⲛⲛⲁⲓ
ⲛⲛⲁⲓⲁⲗⲱⲟⲩⲓ	ⲛⲛⲁⲓⲁⲗⲱⲟⲩⲓ
ⲛⲛⲁⲓⲕⲉⲭⲱⲟⲩⲛⲓ	ⲛⲛⲁⲓⲕⲉⲭⲱⲟⲩⲛⲓ
ⲛⲛⲁⲓⲕⲟⲩϫⲓ	ⲛⲛⲁⲓⲕⲟⲩϫⲓ
ⲛⲛⲁⲙⲱⲓⲧ	ⲛⲛⲁⲙⲱⲓⲧ
ⲛⲛⲁⲡⲓⲣⲱⲙⲓ	ⲛⲛⲁⲡⲓⲣⲱⲙⲓ
ⲛⲛⲉ	ⲛⲛⲉ
ⲛⲛⲉϣ	ⲛⲛⲉϣ
ⲛⲛⲉϥϭⲁⲗⲁⲩϫ	ⲛⲛⲉϥϭⲁⲗⲁⲩϫ
ⲛⲛⲉϥⲓ	ⲛⲛⲉϥⲓ
ⲛⲛⲉϥⲙⲁⲑⲏⲧⲏⲥ	ⲛⲛⲉϥⲙⲁⲑⲏⲧⲏⲥ
ⲛⲛⲉϥⲛⲁϫϩⲓ	ⲛⲛⲉϥⲛⲁϫϩⲓ
ⲛⲛⲉϥⲛⲓϣϯ	ⲛⲛⲉϥⲛⲓϣϯ
ⲛⲛⲉϥⲥⲕⲉⲩⲟⲥ	ⲛⲛⲉϥⲥⲕⲉⲩⲟⲥ
ⲛⲛⲉϥⲭⲱ	ⲛⲛⲉϥⲭⲱ
ⲛⲛⲉϩ	ⲛⲛⲉϩ
ⲛⲛⲉⲕⲙⲁⲑⲏⲧⲏⲥ	ⲛⲛⲉⲕⲙⲁⲑⲏⲧⲏⲥ
ⲛⲛⲉⲛϫⲓϫ	ⲛⲛⲉⲛϫⲓϫ
ⲛⲛⲉⲥϣⲱⲡⲓ	ⲛⲛⲉⲥϣⲱⲡⲓ
ⲛⲛⲉⲧⲉⲛϭⲁⲗⲁⲩϫ	ⲛⲛⲉⲧⲛϭⲁⲗⲁⲩϫ
ⲛⲛⲉⲧⲉⲛⲡⲁⲣⲁⲡⲧⲱⲙⲁ	ⲛⲛⲉⲧⲛⲡⲁⲣⲁⲡⲧⲱⲙⲁ
ⲛⲛⲉⲧⲉⲛⲥⲛⲏⲟⲩ	ⲛⲛⲉⲧⲉⲛⲥⲛⲏⲟⲩ
ⲛⲛⲏ	ⲛⲛⲏ
ⲛⲛⲓϣϯ	ⲛⲛⲓϣϯ
ⲛⲛⲓϣⲏⲣⲓ	ⲛⲛⲓϣⲏⲣⲓ
ⲛⲛⲓϧⲣⲏⲟⲩⲓ	ⲛⲛⲓϧⲣⲏⲟⲩⲓ
ⲛⲛⲓϩⲁⲗⲩⲥⲓⲥ	ⲛⲛⲓϩⲁⲗⲩⲥⲓⲥ
ⲛⲛⲓϩⲏⲕⲓ	ⲛⲛⲓϩⲏⲕⲓ
ⲛⲛⲓϩⲟⲩⲟ	ⲛⲛⲓϩⲟⲩⲟ
ⲛⲛⲓϯⲙⲓ	ⲛⲛⲓϯⲙⲓ
ⲛⲛⲓⲁⲣⲭⲓⲉⲣⲉⲩⲥ	ⲛⲛⲓⲁⲣⲭⲓⲉⲣⲉⲩⲥ
ⲛⲛⲓⲁⲣⲭⲱⲛ	ⲛⲛⲓⲁⲣⲭⲱⲛ
ⲛⲛⲓⲇⲉⲙⲱⲛ	ⲛⲛⲓⲇⲁⲓⲙⲱⲛ
ⲛⲛⲓⲉⲑⲛⲟⲥ	ⲛⲛⲓⲉⲑⲛⲟⲥ
ⲛⲛⲓⲉⲛⲉϩ	ⲛⲛⲓⲉⲛⲉϩ
ⲛⲛⲓⲕⲉⲭⲱⲟⲩⲛⲓ	ⲛⲛⲓⲕⲉⲭⲱⲟⲩⲛⲓ
ⲛⲛⲓⲙⲁⲑⲏⲧⲏⲥ	ⲛⲛⲓⲙⲁⲑⲏⲧⲏⲥ
ⲛⲛⲓⲙⲉⲗⲟⲥ	ⲛⲛⲓⲙⲉⲗⲟⲥ
ⲛⲛⲓⲙⲏϣ	ⲛⲛⲓⲙⲏϣ
ⲛⲛⲓⲙⲟⲕⲙⲉⲕ	ⲛⲛⲓⲙⲟⲕⲙⲉⲕ
ⲛⲛⲓⲟⲩϩⲱⲣ	ⲛⲛⲓⲟⲩϩⲱⲣ
ⲛⲛⲓⲡⲛⲁⲧⲓⲕⲟⲥ	ⲛⲛⲓⲡⲛⲉⲩⲙⲁⲧⲓⲕⲟⲥ
ⲛⲛⲓⲡⲛⲉⲩⲙⲁ	ⲛⲛⲓⲡⲛⲉⲩⲙⲁ
ⲛⲛⲓⲡⲣⲉⲥⲃⲩⲧⲉⲣⲟⲥ	ⲛⲛⲓⲡⲣⲉⲥⲃⲩⲧⲉⲣⲟⲥ
ⲛⲛⲓⲡⲣⲟⲫⲏⲧⲏⲥ	ⲛⲛⲓⲡⲣⲟⲫⲏⲧⲏⲥ
ⲛⲛⲓⲣⲟϯ	ⲛⲛⲓⲣⲟϯ
ⲛⲛⲓⲣⲱⲙⲓ	ⲛⲛⲓⲣⲱⲙⲓ
ⲛⲛⲓⲥⲁϧ	ⲛⲛⲓⲥⲁϧ
ⲛⲛⲓⲥⲁⲃⲉⲩ	ⲛⲛⲓⲥⲁⲃⲉⲩ
ⲛⲛⲓⲥⲟϭⲛⲓ	ⲛⲛⲓⲥⲟϭⲛⲓ
ⲛⲛⲓⲱⲓⲕ	ⲛⲛⲓⲱⲓⲕ
ⲛⲛⲟⲩϣⲛⲏⲟⲩ	ⲛⲛⲟⲩϣⲛⲏⲟⲩ
ⲛⲛⲟⲩϩⲃⲱⲥ	ⲛⲛⲟⲩϩⲃⲱⲥ
ⲛⲛⲟⲩϫ	ⲛⲛⲟⲩϫ
ⲛⲛⲟⲩⲉⲣⲏⲟⲩ	ⲛⲛⲟⲩⲉⲣⲏⲩ
ⲛⲛⲟⲩⲛⲟⲃⲓ	ⲛⲛⲟⲩⲛⲟⲃⲓ
ⲛⲛⲱⲓⲕ	ⲛⲛⲱⲓⲕ
ⲛⲝ	ⲛⲝ
ⲛⲟϩⲉⲙ	ⲛⲟϩⲉⲙ
ⲛⲟⲃⲓ	ⲛⲟⲃⲓ
ⲛⲟⲩ	ⲛⲟⲩ
ⲛⲟⲩϥ	ⲛⲟⲩϥ
ⲛⲟⲩϧⲣⲉ	ⲛⲟⲩϧⲣⲉ
ⲛⲟⲩϫ	ⲛⲟⲩϫ
ⲛⲟⲩϫⲟⲙ	ⲛⲟⲩϫⲟⲙ
ⲛⲟⲩϭⲁⲙⲟⲩⲗ	ⲛⲟⲩϭⲁⲙⲟⲩⲗ
ⲛⲟⲩϭⲣⲟⲙⲡⲓ	ⲛⲟⲩϭⲣⲟⲙⲡⲓ
ⲛⲟⲩϯ	ⲛⲟⲩϯ
ⲛⲟⲩⲁϩⲟ	ⲛⲟⲩⲁϩⲟ
ⲛⲟⲩⲁⲓ	ⲛⲟⲩⲁⲓ
ⲛⲟⲩⲁⲗⲟⲩ	ⲛⲟⲩⲁⲗⲟⲩ
ⲛⲟⲩⲁⲫⲟⲧ	ⲛⲟⲩⲁⲫⲟⲧ
ⲛⲟⲩⲃ	ⲛⲟⲩⲃ
ⲛⲟⲩⲃⲉⲗⲗⲉ	ⲛⲟⲩⲃⲉⲗⲗⲉ
ⲛⲟⲩⲉⲓ	ⲛⲟⲩⲉⲓ
ⲛⲟⲩⲉⲣϣⲓ	ⲛⲟⲩⲉⲣϣⲓ
ⲛⲟⲩⲉⲣⲱϯ	ⲛⲟⲩⲉⲣⲱϯ
ⲛⲟⲩⲑⲃⲁ	ⲛⲟⲩⲑⲃⲁ
ⲛⲟⲩⲕ	ⲛⲟⲩⲕ
ⲛⲟⲩⲕⲟⲩϫⲓ	ⲛⲟⲩⲕⲟⲩϫⲓ
ⲛⲟⲩⲕⲟⲩⲣ	ⲛⲟⲩⲕⲟⲩⲣ
ⲛⲟⲩⲙⲁ	ⲛⲟⲩⲙⲁ
ⲛⲟⲩⲙⲏϣ	ⲛⲟⲩⲙⲏϣ
ⲛⲟⲩⲙⲏⲓⲛⲓ	ⲛⲟⲩⲙⲏⲓⲛⲓ
ⲛⲟⲩⲙⲟϫϧ	ⲛⲟⲩⲙⲟϫϧ
ⲛⲟⲩⲙⲟⲩ	ⲛⲟⲩⲙⲟⲩ
ⲛⲟⲩⲙⲟⲩⲥⲉⲣ	ⲛⲟⲩⲙⲟⲩⲥⲉⲣ
ⲛⲟⲩⲛⲁⲫⲣⲓ	ⲛⲟⲩⲛⲁⲫⲣⲓ
ⲛⲟⲩⲛⲓ	ⲛⲟⲩⲛⲓ
ⲛⲟⲩⲛⲓϣϯ	ⲛⲟⲩⲛⲓϣϯ
ⲛⲟⲩⲛⲟⲃⲓ	ⲛⲟⲩⲛⲟⲃⲓ
ⲛⲟⲩⲛⲟⲩ	ⲛⲟⲩⲛⲟⲩ
ⲛⲟⲩⲟⲛ	ⲛⲟⲩⲟⲛ
ⲛⲟⲩⲟⲣⲡⲟⲩ	ⲛⲟⲩⲟⲣⲡⲟⲩ
ⲛⲟⲩⲣⲁⲛ	ⲛⲟⲩⲣⲁⲛ
ⲛⲟⲩⲣⲉϥⲙⲱⲟⲩⲧ	ⲛⲟⲩⲣⲉϥⲙⲱⲟⲩⲧ
ⲛⲟⲩⲣⲟ	ⲛⲟⲩⲣⲟ
ⲛⲟⲩⲣⲱⲙⲓ	ⲛⲟⲩⲣⲱⲙⲓ
ⲛⲟⲩⲥⲁⲃⲉ	ⲛⲟⲩⲥⲁⲃⲉ
ⲛⲟⲩⲥⲉⲛϯ	ⲛⲟⲩⲥⲉⲛϯ
ⲛⲟⲩⲥⲏϫ	ⲛⲟⲩⲥⲏϫ
ⲛⲟⲩⲥⲓⲙ	ⲛⲟⲩⲥⲓⲙ
ⲛⲟⲩⲥⲕⲉⲡⲱⲗⲁⲧⲟⲣ	ⲛⲟⲩⲥⲕⲉⲡⲱⲗⲁⲧⲟⲣ
ⲛⲟⲩⲥⲟϭⲛⲓ	ⲛⲟⲩⲥⲟϭⲛⲓ
ⲛⲟⲩⲧⲉⲛ	ⲛⲟⲩⲧⲉⲛ
ⲛⲟⲩⲭⲓⲱⲛ	ⲛⲟⲩⲭⲓⲱⲛ
ⲛⲟⲩⲱϣⲉⲙ	ⲛⲟⲩⲱϣⲉⲙ
ⲛⲟⲩⲱⲙ	ⲛⲟⲩⲱⲙ
ⲛⲟⲩⲱⲙⲥ	ⲛⲟⲩⲱⲙⲥ
ⲛⲟⲩⲱⲛϧ	ⲛⲟⲩⲱⲛϧ
ⲛⲟⲩⲱⲛϩ	ⲛⲟⲩⲱⲛϩ
ⲛⲟⲩⲱⲧ	ⲛⲟⲩⲱⲧ
ⲛⲣ	ⲛⲣ
ⲛⲣⲁⲧⲟⲩ	ⲛⲣⲁⲧⲟⲩ
ⲛⲣⲉϥϣⲱⲛⲓ	ⲛⲣⲉϥϣⲱⲛⲓ
ⲛⲣⲉϥⲉⲣϩⲱⲃ	ⲛⲣⲉϥⲉⲣϩⲱⲃ
ⲛⲣⲉϥⲉⲣⲛⲟⲃⲓ	ⲛⲣⲉϥⲉⲣⲛⲟⲃⲓ
ⲛⲣⲉϥⲧⲁϩⲉⲣⲱⲙⲓ	ⲛⲣⲉϥⲧⲁϩⲉⲣⲱⲙⲓ
ⲛⲣⲉϥⲧⲱⲃϩ	ⲛⲣⲉϥⲧⲱⲃϩ
ⲛⲣⲏϯ	ⲛⲣⲏϯ
ⲛⲣⲓⲣ	ⲛⲣⲓⲣ
ⲛⲣⲟⲙⲡⲓ	ⲛⲣⲟⲙⲡⲓ
ⲛⲣⲱⲕ	ⲛⲣⲱⲕ
ⲛⲣⲱⲙⲓ	ⲛⲣⲱⲙⲓ
ⲛⲣⲱⲟⲩ	ⲛⲣⲱⲟⲩ
ⲛⲥϣⲉ	ⲛⲥϣⲉ
ⲛⲥϧⲓ	ⲛⲥϧⲓ
ⲛⲥϩⲓⲙⲓ	ⲛⲥϩⲓⲙⲓ
ⲛⲥⲁ	ⲛⲥⲁ
ⲛⲥⲁⲃⲉ	ⲛⲥⲁⲃⲉ
ⲛⲥⲁⲑⲉⲣⲓ	ⲛⲥⲁⲑⲉⲣⲓ
ⲛⲥⲁⲑⲏⲛⲟⲩ	ⲛⲥⲁⲑⲏⲛⲟⲩ
ⲛⲥⲁⲟⲩ	ⲛⲥⲁⲟⲩ
ⲛⲥⲁⲟⲩⲓⲛⲁⲙ	ⲛⲥⲁⲟⲩⲓⲛⲁⲙ
ⲛⲥⲁⲟⲩⲙⲏⲓⲛⲓ	ⲛⲥⲁⲟⲩⲙⲏⲓⲛⲓ
ⲛⲥⲁⲡⲉϥⲓⲱⲧ	ⲛⲥⲁⲡⲉϥⲉⲓⲱⲧ
ⲛⲥⲉϣⲧⲉⲙϫⲟⲥ	ⲛⲥⲉϣⲧⲉⲙϫⲟⲥ
ⲛⲥⲉϣⲧⲉⲙⲟⲩⲟⲛϩϥ	ⲛⲥⲉϣⲧⲉⲙⲟⲩⲟⲛϩϥ
ⲛⲥⲉϧⲟⲙϧⲉⲙ	ⲛⲥⲉϧⲟⲙϧⲉⲙ
ⲛⲥⲉϩⲓⲧⲕ	ⲛⲥⲉϩⲓⲧⲕ
ⲛⲥⲉϫⲉⲙⲟⲩⲁⲓ	ⲛⲥⲉϫⲉⲙⲟⲩⲁⲓ
ⲛⲥⲉⲉⲣⲙⲉⲧⲁⲛⲟⲓⲛ	ⲛⲥⲉⲉⲣⲙⲉⲧⲁⲛⲟⲓⲛ
ⲛⲥⲉⲛⲁϫⲉⲙϯⲡⲓ	ⲛⲥⲉⲛⲁϫⲉⲙϯⲡⲓ
ⲛⲥⲉⲣⲱⲧⲉⲃ	ⲛⲥⲉⲣⲱⲧⲉⲃ
ⲛⲥⲉⲭⲁϥ	ⲛⲥⲉⲭⲁϥ
ⲛⲥⲉⲱⲗⲓ	ⲛⲥⲉⲱⲗⲓ
ⲛⲥⲏⲓⲛⲓ	ⲛⲥⲏⲓⲛⲓ
ⲛⲥⲏⲟⲩ	ⲛⲥⲏⲟⲩ
ⲛⲥⲓϯ	ⲛⲥⲓϯ
ⲛⲥⲓⲙⲡⲟⲥⲓⲟⲛ	ⲛⲥⲓⲙⲡⲟⲥⲓⲟⲛ
ⲛⲥⲓⲙⲱⲛ	ⲛⲥⲓⲙⲱⲛ
ⲛⲥⲕⲩⲛⲏ	ⲛⲥⲕⲩⲛⲏ
ⲛⲥⲙⲏ	ⲛⲥⲙⲏ
ⲛⲥⲟⲛⲓ	ⲛⲥⲟⲛⲓ
ⲛⲥⲟⲡ	ⲛⲥⲟⲡ
ⲛⲥⲟⲫⲓⲁ	ⲛⲥⲟⲫⲓⲁ
ⲛⲥⲭⲏⲙⲁ	ⲛⲥⲭⲏⲙⲁ
ⲛⲥⲱ	ⲛⲥⲱ
ⲛⲥⲱϥ	ⲛⲥⲱϥ
ⲛⲥⲱϯ	ⲛⲥⲱϯ
ⲛⲥⲱⲓ	ⲛⲥⲱⲓ
ⲛⲥⲱⲕ	ⲛⲥⲱⲕ
ⲛⲥⲱⲛ	ⲛⲥⲱⲛ
ⲛⲥⲱⲟⲩ	ⲛⲥⲱⲟⲩ
ⲛⲥⲱⲧⲉⲙ	ⲛⲥⲱⲧⲉⲙ
ⲛⲧ	ⲛⲧ
ⲛⲧϣⲉⲃⲓⲱ	ⲛⲧϣⲉⲃⲓⲱ
ⲛⲧϫⲓϫ	ⲛⲧϫⲓϫ
ⲛⲧⲁ	ⲛⲧⲁ
ⲛⲧⲁϥ	ⲛⲧⲁϥ
ⲛⲧⲁⲁⲓϥ	ⲛⲧⲁⲁⲓϥ
ⲛⲧⲁⲁⲓⲧⲟⲩ	ⲛⲧⲁⲁⲓⲧⲟⲩ
ⲛⲧⲁⲉⲣⲑⲏⲛⲟⲩ	ⲛⲧⲁⲉⲣⲑⲏⲛⲟⲩ
ⲛⲧⲁⲉⲣⲕⲗⲏⲣⲟⲛⲟⲙⲟⲥ	ⲛⲧⲁⲉⲣⲕⲗⲏⲣⲟⲛⲟⲙⲟⲥ
ⲛⲧⲁⲓ	ⲛⲧⲁⲓ
ⲛⲧⲁⲙⲉⲧⲟⲩⲣⲟ	ⲛⲧⲁⲙⲉⲧⲟⲩⲣⲟ
ⲛⲧⲁⲛⲁⲩ	ⲛⲧⲁⲛⲁⲩ
ⲛⲧⲁⲧⲏⲓϥ	ⲛⲧⲁⲧⲏⲓϥ
ⲛⲧⲁⲫⲉ	ⲛⲧⲁⲫⲉ
ⲛⲧⲁⲱⲗⲓ	ⲛⲧⲁⲱⲗⲓ
ⲛⲧⲉ	ⲛⲧⲉ
ⲛⲧⲉϣⲧⲉⲙϩⲗⲓ	ⲛⲧⲉϣⲧⲉⲙϩⲗⲓ
ⲛⲧⲉϣⲧⲉⲙⲡⲓⲏⲓ	ⲛⲧⲉϣⲧⲉⲙⲡⲓⲏⲓ
ⲛⲧⲉϥ	ⲛⲧⲉϥ
ⲛⲧⲉϥϣϫⲉⲙϫⲟⲙ	ⲛⲧⲉϥϣϫⲉⲙϫⲟⲙ
ⲛⲧⲉϥϣⲧⲉⲙϣϫⲉⲙϫⲟⲙ	ⲛⲧⲉϥϣⲧⲉⲙϣϫⲉⲙϫⲟⲙ
ⲛⲧⲉϥϣⲧⲉⲙϣⲱⲡⲓ	ⲛⲧⲉϥϣⲧⲉⲙϣⲱⲡⲓ
ⲛⲧⲉϥϣⲧⲉⲙϭⲓⲥⲁⲛⲓⲥ	ⲛⲧⲉϥϣⲧⲉⲙϭⲓⲥⲁⲛⲓⲥ
ⲛⲧⲉϥϣⲧⲉⲙⲟⲩⲟⲣⲡ	ⲛⲧⲉϥϣⲧⲉⲙⲟⲩⲟⲣⲡ
ⲛⲧⲉϥϩⲉⲙⲥⲓ	ⲛⲧⲉϥϩⲉⲙⲥⲓ
ⲛⲧⲉϥϩⲓⲇⲉⲙⲱⲛ	ⲛⲧⲉϥϩⲓⲇⲉⲙⲱⲛ
ⲛⲧⲉϥϩⲱⲗⲉⲙ	ⲛⲧⲉϥϩⲱⲗⲉⲙ
ⲛⲧⲉϥϫⲓϫ	ⲛⲧⲉϥϫⲓϫ
ⲛⲧⲉϥϭⲓ	ⲛⲧⲉϥϭⲓ
ⲛⲧⲉϥϯⲟⲥⲓ	ⲛⲧⲉϥϯⲟⲥⲓ
ⲛⲧⲉϥⲁⲗⲏⲓ	ⲛⲧⲉϥⲁⲗⲏⲓ
ⲛⲧⲉϥⲁⲫⲉ	ⲛⲧⲉϥⲁⲫⲉ
ⲛⲧⲉϥⲉⲛⲟⲩⲥⲕⲉⲩⲟⲥ	ⲛⲧⲉϥⲉⲛⲟⲩⲥⲕⲉⲩⲟⲥ
ⲛⲧⲉϥⲉⲣⲥⲁⲃⲉ	ⲛⲧⲉϥⲉⲣⲥⲁⲃⲉ
ⲛⲧⲉϥⲓ	ⲛⲧⲉϥⲓ
ⲛⲧⲉϥⲓⲛⲓ	ⲛⲧⲉϥⲓⲛⲓ
ⲛⲧⲉϥⲙⲟϩ	ⲛⲧⲉϥⲙⲟϩ
ⲛⲧⲉϥⲛⲁϩϯ	ⲛⲧⲉϥⲛⲁϩϯ
ⲛⲧⲉϥⲛⲕⲟⲧ	ⲛⲧⲉϥⲛⲕⲟⲧ
ⲛⲧⲉϥⲟϩⲓ	ⲛⲧⲉϥⲟϩⲓ
ⲛⲧⲉϥⲟⲩⲁϩϥ	ⲛⲧⲉϥⲟⲩⲁϩϥ
ⲛⲧⲉϥⲟⲩⲟⲣⲡⲟⲩ	ⲛⲧⲉϥⲟⲩⲟⲣⲡⲟⲩ
ⲛⲧⲉϥⲥⲱⲗⲡ	ⲛⲧⲉϥⲥⲱⲗⲡ
ⲛⲧⲉϥⲥⲱⲛϩ	ⲛⲧⲉϥⲥⲱⲛϩ
ⲛⲧⲉϥⲧⲁⲕⲟϥ	ⲛⲧⲉϥⲧⲁⲕⲟϥ
ⲛⲧⲉϥⲧⲱⲛϥ	ⲛⲧⲉϥⲧⲱⲛϥ
ⲛⲧⲉϥⲭⲁϫⲓϫ	ⲛⲧⲉϥⲭⲁϫⲓϫ
ⲛⲧⲉϥⲭⲁⲣⲱϥ	ⲛⲧⲉϥⲭⲁⲣⲱϥ
ⲛⲧⲉϥⲭⲱ	ⲛⲧⲉϥⲭⲱ
ⲛⲧⲉϥⲯⲩⲭⲏ	ⲛⲧⲉϥⲯⲩⲭⲏ
ⲛⲧⲉϥⲱⲗⲓ	ⲛⲧⲉϥⲱⲗⲓ
ⲛⲧⲉϩⲁⲛⲁⲫⲟⲧ	ⲛⲧⲉϩⲁⲛⲁⲫⲟⲧ
ⲛⲧⲉϩⲁⲛⲛⲟⲃⲓ	ⲛⲧⲉϩⲁⲛⲛⲟⲃⲓ
ⲛⲧⲉϩⲁⲛⲥⲁϫⲓ	ⲛⲧⲉϩⲁⲛⲥⲁϫⲓ
ⲛⲧⲉϩⲁⲛⲥⲁⲃⲉⲩ	ⲛⲧⲉϩⲉⲛⲥⲁⲃⲉⲩ
ⲛⲧⲉϩⲗⲓ	ⲛⲧⲉϩⲗⲓ
ⲛⲧⲉϯϧⲁⲣⲁⲃⲁⲓ	ⲛⲧⲉϯϧⲁⲣⲁⲃⲁⲓ
ⲛⲧⲉϯⲅⲁⲗⲓⲗⲉⲁ	ⲛⲧⲉϯⲅⲁⲗⲓⲗⲉⲁ
ⲛⲧⲉϯⲓⲟⲩⲇⲉⲁ	ⲛⲧⲉϯⲓⲟⲩⲇⲉⲁ
ⲛⲧⲉϯⲙⲉⲧⲟⲩⲣⲟ	ⲛⲧⲉϯⲙⲉⲧⲟⲩⲣⲟ
ⲛⲧⲉϯⲙⲉⲧⲣⲁⲙⲁⲟ	ⲛⲧⲉϯⲙⲉⲧⲣⲁⲙⲁⲟ
ⲛⲧⲉϯⲙⲏϯ	ⲛⲧⲉϯⲙⲏϯ
ⲛⲧⲉϯⲡⲣⲟⲑⲉⲥⲓⲥ	ⲛⲧⲉϯⲡⲣⲟⲑⲉⲥⲓⲥ
ⲛⲧⲉϯⲥⲁⲣⲝ	ⲛⲧⲉϯⲥⲁⲣⲝ
ⲛⲧⲉⲁⲗⲫⲉⲟⲥ	ⲛⲧⲉⲁⲗⲫⲉⲟⲥ
ⲛⲧⲉⲃⲧ	ⲛⲧⲉⲃⲧ
ⲛⲧⲉⲇⲁⲗⲙⲁⲛⲟⲩⲑⲁ	ⲛⲧⲉⲇⲁⲗⲙⲁⲛⲟⲩⲑⲁ
ⲛⲧⲉⲏⲗⲓⲁⲥ	ⲛⲧⲉⲏⲗⲓⲁⲥ
ⲛⲧⲉⲓⲏⲥⲟⲩⲥ	ⲛⲧⲉⲓⲏⲥⲟⲩⲥ
ⲛⲧⲉⲓⲱⲁⲛⲛⲏⲥ	ⲛⲧⲉⲓⲱⲁⲛⲛⲏⲥ
ⲛⲧⲉⲕϣⲉ	ⲛⲧⲉⲕϣⲉ
ⲛⲧⲉⲕϯ	ⲛⲧⲉⲕϯ
ⲛⲧⲉⲕⲁⲓϥ	ⲛⲧⲉⲕⲁⲓϥ
ⲛⲧⲉⲕⲉⲟⲩⲁⲓ	ⲛⲧⲉⲕⲉⲟⲩⲁⲓ
ⲛⲧⲉⲕⲉⲥⲁⲣⲓⲁ	ⲛⲧⲉⲕⲉⲥⲁⲣⲓⲁ
ⲛⲧⲉⲕⲓ	ⲛⲧⲉⲕⲓ
ⲛⲧⲉⲕⲓⲣⲓ	ⲛⲧⲉⲕⲓⲣⲓ
ⲛⲧⲉⲕⲟⲩⲱϣ	ⲛⲧⲉⲕⲟⲩⲱϣ
ⲛⲧⲉⲕⲭⲁⲧⲉⲕϫⲓϫ	ⲛⲧⲉⲕⲭⲁⲧⲉⲕϫⲓϫ
ⲛⲧⲉⲗⲱⲛⲏⲥ	ⲛⲧⲉⲗⲱⲛⲏⲥ
ⲛⲧⲉⲛ	ⲛⲧⲉⲛ
ⲛⲧⲉⲛϣⲉ	ⲛⲧⲉⲛϣⲉ
ⲛⲧⲉⲛϣⲉⲡ	ⲛⲧⲉⲛϣⲉⲡ
ⲛⲧⲉⲛϣⲱⲡⲓ	ⲛⲧⲉⲛϣⲱⲡⲓ
ⲛⲧⲉⲛϩⲓⲱⲓϣ	ⲛⲧⲉⲛϩⲓⲱⲓϣ
ⲛⲧⲉⲛϫⲟⲥ	ⲛⲧⲉⲛϫⲟⲥ
ⲛⲧⲉⲛϯ	ⲛⲧⲉⲛϯ
ⲛⲧⲉⲛⲉϥϩⲃⲱⲥ	ⲛⲧⲉⲛⲉϥϩⲃⲱⲥ
ⲛⲧⲉⲛⲉϥⲙⲁⲑⲏⲧⲏⲥ	ⲛⲧⲉⲛⲉϥⲙⲁⲑⲏⲧⲏⲥ
ⲛⲧⲉⲛⲉⲙⲓ	ⲛⲧⲉⲛⲉⲙⲓ
ⲛⲧⲉⲛⲉⲣϣⲫⲏⲣ	ⲛⲧⲉⲛⲉⲣϣⲫⲏⲣ
ⲛⲧⲉⲛⲏ	ⲛⲧⲉⲛⲏ
ⲛⲧⲉⲛⲑⲁⲙⲓⲟ	ⲛⲧⲉⲛⲑⲁⲙⲓⲟ
ⲛⲧⲉⲛⲑⲏⲛⲟⲩ	ⲛⲧⲉⲛⲑⲏⲛⲟⲩ
ⲛⲧⲉⲛⲓϩⲏⲧ	ⲛⲧⲉⲛⲓϩⲏⲧ
ⲛⲧⲉⲛⲓϫⲱⲓⲧ	ⲛⲧⲉⲛⲓϫⲱⲓⲧ
ⲛⲧⲉⲛⲓⲁⲗⲱⲟⲩⲓ	ⲛⲧⲉⲛⲓⲁⲗⲱⲟⲩⲓ
ⲛⲧⲉⲛⲓⲁⲣⲭⲏⲥⲩⲛⲁⲅⲱⲅⲟⲥ	ⲛⲧⲉⲛⲓⲁⲣⲭⲏⲥⲩⲛⲁⲅⲱⲅⲟⲥ
ⲛⲧⲉⲛⲓⲅⲉⲣⲅⲉⲥⲏⲛⲟⲥ	ⲛⲧⲉⲛⲓⲅⲉⲣⲅⲉⲥⲏⲛⲟⲥ
ⲛⲧⲉⲛⲓⲇⲉⲙⲱⲛ	ⲛⲧⲉⲛⲓⲇⲁⲓⲙⲱⲛ
ⲛⲧⲉⲛⲓⲕⲉⲥⲱϫⲡ	ⲛⲧⲉⲛⲓⲕⲉⲥⲱϫⲡ
ⲛⲧⲉⲛⲓⲕⲟⲗⲩⲃⲓⲥⲧⲏⲥ	ⲛⲧⲉⲛⲓⲕⲟⲗⲩⲃⲓⲥⲧⲏⲥ
ⲛⲧⲉⲛⲓⲗⲁⲕϩ	ⲛⲧⲉⲛⲓⲗⲁⲕϩ
ⲛⲧⲉⲛⲓⲙⲩⲥⲧⲏⲣⲓⲟⲛ	ⲛⲧⲉⲛⲓⲙⲩⲥⲧⲏⲣⲓⲟⲛ
ⲛⲧⲉⲛⲓⲡⲣⲉⲥⲃⲩⲧⲉⲣⲟⲥ	ⲛⲧⲉⲛⲓⲡⲣⲉⲥⲃⲩⲧⲉⲣⲟⲥ
ⲛⲧⲉⲛⲓⲡⲣⲟⲫⲏⲧⲏⲥ	ⲛⲧⲉⲛⲓⲡⲣⲟⲫⲏⲧⲏⲥ
ⲛⲧⲉⲛⲓⲣⲱⲙⲓ	ⲛⲧⲉⲛⲓⲣⲱⲙⲓ
ⲛⲧⲉⲛⲓⲥⲁϧ	ⲛⲧⲉⲛⲓⲥⲁϧ
ⲛⲧⲉⲛⲓⲫⲁⲣⲓⲥⲉⲟⲥ	ⲛⲧⲉⲛⲓⲫⲁⲣⲓⲥⲉⲟⲥ
ⲛⲧⲉⲛⲥⲩⲣⲓⲁ	ⲛⲧⲉⲛⲥⲩⲣⲓⲁ
ⲛⲧⲉⲛⲫⲛⲟⲩϯ	ⲛⲧⲉⲛⲫⲛⲟⲩϯ
ⲛⲧⲉⲟⲩϫⲟⲓ	ⲛⲧⲉⲟⲩϫⲟⲉⲓ
ⲛⲧⲉⲟⲩⲁⲓ	ⲛⲧⲉⲟⲩⲁⲓ
ⲛⲧⲉⲟⲩⲏⲓ	ⲛⲧⲉⲟⲩⲏⲓ
ⲛⲧⲉⲟⲩⲙⲉⲧⲟⲩⲣⲟ	ⲛⲧⲉⲟⲩⲙⲉⲧⲟⲩⲣⲟ
ⲛⲧⲉⲟⲩⲙⲉⲧⲣⲱⲙⲓ	ⲛⲧⲉⲟⲩⲙⲉⲧⲣⲱⲙⲓ
ⲛⲧⲉⲟⲩⲙⲏϣ	ⲛⲧⲉⲟⲩⲙⲏϣ
ⲛⲧⲉⲟⲩⲟⲛϩ	ⲛⲧⲉⲟⲩⲟⲛϩ
ⲛⲧⲉⲟⲩⲟⲩⲛⲟⲩ	ⲛⲧⲉⲟⲩⲟⲩⲛⲟⲩ
ⲛⲧⲉⲟⲩⲡⲛⲉⲩⲙⲁ	ⲛⲧⲉⲟⲩⲡⲛⲉⲩⲙⲁ
ⲛⲧⲉⲟⲩⲥⲁϫⲓ	ⲛⲧⲉⲟⲩⲥⲁϫⲓ
ⲛⲧⲉⲟⲩⲧⲟⲩⲃⲟ	ⲛⲧⲉⲟⲩⲧⲟⲩⲃⲟ
ⲛⲧⲉⲟⲩⲫⲱϧ	ⲛⲧⲉⲟⲩⲫⲱϧ
ⲛⲧⲉⲡϣⲏⲣⲓ	ⲛⲧⲉⲡϣⲏⲣⲓ
ⲛⲧⲉϭⲥ	ⲛⲧⲉⲡϭⲟⲉⲓⲥ
ⲛⲧⲉⲡⲁⲓⲃⲓⲟⲥ	ⲛⲧⲉⲡⲁⲓⲃⲓⲟⲥ
ⲛⲧⲉⲡⲁⲓⲉⲛⲉϩ	ⲛⲧⲉⲡⲁⲓⲉⲛⲉϩ
ⲛⲧⲉⲡⲁⲓⲕⲟⲥⲙⲟⲥ	ⲛⲧⲉⲡⲁⲓⲕⲟⲥⲙⲟⲥ
ⲛⲧⲉⲡⲉϥⲑⲱⲟⲩⲓ	ⲛⲧⲉⲡⲉϥⲑⲱⲟⲩⲓ
ⲛⲧⲉⲡⲉϥⲓⲱⲧ	ⲛⲧⲉⲡⲉϥⲉⲓⲱⲧ
ⲛⲧⲉⲡⲉϥⲗⲁⲥ	ⲛⲧⲉⲡⲉϥⲗⲁⲥ
ⲛⲧⲉⲡⲉⲕⲃⲁⲗ	ⲛⲧⲉⲡⲉⲕⲃⲁⲗ
ⲛⲧⲉⲡⲉⲛϭⲟⲓⲥ	ⲛⲧⲉⲡⲉⲛϭⲟⲓⲥ
ⲛⲧⲉⲡⲉⲛⲓⲱⲧ	ⲛⲧⲉⲡⲉⲛⲉⲓⲱⲧ
ⲛⲧⲉⲡⲉⲥⲥⲛⲟϥ	ⲛⲧⲉⲡⲉⲥⲥⲛⲟϥ
ⲛⲧⲉⲡⲉⲧⲉⲛⲛⲟⲩϯ	ⲛⲧⲉⲡⲉⲧⲉⲛⲛⲟⲩϯ
ⲛⲧⲉⲡⲓϩⲙⲟⲩ	ⲛⲧⲉⲡⲓϩⲙⲟⲩ
ⲛⲧⲉⲡⲓⲁⲡⲁⲥ	ⲛⲧⲉⲡⲓⲁⲡⲁⲥ
ⲛⲧⲉⲡⲓⲉϫⲱⲣϩ	ⲛⲧⲉⲡⲓⲉϫⲱⲣϩ
ⲛⲧⲉⲡⲓⲏⲓ	ⲛⲧⲉⲡⲓⲏⲓ
ⲛⲧⲉⲡⲓⲡⲛⲉⲩⲙⲁ	ⲛⲧⲉⲡⲓⲡⲛⲉⲩⲙⲁ
ⲛⲧⲉⲡⲓⲣⲱⲙⲓ	ⲛⲧⲉⲡⲓⲣⲱⲙⲓ
ⲛⲧⲉⲡⲟⲩϩⲏⲧ	ⲛⲧⲉⲡⲟⲩϩⲏⲧ
ⲛⲧⲉⲡⲥⲁⲧⲁⲛⲁⲥ	ⲛⲧⲉⲡⲥⲁⲧⲁⲛⲁⲥ
ⲛⲧⲉⲡⲭⲁⲕⲓ	ⲛⲧⲉⲡⲭⲁⲕⲓ
ⲛⲧⲉⲡⲭⲣⲓⲥⲧⲟⲥ	ⲛⲧⲉⲡⲭⲣⲓⲥⲧⲟⲥ
ⲛⲧⲉⲡⲱⲟⲩ	ⲛⲧⲉⲡⲱⲟⲩ
ⲛⲧⲉⲣⲁϧⲧ	ⲛⲧⲉⲣⲁϧⲧ
ⲛⲧⲉⲣⲟⲩϩⲓ	ⲛⲧⲉⲣⲟⲩϩⲓ
ⲛⲧⲉⲣⲱϥ	ⲛⲧⲉⲣⲱϥ
ⲛⲧⲉⲥ	ⲛⲧⲉⲥ
ⲛⲧⲉⲥϣⲉⲣⲓ	ⲛⲧⲉⲥϣⲉⲣⲓ
ⲛⲧⲉⲥϫⲓϫ	ⲛⲧⲉⲥϫⲓϫ
ⲛⲧⲉⲥϭⲓ	ⲛⲧⲉⲥϭⲓ
ⲛⲧⲉⲥⲙⲁⲩ	ⲛⲧⲉⲥⲙⲁⲩ
ⲛⲧⲉⲥⲛⲟϩⲉⲙ	ⲛⲧⲉⲥⲛⲟϩⲉⲙ
ⲛⲧⲉⲥⲭⲁⲡⲉⲥϩⲁⲓ	ⲛⲧⲉⲥⲭⲁⲡⲉⲥϩⲁⲓ
ⲛⲧⲉⲥⲱⲛϧ	ⲛⲧⲉⲥⲱⲛϧ
ⲛⲧⲉⲧⲉⲕϫⲓϫ	ⲛⲧⲉⲧⲉⲕϫⲓϫ
ⲛⲧⲉⲧⲉⲕϭⲁⲗⲟϫ	ⲛⲧⲉⲧⲉⲕϭⲁⲗⲟϫ
ⲛⲧⲉⲧⲉⲛϣⲧⲉⲙⲭⲱ	ⲛⲧⲉⲧⲉⲛϣⲧⲉⲙⲭⲱ
ⲛⲧⲉⲧⲉⲛϣⲱⲡⲓ	ⲛⲧⲉⲧⲉⲛϣⲱⲡⲓ
ⲛⲧⲉⲧⲉⲛϭⲓⲥⲃⲱ	ⲛⲧⲉⲧⲉⲛϭⲓⲥⲃⲱ
ⲛⲧⲉⲧⲉⲛϯϩⲁⲡ	ⲛⲧⲉⲧⲛϯϩⲁⲡ
ⲛⲧⲉⲧⲉⲛⲁⲣⲉϩ	ⲛⲧⲉⲧⲉⲛⲁⲣⲉϩ
ⲛⲧⲉⲧⲉⲛⲉⲙⲓ	ⲛⲧⲉⲧⲉⲛⲉⲙⲓ
ⲛⲧⲉⲧⲉⲛⲑⲱⲟⲩϯ	ⲛⲧⲉⲧⲉⲛⲑⲱⲟⲩϯ
ⲛⲧⲉⲧⲉⲛⲓ	ⲛⲧⲉⲧⲉⲛⲓ
ⲛⲧⲉⲧⲉⲛⲛⲁⲩ	ⲛⲧⲉⲧⲉⲛⲛⲁⲩ
ⲛⲧⲉⲧⲉⲛⲥⲱⲧⲉⲙ	ⲛⲧⲉⲧⲉⲛⲥⲱⲧⲉⲙ
ⲛⲧⲉⲧⲉⲛⲭⲱ	ⲛⲧⲉⲧⲉⲛⲭⲱ
ⲛⲧⲉⲧⲕⲟⲓ	ⲛⲧⲉⲧⲕⲟⲓ
ⲛⲧⲉⲧⲩⲣⲟⲥ	ⲛⲧⲉⲧⲩⲣⲟⲥ
ⲛⲧⲉⲧⲫⲉ	ⲛⲧⲉⲧⲫⲉ
ⲛⲧⲉⲫϯ	ⲛⲧⲉⲫⲛⲟⲩϯ
ⲛⲧⲉⲫⲓⲗⲓⲡⲡⲉ	ⲛⲧⲉⲫⲓⲗⲓⲡⲡⲉ
ⲛⲧⲉⲫⲛⲟⲩϯ	ⲛⲧⲉⲫⲛⲟⲩϯ
ⲛⲧⲏ	ⲛⲧⲏ
ⲛⲧⲏⲓ	ⲛⲧⲏⲓ
ⲛⲧⲓⲙⲉⲟⲥ	ⲛⲧⲓⲙⲉⲟⲥ
ⲛⲧⲓⲙⲟⲑⲉⲟⲥ	ⲛⲧⲓⲙⲟⲑⲉⲟⲥ
ⲛⲧⲟⲧ	ⲛⲧⲟⲧ
ⲛⲧⲟⲧϥ	ⲛⲧⲟⲧϥ
ⲛⲧⲟⲧⲟⲩ	ⲛⲧⲟⲧⲟⲩ
ⲛⲧⲟⲩϣϫⲉⲙϫⲟⲙ	ⲛⲧⲟⲩϣϫⲉⲙϫⲟⲙ
ⲛⲧⲟⲩϣⲉ	ⲛⲧⲟⲩϣⲉ
ⲛⲧⲟⲩϣⲟϣϥ	ⲛⲧⲟⲩϣⲟϣϥ
ⲛⲧⲟⲩϣⲧⲉⲙϣϫⲉⲙϫⲟⲙ	ⲛⲧⲟⲩϣⲧⲉⲙϣϫⲉⲙϫⲟⲙ
ⲛⲧⲟⲩϣⲧⲉⲙϩⲉϫϩⲱϫϥ	ⲛⲧⲟⲩϣⲧⲉⲙϩⲉϫϩⲱϫϥ
ⲛⲧⲟⲩϣⲧⲉⲙϫⲟⲥ	ⲛⲧⲟⲩϣⲧⲉⲙϫⲟⲥ
ⲛⲧⲟⲩϣⲧⲉⲙⲕⲁϯ	ⲛⲧⲟⲩϣⲧⲉⲙⲕⲁϯ
ⲛⲧⲟⲩϣⲧⲉⲙⲛⲁⲩ	ⲛⲧⲟⲩϣⲧⲉⲙⲛⲁⲩ
ⲛⲧⲟⲩϣⲧⲉⲙⲥⲁϫⲓ	ⲛⲧⲟⲩϣⲧⲉⲙⲥⲁϫⲓ
ⲛⲧⲟⲩϣⲧⲉⲙⲥⲱⲧⲉⲙ	ⲛⲧⲟⲩϣⲧⲉⲙⲥⲱⲧⲉⲙ
ⲛⲧⲟⲩϣⲱⲡ	ⲛⲧⲟⲩϣⲱⲡ
ⲛⲧⲟⲩϧⲟⲑⲃⲉϥ	ⲛⲧⲟⲩϧⲟⲑⲃϥ
ⲛⲧⲟⲩϩⲓⲧϥ	ⲛⲧⲟⲩϩⲓⲧϥ
ⲛⲧⲟⲩϭⲓ	ⲛⲧⲟⲩϭⲓ
ⲛⲧⲟⲩϯⲟⲩⲱⲙ	ⲛⲧⲟⲩϯⲟⲩⲱⲙ
ⲛⲧⲟⲩϯⲱⲟⲩ	ⲛⲧⲟⲩϯⲱⲟⲩ
ⲛⲧⲟⲩⲉⲣϣⲫⲏⲣⲓ	ⲛⲧⲟⲩⲉⲣϣⲫⲏⲣⲓ
ⲛⲧⲟⲩⲉⲣⲕⲁⲧⲏⲅⲟⲣⲓⲛ	ⲛⲧⲟⲩⲉⲣⲕⲁⲧⲏⲅⲟⲣⲓⲛ
ⲛⲧⲟⲩⲓ	ⲛⲧⲟⲩⲓ
ⲛⲧⲟⲩⲕⲟⲧⲟⲩ	ⲛⲧⲟⲩⲕⲟⲧⲟⲩ
ⲛⲧⲟⲩⲕⲱϯ	ⲛⲧⲟⲩⲕⲱϯ
ⲛⲧⲟⲩⲛⲁⲩ	ⲛⲧⲟⲩⲛⲁⲩ
ⲛⲧⲟⲩⲟϩⲓ	ⲛⲧⲟⲩⲟϩⲓ
ⲛⲧⲟⲩⲣⲱⲧⲉⲃ	ⲛⲧⲟⲩⲣⲱⲧⲉⲃ
ⲛⲧⲟⲩⲥⲁϫⲓ	ⲛⲧⲟⲩⲥⲁϫⲓ
ⲛⲧⲟⲩⲥⲁⲧⲥ	ⲛⲧⲟⲩⲥⲁⲧⲥ
ⲛⲧⲟⲩⲥⲓ	ⲛⲧⲟⲩⲥⲓ
ⲛⲧⲟⲩⲥⲱⲕ	ⲛⲧⲟⲩⲥⲱⲕ
ⲛⲧⲟⲩⲥⲱⲧⲉⲙ	ⲛⲧⲟⲩⲥⲱⲧⲉⲙ
ⲛⲧⲟⲩⲧⲁⲕⲟϥ	ⲛⲧⲟⲩⲧⲁⲕⲟϥ
ⲛⲧⲟⲩⲧⲟⲩϩⲟ	ⲛⲧⲟⲩⲧⲟⲩϩⲟ
ⲛⲧⲟⲩⲭⲱ	ⲛⲧⲟⲩⲭⲱ
ⲛⲧⲱ	ⲛⲧⲱ
ⲛⲧⲱⲟⲩ	ⲛⲧⲱⲟⲩ
ⲛⲧⲱⲧⲉⲛ	ⲛⲧⲱⲧⲉⲛ
ⲛⲭⲣⲉⲙⲣⲉⲙ	ⲛⲭⲣⲉⲙⲣⲉⲙ
ⲛⲭⲣⲟⲛⲟⲥ	ⲛⲭⲣⲟⲛⲟⲥ
ⲛⲭⲱⲗⲉⲙ	ⲛⲭⲱⲗⲉⲙ
ⲛⲭⲱⲣⲁ	ⲛⲭⲱⲣⲁ
ⲛⲱ	ⲛⲱ
ⲛⲱⲃϣ	ⲛⲱⲃϣ
ⲛⲱⲓⲕ	ⲛⲱⲓⲕ
ⲛⲱⲟⲩ	ⲛⲱⲟⲩ
ⲛⲱⲧⲉⲛ	ⲛⲱⲧⲉⲛ
ⲝ	ⲝ
ⲝⲉⲥⲧⲏⲥ	ⲝⲉⲥⲧⲏⲥ
ⲟϣ	ⲟϣ
ⲟϩⲓ	ⲟϩⲓ
ⲟϫϩ	ⲟϫϩ
ⲟⲃⲓ	ⲟⲃⲓ
ⲟⲓ	ⲟⲓ
ⲟⲓⲕⲟⲛⲟⲙⲟⲥ	ⲟⲓⲕⲟⲛⲟⲙⲟⲥ
ⲟⲗ	ⲟⲗ
ⲟⲙⲥ	ⲟⲙⲥ
ⲟⲛ	ⲟⲛ
ⲟⲛⲓ	ⲟⲛⲓ
ⲟⲛⲧⲱⲥ	ⲟⲛⲧⲱⲥ
ⲟⲥϧ	ⲟⲥϧ
ⲟⲩ	ⲟⲩ
ⲟⲩϣⲁϥⲉ	ⲟⲩϣⲁϥⲉ
ⲟⲩϧⲉⲙⲥ	ⲟⲩϧⲉⲙⲥ
ⲟⲩϩⲱⲃ	ⲟⲩϩⲱⲃ
ⲟⲩϩⲱⲟⲩⲧ	ⲟⲩϩⲱⲟⲩⲧ
ⲟⲩϩⲱⲣ	ⲟⲩϩⲱⲣ
ⲟⲩϫⲁⲓ	ⲟⲩϫⲁⲓ
ⲟⲩϫⲱⲕ	ⲟⲩϫⲱⲕ
ⲟⲩϭⲓⲥⲓ	ⲟⲩϭⲓⲥⲓ
ⲟⲩⲁϣ	ⲟⲩⲁϣ
ⲟⲩⲁϩ	ⲟⲩⲁϩ
ⲟⲩⲁϩⲉⲙ	ⲟⲩⲁϩⲉⲙ
ⲟⲩⲁϩⲕ	ⲟⲩⲁϩⲕ
ⲟⲩⲁϩⲥⲁϩⲛⲓ	ⲟⲩⲁϩⲥⲁϩⲛⲓ
ⲟⲩⲁϩⲥⲟⲓ	ⲟⲩⲁϩⲥⲟⲓ
ⲟⲩⲁϩⲧⲉ	ⲟⲩⲁϩⲧⲉ
ⲟⲩⲁⲃ	ⲟⲩⲁⲃ
ⲟⲩⲁⲅⲉⲗⲏ	ⲟⲩⲁⲅⲉⲗⲏ
ⲟⲩⲁⲓ	ⲟⲩⲁⲓ
ⲟⲩⲃⲁϣ	ⲟⲩⲃⲁϣ
ⲟⲩⲃⲏ	ⲟⲩⲃⲏ
ⲟⲩⲇⲉ	ⲟⲩⲇⲉ
ⲟⲩⲇⲓⲱⲅⲙⲟⲥ	ⲟⲩⲇⲓⲱⲅⲙⲟⲥ
ⲟⲩⲉϩ	ⲟⲩⲉϩ
ⲟⲩⲉⲃⲟⲗ	ⲟⲩⲉⲃⲟⲗ
ⲟⲩⲉⲓ	ⲟⲩⲉⲓ
ⲟⲩⲉⲓⲛⲓⲛ	ⲟⲩⲉⲓⲛⲓⲛ
ⲟⲩⲉⲙ	ⲟⲩⲉⲙ
ⲟⲩⲉⲙⲱⲓⲕ	ⲟⲩⲉⲙⲱⲓⲕ
ⲟⲩⲉⲣϣⲓ	ⲟⲩⲉⲣϣⲓ
ⲟⲩⲉⲣⲏⲟⲩ	ⲛⲟⲩⲉⲣⲏⲩ
ⲟⲩⲉⲣⲫⲉⲓ	ⲟⲩⲉⲣⲫⲉⲓ
ⲟⲩⲉⲧⲟⲩⲱⲧ	ϩⲟⲩⲉⲧⲟⲩⲱⲧ
ⲟⲩⲏⲃ	ⲟⲩⲏⲃ
ⲟⲩⲏⲓ	ⲟⲩⲏⲓ
ⲟⲩⲏⲟⲩ	ⲟⲩⲏⲟⲩ
ⲟⲩⲏⲣ	ⲟⲩⲏⲣ
ⲟⲩⲑⲉⲃⲓⲟ	ⲟⲩⲑⲉⲃⲓⲟ
ⲟⲩⲓ	ⲟⲩⲓ
ⲟⲩⲓⲉⲫⲟⲩⲱⲓ	ⲟⲩⲓⲉⲫⲟⲩⲱⲓ
ⲟⲩⲓⲛⲁⲙ	ⲟⲩⲓⲛⲁⲙ
ⲟⲩⲕⲱⲧ	ⲟⲩⲕⲱⲧ
ⲟⲩⲙⲁϣϫ	ⲟⲩⲙⲁϣϫ
ⲟⲩⲙⲉⲧⲁⲧϫⲟⲙ	ⲟⲩⲙⲉⲧⲁⲧϫⲟⲙ
ⲟⲩⲙⲉⲧⲁⲧⲕⲁϯ	ⲟⲩⲙⲉⲧⲁⲧⲕⲁϯ
ⲟⲩⲙⲉⲧⲕⲟⲩϫⲓ	ⲟⲩⲙⲉⲧⲕⲟⲩϫⲓ
ⲟⲩⲙⲉⲧⲥⲟϫ	ⲟⲩⲙⲉⲧⲥⲟϫ
ⲟⲩⲙⲏϣ	ⲟⲩⲙⲏϣ
ⲟⲩⲛ	ⲟⲩⲛ
ⲟⲩⲛⲓϣϯ	ⲟⲩⲛⲓϣϯ
ⲟⲩⲛⲟⲩ	ⲟⲩⲛⲟⲩ
ⲟⲩⲟϩ	ⲟⲩⲟϩ
ⲟⲩⲟϩⲓ	ⲟⲩⲟϩⲓ
ⲟⲩⲟϯ	ⲟⲩⲟϯ
ⲟⲩⲟⲃϣ	ⲟⲩⲟⲃϣ
ⲟⲩⲟⲙ	ⲟⲩⲟⲙ
ⲟⲩⲟⲛ	ⲟⲩⲟⲛ
ⲟⲩⲟⲛϣϫⲟⲙ	ⲟⲩⲟⲛϣϫⲟⲙ
ⲟⲩⲟⲛϩ	ⲟⲩⲟⲛϩ
ⲟⲩⲟⲛϩⲧⲉⲛ	ⲟⲩⲟⲛϩⲧⲉⲛ
ⲟⲩⲟⲛⲛⲧⲁ	ⲟⲩⲟⲛⲛⲧⲁ
ⲟⲩⲟⲛⲛⲧⲁϥ	ⲟⲩⲟⲛⲛⲧⲁϥ
ⲟⲩⲟⲛⲧⲉ	ⲟⲩⲟⲛⲧⲉ
ⲟⲩⲟⲛⲧⲉϥ	ⲟⲩⲟⲛⲧⲉϥ
ⲟⲩⲟⲛⲧⲱ	ⲟⲩⲟⲛⲧⲱ
ⲟⲩⲟⲣⲡ	ⲟⲩⲟⲣⲡ
ⲟⲩⲡⲛⲉⲩⲙⲁ	ⲟⲩⲡⲛⲉⲩⲙⲁ
ⲟⲩⲡⲟⲣⲛⲓⲁ	ⲟⲩⲡⲟⲣⲛⲓⲁ
ⲟⲩⲡⲣⲟⲫⲏⲧⲏⲥ	ⲟⲩⲡⲣⲟⲫⲏⲧⲏⲥ
ⲟⲩⲣⲁⲙⲁⲟ	ⲟⲩⲣⲁⲙⲁⲟ
ⲟⲩⲣⲉϥϣⲁⲙϣⲉⲓⲇⲱⲗⲟⲛ	ⲟⲩⲣⲉϥϣⲁⲙϣⲉⲓⲇⲱⲗⲟⲛ
ⲟⲩⲣⲉϥϩⲱⲗⲉⲙ	ⲟⲩⲣⲉϥϩⲱⲗⲉⲙ
ⲟⲩⲣⲉϥϩⲱⲟⲩϣ	ⲟⲩⲣⲉϥϩⲱⲟⲩϣ
ⲟⲩⲣⲉϥϭⲓⲛϫⲟⲛⲥ	ⲟⲩⲣⲉϥϭⲓⲛϫⲟⲛⲥ
ⲟⲩⲣⲉϥⲑⲓϧⲓ	ⲟⲩⲣⲉϥⲑⲓϧⲓ
ⲟⲩⲣⲟ	ⲟⲩⲣⲟ
ⲟⲩⲣⲱⲙⲓ	ⲟⲩⲣⲱⲙⲓ
ⲟⲩⲥϩⲓⲙⲓ	ⲟⲩⲥϩⲓⲙⲓ
ⲟⲩⲥⲁⲣⲝ	ⲟⲩⲥⲁⲣⲝ
ⲟⲩⲥⲃⲱ	ⲟⲩⲥⲃⲱ
ⲟⲩⲥⲙⲏ	ⲟⲩⲥⲙⲏ
ⲟⲩⲥⲛⲟϥ	ⲟⲩⲥⲛⲟϥ
ⲟⲩⲥⲟⲛ	ⲟⲩⲥⲟⲛ
ⲟⲩⲥⲟⲫⲓⲁ	ⲟⲩⲥⲟⲫⲓⲁ
ⲟⲩⲥⲱⲙⲁ	ⲟⲩⲥⲱⲙⲁ
ⲟⲩⲧⲁϩ	ⲟⲩⲧⲁϩ
ⲟⲩⲧⲉ	ⲟⲩⲧⲉ
ⲟⲩⲧⲱ	ⲟⲩⲧⲱ
ⲟⲩⲧⲱϥ	ⲟⲩⲧⲱϥ
ⲟⲩⲧⲱⲧⲉⲛ	ⲟⲩⲧⲱⲧⲉⲛ
ⲟⲩⲭⲓ	ⲟⲩⲭⲓ
ⲟⲩⲯⲩⲭⲏ	ⲟⲩⲯⲩⲭⲏ
ⲟⲩⲱϣ	ⲟⲩⲱϣ
ⲟⲩⲱϣⲉⲙ	ⲟⲩⲱϣⲉⲙ
ⲟⲩⲱϣⲧ	ⲟⲩⲱϣⲧ
ⲟⲩⲱⲙ	ⲟⲩⲱⲙ
ⲟⲩⲱⲛ	ⲟⲩⲱⲛ
ⲟⲩⲱⲛϧ	ⲟⲩⲱⲛϧ
ⲟⲩⲱⲛϩ	ⲟⲩⲱⲛϩ
ⲟⲩⲱⲣⲡ	ⲟⲩⲱⲣⲡ
ⲟⲩⲱⲧ	ⲟⲩⲱⲧ
ⲟⲩⲱⲧⲉⲛ	ⲟⲩⲱⲧⲉⲛ
ⲡ	ⲡ
ⲡϣⲏⲣⲓ	ⲡϣⲏⲣⲓ
ⲡϧⲣⲱⲟⲩ	ⲡϧⲣⲱⲟⲩ
ⲡϩⲁⲓ	ⲡϩⲁⲓ
ⲡϩⲏⲧ	ⲡϩⲏⲧ
ⲡϩⲱⲃ	ⲡϩⲱⲃ
ⲡϭⲟⲓⲥ	ⲡϭⲟⲓⲥ
ⲡⲁ	ⲡⲁ
ⲡⲁϣⲏⲣⲓ	ⲡⲁϣⲏⲣⲓ
ⲡⲁϩⲓⲱⲓϣ	ⲡⲁϩⲓⲱⲓϣ
ⲡⲁϭⲟⲓⲥ	ⲡⲁϭⲟⲓⲥ
ⲡⲁⲓ	ⲡⲁⲓ
ⲡⲁⲓϫⲱⲟⲩ	ⲡⲁⲓϫⲱⲟⲩ
ⲡⲁⲓⲣⲏϯ	ⲡⲁⲓⲣⲏϯ
ⲡⲁⲗⲓⲛ	ⲡⲁⲗⲓⲛ
ⲡⲁⲙⲉⲛⲣⲓⲧ	ⲡⲁⲙⲉⲛⲣⲓⲧ
ⲡⲁⲣⲁⲃⲟⲗⲏ	ⲡⲁⲣⲁⲃⲟⲗⲏ
ⲡⲁⲣⲁⲇⲟⲥⲓⲥ	ⲡⲁⲣⲁⲇⲟⲥⲓⲥ
ⲡⲁⲣⲁⲛ	ⲡⲁⲣⲁⲛ
ⲡⲁⲣⲁⲡⲧⲱⲙⲁ	ⲡⲁⲣⲁⲡⲧⲱⲙⲁ
ⲡⲁⲣⲣⲏⲥⲓⲁ	ⲡⲁⲣⲣⲏⲥⲓⲁ
ⲡⲁⲥⲁϫⲓ	ⲡⲁⲥⲁϫⲓ
ⲡⲁⲥⲟⲛ	ⲡⲁⲥⲟⲛ
ⲡⲁⲥⲭⲁ	ⲡⲁⲥⲭⲁ
ⲡⲁⲧϣⲉⲗⲉⲧ	ⲡⲁⲧϣⲉⲗⲉⲧ
ⲡⲁⲩⲗⲟⲥ	ⲡⲁⲩⲗⲟⲥ
ⲡⲉ	ⲡⲉ
ⲡⲉϥ	ⲡⲉϥ
ⲡⲉϥⲓⲱⲧ	ⲡⲉϥⲉⲓⲱⲧ
ⲡⲉϥⲣⲁⲛ	ⲡⲉϥⲣⲁⲛ
ⲡⲉϥⲥⲟⲛ	ⲡⲉϥⲥⲟⲛ
ⲡⲉϫⲁ	ⲡⲉϫⲁ
ⲡⲉϫⲁϥ	ⲡⲉϫⲁϥ
ⲡⲉϫⲁⲥ	ⲡⲉϫⲁⲥ
ⲡⲉϫⲉ	ⲡⲉϫⲉ
ⲡⲉϫⲉⲡⲟⲩⲣⲟ	ⲡⲉϫⲉⲡⲟⲩⲣⲟ
ⲡⲉϫⲱ	ⲡⲉϫⲱ
ⲡⲉϫⲱⲟⲩ	ⲡⲉϫⲱⲟⲩ
ⲡⲉϯϫⲱ	ⲡⲉϯϫⲱ
ⲡⲉϯⲛⲁⲁⲓϥ	ⲡⲉϯⲛⲁⲁⲓϥ
ⲡⲉϯⲛⲁⲉⲣⲉⲧⲓⲛ	ⲡⲉϯⲛⲁⲉⲣⲉⲧⲓⲛ
ⲡⲉϯⲟⲩⲁϩⲥⲁϩⲛⲓ	ⲡⲉϯⲟⲩⲁϩⲥⲁϩⲛⲓ
ⲡⲉⲇⲏⲥ	ⲡⲉⲇⲏⲥ
ⲡⲉⲑⲙⲟⲧⲉⲛ	ⲡⲉⲑⲙⲟⲧⲉⲛ
ⲡⲉⲑⲟⲩⲁϩⲉⲙ	ⲡⲉⲑⲟⲩⲁϩⲉⲙ
ⲡⲉⲕ	ⲡⲉⲕ
ⲡⲉⲕⲛⲁϩϯ	ⲡⲉⲕⲛⲁϩϯ
ⲡⲉⲕⲣⲁⲛ	ⲡⲉⲕⲣⲁⲛ
ⲡⲉⲛ	ⲡⲉⲛ
ⲡⲉⲛϭⲟⲓⲥ	ⲡⲉⲛϭⲟⲓⲥ
ⲡⲉⲛⲁϩϯ	ⲡⲉⲛⲁϩϯ
ⲡⲉⲛⲡⲁⲥⲭⲁ	ⲡⲉⲛⲡⲁⲥⲭⲁ
ⲡⲉⲣⲓⲭⲱⲣⲟⲥ	ⲡⲉⲣⲓⲭⲱⲣⲟⲥ
ⲡⲉⲥ	ⲡⲉⲥ
ⲡⲉⲥⲅⲉⲛⲟⲥ	ⲡⲉⲥⲅⲉⲛⲟⲥ
ⲡⲉⲧϣⲟⲡ	ⲡⲉⲧϣⲟⲡ
ⲡⲉⲧϩⲏⲡ	ⲡⲉⲧϩⲏⲡ
ⲡⲉⲧϩⲱⲟⲩ	ⲡⲉⲧϩⲱⲟⲩ
ⲡⲉⲧⲁϥϩⲟⲛϩⲉⲛ	ⲡⲉⲧⲁϥϩⲟⲛϩⲉⲛ
ⲡⲉⲧⲁϥϭⲓ	ⲡⲉⲧⲁϥϭⲓ
ⲡⲉⲧⲁϥϯ	ⲡⲉⲧⲁϥϯ
ⲡⲉⲧⲁϥⲁⲓϥ	ⲡⲉⲧⲁϥⲁⲓϥ
ⲡⲉⲧⲁϥⲉⲙⲓ	ⲡⲉⲧⲁϥⲉⲙⲓ
ⲡⲉⲧⲁϥⲛⲁϩⲙⲉⲕ	ⲡⲉⲧⲁϥⲛⲁϩⲙⲉⲕ
ⲡⲉⲧⲁϥⲛⲁϩⲙⲓ	ⲡⲉⲧⲁϥⲛⲁϩⲙⲓ
ⲡⲉⲧⲁϥⲥⲟⲛⲧⲟⲩ	ⲡⲉⲧⲁϥⲥⲟⲛⲧⲟⲩ
ⲡⲉⲧⲁϥⲧⲱⲛϥ	ⲡⲉⲧⲁϥⲧⲱⲛϥ
ⲡⲉⲧⲁⲛϭⲓⲧϥ	ⲡⲉⲧⲁⲛϭⲓⲧϥ
ⲡⲉⲧⲉϥϣⲱⲡ	ⲡⲉⲧⲉϥϣⲱⲡ
ⲡⲉⲧⲉϥⲛⲁⲉⲣⲟⲩⲱ	ⲡⲉⲧⲉϥⲛⲁⲉⲣⲟⲩⲱ
ⲡⲉⲧⲉⲕⲉⲣϧⲁⲉ	ⲡⲉⲧⲉⲕⲉⲣϧⲁⲉ
ⲡⲉⲧⲉⲕⲛⲁⲩ	ⲡⲉⲧⲉⲕⲛⲁⲩ
ⲡⲉⲧⲉⲕⲟⲩⲁϣϥ	ⲡⲉⲧⲉⲕⲟⲩⲁϣϥ
ⲡⲉⲧⲉⲙⲙⲟⲛ	ⲡⲉⲧⲉⲙⲙⲟⲛ
ⲡⲉⲧⲉⲛ	ⲡⲉⲧⲉⲛ
ⲡⲉⲧⲉⲛⲓⲱⲧ	ⲡⲉⲧⲉⲛⲓⲱⲧ
ⲡⲉⲧⲉⲛⲛⲁϩϯ	ⲡⲉⲧⲉⲛⲛⲁϩϯ
ⲡⲉⲧⲉⲛⲥⲁϫⲓ	ⲡⲉⲧⲉⲛⲥⲁϫⲓ
ⲡⲉⲧⲉⲛⲧⲁⲕ	ⲡⲉⲧⲉⲛⲧⲁⲕ
ⲡⲉⲧⲉⲛⲧⲟⲧⲕ	ⲡⲉⲧⲉⲛⲧⲟⲧⲕ
ⲡⲉⲧⲉⲟⲩⲟⲛ	ⲡⲉⲧⲉⲟⲩⲟⲛ
ⲡⲉⲧⲉⲣⲇⲓⲁⲕⲣⲓⲛⲓⲛ	ⲡⲉⲧⲉⲣⲇⲓⲁⲕⲣⲓⲛⲓⲛ
ⲡⲉⲧⲉⲣⲭⲣⲓⲁ	ⲡⲉⲧⲉⲣⲭⲣⲓⲁ
ⲡⲉⲧⲉⲧⲉⲛⲓⲣⲓ	ⲡⲉⲧⲉⲧⲉⲛⲓⲣⲓ
ⲡⲉⲧⲉⲧⲉⲛⲛⲁⲉⲣⲉⲧⲓⲛ	ⲡⲉⲧⲉⲧⲉⲛⲛⲁⲉⲣⲉⲧⲓⲛ
ⲡⲉⲧⲉⲧⲉⲛⲥⲱⲧⲉⲙ	ⲡⲉⲧⲉⲧⲉⲛⲥⲱⲧⲉⲙ
ⲡⲉⲧⲕⲱⲧ	ⲡⲉⲧⲕⲱⲧ
ⲡⲉⲧⲟⲩⲓⲣⲓ	ⲡⲉⲧⲟⲩⲓⲣⲓ
ⲡⲉⲧⲟⲩⲛⲁⲟⲩⲟⲙϥ	ⲡⲉⲧⲟⲩⲛⲁⲟⲩⲟⲙϥ
ⲡⲉⲧⲣⲁ	ⲡⲉⲧⲣⲁ
ⲡⲉⲧⲣⲟⲥ	ⲡⲉⲧⲣⲟⲥ
ⲡⲏⲣⲁ	ⲡⲏⲣⲁ
ⲡⲓ	ⲡⲓ
ⲡⲓϩⲉⲙⲥⲓ	ⲡⲓϩⲉⲙⲥⲓ
ⲡⲓϩⲙⲟⲩ	ⲡⲓϩⲙⲟⲩ
ⲡⲓⲁⲅⲓⲟⲥ	ⲡⲓϩⲁⲅⲓⲟⲥ
ⲡⲓⲁⲙϣⲉ	ⲡⲓⲁⲙϣⲉ
ⲡⲓⲁⲣⲭⲓⲉⲣⲉⲩⲥ	ⲡⲓⲁⲣⲭⲓⲉⲣⲉⲩⲥ
ⲡⲓⲁⲫⲟⲧ	ⲡⲓⲁⲫⲟⲧ
ⲡⲓⲃⲉⲗⲗⲉ	ⲡⲓⲃⲉⲗⲗⲉ
ⲡⲓⲇⲉⲙⲱⲛ	ⲡⲓⲇⲁⲓⲙⲱⲛ
ⲡⲓⲉϩⲟⲟⲩ	ⲡⲓⲉϩⲟⲟⲩ
ⲡⲓⲉⲃⲟⲗ	ⲡⲓⲉⲃⲟⲗ
ⲡⲓⲉⲣⲫⲉⲓ	ⲡⲓⲉⲣⲫⲉⲓ
ⲡⲓⲍ	ⲡⲓⲍ
ⲡⲓⲕⲁⲛⲁⲛⲉⲟⲥ	ⲡⲓⲕⲁⲛⲁⲛⲉⲟⲥ
ⲡⲓⲕⲟⲥⲙⲟⲥ	ⲡⲓⲕⲟⲥⲙⲟⲥ
ⲡⲓⲙⲁ	ⲡⲓⲙⲁ
ⲡⲓⲙⲏϣ	ⲡⲓⲙⲏϣ
ⲡⲓⲛⲓϣϯ	ⲡⲓⲛⲓϣϯ
ⲡⲓⲟⲩⲁⲓ	ⲡⲓⲟⲩⲁⲓ
ⲡⲓⲡⲁⲧϣⲉⲗⲉⲧ	ⲡⲓⲡⲁⲧϣⲉⲗⲉⲧ
ⲡⲓⲡⲛⲁⲧⲓⲕⲱⲥ	ⲡⲓⲡⲛⲉⲩⲙⲁⲧⲓⲕⲱⲥ
ⲡⲓⲡⲛⲉⲩⲙⲁ	ⲡⲓⲡⲛⲉⲩⲙⲁ
ⲡⲓⲡⲣⲟⲫⲏⲧⲏⲥ	ⲡⲓⲡⲣⲟⲫⲏⲧⲏⲥ
ⲡⲓⲣⲉϥϯⲱⲙⲥ	ⲡⲓⲣⲉϥϯⲱⲙⲥ
ⲡⲓⲣⲉⲙⲛⲁⲍⲁⲣⲉⲑ	ⲡⲓⲣⲉⲙⲛⲁⲍⲁⲣⲉⲑ
ⲡⲓⲣⲱⲙⲓ	ⲡⲓⲣⲱⲙⲓ
ⲡⲓⲣⲱⲟⲩϣ	ⲡⲓⲣⲱⲟⲩϣ
ⲡⲓⲥⲕⲁⲣⲓⲱⲧⲏⲥ	ⲡⲓⲥⲕⲁⲣⲓⲱⲧⲏⲥ
ⲡⲓⲥⲧⲟⲥ	ⲡⲓⲥⲧⲟⲥ
ⲡⲓⲥⲱⲙⲁ	ⲡⲓⲥⲱⲙⲁ
ⲡⲓⲧⲱⲛϥ	ⲡⲓⲧⲱⲛϥ
ⲡⲓⲭⲣⲱⲙ	ⲡⲓⲭⲣⲱⲙ
ⲡⲓⲯⲩⲭⲓⲕⲟⲥ	ⲡⲓⲯⲩⲭⲓⲕⲟⲥ
ⲡⲓⲱⲙⲥ	ⲡⲓⲱⲙⲥ
ⲡⲛⲁⲧⲓⲕⲟⲛ	ⲡⲛⲉⲩⲙⲁⲧⲓⲕⲟⲛ
ⲡⲛⲁⲧⲓⲕⲟⲥ	ⲡⲛⲉⲩⲙⲁⲧⲓⲕⲟⲥ
ⲡⲛⲁⲧⲓⲕⲱⲥ	ⲡⲛⲉⲩⲙⲁⲧⲓⲕⲱⲥ
ⲡⲛⲉⲩⲙⲁ	ⲡⲛⲉⲩⲙⲁ
ⲡⲟⲛⲏⲣⲓⲁ	ⲡⲟⲛⲏⲣⲓⲁ
ⲡⲟⲣⲛⲏ	ⲡⲟⲣⲛⲏ
ⲡⲟⲣⲛⲓⲁ	ⲡⲟⲣⲛⲉⲓⲁ
ⲡⲟⲣⲛⲟⲥ	ⲡⲟⲣⲛⲟⲥ
ⲡⲟⲩ	ⲡⲟⲩ
ⲡⲟⲩϩⲏⲧ	ⲡⲟⲩϩⲏⲧ
ⲡⲟⲩⲓⲱⲧ	ⲡⲟⲩⲓⲱⲧ
ⲡⲟⲩⲭⲣⲱⲙ	ⲡⲟⲩⲭⲣⲱⲙ
ⲡⲣⲉⲥⲃⲩⲧⲉⲣⲟⲥ	ⲡⲣⲉⲥⲃⲩⲧⲉⲣⲟⲥ
ⲡⲣⲟⲑⲉⲥⲓⲥ	ⲡⲣⲟⲑⲉⲥⲓⲥ
ⲡⲣⲟⲥⲉⲩⲭⲏ	ⲡⲣⲟⲥⲉⲩⲭⲏ
ⲡⲣⲟⲥⲟⲩⲥⲏⲟⲩ	ⲡⲣⲟⲥⲟⲩⲥⲏⲟⲩ
ⲡⲣⲟⲫⲏⲧⲏⲥ	ⲡⲣⲟⲫⲏⲧⲏⲥ
ⲡⲥⲁⲧⲁⲛⲁⲥ	ⲡⲥⲁⲧⲁⲛⲁⲥ
ⲡⲥⲟⲛ	ⲡⲥⲟⲛ
ⲡⲧⲏⲣϥ	ⲡⲧⲏⲣϥ
ⲡⲭⲣⲓⲥⲧⲟⲥ	ⲡⲭⲣⲓⲥⲧⲟⲥ
ⲡⲭⲥ	ⲡⲭⲣⲓⲥⲧⲟⲥ
ⲡⲱⲏⲣⲓ	ⲡⲱⲏⲣⲓ
ⲡⲱⲛϧ	ⲡⲱⲛϧ
ⲡⲱⲥ	ⲡⲱⲥ
ⲣ	ⲣ
ⲣⲁ	ⲣⲁ
ⲣⲁϣⲓ	ⲣⲁϣⲓ
ⲣⲁϧⲧ	ⲣⲁϧⲧ
ⲣⲁⲃⲃⲓ	ⲣⲁⲃⲃⲓ
ⲣⲁⲃⲃⲟⲩⲛⲓ	ⲣⲁⲃⲃⲟⲩⲛⲓ
ⲣⲁⲙⲁⲟ	ⲣⲁⲙⲁⲟ
ⲣⲁⲛ	ⲣⲁⲛ
ⲣⲁⲥϯ	ⲣⲁⲥϯ
ⲣⲁⲧ	ⲣⲁⲧ
ⲣⲉϥϣⲁⲙϣⲉⲓⲇⲱⲗⲟⲛ	ⲣⲉϥϣⲁⲙϣⲉⲓⲇⲱⲗⲟⲛ
ⲣⲉϥϣⲱⲛⲓ	ⲣⲉϥϣⲱⲛⲓ
ⲣⲉϥϩⲱⲗⲉⲙ	ⲣⲉϥϩⲱⲗⲉⲙ
ⲣⲉϥϩⲱⲟⲩϣ	ⲣⲉϥϩⲱⲟⲩϣ
ⲣⲉϥϭⲓ	ⲣⲉϥϭⲓ
ⲣⲉϥϭⲓⲛϫⲟⲛⲥ	ⲣⲉϥϭⲓⲛϫⲟⲛⲥ
ⲣⲉϥϭⲓⲟⲩⲓ	ⲣⲉϥϭⲓⲟⲩⲓ
ⲣⲉϥϯϣⲱϣ	ⲣⲉϥϯϣⲱϣ
ⲣⲉϥϯⲥⲃⲱ	ⲣⲉϥϯⲥⲃⲱ
ⲣⲉϥϯⲱⲙⲥ	ⲣⲉϥϯⲱⲙⲥ
ⲣⲉϥⲉⲛⲕⲟⲧ	ⲣⲉϥⲉⲛⲕⲟⲧ
ⲣⲉϥⲉⲣϩⲱⲃ	ⲣⲉϥⲉⲣϩⲱⲃ
ⲣⲉϥⲉⲣⲛⲟⲃⲓ	ⲣⲉϥⲉⲣⲛⲟⲃⲓ
ⲣⲉϥⲑⲓϧⲓ	ⲣⲉϥⲑⲓϧⲓ
ⲣⲉϥⲙⲱⲟⲩⲧ	ⲣⲉϥⲙⲱⲟⲩⲧ
ⲣⲉϥⲧⲁϩⲉⲣⲱⲙⲓ	ⲣⲉϥⲧⲁϩⲉⲣⲱⲙⲓ
ⲣⲉϥⲧⲱⲃϩ	ⲣⲉϥⲧⲱⲃϩ
ⲣⲉⲙⲛⲁⲍⲁⲣⲉⲑ	ⲣⲉⲙⲛⲁⲍⲁⲣⲉⲑ
ⲣⲉⲛ	ⲣⲉⲛ
ⲣⲏ	ⲣⲏ
ⲣⲏϯ	ⲣⲏϯ
ⲣⲓⲙⲓ	ⲣⲓⲙⲓ
ⲣⲓⲣ	ⲣⲓⲣ
ⲣⲟ	ⲣⲟ
ⲣⲟϯ	ⲣⲟϯ
ⲣⲟⲙⲡⲓ	ⲣⲟⲙⲡⲓ
ⲣⲟⲧⲉⲃ	ⲣⲟⲧⲉⲃ
ⲣⲟⲩϩⲓ	ⲣⲟⲩϩⲓ
ⲣⲡⲟⲣⲛⲉⲩⲓⲛ	ⲣⲡⲟⲣⲛⲉⲩⲓⲛ
ⲣⲭⲣⲓⲁ	ⲣⲭⲣⲓⲁ
ⲣⲱ	ⲣⲱ
ⲣⲱⲓⲙⲓ	ⲣⲱⲓⲙⲓ
ⲣⲱⲕϩ	ⲣⲱⲕϩ
ⲣⲱⲙⲓ	ⲣⲱⲙⲓ
ⲣⲱⲟⲩϣ	ⲣⲱⲟⲩϣ
ⲣⲱⲟⲩⲓ	ⲣⲱⲟⲩⲓ
ⲣⲱⲧ	ⲣⲱⲧ
ⲣⲱⲧⲉⲃ	ⲣⲱⲧⲉⲃ
ⲥ	ⲥ
ⲥϣⲉ	ⲥϣⲉ
ⲥϧⲁⲓ	ⲥϧⲁⲓ
ⲥϧⲉ	ⲥϧⲉ
ⲥϧⲏⲟⲩⲧ	ⲥϧⲏⲟⲩⲧ
ⲥϧⲓ	ⲥϧⲓ
ⲥϩⲓⲙⲓ	ⲥϩⲓⲙⲓ
ⲥⲁ	ⲥⲁ
ⲥⲁϧ	ⲥⲁϧ
ⲥⲁϧⲟⲩⲛ	ⲥⲁϧⲟⲩⲛ
ⲥⲁϩⲟⲩⲓ	ⲥⲁϩⲟⲩⲓ
ⲥⲁϫⲓ	ⲥⲁϫⲓ
ⲥⲁⲃⲃⲁⲧⲟⲛ	ⲥⲁⲃⲃⲁⲧⲟⲛ
ⲥⲁⲃⲉ	ⲥⲁⲃⲉ
ⲥⲁⲃⲉⲩ	ⲥⲁⲃⲉⲩ
ⲥⲁⲃⲟⲗ	ⲥⲁⲃⲟⲗ
ⲥⲁⲑⲉⲣⲓ	ⲥⲁⲑⲉⲣⲓ
ⲥⲁⲙⲉⲛϩⲏ	ⲥⲁⲙⲉⲛϩⲏ
ⲥⲁⲙⲉⲛϩⲏⲓ	ⲥⲁⲙⲉⲛϩⲏⲓ
ⲥⲁⲛⲇⲁⲗⲓⲟⲛ	ⲥⲁⲛⲇⲁⲗⲓⲟⲛ
ⲥⲁⲡⲥⲁ	ⲥⲁⲡⲥⲁ
ⲥⲁⲣⲕⲓⲕⲟⲥ	ⲥⲁⲣⲕⲓⲕⲟⲥ
ⲥⲁⲣⲕⲓⲕⲱⲥ	ⲥⲁⲣⲕⲓⲕⲱⲥ
ⲥⲁⲣⲝ	ⲥⲁⲣⲝ
ⲥⲁⲧ	ⲥⲁⲧ
ⲥⲁⲧⲁⲛⲁⲥ	ⲥⲁⲧⲁⲛⲁⲥ
ⲥⲁⲧⲉⲕϫⲁϭⲏ	ⲥⲁⲧⲉⲕϫⲁϭⲏ
ⲥⲁⲧⲉⲕⲟⲩⲓⲛⲁⲙ	ⲥⲁⲧⲉⲕⲟⲩⲓⲛⲁⲙ
ⲥⲁⲧⲉⲛ	ⲥⲁⲧⲉⲛ
ⲥⲁⲧⲉⲛⲑⲏⲛⲟⲩ	ⲥⲁⲧⲉⲛⲑⲏⲛⲟⲩ
ⲥⲁⲧⲟⲧ	ⲥⲁⲧⲟⲧ
ⲥⲁⲧⲟⲧϥ	ⲥⲁⲧⲟⲧϥ
ⲥⲁⲧⲟⲧⲟⲩ	ⲥⲁⲧⲟⲧⲟⲩ
ⲥⲁⲧⲟⲧⲥ	ⲥⲁⲧⲟⲧⲥ
ⲥⲁⲫⲁϩⲟⲩ	ⲥⲁⲫⲁϩⲟⲩ
ⲥⲃⲱ	ⲥⲃⲱ
ⲥⲉ	ⲥⲉ
ⲥⲉϥ	ⲥⲉϥ
ⲥⲉϥⲱϫⲓ	ⲥⲉϥⲱϫⲓ
ⲥⲉϩⲧ	ⲥⲉϩⲧ
ⲥⲉϩⲱⲟⲩϣ	ⲥⲉϩⲱⲟⲩϣ
ⲥⲉϫⲱ	ⲥⲉϫⲱ
ⲥⲉϭⲓ	ⲥⲉϭⲓ
ⲥⲉϯⲕⲉϩ	ⲥⲉϯⲕⲉϩ
ⲥⲉⲃⲧⲉ	ⲥⲉⲃⲧⲉ
ⲥⲉⲃⲧⲱⲧ	ⲥⲉⲃⲧⲱⲧ
ⲥⲉⲃⲧⲱⲧⲟⲩ	ⲥⲉⲃⲧⲱⲧⲟⲩ
ⲥⲉⲉⲣϩⲱⲃ	ⲥⲉⲉⲣϩⲱⲃ
ⲥⲉⲉⲣⲛⲏⲥⲧⲉⲩⲓⲛ	ⲥⲉⲉⲣⲛⲏⲥⲧⲉⲩⲓⲛ
ⲥⲉⲉⲣⲛⲟϥⲣⲓ	ⲥⲉⲉⲣⲛⲟϥⲣⲓ
ⲥⲉⲕⲱϯ	ⲥⲉⲕⲱϯ
ⲥⲉⲙⲛⲏⲟⲩⲧ	ⲥⲉⲙⲛⲏⲟⲩⲧ
ⲥⲉⲙⲟϣⲓ	ⲥⲉⲙⲟϣⲓ
ⲥⲉⲛ	ⲥⲉⲛ
ⲥⲉⲛϯ	ⲥⲉⲛϯ
ⲥⲉⲛⲁϧⲟⲑⲃⲉϥ	ⲥⲉⲛⲁϧⲟⲑⲃϥ
ⲥⲉⲛⲁϩⲓⲑⲁϥ	ⲥⲉⲛⲁϩⲓⲑⲁϥ
ⲥⲉⲛⲁϯ	ⲥⲉⲛⲁϯ
ⲥⲉⲛⲁϯϩⲁⲡ	ⲥⲉⲛⲁϯϩⲁⲡ
ⲥⲉⲛⲁⲃⲱⲗ	ⲥⲉⲛⲁⲃⲱⲗ
ⲥⲉⲛⲁⲉⲣⲕⲗⲏⲣⲟⲛⲟⲙⲓⲛ	ⲥⲉⲛⲁⲉⲣⲕⲗⲏⲣⲟⲛⲟⲙⲓⲛ
ⲥⲉⲛⲁⲉⲣⲙⲁⲥⲧⲓⲅⲅⲟⲓⲛ	ⲥⲉⲛⲁⲉⲣⲙⲁⲥⲧⲓⲅⲅⲟⲓⲛ
ⲥⲉⲛⲁⲉⲣⲛⲏⲥⲧⲉⲩⲓⲛ	ⲥⲉⲛⲁⲉⲣⲛⲏⲥⲧⲉⲩⲓⲛ
ⲥⲉⲛⲁⲥⲱⲃⲓ	ⲥⲉⲛⲁⲥⲱⲃⲓ
ⲥⲉⲛⲁⲧⲏⲓϥ	ⲥⲉⲛⲁⲧⲏⲓϥ
ⲥⲉⲛⲏⲟⲩ	ⲥⲉⲛⲏⲟⲩ
ⲥⲉⲟϩⲓ	ⲥⲉⲟϩⲓ
ⲥⲉⲟⲓ	ⲥⲉⲟⲓ
ⲥⲉⲟⲩⲱⲙ	ⲥⲉⲟⲩⲱⲙ
ⲥⲉⲣ	ⲥⲉⲣ
ⲥⲉⲣⲙⲉⲗⲓⲛ	ⲥⲉⲣⲙⲉⲗⲓⲛ
ⲥⲉⲥⲱϥ	ⲥⲉⲥⲱϥ
ⲥⲉⲥⲱⲧⲉⲙ	ⲥⲉⲥⲱⲧⲉⲙ
ⲥⲉⲧ	ⲥⲉⲧ
ⲥⲉⲭⲏ	ⲥⲉⲭⲏ
ⲥⲉⲱϫϩ	ⲥⲉⲱϫϩ
ⲥⲏϫ	ⲥⲏϫ
ⲥⲏⲓⲛⲓ	ⲥⲏⲓⲛⲓ
ⲥⲏⲟⲩ	ⲥⲏⲟⲩ
ⲥⲑⲉⲣⲧⲉⲣ	ⲥⲑⲉⲣⲧⲉⲣ
ⲥⲓ	ⲥⲓ
ⲥⲓϩⲓ	ⲥⲓϩⲓ
ⲥⲓϯ	ⲥⲓϯ
ⲥⲓⲇⲱⲛ	ⲥⲓⲇⲱⲛ
ⲥⲓⲙ	ⲥⲓⲙ
ⲥⲓⲙⲡⲟⲥⲓⲟⲛ	ⲥⲓⲙⲡⲟⲥⲓⲟⲛ
ⲥⲓⲙⲱⲛ	ⲥⲓⲙⲱⲛ
ⲥⲓⲛⲓ	ⲥⲓⲛⲓ
ⲥⲓⲛⲓⲱⲟⲩ	ⲥⲓⲛⲓⲱⲟⲩ
ⲥⲕⲁⲣⲓⲱⲧⲏⲥ	ⲓⲥⲕⲁⲣⲓⲱⲧⲏⲥ
ⲥⲕⲉⲡⲱⲗⲁⲧⲟⲣ	ⲥⲕⲉⲡⲱⲗⲁⲧⲟⲣ
ⲥⲕⲉⲩⲟⲥ	ⲥⲕⲉⲩⲟⲥ
ⲥⲕⲩⲛⲏ	ⲥⲕⲩⲛⲏ
ⲥⲙⲁⲣⲱⲟⲩⲧ	ⲥⲙⲁⲣⲱⲟⲩⲧ
ⲥⲙⲏ	ⲥⲙⲏ
ⲥⲙⲟⲕϩ	ⲥⲙⲟⲕϩ
ⲥⲙⲟⲧⲉⲛ	ⲥⲙⲟⲧⲉⲛ
ⲥⲙⲟⲩ	ⲥⲙⲟⲩ
ⲥⲛⲁϩ	ⲥⲛⲁϩ
ⲥⲛⲁⲩ	ⲥⲛⲁⲩ
ⲥⲛⲏⲟⲩ	ⲥⲛⲏⲟⲩ
ⲥⲛⲟϥ	ⲥⲛⲟϥ
ⲥⲛⲟⲩϯ	ⲥⲛⲟⲩϯ
ⲥⲟ	ⲥⲟ
ⲥⲟϥ	ⲥⲟϥ
ⲥⲟϫ	ⲥⲟϫ
ⲥⲟϭⲛⲓ	ⲥⲟϭⲛⲓ
ⲥⲟⲃϯ	ⲥⲟⲃϯ
ⲥⲟⲑⲙ	ⲥⲟⲑⲙ
ⲥⲟⲑⲙⲟⲩ	ⲥⲟⲑⲙⲟⲩ
ⲥⲟⲓ	ⲥⲟⲓ
ⲥⲟⲙⲥ	ⲥⲟⲙⲥ
ⲥⲟⲛ	ⲥⲟⲛ
ⲥⲟⲛϩ	ⲥⲟⲛϩ
ⲥⲟⲛⲓ	ⲥⲟⲛⲓ
ⲥⲟⲛⲧ	ⲥⲟⲛⲧ
ⲥⲟⲡ	ⲥⲟⲡ
ⲥⲟⲥⲟⲩ	ⲥⲟⲥⲟⲩ
ⲥⲟⲩⲣⲓ	ⲥⲟⲩⲣⲓ
ⲥⲟⲩⲧⲉⲛ	ⲥⲟⲩⲧⲉⲛ
ⲥⲟⲩⲧⲉⲛⲛⲉϥⲙⲁ	ⲥⲟⲩⲧⲉⲛⲛⲉϥⲙⲁ
ⲥⲟⲩⲧⲉⲛⲧⲉⲕϫⲓϫ	ⲥⲟⲩⲧⲉⲛⲧⲉⲕϫⲓϫ
ⲥⲟⲩⲧⲱⲛ	ⲥⲟⲩⲧⲱⲛ
ⲥⲟⲩⲱⲛ	ⲥⲟⲩⲱⲛ
ⲥⲟⲩⲱⲛⲥ	ⲥⲟⲩⲱⲛⲥ
ⲥⲟⲫⲓⲁ	ⲥⲟⲫⲓⲁ
ⲥⲡⲟⲩⲇⲏ	ⲥⲡⲟⲩⲇⲏ
ⲥⲣⲉⲙⲣⲱⲙ	ⲥⲣⲉⲙⲣⲱⲙ
ⲥⲥϧⲏⲟⲩⲧ	ⲥⲥϧⲏⲟⲩⲧ
ⲥⲥⲙⲁⲣⲱⲟⲩⲧ	ⲥⲥⲙⲁⲣⲱⲟⲩⲧ
ⲥⲧⲁⲩⲣⲟⲥ	ⲥⲧⲁⲩⲣⲟⲥ
ⲥⲩⲅⲅⲉⲛⲓⲁ	ⲥⲩⲅⲅⲉⲛⲓⲁ
ⲥⲩⲛⲁⲅⲱⲅⲏ	ⲥⲩⲛⲁⲅⲱⲅⲏ
ⲥⲩⲛⲏⲑⲓⲁ	ⲥⲩⲛⲏⲑⲓⲁ
ⲥⲩⲣⲓⲁ	ⲥⲩⲣⲓⲁ
ⲥⲫⲟⲧⲟⲩ	ⲥⲫⲟⲧⲟⲩ
ⲥⲭⲏⲙⲁ	ⲥⲭⲏⲙⲁ
ⲥⲱ	ⲥⲱ
ⲥⲱϥ	ⲥⲱϥ
ⲥⲱϫⲡ	ⲥⲱϫⲡ
ⲥⲱϯ	ⲥⲱϯ
ⲥⲱⲃⲓ	ⲥⲱⲃⲓ
ⲥⲱⲕ	ⲥⲱⲕ
ⲥⲱⲗⲡ	ⲥⲱⲗⲡ
ⲥⲱⲙⲁ	ⲥⲱⲙⲁ
ⲥⲱⲛϩ	ⲥⲱⲛϩ
ⲥⲱⲛⲓ	ⲥⲱⲛⲓ
ⲥⲱⲛⲧ	ⲥⲱⲛⲧ
ⲥⲱⲟⲩⲃⲉⲛ	ⲥⲱⲟⲩⲃⲉⲛ
ⲥⲱⲟⲩⲛ	ⲥⲱⲟⲩⲛ
ⲥⲱⲣ	ⲥⲱⲣ
ⲥⲱⲣⲉⲙ	ⲥⲱⲣⲉⲙ
ⲥⲱⲧⲉⲙ	ⲥⲱⲧⲉⲙ
ⲧ	ⲧ
ⲧϣⲱⲙⲓ	ⲧϣⲱⲙⲓ
ⲧϩⲉⲙⲕⲏⲟⲩⲧ	ⲧϩⲉⲙⲕⲏⲟⲩⲧ
ⲧϩⲉⲙⲥⲱ	ⲧϩⲉⲙⲥⲱ
ⲧϩⲟ	ⲧϩⲟ
ⲧⲁ	ⲧⲁ
ⲧⲁϩⲛⲟ	ⲧⲁϩⲛⲟ
ⲧⲁϩⲟ	ⲧⲁϩⲟ
ⲧⲁⲓ	ⲧⲁⲓ
ⲧⲁⲓⲏⲟⲩⲧ	ⲧⲁⲓⲏⲟⲩⲧ
ⲧⲁⲓⲟ	ⲧⲁⲓⲟ
ⲧⲁⲓⲥⲟⲫⲓⲁ	ⲧⲁⲓⲥⲟⲫⲓⲁ
ⲧⲁⲕⲟ	ⲧⲁⲕⲟ
ⲧⲁⲗⲉ	ⲧⲁⲗⲉ
ⲧⲁⲗⲓⲑⲁ	ⲧⲁⲗⲓⲑⲁ
ⲧⲁⲙⲁⲩ	ⲧⲁⲙⲁⲩ
ⲧⲁⲙⲉ	ⲧⲁⲙⲉ
ⲧⲁⲙⲟ	ⲧⲁⲙⲟ
ⲧⲁⲙⲱ	ⲧⲁⲙⲱ
ⲧⲁⲟⲩⲟ	ⲧⲁⲟⲩⲟ
ⲧⲁⲣⲕⲟ	ⲧⲁⲣⲕⲟ
ⲧⲁⲣⲭⲏ	ⲧⲁⲣⲭⲏ
ⲧⲁⲩⲧⲁ	ⲧⲁⲩⲧⲁ
ⲧⲉ	ⲧⲉ
ⲧⲉϥ	ⲧⲉϥ
ⲧⲉϥϫⲓϫ	ⲧⲉϥϫⲓϫ
ⲧⲉϥⲙⲁⲩ	ⲧⲉϥⲙⲁⲩ
ⲧⲉϥⲛⲉϫⲓ	ⲧⲉϥⲛⲉϫⲓ
ⲧⲉⲃⲧ	ⲧⲉⲃⲧ
ⲧⲉⲕ	ⲧⲉⲕ
ⲧⲉⲕⲙⲁⲩ	ⲧⲉⲕⲙⲁⲩ
ⲧⲉⲗⲱⲛⲏⲥ	ⲧⲉⲗⲱⲛⲏⲥ
ⲧⲉⲗⲱⲛⲓⲟⲛ	ⲧⲉⲗⲱⲛⲓⲟⲛ
ⲧⲉⲛ	ⲧⲉⲛ
ⲧⲉⲛϣⲏϣ	ⲧⲉⲛϣⲏϣ
ⲧⲉⲛϧⲟⲥⲓ	ⲧⲉⲛϧⲟⲥⲓ
ⲧⲉⲛϩⲟⲕⲉⲣ	ⲧⲉⲛϩⲟⲕⲉⲣ
ⲧⲉⲛϯϩⲟ	ⲧⲉⲛϯϩⲟ
ⲧⲉⲛⲃⲏϣ	ⲧⲉⲛⲃⲏϣ
ⲧⲉⲛⲉ	ⲧⲉⲛⲉ
ⲧⲉⲛⲉⲣϩⲟϯ	ⲧⲉⲛⲉⲣϩⲟϯ
ⲧⲉⲛⲑⲱⲛ	ⲧⲉⲛⲑⲱⲛ
ⲧⲉⲛⲛⲁϣⲉ	ⲧⲉⲛⲛⲁϣⲉ
ⲧⲉⲛⲟⲃⲓ	ⲧⲉⲛⲟⲃⲓ
ⲧⲉⲛⲟⲩⲱϣ	ⲧⲉⲛⲟⲩⲱϣ
ⲧⲉⲛⲥⲉⲙⲛⲏⲟⲩⲧ	ⲧⲉⲛⲥⲉⲙⲛⲏⲟⲩⲧ
ⲧⲉⲛⲥⲙⲟⲩ	ⲧⲉⲛⲥⲙⲟⲩ
ⲧⲉⲛⲥⲱⲟⲩⲛ	ⲧⲉⲛⲥⲱⲟⲩⲛ
ⲧⲉⲛⲱⲟⲩ	ⲧⲉⲛⲱⲟⲩ
ⲧⲉⲥ	ⲧⲉⲥ
ⲧⲉⲧⲉⲛ	ⲧⲉⲧⲉⲛ
ⲧⲉⲧⲉⲛϣⲧⲉⲣⲑⲱⲣ	ⲧⲉⲧⲛϣⲧⲉⲣⲑⲱⲣ
ⲧⲉⲧⲉⲛϫⲱ	ⲧⲉⲧⲉⲛϫⲱ
ⲧⲉⲧⲉⲛϭⲟⲥⲓ	ⲧⲉⲧⲉⲛϭⲟⲥⲓ
ⲧⲉⲧⲉⲛⲁⲙⲟⲛⲓ	ⲧⲉⲧⲛⲁⲙⲟⲛⲓ
ⲧⲉⲧⲉⲛⲉⲙⲓ	ⲧⲉⲧⲉⲛⲉⲙⲓ
ⲧⲉⲧⲉⲛⲉⲣϩⲟϯ	ⲧⲉⲧⲛⲉⲣϩⲟϯ
ⲧⲉⲧⲉⲛⲉⲣⲁⲑⲉⲧⲓⲛ	ⲧⲉⲧⲛⲉⲣⲁⲑⲉⲧⲓⲛ
ⲧⲉⲧⲉⲛⲓⲣⲓ	ⲧⲉⲧⲉⲛⲓⲣⲓ
ⲧⲉⲧⲉⲛⲕⲁϯ	ⲧⲉⲧⲉⲛⲕⲁϯ
ⲧⲉⲧⲉⲛⲙⲟⲕⲙⲉⲕ	ⲧⲉⲧⲛⲙⲟⲕⲙⲉⲕ
ⲧⲉⲧⲉⲛⲛⲁⲥⲟⲩⲱⲛⲟⲩ	ⲧⲉⲧⲛⲛⲁⲥⲟⲩⲱⲛⲟⲩ
ⲧⲉⲧⲉⲛⲟⲩⲁϣϥ	ⲧⲉⲧⲉⲛⲟⲩⲁϣϥ
ⲧⲉⲧⲉⲛⲣⲁ	ⲧⲉⲧⲉⲛⲣⲁ
ⲧⲉⲧⲉⲛⲣⲓⲙⲓ	ⲧⲉⲧⲛⲣⲓⲙⲓ
ⲧⲉⲧⲉⲛⲧⲁⲓⲏⲟⲩⲧ	ⲧⲉⲧⲉⲛⲧⲁⲓⲏⲟⲩⲧ
ⲧⲏⲃ	ⲧⲏⲃ
ⲧⲏⲓ	ⲧⲏⲓ
ⲧⲏⲓⲥ	ⲧⲏⲓⲥ
ⲧⲏⲓⲧ	ⲧⲏⲓⲧ
ⲧⲏⲓⲧⲟⲩ	ⲧⲏⲓⲧⲟⲩ
ⲧⲏⲣ	ⲧⲏⲣ
ⲧⲏⲣϥ	ⲧⲏⲣϥ
ⲧⲏⲣⲟⲩ	ⲧⲏⲣⲟⲩ
ⲧⲏⲣⲥ	ⲧⲏⲣⲥ
ⲧⲓⲙⲉⲟⲥ	ⲧⲓⲙⲉⲟⲥ
ⲧⲓⲙⲏ	ⲧⲓⲙⲏ
ⲧⲓⲙⲟⲑⲉⲟⲥ	ⲧⲓⲙⲟⲑⲉⲟⲥ
ⲧⲟⲓ	ⲧⲟⲓ
ⲧⲟⲙ	ⲧⲟⲙ
ⲧⲟⲙϥ	ⲧⲟⲙϥ
ⲧⲟⲧ	ⲧⲟⲧ
ⲧⲟⲧⲉ	ⲧⲟⲧⲉ
ⲧⲟⲩ	ⲧⲟⲩ
ⲧⲟⲩϩⲟ	ⲧⲟⲩϩⲟ
ⲧⲟⲩⲃⲉ	ⲧⲟⲩⲃⲉ
ⲧⲟⲩⲃⲟ	ⲧⲟⲩⲃⲟ
ⲧⲟⲩⲛⲟⲥ	ⲧⲟⲩⲛⲟⲥ
ⲧⲣⲁⲡⲉⲍⲁ	ⲧⲣⲁⲡⲉⲍⲁ
ⲧⲥϩⲓⲙⲓ	ⲧⲥϩⲓⲙⲓ
ⲧⲥⲁⲃⲟ	ⲧⲥⲁⲃⲟ
ⲧⲥⲃⲱ	ⲧⲥⲃⲱ
ⲧⲥⲉ	ⲧⲥⲉ
ⲧⲥⲟ	ⲧⲥⲟ
ⲧⲩⲣⲟⲥ	ⲧⲩⲣⲟⲥ
ⲧⲫⲉ	ⲧⲫⲉ
ⲧⲱϫⲓ	ⲧⲱϫⲓ
ⲧⲱⲓⲥ	ⲧⲱⲓⲥ
ⲧⲱⲙⲓ	ⲧⲱⲙⲓ
ⲧⲱⲙⲧ	ⲧⲱⲙⲧ
ⲧⲱⲛ	ⲧⲱⲛ
ⲧⲱⲛϥ	ⲧⲱⲛϥ
ⲧⲱⲛⲓ	ⲧⲱⲛⲓ
ⲧⲱⲛⲕ	ⲧⲱⲛⲕ
ⲧⲱⲟⲩ	ⲧⲱⲟⲩ
ⲩ	ⲩ
ⲫ	ⲫ
ⲫⲁ	ⲫⲁ
ⲫⲁϣ	ⲫⲁϣ
ⲫⲁϣⲓ	ⲫⲁϣⲓ
ⲫⲁϩⲟⲩ	ⲫⲁϩⲟⲩ
ⲫⲁⲁⲡⲟⲗⲗⲱ	ⲫⲁⲁⲡⲟⲗⲗⲱ
ⲫⲁⲓ	ⲫⲁⲓ
ⲫⲁⲛⲏ	ⲫⲁⲛⲏ
ⲫⲁⲡⲁⲩⲗⲟⲥ	ⲫⲁⲡⲁⲩⲗⲟⲥ
ⲫⲁⲣⲓⲥⲉⲟⲥ	ⲫⲁⲣⲓⲥⲉⲟⲥ
ⲫⲁⲫⲛⲟⲩϯ	ⲫⲁⲫⲛⲟⲩϯ
ⲫⲉ	ⲫⲉ
ⲫⲉϧ	ⲫⲉϧ
ⲫⲏ	ⲫⲏ
ⲫⲏⲟⲩⲓ	ⲫⲏⲟⲩⲓ
ⲫⲓⲗⲓⲡⲡⲉ	ⲫⲓⲗⲓⲡⲡⲉ
ⲫⲓⲗⲓⲡⲡⲟⲥ	ⲫⲓⲗⲓⲡⲡⲟⲥ
ⲫⲓⲟⲙ	ⲡⲓⲟⲙ
ⲫⲙⲱⲓⲧ	ⲫⲙⲱⲓⲧ
ⲫⲛⲟⲩϯ	ⲫⲛⲟⲩϯ
ⲫⲟϩ	ⲫⲟϩ
ⲫⲟⲓⲛⲓⲕⲏ	ⲫⲟⲓⲛⲓⲕⲏ
ⲫⲟⲛϩ	ⲫⲟⲛϩ
ⲫⲟⲣϫ	ⲫⲟⲣϫ
ⲫⲟⲣϫϥ	ⲫⲟⲣϫϥ
ⲫⲟⲣⲓ	ⲫⲟⲣⲉⲓ
ⲫⲟⲣⲕ	ⲫⲟⲣⲕ
ⲫⲟⲣⲕϥ	ⲫⲟⲣⲕϥ
ⲫⲣⲏϯ	ⲡⲣⲏϯ
ⲫⲱ	ⲫⲱ
ⲫⲱϣ	ⲫⲱϣ
ⲫⲱϧ	ⲫⲱϧ
ⲫⲱⲓ	ⲫⲱⲓ
ⲫⲱⲣϣ	ⲫⲱⲣϣ
ⲫⲱⲧ	ⲫⲱⲧ
ⲫⲱⲧⲉⲧⲉⲛ	ⲫⲱⲧⲉⲧⲉⲛ
ⲭ	ⲭ
ⲭⲁ	ⲭⲁ
ⲭⲁϫⲓϫ	ⲭⲁϫⲓϫ
ⲭⲁⲏⲓ	ⲭⲁⲏⲓ
ⲭⲁⲕⲓ	ⲭⲁⲕⲓ
ⲭⲁⲗⲕⲓⲛ	ⲭⲁⲗⲕⲓⲛ
ⲭⲁⲛⲟⲃⲓ	ⲭⲁⲛⲟⲃⲓ
ⲭⲁⲡⲉϥⲓⲱⲧ	ⲭⲁⲡⲉϥⲓⲱⲧ
ⲭⲁⲥ	ⲭⲁⲥ
ⲭⲁⲩ	ⲭⲁⲩ
ⲭⲏ	ⲭⲏ
ⲭⲓⲗⲓⲁⲣⲭⲟⲥ	ⲭⲓⲗⲓⲁⲣⲭⲟⲥ
ⲭⲓⲱⲛ	ⲭⲓⲱⲛ
ⲭⲟϩ	ⲭⲟϩ
ⲭⲣⲉⲙⲣⲉⲙ	ⲭⲣⲉⲙⲣⲉⲙ
ⲭⲣⲏⲙⲁ	ⲭⲣⲏⲙⲁ
ⲭⲣⲓⲥⲧⲟⲥ	ⲭⲣⲓⲥⲧⲟⲥ
ⲭⲣⲟ	ⲭⲣⲟ
ⲭⲣⲟⲛⲟⲥ	ⲭⲣⲟⲛⲟⲥ
ⲭⲣⲱⲙ	ⲭⲣⲱⲙ
ⲭⲥ	ⲭⲣⲓⲥⲧⲟⲥ
ⲭⲱ	ⲭⲱ
ⲭⲱⲗⲉⲙ	ⲭⲱⲗⲉⲙ
ⲭⲱⲟⲩⲛⲓ	ⲭⲱⲟⲩⲛⲓ
ⲭⲱⲣⲁ	ⲭⲱⲣⲁ
ⲭⲱⲣⲓⲥ	ⲭⲱⲣⲓⲥ
ⲯⲩⲭⲏ	ⲯⲩⲭⲏ
ⲯⲩⲭⲓⲕⲟⲥ	ⲯⲩⲭⲓⲕⲟⲥ
ⲱ	ⲱ
ⲱϣ	ⲱϣ
ⲱϣⲉⲙ	ⲱϣⲉⲙ
ⲱϫϩ	ⲱϫϩ
ⲱⲃϣ	ⲱⲃϣ
ⲱⲏⲣⲓ	ⲱⲏⲣⲓ
ⲱⲓⲕ	ⲱⲓⲕ
ⲱⲕⲉⲙ	ⲱⲕⲉⲙ
ⲱⲗⲓ	ⲱⲗⲓ
ⲱⲙⲥ	ⲱⲙⲥ
ⲱⲛϧ	ⲱⲛϧ
ⲱⲛⲓ	ⲱⲛⲓ
ⲱⲟⲩ	ⲱⲟⲩ
ⲱⲣⲕ	ⲱⲣⲕ
ⲱⲥϧ	ⲱⲥϧ
ⲱⲥⲁⲛⲛⲁ	ⲱⲥⲁⲛⲛⲁ
ⲑⲏ	ⲑⲏ
ⲫϯ	ⲫⲛⲟⲩϯ
ⲙⲫϯ	ⲙⲫⲛⲟⲩϯ
ⲫⲁⲣⲓⲥⲉⲟⲥ	ⲫⲁⲣⲓⲥⲁⲓⲟⲥ
ⲓⲗⲏⲙ	ϩⲓⲉⲣⲟⲩⲥⲁⲗⲏⲙ
ⲉⲧⲁⲫϯ	ⲉⲧⲁⲫⲛⲟⲩϯ