ϯⲡⲣⲟⲥⲉⲩⲭⲏ	ϯ|ⲡⲣⲟⲥⲉⲩⲭⲏ
ⲛⲧⲉⲁⲃⲃⲁⲕⲟⲩⲙ	ⲛⲧⲉ|ⲁⲃⲃⲁⲕⲟⲩⲙ
ⲡⲓⲡⲣⲟⲫⲏⲧⲏⲥ	ⲡⲓ|ⲡⲣⲟⲫⲏⲧⲏⲥ
ⲛⲉⲙⲟⲩϩⲱⲇⲏ	ⲛⲉⲙ|ⲟⲩ|ϩⲱⲇⲏ
.	.
ⲡϭⲟⲉⲓⲥ	ⲡ|ϭⲟⲉⲓⲥ
ⲁⲓⲥⲱⲧⲉⲙ	ⲁ|ⲓ|ⲥⲱⲧⲉⲙ
ⲉⲡⲉⲕϧⲣⲱⲟⲩ	ⲉ|ⲡⲉⲕ|ϧⲣⲱⲟⲩ
ⲟⲩⲟϩ	ⲟⲩⲟϩ
ⲁⲓⲉⲣϩⲟϯ	ⲁ|ⲓ|ⲉⲣϩⲟϯ
ⲁⲓϯ	ⲁ|ⲓ|ϯ
ⲛⲓⲁⲧ	ⲛ|ⲓⲁⲧ
ⲛⲛⲉⲕϩⲃⲏⲟⲩⲓ	ⲛ|ⲛⲉⲕ|ϩⲃⲏⲟⲩⲓ
ⲁⲓⲧⲱⲙⲧ	ⲁ|ⲓ|ⲧⲱⲙⲧ
ⲉⲩⲉⲉⲙⲓ	ⲉⲩⲉ|ⲉⲙⲓ
ⲉⲣⲟⲕ	ⲉⲣⲟ|ⲕ
ϧⲉⲛⲑⲙⲏϯ	ϧⲉⲛ|ⲑ|ⲙⲏϯ
ⲛⲍⲱⲟⲛ	ⲛ|ⲍⲱⲟⲛ
ⲃ	ⲃ
ϧⲉⲛⲡϫⲓⲛⲑⲣⲟⲩϧⲱⲛⲧ	ϧⲉⲛ|ⲡ|ϫⲓⲛⲑⲣⲟⲩϧⲱⲛⲧ
ⲉϧⲟⲩⲛ	ⲉϧⲟⲩⲛ
ⲛϫⲉⲛⲓⲣⲟⲙⲡⲓ	ⲛϫⲉ|ⲛⲓ|ⲣⲟⲙⲡⲓ
ⲉⲩⲉⲥⲟⲩⲱⲛⲕ	ⲉⲩⲉ|ⲥⲟⲩⲱⲛ|ⲕ
ϧⲉⲛⲡϫⲓⲛⲑⲣⲉϥⲓ	ϧⲉⲛ|ⲡ|ϫⲓⲛⲑⲣⲉϥⲓ
ⲛϫⲉⲡⲓⲥⲏⲟⲩ	ⲛϫⲉ|ⲡⲓ|ⲥⲏⲟⲩ
ⲉⲕⲉϭⲱⲣⲡ	ⲉⲕⲉ|ϭⲱⲣⲡ
ⲉⲃⲟⲗ	ⲉⲃⲟⲗ
ϧⲉⲛⲡϫⲓⲛⲑⲣⲉⲥϣⲑⲟⲣⲧⲉⲣ	ϧⲉⲛ|ⲡ|ϫⲓⲛⲑⲣⲉⲥϣⲑⲟⲣⲧⲉⲣ
ⲛϫⲉⲧⲁⲯⲩⲭⲏ	ⲛϫⲉ|ⲧⲁ|ⲯⲩⲭⲏ
ϧⲉⲛⲟⲩⲙⲃⲟⲛ	ϧⲉⲛ|ⲟⲩ|ⲙⲃⲟⲛ
ⲭⲛⲁⲉⲣⲫⲙⲉⲩⲓ	ⲭ|ⲛⲁ|ⲉⲣ|ⲫ|ⲙⲉⲩⲓ
ⲙⲫⲛⲁⲓ	ⲙ|ⲫ|ⲛⲁⲓ
ϥⲛⲏⲟⲩ	ϥ|ⲛⲏⲟⲩ
ⲛϫⲉⲫⲛⲟⲩϯ	ⲛϫⲉ|ⲫ|ⲛⲟⲩϯ
ϧⲉⲛⲑⲱⲉⲙⲁⲛ	ϧⲉⲛ|ⲑⲱⲉⲙⲁⲛ
ⲡⲉⲑⲟⲩⲁⲃ	ⲡ|ⲉⲑ|ⲟⲩⲁⲃ
ϧⲉⲛⲡⲧⲱⲟⲩ	ϧⲉⲛ|ⲡ|ⲧⲱⲟⲩ
ⲙⲫⲁⲣⲣⲁⲛ	ⲙ|ⲫⲁⲣⲣⲁⲛ
ⲉϥⲟⲓ	ⲉ|ϥ|ⲟⲓ
ⲛϧⲏⲓⲃⲓ	ⲛ|ϧⲏⲓⲃⲓ
ⲉϥⲟϣ	ⲉ|ϥ|ⲟϣ
ⲛϣϣⲏⲛ	ⲛ|ϣϣⲏⲛ
ⲇⲓⲁⲯⲁⲗⲙⲁ	ⲇⲓⲁⲯⲁⲗⲙⲁ
ⲁⲥϩⲱⲃⲥ	ⲁ|ⲥ|ϩⲱⲃⲥ
ⲛⲧⲫⲉ	ⲛ|ⲧ|ⲫⲉ
ⲛϫⲉⲧⲉϥⲁⲣⲉⲧⲏ	ⲛϫⲉ|ⲧⲉϥ|ⲁⲣⲉⲧⲏ
ϥⲙⲉϩ	ϥ|ⲙⲉϩ
ⲛϫⲉⲡⲕⲁϩⲓ	ⲛϫⲉ|ⲡ|ⲕⲁϩⲓ
ϧⲉⲛⲥⲙⲟⲩ	ϧⲉⲛ|ⲥⲙⲟⲩ
ⲡⲉϥⲙⲟⲩⲉ	ⲡⲉϥ|ⲙⲟⲩⲉ
ⲉϥⲉⲉⲣ	ⲉϥⲉ|ⲉⲣ
ⲙⲫⲣⲏϯ	ⲙ|ⲫ|ⲣⲏϯ
ⲙⲡⲓⲟⲩⲱⲓⲛⲓ	ⲙ|ⲡⲓ|ⲟⲩⲱⲓⲛⲓ
ϩⲁⲛⲧⲁⲡ	ϩⲁⲛ|ⲧⲁⲡ
ⲥⲉ	ⲥⲉ
ⲛϩⲣⲏⲓ	ⲛϩⲣⲏⲓ
ϧⲉⲛⲛⲉϥϫⲓϫ	ϧⲉⲛ|ⲛⲉϥ|ϫⲓϫ
ⲁϥⲭⲱ	ⲁ|ϥ|ⲭⲱ
ⲛϯⲁⲅⲁⲁⲡⲏ	ⲛ|ϯ|ⲁⲅⲁⲁⲡⲏ
ⲛⲧⲉⲧⲉϥϫⲟⲙ	ⲛⲧⲉ|ⲧⲉϥ|ϫⲟⲙ
ⲉⲥⲧⲁϫⲣⲏⲟⲩⲧ	ⲉ|ⲥ|ⲧⲁϫⲣⲏⲟⲩⲧ
ⲉϥⲉⲙⲟϣⲓ	ⲉϥⲉ|ⲙⲟϣⲓ
ϧⲁϫⲱϥ	ϧⲁϫⲱ|ϥ
ⲛϫⲉⲟⲩⲥⲁϫⲓ	ⲛϫⲉ|ⲟⲩ|ⲥⲁϫⲓ
ⲉⲩⲉⲓ	ⲉⲩⲉ|ⲓ
ⲛϫⲉⲛⲉϥϭⲁⲗⲁⲩϫ	ⲛϫⲉ|ⲛⲉϥ|ϭⲁⲗⲁⲩϫ
ⲉϩⲁⲛⲙⲉϣϣⲟϯ	ⲉ|ϩⲁⲛ|ⲙⲉϣϣⲟϯ
ⲁϥⲟϩⲓ	ⲁ|ϥ|ⲟϩⲓ
ⲉⲣⲁⲧϥ	ⲉⲣⲁⲧ|ϥ
ⲁϥⲕⲓⲙ	ⲁ|ϥ|ⲕⲓⲙ
ⲁϥϫⲟⲩϣⲧ	ⲁ|ϥ|ϫⲟⲩϣⲧ
ⲁⲩⲃⲱⲗ	ⲁ|ⲩ|ⲃⲱⲗ
ⲛϫⲉϩⲁⲛⲉⲑⲛⲟⲥ	ⲛϫⲉ|ϩⲁⲛ|ⲉⲑⲛⲟⲥ
ⲁⲩϧⲟⲙϧⲉⲙ	ⲁ|ⲩ|ϧⲟⲙϧⲉⲙ
ⲛϫⲟⲛⲥ	ⲛ|ϫⲟⲛⲥ
ⲛϫⲉⲛⲓⲧⲱⲟⲩ	ⲛϫⲉ|ⲛⲓ|ⲧⲱⲟⲩ
ⲛϫⲉⲛⲓⲕⲁⲗⲁⲙⲫⲟ	ⲛϫⲉ|ⲛⲓ|ⲕⲁⲗⲁⲙⲫⲟ
ⲛⲉⲛⲉϩ	ⲛ|ⲉⲛⲉϩ
ⲛⲧϣⲉⲃⲓⲱ	ⲛ|ⲧ|ϣⲉⲃⲓⲱ
ⲛϩⲁⲛϧⲓⲥⲓ	ⲛ|ϩⲁⲛ|ϧⲓⲥⲓ
ⲉⲩⲉⲛⲁⲩ	ⲉⲩⲉ|ⲛⲁⲩ
ⲉⲛⲉⲕⲙⲁ	ⲉ|ⲛⲉⲕ|ⲙⲁ
ⲛⲙⲟϣⲓ	ⲛ|ⲙⲟϣⲓ
ⲉⲩⲉⲛⲟⲩϣⲡ	ⲉⲩⲉ|ⲛⲟⲩϣⲡ
ⲛϫⲉⲛⲓⲙⲁ	ⲛϫⲉ|ⲛⲓ|ⲙⲁ
ⲛϣⲱⲡⲓ	ⲛ|ϣⲱⲡⲓ
ⲛⲧⲉⲛⲓⲉⲑⲁⲩϣ	ⲛⲧⲉ|ⲛⲓ|ⲉⲑⲁⲩϣ
ⲛⲉⲙⲛⲓⲥⲕⲩⲛⲏ	ⲛⲉⲙ|ⲛⲓ|ⲥⲕⲩⲛⲏ
ⲛⲧⲉⲡⲕⲁϩⲓ	ⲛⲧⲉ|ⲡ|ⲕⲁϩⲓ
ⲙⲙⲁⲇⲓⲁⲙ	ⲙ|ⲙⲁⲇⲓⲁⲙ
ⲙⲏ	ⲙⲏ
ⲭⲛⲁϫⲱⲛⲧ	ⲭ|ⲛⲁ|ϫⲱⲛⲧ
ϧⲉⲛϩⲁⲛⲓⲁⲣⲱⲟⲩ	ϧⲉⲛ|ϩⲁⲛ|ⲓⲁⲣⲱⲟⲩ
ⲓⲉ	ⲓⲉ
ⲁⲣⲉⲡⲉⲕⲙⲃⲟⲛ	ⲁⲣⲉ|ⲡⲉⲕ|ⲙⲃⲟⲛ
ⲁⲣⲉⲡⲉⲕⲟⲩⲟⲓ	ⲁⲣⲉ|ⲡⲉⲕ|ⲟⲩⲟⲓ
ϧⲉⲛⲫⲓⲟⲙ	ϧⲉⲛ|ⲫ|ⲓⲟⲙ
ϫⲉⲭⲛⲁⲁⲗⲏⲓ	ϫⲉ|ⲭ|ⲛⲁ|ⲁⲗⲏⲓ
ⲉϫⲉⲛⲛⲉⲕϩⲑⲱⲣ	ⲉϫⲉⲛ|ⲛⲉⲕ|ϩⲑⲱⲣ
ⲫⲟⲩⲟⲓ	ⲫ|ⲟⲩⲟⲓ
ⲙⲫⲱⲧ	ⲙ|ⲫⲱⲧ
ⲛⲧⲉⲛⲉⲕϩⲑⲱⲣ	ⲛⲧⲉ|ⲛⲉⲕ|ϩⲑⲱⲣ
ⲟⲩⲟⲩϫⲁⲓ	ⲟⲩ|ⲟⲩϫⲁⲓ
ⲡⲉ	ⲡⲉ
ϧⲉⲛⲟⲩϭⲱⲗⲕ	ϧⲉⲛ|ⲟⲩ|ϭⲱⲗⲕ
ⲕⲛⲁϭⲱⲗⲕ	ⲕ|ⲛⲁ|ϭⲱⲗⲕ
ⲛⲧⲉⲕⲫⲓϯ	ⲛ|ⲧⲉⲕ|ⲫⲓϯ
ϩⲓϫⲉⲛⲛⲓϭⲏⲡⲓ	ϩⲓϫⲉⲛ|ⲛⲓ|ϭⲏⲡⲓ
ⲉϥⲉⲫⲱϫⲓ	ⲉϥⲉ|ⲫⲱϫⲓ
ⲉⲩⲉϯⲛⲁⲕϩⲓ	ⲉⲩⲉ|ϯⲛⲁⲕϩⲓ
ⲛϫⲉϩⲁⲛⲗⲁⲟⲥ	ⲛϫⲉ|ϩⲁⲛ|ⲗⲁⲟⲥ
ⲉϥⲉϫⲱⲣ	ⲉϥⲉ|ϫⲱⲣ
ⲛⲛⲓⲙⲱⲟⲩ	ⲛ|ⲛⲓ|ⲙⲱⲟⲩ
ⲛⲧⲉⲡⲉϥⲙⲱⲓⲧ	ⲛⲧⲉ|ⲡⲉϥ|ⲙⲱⲓⲧ
ⲙⲙⲟϣⲓ	ⲙ|ⲙⲟϣⲓ
ⲫⲛⲟⲩⲛ	ⲫ|ⲛⲟⲩⲛ
ⲁϥϯ	ⲁ|ϥ|ϯ
ⲛⲧⲉϥⲥⲙⲏ	ⲛ|ⲧⲉϥ|ⲥⲙⲏ
ⲉⲡϭⲓⲥⲓ	ⲉ|ⲡ|ϭⲓⲥⲓ
ⲛⲧⲉⲡⲉϥϩⲟⲣⲧϥ	ⲛⲧⲉ|ⲡⲉϥ|ϩⲟⲣⲧϥ
ⲁϥϭⲓⲥⲓ	ⲁ|ϥ|ϭⲓⲥⲓ
ⲛϫⲉⲫⲣⲏ	ⲛϫⲉ|ⲫ|ⲣⲏ
ⲡⲓⲓⲟϩ	ⲡⲓ|ⲓⲟϩ
ⲉⲧⲉϥⲧⲁⲝⲓⲥ	ⲉ|ⲧⲉϥ|ⲧⲁⲝⲓⲥ
ⲉⲩⲟⲩⲱⲓⲛⲓ	ⲉ|ⲩ|ⲟⲩⲱⲓⲛⲓ
ⲉⲩⲉⲙⲟϣⲓ	ⲉⲩⲉ|ⲙⲟϣⲓ
ⲛϫⲉⲛⲉⲕⲥⲟⲑⲛⲉϥ	ⲛϫⲉ|ⲛⲉⲕ|ⲥⲟⲑⲛⲉϥ
ⲉⲩⲙⲟⲩⲉ	ⲉ|ⲩ|ⲙⲟⲩⲉ
ⲛⲧⲉⲛⲉⲕⲥⲉⲧⲉⲃⲣⲏϫ	ⲛⲧⲉ|ⲛⲉⲕ|ⲥⲉⲧⲉⲃⲣⲏϫ
ⲛⲧⲉⲛⲉⲕϩⲟⲡⲗⲟⲛ	ⲛⲧⲉ|ⲛⲉⲕ|ϩⲟⲡⲗⲟⲛ
ϧⲉⲛⲡⲉⲕϫⲱⲛⲧ	ϧⲉⲛ|ⲡⲉⲕ|ϫⲱⲛⲧ
ⲉⲕⲉⲑⲣⲉⲡⲕⲁϩⲓ	ⲉⲕⲉ|ⲑⲣⲉ|ⲡ|ⲕⲁϩⲓ
ⲉⲣⲕⲟⲩϫⲓ	ⲉⲣⲕⲟⲩϫⲓ
ϧⲉⲛⲡⲉⲕⲙⲃⲟⲛ	ϧⲉⲛ|ⲡⲉⲕ|ⲙⲃⲟⲛ
ⲉⲕⲉⲃⲱⲗ	ⲉⲕⲉ|ⲃⲱⲗ
ⲛϩⲁⲛⲉⲑⲛⲟⲥ	ⲛ|ϩⲁⲛ|ⲉⲑⲛⲟⲥ
ⲁⲕⲓ	ⲁ|ⲕ|ⲓ
ⲉⲩⲟⲩϫⲁⲓ	ⲉ|ⲩ|ⲟⲩϫⲁⲓ
ⲙⲡⲉⲕⲗⲁⲟⲥ	ⲙ|ⲡⲉⲕ|ⲗⲁⲟⲥ
ⲉⲑⲣⲉⲕⲧⲟⲩϫⲟ	ⲉ|ⲑⲣⲉ|ⲕ|ⲧⲟⲩϫⲟ
ⲛⲛⲏ	ⲛ|ⲛⲏ
ⲉⲧⲁⲕⲑⲁϩⲥⲟⲩ	ⲉⲧ|ⲁ|ⲕ|ⲑⲁϩⲥ|ⲟⲩ
ⲁⲕϩⲓⲟⲩⲓ	ⲁ|ⲕ|ϩⲓⲟⲩⲓ
ⲛⲟⲩⲙⲟⲩ	ⲛ|ⲟⲩ|ⲙⲟⲩ
ⲉϫⲉⲛⲧⲁⲫⲉ	ⲉϫⲉⲛ|ⲧ|ⲁⲫⲉ
ⲛⲛⲓⲁⲛⲟⲙⲟⲥ	ⲛ|ⲛⲓ|ⲁⲛⲟⲙⲟⲥ
ⲁⲕⲭⲱ	ⲁ|ⲕ|ⲭⲱ
ⲛϯⲥⲉⲛϯ	ⲛ|ϯ|ⲥⲉⲛϯ
ⲉⲥϣⲟⲩⲓⲧ	ⲉ|ⲥ|ϣⲟⲩⲓⲧ
ⲁⲕⲧⲟⲩⲛⲟⲥⲛⲉⲕⲥⲛⲁⲩϩ	ⲁ|ⲕ|ⲧⲟⲩⲛⲟⲥ|ⲛⲉⲕ|ⲥⲛⲁⲩϩ
ϣⲁⲛⲙⲟϯ	ϣⲁ|ⲛ|ⲙⲟϯ
ⲁⲕϣⲱⲧ	ⲁ|ⲕ|ϣⲱⲧ
ⲛⲛⲓⲁⲫⲏⲟⲩⲓ	ⲛ|ⲛⲓ|ⲁⲫⲏⲟⲩⲓ
ⲛⲧⲉⲛⲓⲁⲛⲟⲙⲟⲥ	ⲛⲧⲉ|ⲛⲓ|ⲁⲛⲟⲙⲟⲥ
ⲛⲉⲙⲛⲓϫⲱⲣⲓ	ⲛⲉⲙ|ⲛⲓ|ϫⲱⲣⲓ
ϧⲉⲛⲟⲩⲧⲱⲙⲧ	ϧⲉⲛ|ⲟⲩ|ⲧⲱⲙⲧ
ⲉⲩⲉⲙⲟⲛⲙⲉⲛ	ⲉⲩⲉ|ⲙⲟⲛⲙⲉⲛ
ⲛϧⲣⲏⲓ	ⲛϧⲣⲏⲓ
ⲛϧⲏⲧⲥ	ⲛϧⲏⲧ|ⲥ
ⲉⲩⲉⲁⲟⲩⲱⲛⲛⲟⲩⲭⲁⲗⲓⲛⲟⲩⲥ	ⲉⲩⲉ|ⲁⲟⲩⲱⲛ|ⲛⲟⲩ|ⲭⲁⲗⲓⲛⲟⲩⲥ
ⲛⲟⲩϩⲏⲕⲓ	ⲛ|ⲟⲩ|ϩⲏⲕⲓ
ⲉϥⲟⲩⲱⲙ	ⲉ|ϥ|ⲟⲩⲱⲙ
ⲛⲭⲱⲡ	ⲛ|ⲭⲱⲡ
ⲁⲕⲧⲁⲗⲟ	ⲁ|ⲕ|ⲧⲁⲗⲟ
ⲛⲛⲉⲕϩⲑⲱⲣ	ⲛ|ⲛⲉⲕ|ϩⲑⲱⲣ
ⲉϩⲣⲏⲓ	ⲉϩⲣⲏⲓ
ⲉϫⲉⲛⲫⲓⲟⲙ	ⲉϫⲉⲛ|ⲫ|ⲓⲟⲙ
ⲉⲩⲉⲑⲱϩ	ⲉⲩⲉ|ⲑⲱϩ
ⲛⲟⲩⲙⲱⲟⲩ	ⲛ|ⲟⲩ|ⲙⲱⲟⲩ
ⲁⲓⲁⲣⲉϩ	ⲁ|ⲓ|ⲁⲣⲉϩ
ⲉⲣⲟⲓ	ⲉⲣⲟ|ⲓ
ⲁⲥϣⲑⲟⲣⲧⲉⲣ	ⲁ|ⲥ|ϣⲑⲟⲣⲧⲉⲣ
ⲛϫⲉⲧⲁⲛⲉϫⲓ	ⲛϫⲉ|ⲧⲁ|ⲛⲉϫⲓ
ϧⲉⲛⲧⲥⲙⲏ	ϧⲉⲛ|ⲧ|ⲥⲙⲏ
ⲛⲧⲡⲣⲟⲥⲉⲩⲭⲏ	ⲛ|ⲧ|ⲡⲣⲟⲥⲉⲩⲭⲏ
ⲛⲧⲉⲛⲁⲥⲫⲟⲧⲟⲩ	ⲛⲧⲉ|ⲛⲁ|ⲥⲫⲟⲧⲟⲩ
ⲁϥⲓ	ⲁ|ϥ|ⲓ
ⲉⲛⲁⲕⲁⲥ	ⲉ|ⲛⲁ|ⲕⲁⲥ
ⲛϫⲉⲟⲩⲥⲑⲉⲣⲧⲉⲣ	ⲛϫⲉ|ⲟⲩ|ⲥⲑⲉⲣⲧⲉⲣ
ⲥⲁⲡⲉⲥⲏⲧ	ⲥⲁ|ⲡ|ⲉⲥⲏⲧ
ⲙⲙⲟⲓ	ⲙⲙⲟ|ⲓ
ⲛϫⲉⲧⲁϩⲉⲝⲓⲥ	ⲛϫⲉ|ⲧⲁ|ϩⲉⲝⲓⲥ
ϯⲛⲁⲙⲧⲟⲛ	ϯ|ⲛⲁ|ⲙⲧⲟⲛ
ⲛⲟⲩϩⲟϫϩⲉϫ	ⲛ|ⲟⲩ|ϩⲟϫϩⲉϫ
ⲉⲑⲣⲓϣⲉ	ⲉ|ⲑⲣ|ⲓ|ϣⲉ
ⲛⲏⲓ	ⲛⲏ|ⲓ
ⲉⲫⲗⲁⲟⲥ	ⲉ|ⲫ|ⲗⲁⲟⲥ
ⲛⲧⲉⲡⲁⲙⲁ	ⲛⲧⲉ|ⲡⲁ|ⲙⲁ
ⲛϫⲱⲓⲗⲓ	ⲛ|ϫⲱⲓⲗⲓ
ϫⲉⲟⲩⲏⲓ	ϫⲉ|ⲟⲩⲏⲓ
ϯⲃⲱ	ϯ|ⲃⲱ
ⲛⲕⲉⲛⲧⲉ	ⲛ|ⲕⲉⲛⲧⲉ
ⲥⲛⲁϯⲟⲩⲧⲁϩ	ⲥ|ⲛⲁ|ϯⲟⲩⲧⲁϩ
ⲁⲛ	ⲁⲛ
ⲛⲛⲉⲟⲩⲧⲁϩ	ⲛⲛⲉ|ⲟⲩⲧⲁϩ
ϣⲱⲡⲓ	ϣⲱⲡⲓ
ϧⲉⲛϯⲃⲱ	ϧⲉⲛ|ϯ|ⲃⲱ
ⲛⲁⲗⲟⲗⲓ	ⲛ|ⲁⲗⲟⲗⲓ
ⲉϥⲉϫⲉⲙⲉⲑⲛⲟⲩϫ	ⲉϥⲉ|ϫⲉⲙⲉⲑⲛⲟⲩϫ
ⲛϫⲉⲡϩⲱⲃ	ⲛϫⲉ|ⲡ|ϩⲱⲃ
ⲛϯⲃⲱ	ⲛ|ϯ|ⲃⲱ
ⲛϫⲱⲓⲧ	ⲛ|ϫⲱⲓⲧ
ⲛⲓⲙⲉϣϣⲟϯ	ⲛⲓ|ⲙⲉϣϣⲟϯ
ⲛⲛⲟⲩⲉⲣϧⲣⲉ	ⲛⲛ|ⲟⲩ|ⲉⲣϧⲣⲉ
ⲁⲩⲙⲟⲩⲛⲕ	ⲁ|ⲩ|ⲙⲟⲩⲛⲕ
ⲛϫⲉⲛⲓⲉⲥⲱⲟⲩ	ⲛϫⲉ|ⲛⲓ|ⲉⲥⲱⲟⲩ
ϫⲉⲙⲙⲟⲛϧⲣⲉ	ϫⲉ|ⲙⲙⲟⲛ|ϧⲣⲉ
ⲛⲧⲱⲟⲩ	ⲛⲧⲱ|ⲟⲩ
ⲙⲙⲟⲛⲉϩⲉ	ⲙⲙⲟⲛ|ⲉϩⲉ
ϣⲟⲡ	ϣⲟⲡ
ϧⲉⲛⲡⲓⲟⲩⲛϩϥ	ϧⲉⲛ|ⲡⲓ|ⲟⲩⲛϩϥ
ⲛⲧⲉⲡⲟⲩⲭⲱ	ⲛⲧⲉ|ⲡⲟⲩ|ⲭⲱ
ⲁⲛⲟⲕ	ⲁⲛⲟⲕ
ⲇⲉ	ⲇⲉ
ϯⲛⲁⲑⲉⲗⲏⲗ	ϯ|ⲛⲁ|ⲑⲉⲗⲏⲗ
ϧⲉⲛⲡϭⲟⲉⲓⲥ	ϧⲉⲛ|ⲡ|ϭⲟⲉⲓⲥ
ϯⲛⲁⲣⲁϣⲓ	ϯ|ⲛⲁ|ⲣⲁϣⲓ
ⲉϫⲉⲛⲫⲛⲟⲩϯ	ⲉϫⲉⲛ|ⲫ|ⲛⲟⲩϯ
ⲡⲁⲥⲱⲧⲏⲣ	ⲡⲁ|ⲥⲱⲧⲏⲣ
ⲫⲛⲟⲩϯ	ⲫ|ⲛⲟⲩϯ
ⲧⲁϫⲟⲙ	ⲧⲁ|ϫⲟⲙ
ⲉϥⲉⲑⲱϣ	ⲉϥⲉ|ⲑⲱϣ
ⲛⲛⲁϭⲁⲗⲁⲩϫ	ⲛ|ⲛⲁ|ϭⲁⲗⲁⲩϫ
ⲉⲟⲩⲥⲩⲛⲧⲉⲗⲓⲁ	ⲉ|ⲟⲩ|ⲥⲩⲛⲧⲉⲗⲓⲁ
ϥⲛⲁⲧⲁⲗⲟⲓ	ϥ|ⲛⲁ|ⲧⲁⲗⲟ|ⲓ
ⲉϫⲉⲛⲛⲓϭⲓⲥⲓ	ⲉϫⲉⲛ|ⲛⲓ|ϭⲓⲥⲓ
ⲉⲑⲣⲓϭⲣⲟ	ⲉ|ⲑⲣ|ⲓ|ϭⲣⲟ
ϧⲉⲛⲧⲉϥϩⲱⲇⲏ	ϧⲉⲛ|ⲧⲉϥ|ϩⲱⲇⲏ
ⲉⲑⲃⲉⲡⲓⲥⲱⲣ	ⲉⲑⲃⲉ|ⲡⲓ|ⲥⲱⲣ
ⲉⲧⲁϥϣⲱⲡⲓ	ⲉⲧ|ⲁ|ϥ|ϣⲱⲡⲓ
ⲉⲑⲃⲉⲛⲓϩⲁⲅⲓⲟⲥ	ⲉⲑⲃⲉ|ⲛⲓ|ϩⲁⲅⲓⲟⲥ
ⲉⲧⲁⲓⲟⲩⲁϩⲥⲁϩⲛⲓ	ⲉⲧ|ⲁ|ⲓ|ⲟⲩⲁϩⲥⲁϩⲛⲓ
ⲛⲛⲓⲉⲕⲕⲗⲏⲥⲓⲁ	ⲛ|ⲛⲓ|ⲉⲕⲕⲗⲏⲥⲓⲁ
ⲛⲧⲉⲧⲅⲁⲗⲁⲧⲓⲁ	ⲛⲧⲉ|ⲧ|ⲅⲁⲗⲁⲧⲓⲁ
ⲁⲣⲓⲟⲩⲓ	ⲁⲣⲓⲟⲩⲓ
ϩⲱⲧⲉⲛ	ϩⲱ|ⲧⲉⲛ
ⲙⲡⲁⲓⲣⲏϯ	ⲙ|ⲡⲁⲓ|ⲣⲏϯ
ⲕⲁⲧⲁⲫⲟⲩⲁⲓ	ⲕⲁⲧⲁ|ⲫ|ⲟⲩⲁⲓ
ⲛⲛⲓⲥⲁⲃⲃⲁⲧⲟⲛ	ⲛ|ⲛⲓ|ⲥⲁⲃⲃⲁⲧⲟⲛ
ⲙⲁⲣⲉⲡⲓⲟⲩⲁⲓ	ⲙⲁⲣⲉ|ⲡⲓ|ⲟⲩⲁⲓ
ⲡⲓⲟⲩⲁⲓ	ⲡⲓ|ⲟⲩⲁⲓ
ⲙⲙⲱⲧⲉⲛ	ⲙⲙⲱ|ⲧⲉⲛ
ⲭⲱ	ⲭⲱ
ⲛⲧⲟⲧϥ	ⲛⲧⲟⲧ|ϥ
ⲉϥϩⲓⲟⲩⲓ	ⲉ|ϥ|ϩⲓⲟⲩⲓ
ⲙⲫⲏ	ⲙ|ⲫⲏ
ⲉⲧⲉⲡⲉϥⲙⲱⲓⲧ	ⲉⲧⲉ|ⲡⲉϥ|ⲙⲱⲓⲧ
ⲛⲁⲥⲱⲟⲩⲧⲉⲛ	ⲛⲁ|ⲥⲱⲟⲩⲧⲉⲛ
ⲛϧⲏⲧϥ	ⲛϧⲏⲧ|ϥ
ϩⲓⲛⲁ	ϩⲓⲛⲁ
ⲙⲏⲡⲱⲥ	ⲙⲏⲡⲱⲥ
ⲁⲓϣⲁⲛⲓ	ⲁⲓϣⲁⲛ|ⲓ
ⲧⲟⲧⲉ	ⲧⲟⲧⲉ
ⲛⲧⲉϩⲁⲛⲱⲡ	ⲛⲧⲉ|ϩⲁⲛ|ⲱⲡ
ⲉϣⲱⲡ	ⲉϣⲱⲡ
ⲛⲏ	ⲛⲏ
ⲉⲧⲉⲧⲉⲛⲛⲁⲉⲣⲇⲟⲕⲓⲙⲁⲍⲓⲛ	ⲉⲧⲉ|ⲧⲉⲛ|ⲛⲁ|ⲉⲣⲇⲟⲕⲓⲙⲁⲍⲓⲛ
ⲙⲙⲱⲟⲩ	ⲙⲙⲱ|ⲟⲩ
ⲉⲓⲉⲟⲩⲟⲣⲡⲟⲩ	ⲉⲓⲉ|ⲟⲩⲟⲣⲡ|ⲟⲩ
ϩⲓⲧⲉⲛϩⲁⲛⲉⲡⲓⲥⲧⲟⲗⲏ	ϩⲓⲧⲉⲛ|ϩⲁⲛ|ⲉⲡⲓⲥⲧⲟⲗⲏ
ⲉϭⲓ	ⲉ|ϭⲓ
ⲙⲡⲉⲧⲉⲛϩⲙⲟⲧ	ⲙⲡⲉ|ⲧⲉⲛ|ϩⲙⲟⲧ
ⲉⲓⲉⲣⲟⲥⲁⲗⲏⲙ	ⲉ|ⲓⲉⲣⲟⲥⲁⲗⲏⲙ
ⲉⲡⲓϩⲱⲃ	ⲉ|ⲡⲓ|ϩⲱⲃ
ⲙⲡϣⲁ	ⲙⲡϣⲁ
ϩⲱ	ϩⲱ
ⲛⲉⲙⲏⲓ	ⲛⲉⲙⲏ|ⲓ
ⲉⲓⲉⲓ	ⲉⲓⲉ|ⲓ
ϩⲁⲣⲱⲧⲉⲛ	ϩⲁⲣⲱ|ⲧⲉⲛ
ⲁⲓϣⲁⲛⲥⲉⲛ	ⲁⲓϣⲁⲛ|ⲥⲉⲛ
ⲧⲙⲁⲕⲉⲇⲟⲛⲓⲁ	ⲧ|ⲙⲁⲕⲉⲇⲟⲛⲓⲁ
ⲅⲁⲣ	ⲅⲁⲣ
ϯⲛⲁⲥⲉⲛⲥ	ϯ|ⲛⲁ|ⲥⲉⲛ|ⲥ
ⲧⲁⲭⲁ	ⲧⲁⲭⲁ
ⲛⲧⲁⲟϩⲓ	ⲛ|ⲧⲁ|ⲟϩⲓ
ϧⲁⲧⲉⲛ	ϧⲁ|ⲧⲉⲛ
ⲑⲏⲛⲟⲩ	ⲑⲏⲛⲟⲩ
ⲛⲧⲁⲉⲣϯⲫⲣⲱ	ⲛ|ⲧⲁ|ⲉⲣ|ϯ|ⲫⲣⲱ
ⲛⲑⲱⲧⲉⲛ	ⲛⲑⲱⲧⲉⲛ
ⲛⲧⲉⲧⲉⲛⲧⲫⲟⲓ	ⲛⲧⲉ|ⲧⲉⲛ|ⲧⲫⲟ|ⲓ
ⲉⲡⲓⲙⲁ	ⲉ|ⲡⲓ|ⲙⲁ
ⲉϯⲛⲁϣⲉ	ⲉ|ϯ|ⲛⲁ|ϣⲉ
ⲉⲣⲟϥ	ⲉⲣⲟ|ϥ
ϯⲟⲩⲱϣ	ϯ|ⲟⲩⲱϣ
ⲉⲛⲁⲩ	ⲉ|ⲛⲁⲩ
ⲉⲣⲱⲧⲉⲛ	ⲉⲣⲱ|ⲧⲉⲛ
ⲉⲓⲭⲏ	ⲉ|ⲓ|ⲭⲏ
ϩⲓⲫⲙⲱⲓⲧ	ϩⲓ|ⲫ|ⲙⲱⲓⲧ
ϯⲉⲣϩⲉⲗⲡⲓⲥ	ϯ|ⲉⲣϩⲉⲗⲡⲓⲥ
ⲉⲉⲣⲭⲣⲟⲛⲟⲥ	ⲉ|ⲉⲣⲭⲣⲟⲛⲟⲥ
ⲁⲣⲉϣⲁⲛⲡϭⲟⲓⲥ	ⲁⲣⲉϣⲁⲛ|ⲡ|ϭⲟⲓⲥ
ⲟⲩⲁϩⲥⲁϩⲛⲓ	ⲟⲩⲁϩⲥⲁϩⲛⲓ
ϯⲛⲁϣⲱⲡⲓ	ϯ|ⲛⲁ|ϣⲱⲡⲓ
ϧⲉⲛⲉⲫⲉⲥⲟⲥ	ϧⲉⲛ|ⲉⲫⲉⲥⲟⲥ
ϣⲁϯⲡⲉⲛⲧⲏⲕⲟⲥⲧⲏ	ϣⲁ|ϯ|ⲡⲉⲛⲧⲏⲕⲟⲥⲧⲏ
ⲁϥⲟⲩⲱⲛ	ⲁ|ϥ|ⲟⲩⲱⲛ
ⲛϫⲉⲟⲩⲛⲓϣϯ	ⲛϫⲉ|ⲟⲩ|ⲛⲓϣϯ
ⲛⲣⲟ	ⲛ|ⲣⲟ
ⲉϥⲉⲣϩⲱⲃ	ⲉ|ϥ|ⲉⲣϩⲱⲃ
ⲛⲉⲙⲟⲩⲙⲏϣ	ⲛⲉⲙ|ⲟⲩ|ⲙⲏϣ
ⲛⲁⲛⲧⲓⲕⲓⲙⲉⲛⲟⲥ	ⲛ|ⲁⲛⲧⲓⲕⲓⲙⲉⲛⲟⲥ
ⲁⲣⲉϣⲁⲛⲧⲓⲙⲟⲑⲉⲟⲥ	ⲁⲣⲉϣⲁⲛ|ⲧⲓⲙⲟⲑⲉⲟⲥ
ⲓ	ⲓ
ⲁⲛⲁⲩ	ⲁⲛⲁⲩ
ⲛⲧⲉϥⲓ	ⲛⲧⲉ|ϥ|ⲓ
ⲁⲧϭⲛⲉϩⲟϯ	ⲁⲧϭⲛⲉ|ϩⲟϯ
ⲡⲓϩⲱⲃ	ⲡⲓ|ϩⲱⲃ
ⲛⲧⲉⲡϭⲟⲓⲥ	ⲛⲧⲉ|ⲡ|ϭⲟⲓⲥ
ⲡⲉⲧⲉϥⲉⲣϩⲱⲃ	ⲡ|ⲉⲧⲉ|ϥ|ⲉⲣϩⲱⲃ
ⲙⲡⲁⲣⲏϯ	ⲙ|ⲡⲁ|ⲣⲏϯ
ⲙⲡⲉⲛⲑⲣⲉϩⲗⲓ	ⲙⲡⲉⲛⲑⲣⲉ|ϩⲗⲓ
ⲟⲩⲛ	ⲟⲩⲛ
ϣⲟϣϥ	ϣⲟϣ|ϥ
ⲙⲁϯⲫⲟϥ	ⲙⲁ|ϯⲫⲟ|ϥ
ϧⲉⲛⲟⲩϩⲓⲣⲏⲛⲏ	ϧⲉⲛ|ⲟⲩ|ϩⲓⲣⲏⲛⲏ
ϩⲁⲣⲟⲓ	ϩⲁⲣⲟ|ⲓ
ϯⲥⲟⲙⲥ	ϯ|ⲥⲟⲙⲥ
ⲛⲉⲙⲛⲓⲥⲛⲏⲩ	ⲛⲉⲙ|ⲛⲓ|ⲥⲛⲏⲩ
ⲉⲑⲃⲉⲁⲡⲟⲗⲗⲱ	ⲉⲑⲃⲉ|ⲁⲡⲟⲗⲗⲱ
ⲡⲓⲥⲟⲛ	ⲡⲓ|ⲥⲟⲛ
ⲁⲓϯϩⲟ	ⲁ|ⲓ|ϯϩⲟ
ⲉⲙⲁϣⲱ	ⲉⲙⲁϣⲱ
ⲡⲁⲛⲧⲱⲥ	ⲡⲁⲛⲧⲱⲥ
ⲫⲟⲩⲱϣ	ⲫ|ⲟⲩⲱϣ
ⲉϥⲉⲓ	ⲉϥⲉ|ⲓ
ⲁϥϣⲁⲛϫⲉⲙⲧⲉⲩⲕⲉⲣⲓⲁ	ⲁϥϣⲁⲛ|ϫⲉⲙ|ⲧ|ⲉⲩⲕⲉⲣⲓⲁ
ⲣⲱⲓⲥ	ⲣⲱⲓⲥ
ⲟϩⲓ	ⲟϩⲓ
ⲉⲛⲑⲏⲛⲟⲩ	ⲉⲛ|ⲑⲏⲛⲟⲩ
ϧⲉⲛⲫⲛⲁϩϯ	ϧⲉⲛ|ⲫ|ⲛⲁϩϯ
ϭⲣⲟ	ϭⲣⲟ
ϫⲉⲙⲛⲟⲙϯ	ϫⲉⲙⲛⲟⲙϯ
ϩⲱⲃ	ϩⲱⲃ
ⲛⲓⲃⲉⲛ	ⲛⲓⲃⲉⲛ
ⲉⲧⲉⲛⲧⲱⲧⲉⲛ	ⲉⲧⲉ|ⲛⲧⲱⲧⲉⲛ
ⲙⲁⲣⲟⲩϣⲱⲡⲓ	ⲙⲁⲣ|ⲟⲩ|ϣⲱⲡⲓ
ϧⲉⲛⲟⲩⲁⲅⲁⲡⲏ	ϧⲉⲛ|ⲟⲩ|ⲁⲅⲁⲡⲏ
ϯϯϩⲟ	ϯ|ϯϩⲟ
ⲛⲉⲛⲥⲛⲏⲩ	ⲛⲉⲛ|ⲥⲛⲏⲩ
ⲧⲉⲧⲉⲛⲥⲱⲟⲩⲛ	ⲧⲉⲧⲉⲛ|ⲥⲱⲟⲩⲛ
ⲙⲡⲏⲓ	ⲙ|ⲡ|ⲏⲓ
ⲛⲥⲧⲉⲫⲁⲛⲁ	ⲛ|ⲥⲧⲉⲫⲁⲛⲁ
ⲛⲉⲙⲫⲟⲣⲧⲟⲩⲛⲁⲧⲟⲥ	ⲛⲉⲙ|ⲫⲟⲣⲧⲟⲩⲛⲁⲧⲟⲥ
ϫⲉⲧⲁⲣⲭⲏ	ϫⲉ|ⲧ|ⲁⲣⲭⲏ
ⲛⲧⲉϯⲁⲭⲁⲓⲁ	ⲛⲧⲉ|ϯ|ⲁⲭⲁⲓⲁ
ⲧⲉ	ⲧⲉ
ⲁⲩⲑⲁϣⲟⲩ	ⲁ|ⲩ|ⲑⲁϣ|ⲟⲩ
ⲉⲩⲇⲓⲁⲕⲟⲛⲓⲁ	ⲉ|ⲩ|ⲇⲓⲁⲕⲟⲛⲓⲁ
ⲛⲛⲓϩⲁⲅⲓⲟⲥ	ⲛ|ⲛⲓ|ϩⲁⲅⲓⲟⲥ
ⲛⲧⲉⲧⲉⲛϭⲛⲉϫⲱⲧⲉⲛ	ⲛⲧⲉ|ⲧⲉⲛ|ϭⲛⲉ|ϫⲱ|ⲧⲉⲛ
ⲛⲛⲁⲓⲟⲩⲟⲛ	ⲛ|ⲛⲁⲓ|ⲟⲩⲟⲛ
ⲛⲉⲙⲟⲩⲟⲛ	ⲛⲉⲙ|ⲟⲩⲟⲛ
ⲉⲧⲟⲓ	ⲉⲧ|ⲟⲓ
ⲛϣⲫⲏⲣ	ⲛ|ϣⲫⲏⲣ
ⲛⲣⲉϥⲉⲣϩⲱⲃ	ⲛ|ⲣⲉϥⲉⲣϩⲱⲃ
ⲉⲧϧⲟⲥⲓ	ⲉⲧ|ϧⲟⲥⲓ
ϯⲣⲁϣⲓ	ϯ|ⲣⲁϣⲓ
ⲉϫⲉⲛⲧⲡⲁⲣⲟⲩⲥⲓⲁ	ⲉϫⲉⲛ|ⲧ|ⲡⲁⲣⲟⲩⲥⲓⲁ
ⲛⲉⲙⲁⲭⲁⲓⲕⲟⲥ	ⲛⲉⲙ|ⲁⲭⲁⲓⲕⲟⲥ
ϫⲉⲡⲉⲧⲉⲛϭⲣⲟϩ	ϫⲉ|ⲡⲉⲧⲉⲛ|ϭⲣⲟϩ
ⲁⲩϫⲉⲕⲣⲱϥ	ⲁ|ⲩ|ϫⲉⲕⲣⲱ|ϥ
ⲁⲩϯⲙⲧⲟⲛ	ⲁ|ⲩ|ϯⲙⲧⲟⲛ
ⲙⲡⲁⲡⲛⲉⲩⲙⲁ	ⲙ|ⲡⲁ|ⲡⲛⲉⲩⲙⲁ
ⲛⲉⲙⲫⲱⲧⲉⲛ	ⲛⲉⲙ|ⲫⲱⲧⲉⲛ
ⲥⲟⲩⲉⲛⲛⲁⲓⲟⲩⲟⲛ	ⲥⲟⲩⲉⲛ|ⲛⲁⲓ|ⲟⲩⲟⲛ
ⲥⲉϣⲓⲛⲓ	ⲥⲉ|ϣⲓⲛⲓ
ⲛϫⲉⲛⲓⲉⲕⲕⲗⲏⲥⲓⲁ	ⲛϫⲉ|ⲛⲓ|ⲉⲕⲕⲗⲏⲥⲓⲁ
ⲛⲧⲉϯⲁⲥⲓⲁ	ⲛⲧⲉ|ϯ|ⲁⲥⲓⲁ
ϧⲉⲛⲡϭⲟⲓⲥ	ϧⲉⲛ|ⲡ|ϭⲟⲓⲥ
ⲛϫⲉⲁⲕⲩⲗⲁ	ⲛϫⲉ|ⲁⲕⲩⲗⲁ
ⲛⲉⲙⲡⲣⲓⲥⲕⲁ	ⲛⲉⲙ|ⲡⲣⲓⲥⲕⲁ
ⲛⲉⲙϯⲉⲕⲕⲗⲏⲥⲓⲁ	ⲛⲉⲙ|ϯ|ⲉⲕⲕⲗⲏⲥⲓⲁ
ⲛⲧⲉⲡⲟⲩⲏⲓ	ⲛⲧⲉ|ⲡⲟⲩ|ⲏⲓ
ⲛϫⲉⲛⲓⲥⲛⲏⲩ	ⲛϫⲉ|ⲛⲓ|ⲥⲛⲏⲩ
ⲧⲏⲣⲟⲩ	ⲧⲏⲣ|ⲟⲩ
ⲉⲧⲛⲉⲙⲏⲓ	ⲉⲧ|ⲛⲉⲙⲏ|ⲓ
ⲁⲣⲓⲁⲥⲡⲁⲍⲉⲥⲑⲉ	ⲁⲣⲓⲁⲥⲡⲁⲍⲉⲥⲑⲉ
ⲛⲛⲉⲧⲉⲛⲉⲣⲏⲩ	ⲛ|ⲛⲉⲧⲉⲛ|ⲉⲣⲏⲩ
ϧⲉⲛⲟⲩⲫⲓ	ϧⲉⲛ|ⲟⲩ|ⲫⲓ
ⲉⲥⲟⲩⲁⲃ	ⲉ|ⲥ|ⲟⲩⲁⲃ
ⲡⲁⲁⲥⲡⲁⲥⲙⲟⲥ	ⲡⲁ|ⲁⲥⲡⲁⲥⲙⲟⲥ
ϧⲉⲛⲧⲁϫⲓϫ	ϧⲉⲛ|ⲧⲁ|ϫⲓϫ
ⲡⲁⲩⲗⲟⲥ	ⲡⲁⲩⲗⲟⲥ
ⲫⲏ	ⲫⲏ
ⲉⲧⲉⲛϥⲙⲉⲓ	ⲉⲧⲉ|ⲛ|ϥ|ⲙⲉⲓ
ⲙⲡⲉⲛϭⲟⲓⲥ	ⲙ|ⲡⲉⲛ|ϭⲟⲓⲥ
ⲓⲏⲥⲟⲩⲥ	ⲓⲏⲥⲟⲩⲥ
ⲡⲭⲣⲓⲥⲧⲟⲥ	ⲡ|ⲭⲣⲓⲥⲧⲟⲥ
ⲙⲁⲣⲉϥϣⲱⲡⲓ	ⲙⲁⲣⲉ|ϥ|ϣⲱⲡⲓ
ⲛⲟⲩⲁⲛⲁⲑⲉⲙⲁ	ⲛ|ⲟⲩ|ⲁⲛⲁⲑⲉⲙⲁ
ⲙⲁⲣⲁⲛⲁⲑⲁ	ⲙⲁⲣⲁⲛⲁⲑⲁ
ⲡϩⲙⲟⲧ	ⲡ|ϩⲙⲟⲧ
ⲛⲉⲙⲱⲧⲉⲛ	ⲛⲉⲙⲱ|ⲧⲉⲛ
ⲧⲁⲁⲅⲁⲡⲏ	ⲧⲁ|ⲁⲅⲁⲡⲏ
ϧⲉⲛⲡⲭⲣⲓⲥⲧⲟⲥ	ϧⲉⲛ|ⲡ|ⲭⲣⲓⲥⲧⲟⲥ
ⲁⲙⲏⲛ	ⲁⲙⲏⲛ
ⲫⲃⲓⲟⲥ	ⲫ|ⲃⲓⲟⲥ
ⲙⲡⲓⲡⲁⲧⲣⲓⲁⲣⲭⲏⲥ	ⲙ|ⲡⲓ|ⲡⲁⲧⲣⲓⲁⲣⲭⲏⲥ
ⲉⲑⲟⲩⲁⲃ	ⲉⲑ|ⲟⲩⲁⲃ
ⲡⲓⲁⲣⲭⲓⲉⲡⲓⲥⲕⲟⲡⲟⲥ	ⲡⲓ|ⲁⲣⲭⲓⲉⲡⲓⲥⲕⲟⲡⲟⲥ
ⲛⲧⲉϯⲛⲓϣϯ	ⲛⲧⲉ|ϯ|ⲛⲓϣϯ
ⲙⲡⲟⲗⲓⲥ	ⲙ|ⲡⲟⲗⲓⲥ
ⲣⲁⲕⲟϯ	ⲣⲁⲕⲟϯ
ⲁⲃⲃⲁ	ⲁⲃⲃⲁ
ⲓⲥⲁⲁⲕ	ⲓⲥⲁⲁⲕ
ⲉⲁϥϩⲓⲥⲧⲟⲣⲉⲓⲛ	ⲉ|ⲁ|ϥ|ϩⲓⲥⲧⲟⲣⲉⲓⲛ
ⲙⲙⲟϥ	ⲙⲙⲟ|ϥ
ⲛϫⲉⲫⲏ	ⲛϫⲉ|ⲫⲏ
ⲙⲏⲛⲁ	ⲙⲏⲛⲁ
ⲡⲓϩⲟⲥⲓⲱⲧⲁⲧⲟⲥ	ⲡⲓ|ϩⲟⲥⲓⲱⲧⲁⲧⲟⲥ
ⲛⲉⲡⲓⲥⲕⲡⲟⲥ	ⲛ|ⲉⲡⲓⲥⲕⲡⲟⲥ
ⲛⲧⲉϯⲡⲟⲗⲓⲥ	ⲛⲧⲉ|ϯ|ⲡⲟⲗⲓⲥ
ⲡϣⲁϯ	ⲡ|ϣⲁϯ
ϧⲉⲛⲟⲩϩⲉⲓⲣⲏⲛⲏ	ϧⲉⲛ|ⲟⲩ|ϩⲉⲓⲣⲏⲛⲏ
ⲛⲧⲉⲫⲛⲟⲩϯ	ⲛⲧⲉ|ⲫ|ⲛⲟⲩϯ
ϥⲑⲱϩⲉⲙ	ϥ|ⲑⲱϩⲉⲙ
ⲙⲫⲟⲟⲩ	ⲙ|ⲫ|ⲟⲟⲩ
ⲛϫⲉⲡⲓⲉⲣⲫⲙⲉⲩⲓ	ⲛϫⲉ|ⲡⲓ|ⲉⲣⲫⲙⲉⲩⲓ
ⲉⲧⲧⲁⲓⲏⲟⲧ	ⲉⲧ|ⲧⲁⲓⲏⲟⲧ
ⲱ	ⲱ
ⲛⲁⲙⲉⲛⲣⲁϯ	ⲛⲁ|ⲙⲉⲛⲣⲁϯ
ⲉϥⲧⲟⲩⲛⲟⲥ	ⲉ|ϥ|ⲧⲟⲩⲛⲟⲥ
ⲙⲫⲣⲱⲟⲩⲧϥ	ⲙ|ⲫ|ⲣⲱⲟⲩⲧϥ
ⲙⲡⲁϩⲏⲧ	ⲙ|ⲡⲁ|ϩⲏⲧ
ⲉⲑⲣⲉⲛϭⲓⲫⲉⲓ	ⲉ|ⲑⲣⲉ|ⲛ|ϭⲓⲫⲉⲓ
ϧⲁⲡⲓⲣⲁϣⲓ	ϧⲁ|ⲡⲓ|ⲣⲁϣⲓ
ⲙⲡⲛⲉⲩⲙⲁⲧⲓⲕⲟⲛ	ⲙ|ⲡⲛⲉⲩⲙⲁⲧⲓⲕⲟⲛ
ⲛⲧⲁϯⲙⲡⲁⲟⲩⲟⲓ	ⲛ|ⲧⲁ|ϯ|ⲙ|ⲡⲁ|ⲟⲩⲟⲓ
ⲉⲛⲉϥⲉⲅⲕⲱⲓⲟⲛ	ⲉ|ⲛⲉϥ|ⲉⲅⲕⲱⲓⲟⲛ
ⲛⲓⲙ	ⲛⲓⲙ
ⲡⲉⲑⲛⲁϣⲁϫⲓ	ⲡ|ⲉⲑ|ⲛⲁ|ϣⲁϫⲓ
ⲙⲡⲧⲁⲓⲟ	ⲙ|ⲡ|ⲧⲁⲓⲟ
ⲙⲡⲓⲙⲁ	ⲙ|ⲡⲓ|ⲙⲁ
ⲛⲉⲥⲱⲟⲩ	ⲛ|ⲉⲥⲱⲟⲩ
ⲛⲁⲗⲏⲑⲓⲛⲟⲛ	ⲛ|ⲁⲗⲏⲑⲓⲛⲟⲛ
ⲛⲁⲣⲭⲓⲉⲣⲉⲩⲥ	ⲛ|ⲁⲣⲭⲓⲉⲣⲉⲩⲥ
ⲉⲧⲉⲛϩⲟⲧ	ⲉⲧ|ⲉⲛϩⲟⲧ
ⲛⲧⲉϯⲇⲓⲕⲁⲓⲟⲥⲩⲛⲏ	ⲛⲧⲉ|ϯ|ⲇⲓⲕⲁⲓⲟⲥⲩⲛⲏ
ⲉⲧⲁϥⲙⲉⲛⲣⲉ	ⲉⲧ|ⲁ|ϥ|ⲙⲉⲛⲣⲉ
ϯⲁⲣⲉⲧⲏ	ϯ|ⲁⲣⲉⲧⲏ
ⲓⲥϫⲉⲛⲧⲉϥⲙⲉⲧⲕⲟⲩϫⲓ	ⲓⲥϫⲉⲛ|ⲧⲉϥ|ⲙⲉⲧⲕⲟⲩϫⲓ
ⲛⲉⲙⲡⲓϫⲓ	ⲛⲉⲙ|ⲡⲓ|ϫⲓ
ⲛⲱⲛϧ	ⲛ|ⲱⲛϧ
ⲛⲧⲉⲛⲓⲁⲅⲅⲉⲗⲟⲥ	ⲛⲧⲉ|ⲛⲓ|ⲁⲅⲅⲉⲗⲟⲥ
ⲉⲧⲁϥⲭⲟϩ	ⲉⲧ|ⲁ|ϥ|ⲭⲟϩ
ⲉⲛⲟⲩϫⲓ	ⲉ|ⲛⲟⲩϫⲓ
ⲁϥⲧⲉⲛⲑⲱⲛϥ	ⲁ|ϥ|ⲧⲉⲛⲑⲱⲛ|ϥ
ⲉⲣⲱⲟⲩ	ⲉⲣⲱ|ⲟⲩ
ϧⲉⲛⲫⲁⲓ	ϧⲉⲛ|ⲫⲁⲓ
ⲁϥⲟⲩⲱⲛϩ	ⲁ|ϥ|ⲟⲩⲱⲛϩ
ⲉϥⲉⲣⲟⲩⲱⲓⲛⲓ	ⲉ|ϥ|ⲉⲣⲟⲩⲱⲓⲛⲓ
ⲛⲧⲁⲓϧⲉ	ⲛ|ⲧⲁⲓ|ϧⲉ
ϩⲱⲥⲧⲉ	ϩⲱⲥⲧⲉ
ⲛⲥⲉⲧⲉⲛϩⲟⲩⲧϥ	ⲛ|ⲥⲉ|ⲧⲉⲛϩⲟⲩⲧ|ϥ
ⲉⲁⲙⲟⲛⲓ	ⲉ|ⲁⲙⲟⲛⲓ
ⲛⲛⲓϩⲓⲏⲃ	ⲛ|ⲛⲓ|ϩⲓⲏⲃ
ⲛⲧⲉϯⲉⲕⲕⲗⲏⲥⲓⲁ	ⲛⲧⲉ|ϯ|ⲉⲕⲕⲗⲏⲥⲓⲁ
ⲛⲉⲙⲭⲏⲙⲓ	ⲛⲉⲙ|ⲭⲏⲙⲓ
ⲧⲏⲣϥ	ⲧⲏⲣ|ϥ
ⲙⲁⲗⲗⲟⲛ	ⲙⲁⲗⲗⲟⲛ
ⲛⲉⲙⲥⲁⲡⲉⲥⲏⲧ	ⲛⲉⲙ|ⲥⲁ|ⲡ|ⲉⲥⲏⲧ
ⲧⲏⲣⲥ	ⲧⲏⲣ|ⲥ
ⲟⲩ	ⲟⲩ
ⲉⲧⲁⲓⲉⲣⲧⲟⲗⲙⲁⲛ	ⲉⲧ|ⲁ|ⲓ|ⲉⲣⲧⲟⲗⲙⲁⲛ
ⲉϫⲱ	ⲉ|ϫⲱ
ⲛⲟⲩⲥⲁϫⲓ	ⲛ|ⲟⲩ|ⲥⲁϫⲓ
ϩⲓⲧⲟⲧ	ϩⲓⲧⲟⲧ
ⲙⲙⲁⲩⲁⲧ	ⲙⲙⲁⲩⲁ|ⲧ
ϧⲁⲡⲓⲉⲗⲁⲭⲓⲥⲧⲟⲥ	ϧⲁ|ⲡⲓ|ⲉⲗⲁⲭⲓⲥⲧⲟⲥ
ⲁⲗⲗⲁ	ⲁⲗⲗⲁ
ⲉⲧⲁⲛⲥⲟⲑⲙⲟⲩ	ⲉⲧ|ⲁ|ⲛ|ⲥⲟⲑⲙ|ⲟⲩ
ⲛⲉⲙⲛⲏ	ⲛⲉⲙ|ⲛⲏ
ⲉⲧⲁⲛⲉⲙⲓ	ⲉⲧ|ⲁ|ⲛ|ⲉⲙⲓ
ⲛⲉ	ⲛⲉ
ⲉⲧⲁⲛⲥϧⲏⲧⲟⲩ	ⲉⲧ|ⲁ|ⲛ|ⲥϧⲏⲧ|ⲟⲩ
ⲛⲱⲧⲉⲛ	ⲛⲱ|ⲧⲉⲛ
ϧⲁⲛⲏ	ϧⲁ|ⲛⲏ
ⲉⲧⲱϣ	ⲉⲧ|ⲱϣ
ⲉⲧⲥⲱⲧⲉⲙ	ⲉⲧ|ⲥⲱⲧⲉⲙ
ⲉⲟⲩⲱⲟⲩ	ⲉ|ⲟⲩ|ⲱⲟⲩ
ⲙⲫⲛⲟⲩϯ	ⲙ|ⲫ|ⲛⲟⲩϯ
ⲛⲧⲁϥ	ⲛⲧⲁ|ϥ
ⲡⲁⲓϩⲁⲅⲓⲟⲥ	ⲡⲁⲓ|ϩⲁⲅⲓⲟⲥ
ⲛⲁⲥⲛⲏⲟⲩ	ⲛⲁ|ⲥⲛⲏⲟⲩ
ⲟⲩⲣⲉⲙⲛⲭⲏⲙⲓ	ⲟⲩ|ⲣⲉⲙⲛⲭⲏⲙⲓ
ϧⲉⲛⲡⲉϥⲅⲉⲛⲟⲥ	ϧⲉⲛ|ⲡⲉϥ|ⲅⲉⲛⲟⲥ
ⲟⲩⲉⲃⲟⲗ	ⲟⲩ|ⲉⲃⲟⲗ
ϧⲉⲛⲟⲩϯⲙⲓ	ϧⲉⲛ|ⲟⲩ|ϯⲙⲓ
ⲉⲩⲙⲟⲩϯ	ⲉ|ⲩ|ⲙⲟⲩϯ
ϫⲉⲡⲓϣⲱ	ϫⲉ|ⲡⲓϣⲱ
ⲛⲉϥⲓⲟϯ	ⲛⲉϥ|ⲓⲟϯ
ⲛⲉϩⲁⲛⲙⲁⲓⲛⲟⲩϯ	ⲛⲉ|ϩⲁⲛ|ⲙⲁⲓⲛⲟⲩϯ
ⲛⲉⲟⲩⲟⲛ	ⲛⲉ|ⲟⲩⲟⲛ
ⲙⲙⲁⲩ	ⲙⲙⲁⲩ
ⲛⲟⲩⲙⲏϣ	ⲛ|ⲟⲩ|ⲙⲏϣ
ⲛϩⲩⲡⲁⲣⲭⲟⲛⲧⲁ	ⲛ|ϩⲩⲡⲁⲣⲭⲟⲛⲧⲁ
ϩⲁⲛⲃⲱⲕ	ϩⲁⲛ|ⲃⲱⲕ
ⲛⲉⲙϩⲁⲛⲃⲱⲕⲓ	ⲛⲉⲙ|ϩⲁⲛ|ⲃⲱⲕⲓ
ⲁⲥϣⲱⲡⲓ	ⲁ|ⲥ|ϣⲱⲡⲓ
ⲉⲧⲁⲩϫⲫⲟ	ⲉⲧ|ⲁ|ⲩ|ϫⲫⲟ
ⲙⲡⲓⲁⲗⲟⲩ	ⲙ|ⲡⲓ|ⲁⲗⲟⲩ
ⲁⲩⲙⲟⲩϯ	ⲁ|ⲩ|ⲙⲟⲩϯ
ⲉⲡⲉϥⲣⲁⲛ	ⲉ|ⲡⲉϥ|ⲣⲁⲛ
ϫⲉⲓⲥⲁⲁⲕ	ϫⲉ|ⲓⲥⲁⲁⲕ
ⲉⲧⲉⲧϩⲉⲣⲙⲏⲛⲉⲓⲁ	ⲉⲧⲉ|ⲧ|ϩⲉⲣⲙⲏⲛⲉⲓⲁ
ⲙⲡⲉϥⲣⲁⲛ	ⲙ|ⲡⲉϥ|ⲣⲁⲛ
ϫⲉⲡⲓⲣⲁϣⲓ	ϫⲉ|ⲡⲓ|ⲣⲁϣⲓ
ⲉⲧⲁⲩⲙⲟϩ	ⲉⲧ|ⲁ|ⲩ|ⲙⲟϩ
ⲛϫⲉⲛⲓⲉϩⲟⲟⲩ	ⲛϫⲉ|ⲛⲓ|ⲉϩⲟⲟⲩ
ϫⲉϩⲓⲛⲁ	ϫⲉ|ϩⲓⲛⲁ
ⲛⲧⲟⲩϯⲱⲙⲥ	ⲛⲧ|ⲟⲩ|ϯⲱⲙⲥ
ⲛⲁϥ	ⲛⲁ|ϥ
ⲕⲁⲧⲁⲛⲓⲡⲁⲣⲁⲇⲟⲥⲓⲥ	ⲕⲁⲧⲁ|ⲛⲓ|ⲡⲁⲣⲁⲇⲟⲥⲓⲥ
ⲛⲧⲉⲛⲓⲭⲣⲓⲥⲧⲓⲁⲛⲟⲥ	ⲛⲧⲉ|ⲛⲓ|ⲭⲣⲓⲥⲧⲓⲁⲛⲟⲥ
ⲁⲩϭⲓⲧϥ	ⲁ|ⲩ|ϭⲓⲧ|ϥ
ⲛϫⲉⲛⲉϥⲓⲟϯ	ⲛϫⲉ|ⲛⲉϥ|ⲓⲟϯ
ⲙⲡⲓⲉⲡⲓⲥⲕⲟⲡⲟⲥ	ⲙ|ⲡⲓ|ⲉⲡⲓⲥⲕⲟⲡⲟⲥ
ⲛⲧⲉⲡⲓⲥⲏⲟⲩ	ⲛⲧⲉ|ⲡⲓ|ⲥⲏⲟⲩ
ⲉⲧⲉⲙⲙⲁⲩ	ⲉⲧⲉ|ⲙⲙⲁⲩ
ⲉⲟⲩⲣⲱⲙⲓ	ⲉ|ⲟⲩ|ⲣⲱⲙⲓ
ⲙⲡⲛⲉⲩⲙⲁⲧⲟⲫⲟⲣⲟⲥ	ⲙ|ⲡⲛⲉⲩⲙⲁⲧⲟⲫⲟⲣⲟⲥ
ⲫⲁⲓ	ⲫⲁⲓ
ϧⲉⲛⲡϫⲓⲛⲑⲣⲉϥⲱⲙⲉ	ϧⲉⲛ|ⲡ|ϫⲓⲛⲑⲣⲉϥⲱⲙⲉ
ϧⲉⲛϯⲕⲟⲗⲩⲃⲏⲑⲣⲁ	ϧⲉⲛ|ϯ|ⲕⲟⲗⲩⲃⲏⲑⲣⲁ
ϧⲉⲛⲫⲣⲁⲛ	ϧⲉⲛ|ⲫ|ⲣⲁⲛ
ⲙⲫⲓⲱⲧ	ⲙ|ⲫ|ⲓⲱⲧ
ⲛⲉⲙⲡϣⲏⲣⲓ	ⲛⲉⲙ|ⲡ|ϣⲏⲣⲓ
ⲛⲉⲙⲡⲓⲡⲛⲉⲩⲙⲁ	ⲛⲉⲙ|ⲡⲓ|ⲡⲛⲉⲩⲙⲁ
ϯⲧⲣⲓⲁⲉ	ϯ|ⲧⲣⲓⲁⲉ
ⲛⲟⲙⲟⲟⲩⲉⲓⲟⲉ	ⲛ|ⲟⲙⲟⲟⲩⲉⲓⲟⲉ
ⲁⲩⲟⲩⲱⲛ	ⲁ|ⲩ|ⲟⲩⲱⲛ
ⲛϫⲉⲛⲉϥⲃⲁⲗ	ⲛϫⲉ|ⲛⲉϥ|ⲃⲁⲗ
ⲁϥⲛⲁⲩ	ⲁ|ϥ|ⲛⲁⲩ
ⲉⲟⲩⲥⲧⲁⲩⲣⲟⲥ	ⲉ|ⲟⲩ|ⲥⲧⲁⲩⲣⲟⲥ
ⲛⲟⲩⲱⲓⲛⲓ	ⲛ|ⲟⲩⲱⲓⲛⲓ
ϩⲱⲥ	ϩⲱⲥ
ⲉⲁⲩⲕⲓⲙ	ⲉ|ⲁ|ⲩ|ⲕⲓⲙ
ϩⲓⲧⲉⲛⲡⲓⲡⲛⲉⲩⲙⲁ	ϩⲓⲧⲉⲛ|ⲡⲓ|ⲡⲛⲉⲩⲙⲁ
ⲁϥⲱϣ	ⲁ|ϥ|ⲱϣ
ϧⲉⲛⲟⲩⲥⲙⲏ	ϧⲉⲛ|ⲟⲩ|ⲥⲙⲏ
ⲙⲡⲣⲟⲫⲏⲧⲓⲕⲟⲛ	ⲙ|ⲡⲣⲟⲫⲏⲧⲓⲕⲟⲛ
ⲉϥϫⲱ	ⲉ|ϥ|ϫⲱ
ⲙⲙⲟⲥ	ⲙⲙⲟ|ⲥ
ϫⲉⲛⲑⲟⲕ	ϫⲉ|ⲛⲑⲟⲕ
ⲟⲩⲛⲓϣϯ	ⲟⲩ|ⲛⲓϣϯ
ⲡⲓⲡⲁⲛⲧⲟⲕⲣⲁⲧⲱⲣ	ⲡⲓ|ⲡⲁⲛⲧⲟⲕⲣⲁⲧⲱⲣ
ⲛⲑⲟⲕ	ⲛⲑⲟⲕ
ⲙⲙⲁⲩⲁⲧⲕ	ⲙⲙⲁⲩⲁⲧ|ⲕ
ⲉⲑⲛⲁⲁϥ	ⲉⲑ|ⲛⲁⲁ|ϥ
ϧⲉⲛⲛⲉⲕⲙⲟⲕⲙⲉⲕ	ϧⲉⲛ|ⲛⲉⲕ|ⲙⲟⲕⲙⲉⲕ
ⲡⲉⲧⲛⲁϣⲓⲛⲓ	ⲡ|ⲉⲧ|ⲛⲁ|ϣⲓⲛⲓ
ⲙⲙⲟⲕ	ⲙⲙⲟ|ⲕ
ⲉⲧⲁϥϫⲟⲧⲟⲩ	ⲉⲧ|ⲁ|ϥ|ϫⲟⲧ|ⲟⲩ
ⲛϫⲉⲡⲓⲉⲡⲓⲥⲕⲟⲡⲟⲥ	ⲛϫⲉ|ⲡⲓ|ⲉⲡⲓⲥⲕⲟⲡⲟⲥ
ⲁϥⲧⲏⲓϥ	ⲁ|ϥ|ⲧⲏⲓ|ϥ
ⲛⲛⲉϥⲓⲟϯ	ⲛ|ⲛⲉϥ|ⲓⲟϯ
ϫⲉⲁⲣⲉϩ	ϫⲉ|ⲁⲣⲉϩ
ⲉⲡⲁⲓⲁⲗⲟⲩ	ⲉ|ⲡⲁⲓ|ⲁⲗⲟⲩ
ϫⲉⲟⲩⲇⲱⲣⲟⲛ	ϫⲉ|ⲟⲩ|ⲇⲱⲣⲟⲛ
ⲛⲁϣⲱⲡⲓ	ⲛⲁ|ϣⲱⲡⲓ
ⲛⲟⲩⲛⲓϣϯ	ⲛ|ⲟⲩ|ⲛⲓϣϯ
ϧⲉⲛⲡⲏⲓ	ϧⲉⲛ|ⲡ|ⲏⲓ
ⲥⲉⲛⲁⲧⲉⲛϩⲟⲩⲧϥ	ⲥⲉ|ⲛⲁ|ⲧⲉⲛϩⲟⲩⲧ|ϥ
ⲉϩⲁⲛⲗⲁⲟⲥ	ⲉ|ϩⲁⲛ|ⲗⲁⲟⲥ
ⲉⲩⲟϣ	ⲉ|ⲩ|ⲟϣ
ⲉⲧⲁⲩⲥⲟⲑⲙⲟⲩ	ⲉⲧ|ⲁ|ⲩ|ⲥⲟⲑⲙ|ⲟⲩ
ⲁⲩϭⲓⲥⲓ	ⲁ|ⲩ|ϭⲓⲥⲓ
ⲛⲧⲟⲩⲥⲙⲏ	ⲛ|ⲧⲟⲩ|ⲥⲙⲏ
ⲉⲩϫⲱ	ⲉ|ⲩ|ϫⲱ
ϫⲉⲙⲁⲣⲉϥϣⲱⲡⲓ	ϫⲉ|ⲙⲁⲣⲉ|ϥ|ϣⲱⲡⲓ
ⲛϫⲉⲫⲣⲁⲛ	ⲛϫⲉ|ⲫ|ⲣⲁⲛ
ⲙⲡϭⲟⲉⲓⲥ	ⲙ|ⲡ|ϭⲟⲉⲓⲥ
ⲉϥⲥⲙⲁⲣⲱⲟⲩⲧ	ⲉ|ϥ|ⲥⲙⲁⲣⲱⲟⲩⲧ
ⲓⲥϫⲉⲛⲡⲓⲉⲛⲉϩ	ⲓⲥϫⲉⲛ|ⲡⲓ|ⲉⲛⲉϩ
ϣⲁⲉⲛⲉϩ	ϣⲁ|ⲉⲛⲉϩ
ⲉⲧⲁϥⲉⲣⲡⲣⲟⲕⲟⲡⲧⲉⲓⲛ	ⲉⲧ|ⲁ|ϥ|ⲉⲣⲡⲣⲟⲕⲟⲡⲧⲉⲓⲛ
ⲛϫⲉⲡⲓⲁⲗⲟⲩ	ⲛϫⲉ|ⲡⲓ|ⲁⲗⲟⲩ
ϧⲉⲛϯⲙⲁⲓⲏ	ϧⲉⲛ|ϯ|ⲙⲁⲓⲏ
ⲁⲩⲧⲏⲓϥ	ⲁ|ⲩ|ⲧⲏⲓ|ϥ
ⲉϯⲁⲛⲍⲏⲃ	ⲉ|ϯ|ⲁⲛⲍⲏⲃ
ϧⲉⲛϩⲁⲛⲕⲟⲩϫⲓ	ϧⲉⲛ|ϩⲁⲛ|ⲕⲟⲩϫⲓ
ⲛⲉϩⲟⲟⲩ	ⲛ|ⲉϩⲟⲟⲩ
ⲁϥⲉⲙⲓ	ⲁ|ϥ|ⲉⲙⲓ
ⲉⲧϫⲟⲙ	ⲉ|ⲧ|ϫⲟⲙ
ⲛⲛⲓⲥϧⲁⲓ	ⲛ|ⲛⲓ|ⲥϧⲁⲓ
ⲛⲉⲙⲛⲓⲙⲁⲑⲏⲙⲁ	ⲛⲉⲙ|ⲛⲓ|ⲙⲁⲑⲏⲙⲁ
ⲛⲧⲟⲩⲉⲣϣⲫⲏⲣⲓ	ⲛⲧ|ⲟⲩ|ⲉⲣϣⲫⲏⲣⲓ
ⲛϫⲉⲟⲩⲟⲛ	ⲛϫⲉ|ⲟⲩⲟⲛ
ⲉⲧⲭⲏ	ⲉⲧ|ⲭⲏ
ϧⲉⲛϯⲁⲛⲍⲏⲃ	ϧⲉⲛ|ϯ|ⲁⲛⲍⲏⲃ
ⲛⲉⲙⲁϥ	ⲛⲉⲙⲁ|ϥ
ⲉⲩⲛⲁⲩ	ⲉ|ⲩ|ⲛⲁⲩ
ⲉⲡⲓⲉⲙⲓ	ⲉ|ⲡⲓ|ⲉⲙⲓ
ⲧⲏⲓϥ	ⲧⲏⲓ|ϥ
ⲛⲁⲩϭⲛⲟⲛ	ⲛⲁ|ⲩ|ϭⲛⲟⲛ
ⲛϫⲱⲟⲩ	ⲛ|ϫⲱ|ⲟⲩ
ⲉⲧϧⲉⲛϯⲁⲛⲍⲏⲃ	ⲉⲧ|ϧⲉⲛ|ϯ|ⲁⲛⲍⲏⲃ
ⲉⲧⲁϥⲙⲟϩ	ⲉⲧ|ⲁ|ϥ|ⲙⲟϩ
ϧⲉⲛⲡⲓⲉⲙⲓ	ϧⲉⲛ|ⲡⲓ|ⲉⲙⲓ
ⲛⲉⲙϯⲥⲟⲫⲓⲁ	ⲛⲉⲙ|ϯ|ⲥⲟⲫⲓⲁ
ⲉⲧⲟⲧϥ	ⲉⲧⲟⲧ|ϥ
ⲛⲟⲩⲥⲩⲅⲅⲉⲛⲏⲥ	ⲛ|ⲟⲩ|ⲥⲩⲅⲅⲉⲛⲏⲥ
ⲙⲉⲛⲉⲥⲱⲛ	ⲙⲉⲛⲉⲥⲱⲛ
ⲛⲭⲁⲣⲧⲟⲗⲁⲣⲓⲟⲥ	ⲛ|ⲭⲁⲣⲧⲟⲗⲁⲣⲓⲟⲥ
ϧⲁⲣⲁⲧϥ	ϧⲁⲣⲁⲧ|ϥ
ⲛⲅⲉⲱⲣⲅⲓⲟⲥ	ⲛ|ⲅⲉⲱⲣⲅⲓⲟⲥ
ⲛⲉⲡⲁⲣⲭⲟⲥ	ⲛ|ⲉⲡⲁⲣⲭⲟⲥ
ⲉϯⲭⲱⲣⲁ	ⲉ|ϯ|ⲭⲱⲣⲁ
ⲛⲧⲉⲭⲏⲙⲓ	ⲛⲧⲉ|ⲭⲏⲙⲓ
ⲛⲧⲉⲡⲓⲁⲗⲟⲩ	ⲛⲧⲉ|ⲡⲓ|ⲁⲗⲟⲩ
ⲛⲛⲟⲧⲁⲣⲓⲟⲥ	ⲛ|ⲛⲟⲧⲁⲣⲓⲟⲥ
ⲉⲧⲓ	ⲉⲧⲓ
ⲉϥϣⲟⲡ	ⲉ|ϥ|ϣⲟⲡ
ϧⲉⲛⲡⲓⲙⲁ	ϧⲉⲛ|ⲡⲓ|ⲙⲁ
ⲁϥⲟⲩⲱⲛϧ	ⲁ|ϥ|ⲟⲩⲱⲛϧ
ⲙⲫⲃⲓⲟⲥ	ⲙ|ⲫ|ⲃⲓⲟⲥ
ⲛϯⲙⲉⲧⲙⲟⲛⲁⲭⲟⲥ	ⲛ|ϯ|ⲙⲉⲧⲙⲟⲛⲁⲭⲟⲥ
ⲛϣⲟⲣⲡ	ⲛ|ϣⲟⲣⲡ
ⲙⲉⲛ	ⲙⲉⲛ
ⲁϥⲱⲗⲓ	ⲁ|ϥ|ⲱⲗⲓ
ⲛⲛⲓⲯⲁⲗⲙⲟⲥ	ⲛ|ⲛⲓ|ⲯⲁⲗⲙⲟⲥ
ⲛⲁⲡⲟⲥⲧⲏⲑⲏⲥ	ⲛ|ⲁⲡⲟⲥⲧⲏⲑⲏⲥ
ⲉϥⲉⲣⲛⲏⲥⲧⲉⲩⲉⲓⲛ	ⲉ|ϥ|ⲉⲣⲛⲏⲥⲧⲉⲩⲉⲓⲛ
ϣⲁⲣⲟⲩϩⲓ	ϣⲁ|ⲣⲟⲩϩⲓ
ⲙⲙⲏⲛⲓ	ⲙ|ⲙⲏⲛⲓ
ⲉϥⲙⲏⲛ	ⲉ|ϥ|ⲙⲏⲛ
ⲉⲛⲓⲥⲩⲛⲁⲝⲓⲥ	ⲉ|ⲛⲓ|ⲥⲩⲛⲁⲝⲓⲥ
ⲉϥⲉⲣⲫⲟⲣⲉⲓⲛ	ⲉ|ϥ|ⲉⲣⲫⲟⲣⲉⲓⲛ
ⲛⲟⲩϣⲑⲏⲛ	ⲛ|ⲟⲩ|ϣⲑⲏⲛ
ⲛϥⲱⲓ	ⲛ|ϥⲱⲓ
ⲥⲁϧⲟⲩⲛ	ⲥⲁϧⲟⲩⲛ
ⲥⲁⲃⲟⲗ	ⲥⲁⲃⲟⲗ
ⲛⲑⲁⲓ	ⲛ|ⲑⲁⲓ
ⲟⲩϩⲉⲃⲥⲱ	ⲟⲩ|ϩⲉⲃⲥⲱ
ⲉⲥⲫⲉⲣⲓⲱⲟⲩ	ⲉ|ⲥ|ⲫⲉⲣⲓⲱⲟⲩ
ⲛⲟⲩⲁⲓ	ⲛ|ⲟⲩⲁⲓ
ⲛⲛⲓⲉϩⲟⲟⲩ	ⲛ|ⲛⲓ|ⲉϩⲟⲟⲩ
ⲁϥⲙⲟⲩϯ	ⲁ|ϥ|ⲙⲟⲩϯ
ⲛϫⲉⲡⲓⲁⲣⲭⲱⲛ	ⲛϫⲉ|ⲡⲓ|ⲁⲣⲭⲱⲛ
ⲉⲙⲉⲛⲉⲥⲱⲛ	ⲉ|ⲙⲉⲛⲉⲥⲱⲛ
ⲉϥⲟⲩⲱϣ	ⲉ|ϥ|ⲟⲩⲱϣ
ⲉⲥϧⲏⲧⲟⲩⲉⲡⲓⲥⲧⲟⲗⲏ	ⲉ|ⲥϧⲏⲧ|ⲟⲩ|ⲉⲡⲓⲥⲧⲟⲗⲏ
ⲛⲁⲛⲁⲅⲕⲁⲓⲟⲛ	ⲛ|ⲁⲛⲁⲅⲕⲁⲓⲟⲛ
ⲛⲑⲟϥ	ⲛⲑⲟϥ
ⲡⲓⲛⲓϣϯ	ⲡⲓ|ⲛⲓϣϯ
ⲉⲧⲉⲙⲡⲉϥϫⲉⲙϥ	ⲉⲧⲉ|ⲙⲡⲉ|ϥ|ϫⲉⲙ|ϥ
ⲡⲣⲟⲥⲡⲓⲛⲁⲩ	ⲡⲣⲟⲥ|ⲡⲓ|ⲛⲁⲩ
ⲁϥⲙⲃⲟⲛ	ⲁ|ϥ|ⲙⲃⲟⲛ
ϧⲉⲛⲟⲩⲛⲓϣϯ	ϧⲉⲛ|ⲟⲩ|ⲛⲓϣϯ
ⲛϫⲱⲛⲧ	ⲛ|ϫⲱⲛⲧ
ⲉⲧⲁϥⲙⲟⲩϯ	ⲉⲧ|ⲁ|ϥ|ⲙⲟⲩϯ
ⲉⲡⲓⲁⲗⲟⲩ	ⲉ|ⲡⲓ|ⲁⲗⲟⲩ
ⲁϥϣⲉⲛϥ	ⲁ|ϥ|ϣⲉⲛ|ϥ
ϫⲉⲉⲣⲉⲡⲉⲕⲥⲁϧ	ϫⲉ|ⲉⲣⲉ|ⲡⲉⲕ|ⲥⲁϧ
ⲑⲱⲛ	ⲑⲱⲛ
ⲡⲉϫⲁϥ	ⲡⲉϫⲁ|ϥ
ϫⲉϯⲉⲙⲓ	ϫⲉ|ϯ|ⲉⲙⲓ
ⲉⲧⲁⲡⲓⲁⲗⲟⲩ	ⲉⲧ|ⲁ|ⲡⲓ|ⲁⲗⲟⲩ
ⲛⲁⲩ	ⲛⲁⲩ
ⲉⲣⲉⲡⲉϥϩⲟ	ⲉⲣⲉ|ⲡⲉϥ|ϩⲟ
ⲟⲕⲉⲙ	ⲟⲕⲉⲙ
ⲁϥⲉⲣⲟⲩⲱ	ⲁ|ϥ|ⲉⲣⲟⲩⲱ
ⲛⲁϩⲣⲁϥ	ⲛⲁϩⲣⲁ|ϥ
ⲇⲁⲩⲓⲇ	ⲇⲁⲩⲓⲇ
ⲛⲁϩⲣⲉⲛⲡⲟⲩⲣⲟ	ⲛⲁϩⲣⲉⲛ|ⲡ|ⲟⲩⲣⲟ
ⲙⲡⲓⲥⲣⲁⲏⲗ	ⲙ|ⲡ|ⲓⲥⲣⲁⲏⲗ
ϫⲉⲉⲑⲃⲉⲟⲩ	ϫⲉ|ⲉⲑⲃⲉ|ⲟⲩ
ⲡϩⲟ	ⲡ|ϩⲟ
ⲙⲡⲁϭⲟⲉⲓⲥ	ⲙ|ⲡⲁ|ϭⲟⲉⲓⲥ
ϯⲛⲁⲥϧⲉϯⲉⲡⲓⲥⲧⲟⲗⲏ	ϯ|ⲛⲁ|ⲥϧⲉ|ϯ|ⲉⲡⲓⲥⲧⲟⲗⲏ
ⲉⲧⲉⲕⲟⲩⲱϣ	ⲉⲧⲉ|ⲕ|ⲟⲩⲱϣ
ⲉⲧⲁϥⲉⲣϣⲫⲏⲣⲓ	ⲉⲧ|ⲁ|ϥ|ⲉⲣϣⲫⲏⲣⲓ
ⲉϫⲉⲛⲧⲉϥϫⲓⲛⲉⲣⲟⲩⲱ	ⲉϫⲉⲛ|ⲧⲉϥ|ϫⲓⲛⲉⲣⲟⲩⲱ
ϫⲉⲉϥⲉⲣⲇⲟⲕⲓⲙⲁⲍⲓⲛ	ϫⲉ|ⲉ|ϥ|ⲉⲣⲇⲟⲕⲓⲙⲁⲍⲓⲛ
ϫⲉⲙⲁϣⲉ	ϫⲉ|ⲙⲁϣⲉ
ⲛⲁⲕ	ⲛⲁ|ⲕ
ⲉⲟⲩⲁⲓ	ⲉ|ⲟⲩⲁⲓ
ⲙⲙⲁ	ⲙ|ⲙⲁ
ⲛⲕⲟⲓⲧⲱⲛ	ⲛ|ⲕⲟⲓⲧⲱⲛ
ⲥϧⲏⲧⲥ	ⲥϧⲏⲧ|ⲥ
ⲁⲛⲓⲧⲥ	ⲁⲛⲓⲧ|ⲥ
ⲛⲧⲁⲛⲁⲩ	ⲛ|ⲧⲁ|ⲛⲁⲩ
ⲉⲣⲟⲥ	ⲉⲣⲟ|ⲥ
ⲉⲧⲁϥⲥϧⲏⲧⲥ	ⲉⲧ|ⲁ|ϥ|ⲥϧⲏⲧ|ⲥ
ⲁϥⲉⲛⲥ	ⲁ|ϥ|ⲉⲛ|ⲥ
ⲁϥⲧⲁⲙⲟⲥ	ⲁ|ϥ|ⲧⲁⲙⲟ|ⲥ
ⲉⲧⲁⲡⲓⲁⲣⲭⲱⲛ	ⲉⲧ|ⲁ|ⲡⲓ|ⲁⲣⲭⲱⲛ
ⲉϯⲉⲡⲓⲥⲧⲟⲗⲏ	ⲉ|ϯ|ⲉⲡⲓⲥⲧⲟⲗⲏ
ⲁϥⲧⲱⲙⲧ	ⲁ|ϥ|ⲧⲱⲙⲧ
ⲉϧⲣⲏⲓ	ⲉϧⲣⲏⲓ
ⲉϫⲱⲥ	ⲉϫⲱ|ⲥ
ϫⲉⲟⲩⲕⲟⲩⲛ	ϫⲉ|ⲟⲩⲕ|ⲟⲩⲛ
ⲟⲩⲁⲓ	ⲟⲩⲁⲓ
ⲙⲡⲓⲉⲙⲓ	ⲙⲡ|ⲓ|ⲉⲙⲓ
ϣⲁⲫⲟⲟⲩ	ϣⲁ|ⲫ|ⲟⲟⲩ
ⲁⲗⲏⲑⲱⲥ	ⲁⲗⲏⲑⲱⲥ
ⲉⲣⲉⲡⲓⲣⲱⲙⲓ	ⲉⲣⲉ|ⲡⲓ|ⲣⲱⲙⲓ
ϫⲟⲩϣⲧ	ϫⲟⲩϣⲧ
ⲉⲡⲓϩⲟ	ⲉ|ⲡⲓ|ϩⲟ
ⲉⲡⲓϩⲏⲧ	ⲉ|ⲡⲓ|ϩⲏⲧ
ⲓⲥϫⲉⲛⲡⲓⲉϩⲟⲟⲩ	ⲓⲥϫⲉⲛ|ⲡⲓ|ⲉϩⲟⲟⲩ
ⲁⲡⲓⲁⲣⲭⲱⲛ	ⲁ|ⲡⲓ|ⲁⲣⲭⲱⲛ
ⲁⲓϥ	ⲁⲓ|ϥ
ⲛⲁⲫⲉ	ⲛ|ⲁⲫⲉ
ⲉϫⲉⲛⲛⲓⲛⲟⲧⲁⲣⲓⲟⲥ	ⲉϫⲉⲛ|ⲛⲓ|ⲛⲟⲧⲁⲣⲓⲟⲥ
ⲧⲏⲣⲩ	ⲧⲏⲣ|ⲩ
ⲛⲁⲩⲙⲉⲓ	ⲛⲁ|ⲩ|ⲙⲉⲓ
ⲉⲩⲉⲣⲁⲅⲁⲡⲁⲛ	ⲉ|ⲩ|ⲉⲣⲁⲅⲁⲡⲁⲛ
ⲉⲧϧⲉⲛⲡⲓⲡⲣⲁⲓⲧⲱⲣⲓⲟⲛ	ⲉⲧ|ϧⲉⲛ|ⲡⲓ|ⲡⲣⲁⲓⲧⲱⲣⲓⲟⲛ
ϫⲉⲫⲏ	ϫⲉ|ⲫⲏ
ⲉⲑⲃⲉϯⲥⲟⲫⲓⲁ	ⲉⲑⲃⲉ|ϯ|ⲥⲟⲫⲓⲁ
ⲉⲧⲉⲛϧⲏⲧϥ	ⲉⲧⲉ|ⲛϧⲏⲧ|ϥ
ⲗⲟⲓⲡⲟⲛ	ⲗⲟⲓⲡⲟⲛ
ⲛⲁⲣⲉⲛⲉϥⲓⲟϯ	ⲛⲁⲣⲉ|ⲛⲉϥ|ⲓⲟϯ
ⲛⲟⲩⲓⲁⲗ	ⲛ|ⲟⲩ|ⲓⲁⲗ
ⲉⲩⲉⲣϩⲉⲗⲡⲓⲥ	ⲉ|ⲩ|ⲉⲣϩⲉⲗⲡⲓⲥ
ϫⲉⲛⲑⲟϥ	ϫⲉ|ⲛⲑⲟϥ
ⲉⲑⲛⲁⲉⲣϭⲟⲉⲓⲥ	ⲉⲑ|ⲛⲁ|ⲉⲣϭⲟⲉⲓⲥ
ⲉϫⲉⲛⲛⲏ	ⲉϫⲉⲛ|ⲛⲏ
ⲉⲧⲉⲛⲧⲱⲟⲩ	ⲉⲧⲉ|ⲛⲧ|ⲱⲟⲩ
ⲛⲁⲩⲟⲩⲱϣ	ⲛⲁ|ⲩ|ⲟⲩⲱϣ
ⲉϭⲓⲥϩⲓⲙⲓ	ⲉ|ϭⲓⲥϩⲓⲙⲓ
ⲉϩⲁⲛϣⲏⲣⲓ	ⲉ|ϩⲁⲛ|ϣⲏⲣⲓ
ⲛⲥⲉⲉⲙⲓ	ⲛ|ⲥⲉ|ⲉⲙⲓ
ⲣⲱ	ⲣⲱ
ϫⲉⲟⲩⲡⲁⲓⲣⲏϯ	ϫⲉ|ⲟⲩ|ⲡⲁⲓ|ⲣⲏϯ
ⲧⲧⲟⲓ	ⲧ|ⲧⲟⲓ
ⲛⲓⲁⲕⲱⲃ	ⲛ|ⲓⲁⲕⲱⲃ
ⲉⲁⲓϥ	ⲉ|ⲁⲓ|ϥ
ⲛⲓⲱⲧ	ⲛ|ⲓⲱⲧ
ⲉϫⲉⲛⲟⲩⲙⲏϣ	ⲉϫⲉⲛ|ⲟⲩ|ⲙⲏϣ
ⲛϣⲏⲣⲓ	ⲛ|ϣⲏⲣⲓ
ⲉⲧⲁϥⲫⲱⲣϫ	ⲉⲧ|ⲁ|ϥ|ⲫⲱⲣϫ
ⲛⲓⲉⲣⲉⲙⲓⲁⲥ	ⲛ|ⲓⲉⲣⲉⲙⲓⲁⲥ
ⲓⲥϫⲉⲛⲉϥϧⲉⲛⲧⲛⲉϫⲓ	ⲓⲥϫⲉⲛ|ⲉ|ϥ|ϧⲉⲛ|ⲧ|ⲛⲉϫⲓ
ⲟⲛ	ⲟⲛ
ⲁϥⲫⲱⲣϫ	ⲁ|ϥ|ⲫⲱⲣϫ
ⲙⲡⲁⲓϩⲁⲅⲓⲟⲥ	ⲙ|ⲡⲁⲓ|ϩⲁⲅⲓⲟⲥ
ⲡⲗⲏⲛ	ⲡⲗⲏⲛ
ⲁⲛⲉϥⲓⲟϯ	ⲁ|ⲛⲉϥ|ⲓⲟϯ
ϭⲓⲧϥ	ϭⲓⲧ|ϥ
ⲡⲁⲣⲁⲡⲉϥⲟⲩⲱϣ	ⲡⲁⲣⲁ|ⲡⲉϥ|ⲟⲩⲱϣ
ⲁⲩⲱⲡ	ⲁ|ⲩ|ⲱⲡ
ⲛⲥⲁϯⲥϩⲓⲙⲓ	ⲛⲥⲁ|ϯ|ⲥϩⲓⲙⲓ
ⲁⲩⲟϩⲓ	ⲁ|ⲩ|ⲟϩⲓ
ϣⲁⲡⲓⲥⲏⲟⲩ	ϣⲁ|ⲡⲓ|ⲥⲏⲟⲩ
ⲙⲡⲓϩⲟⲡ	ⲙ|ⲡⲓ|ϩⲟⲡ
ⲡⲓⲁⲗⲟⲩ	ⲡⲓ|ⲁⲗⲟⲩ
ⲛⲁⲣⲉⲟⲩⲟⲛ	ⲛⲁⲣⲉ|ⲟⲩⲟⲛ
ⲛϭⲓϣϣⲱⲟⲩ	ⲛ|ϭⲓϣϣⲱⲟⲩ
ⲉϯϫⲓⲛⲱⲛϧ	ⲉ|ϯ|ϫⲓⲛⲱⲛϧ
ⲉⲧϩⲟⲗϫ	ⲉⲧ|ϩⲟⲗϫ
ⲛⲧⲉϯⲙⲉⲧⲙⲟⲛⲁⲭⲟⲥ	ⲛⲧⲉ|ϯ|ⲙⲉⲧⲙⲟⲛⲁⲭⲟⲥ
ⲉϥⲓⲣⲓ	ⲉ|ϥ|ⲓⲣⲓ
ⲙⲫⲙⲉⲩⲓ	ⲙ|ⲫ|ⲙⲉⲩⲓ
ⲛϫⲉⲡⲁⲓⲁⲗⲟⲩ	ⲛϫⲉ|ⲡⲁⲓ|ⲁⲗⲟⲩ
ⲉϥⲱϣ	ⲉ|ϥ|ⲱϣ
ϧⲉⲛⲡⲓⲉⲩⲁⲅⲅⲉⲗⲓⲟⲛ	ϧⲉⲛ|ⲡⲓ|ⲉⲩⲁⲅⲅⲉⲗⲓⲟⲛ
ϫⲉⲡⲉⲧⲙⲉⲓ	ϫⲉ|ⲡ|ⲉⲧ|ⲙⲉⲓ
ⲙⲡⲉϥⲓⲱⲧ	ⲙ|ⲡⲉϥ|ⲓⲱⲧ
ⲧⲉϥⲙⲁⲩ	ⲧⲉϥ|ⲙⲁⲩ
ⲉϩⲟⲧ	ⲉϩⲟⲧ
ϥⲉⲙⲡϣⲁ	ϥ|ⲉⲙⲡϣⲁ
ⲡⲁⲗⲓⲛ	ⲡⲁⲗⲓⲛ
ⲉⲧⲁϥⲭⲁⲓⲱⲧ	ⲉⲧ|ⲁ|ϥ|ⲭⲁ|ⲓⲱⲧ
ⲛⲥⲱϥ	ⲛⲥⲱ|ϥ
ⲙⲁⲩ	ⲙⲁⲩ
ⲥϩⲓⲙⲓ	ⲥϩⲓⲙⲓ
ⲥⲱⲛⲓ	ⲥⲱⲛⲓ
ⲥⲟⲛ	ⲥⲟⲛ
ⲏⲓ	ⲏⲓ
ϣⲏⲣⲓ	ϣⲏⲣⲓ
ⲉⲑⲃⲉⲧⲙⲉⲧⲟⲩⲣⲟ	ⲉⲑⲃⲉ|ⲧ|ⲙⲉⲧⲟⲩⲣⲟ
ϥⲛⲁϭⲓⲧⲟⲩ	ϥ|ⲛⲁ|ϭⲓⲧ|ⲟⲩ
ⲛⲣ	ⲛ|ⲣ
ⲛⲕⲱⲡ	ⲛ|ⲕⲱⲡ
ⲛⲥⲟⲡ	ⲛ|ⲥⲟⲡ
ϧⲉⲛⲡⲁⲓⲉⲛⲉϩ	ϧⲉⲛ|ⲡⲁⲓ|ⲉⲛⲉϩ
ϧⲉⲛⲡⲉⲑⲛⲏⲟⲩ	ϧⲉⲛ|ⲡ|ⲉⲑ|ⲛⲏⲟⲩ
ⲟⲩⲱⲛϧ	ⲟⲩ|ⲱⲛϧ
ⲡⲓⲁⲡⲟⲥⲧⲟⲗⲟⲥ	ⲡⲓ|ⲁⲡⲟⲥⲧⲟⲗⲟⲥ
ⲱϣ	ⲱϣ
ϫⲉϥⲛⲁⲥⲓⲛⲓ	ϫⲉ|ϥ|ⲛⲁ|ⲥⲓⲛⲓ
ⲛϫⲉⲡⲓⲥⲭⲏⲙⲁ	ⲛϫⲉ|ⲡⲓ|ⲥⲭⲏⲙⲁ
ⲛⲧⲉⲡⲁⲓⲕⲟⲥⲙⲟⲥ	ⲛⲧⲉ|ⲡⲁⲓ|ⲕⲟⲥⲙⲟⲥ
ϯⲟⲩⲉϣⲑⲏⲛⲟⲩ	ϯ|ⲟⲩⲉϣ|ⲑⲏⲛⲟⲩ
ⲉⲣⲉⲧⲉⲛⲟⲓ	ⲉⲣⲉ|ⲧⲉⲛ|ⲟⲓ
ⲛⲁⲧⲣⲱⲟⲩϣ	ⲛ|ⲁⲧⲣⲱⲟⲩϣ
ⲓⲱⲁⲛⲛⲏⲥ	ⲓⲱⲁⲛⲛⲏⲥ
ϫⲱ	ϫⲱ
ϫⲉⲡⲓⲕⲟⲥⲙⲟⲥ	ϫⲉ|ⲡⲓ|ⲕⲟⲥⲙⲟⲥ
ⲛⲁⲥⲓⲛⲓ	ⲛⲁ|ⲥ|ⲓⲛⲓ
ⲛⲉⲙⲧⲉϥⲉⲡⲓⲑⲩⲙⲓⲁ	ⲛⲉⲙ|ⲧⲉϥ|ⲉⲡⲓⲑⲩⲙⲓⲁ
ⲉⲧⲓⲣⲓ	ⲉⲧ|ⲓⲣⲓ
ⲙⲫⲟⲩⲱϣ	ⲙ|ⲫ|ⲟⲩⲱϣ
ϥⲛⲁϣⲱⲡⲓ	ϥ|ⲛⲁ|ϣⲱⲡⲓ
ϫⲉⲛⲭⲁⲓ	ϫⲉ|ⲛⲭⲁⲓ
ⲉⲧϧⲉⲛ	ⲉⲧ|ϧⲉⲛ
ⲡⲓⲕⲟⲥⲙⲟⲥ	ⲡⲓ|ⲕⲟⲥⲙⲟⲥ
ϯⲉⲡⲓⲑⲩⲙⲓⲁ	ϯ|ⲉⲡⲓⲑⲩⲙⲓⲁ
ⲛⲧⲉⲛⲓⲃⲁⲗ	ⲛⲧⲉ|ⲛⲓ|ⲃⲁⲗ
ⲛⲉⲙϯⲉⲡⲓⲑⲩⲙⲓⲁ	ⲛⲉⲙ|ϯ|ⲉⲡⲓⲑⲩⲙⲓⲁ
ⲛⲧⲉϯⲥⲁⲣⲝ	ⲛⲧⲉ|ϯ|ⲥⲁⲣⲝ
ϩⲁⲛⲁⲧϣⲧⲁϩⲱⲟⲩ	ϩⲁⲛ|ⲁⲧϣⲧⲁϩⲱⲟⲩ
ϧⲉⲛⲡⲟⲩϭⲓⲙⲡϣⲓϣ	ϧⲉⲛ|ⲡⲟⲩ|ϭⲓⲙⲡϣⲓϣ
ϩⲁⲛⲉⲃⲟⲗ	ϩⲁⲛ|ⲉⲃⲟⲗ
ϧⲉⲛⲡⲓⲕⲟⲥⲙⲟⲥ	ϧⲉⲛ|ⲡⲓ|ⲕⲟⲥⲙⲟⲥ
ⲉⲣⲉⲡⲓⲑⲙⲏⲓ	ⲉⲣⲉ|ⲡⲓ|ⲑⲙⲏⲓ
ⲉⲣⲙⲉⲗⲉⲧⲁⲛ	ⲉⲣⲙⲉⲗⲉⲧⲁⲛ
ⲉⲛⲉϩⲟⲟⲩ	ⲉ|ⲛ|ⲉϩⲟⲟⲩ
ϧⲁⲧϩⲏ	ϧⲁ|ⲧ|ϩⲏ
ⲉϥⲥⲟϭⲛⲓ	ⲉ|ϥ|ⲥⲟϭⲛⲓ
ⲛϧⲏⲧⲓ	ⲛϧⲏⲧⲓ
ⲉⲭⲱ	ⲉ|ⲭⲱ
ⲛϯⲙⲉⲧⲉⲫⲗⲏⲟⲩ	ⲛ|ϯ|ⲙⲉⲧⲉⲫⲗⲏⲟⲩ
ⲛⲉⲙⲛⲉϥⲣⲱⲟⲩϣ	ⲛⲉⲙ|ⲛⲉϥ|ⲣⲱⲟⲩϣ
ⲉⲣⲉⲛⲁⲓ	ⲉⲣⲉ|ⲛⲁⲓ
ϧⲉⲛⲥⲱⲙⲁ	ϧⲉⲛ|ⲥⲱⲙⲁ
ⲛϫⲉⲅⲉⲱⲣⲅⲓⲟⲥ	ⲛϫⲉ|ⲅⲉⲱⲣⲅⲓⲟⲥ
ⲡⲓⲉⲡⲁⲣⲭⲟⲥ	ⲡⲓ|ⲉⲡⲁⲣⲭⲟⲥ
ⲉⲣⲉⲡⲓⲁⲗⲟⲩ	ⲉⲣⲉ|ⲡⲓ|ⲁⲗⲟⲩ
ⲟⲓ	ⲟⲓ
ⲉⲧⲁϥⲙⲟⲩ	ⲉⲧ|ⲁ|ϥ|ⲙⲟⲩ
ϫⲉⲁⲡⲉⲑⲟⲩⲁⲃ	ϫⲉ|ⲁ|ⲡ|ⲉⲑ|ⲟⲩⲁⲃ
ϫⲉⲙⲡⲓⲥⲏⲟⲩ	ϫⲉⲙ|ⲡⲓ|ⲥⲏⲟⲩ
ⲉⲧⲉϥⲉⲣⲉⲡⲓⲑⲩⲙⲉⲓⲛ	ⲉⲧⲉ|ϥ|ⲉⲣⲉⲡⲓⲑⲩⲙⲉⲓⲛ
ϧⲉⲛ	ϧⲉⲛ
ⲡⲓⲡⲣⲁⲓⲧⲱⲣⲓⲟⲛ	ⲡⲓ|ⲡⲣⲁⲓⲧⲱⲣⲓⲟⲛ
ⲁϥϣⲉ	ⲁ|ϥ|ϣⲉ
ⲉⲡⲉϥⲏⲓ	ⲉ|ⲡⲉϥ|ⲏⲓ
ⲁϥϣⲱⲡⲓ	ⲁ|ϥ|ϣⲱⲡⲓ
ϧⲁⲧⲉⲛⲛⲉϥⲓⲟϯ	ϧⲁⲧⲉⲛ|ⲛⲉϥ|ⲓⲟϯ
ⲛϩⲁⲛⲕⲟⲩϫⲓ	ⲛ|ϩⲁⲛ|ⲕⲟⲩϫⲓ
ⲛⲑⲱⲟⲩ	ⲛⲑⲱⲟⲩ
ⲛⲁⲩⲉⲣⲁⲅⲁⲡⲁⲛ	ⲛⲁ|ⲩ|ⲉⲣⲁⲅⲁⲡⲁⲛ
ⲉⲩϯⲛⲟⲙϯ	ⲉ|ⲩ|ϯⲛⲟⲙϯ
ⲉⲩⲉⲣϩⲟϯ	ⲉ|ⲩ|ⲉⲣϩⲟϯ
ϫⲉⲙⲏⲡⲱⲥ	ϫⲉ|ⲙⲏⲡⲱⲥ
ⲛⲧⲉϥⲉⲣⲁⲑⲟⲩⲱⲛϩ	ⲛⲧⲉ|ϥ|ⲉⲣⲁⲑⲟⲩⲱⲛϩ
ϩⲁⲣⲱⲟⲩ	ϩⲁⲣⲱ|ⲟⲩ
ⲉⲡⲓⲛⲓϣϯ	ⲉ|ⲡⲓ|ⲛⲓϣϯ
ⲛϧⲙⲟⲙ	ⲛ|ϧⲙⲟⲙ
ⲉⲧϣⲟⲡ	ⲉⲧ|ϣⲟⲡ
ⲉⲡⲓⲁⲅⲁⲑⲟⲛ	ⲉ|ⲡⲓ|ⲁⲅⲁⲑⲟⲛ
ϧⲉⲛⲡⲓⲏⲓ	ϧⲉⲛ|ⲡⲓ|ⲏⲓ
ⲙⲡⲉϥⲭⲁϩⲗⲓ	ⲙⲡⲉ|ϥ|ⲭⲁ|ϩⲗⲓ
ϧⲉⲛⲛⲏ	ϧⲉⲛ|ⲛⲏ
ⲉⲧⲉⲛⲟⲩϥ	ⲉⲧⲉ|ⲛⲟⲩϥ
ⲉⲉⲙⲓ	ⲉ|ⲉⲙⲓ
ⲉⲡⲓⲧⲱⲟⲩ	ⲉ|ⲡⲓ|ⲧⲱⲟⲩ
ⲛⲧⲉϣⲓⲏⲧ	ⲛⲧⲉ|ϣⲓⲏⲧ
ⲉⲧⲟⲩϣⲟⲡ	ⲉⲧ|ⲟⲩ|ϣⲟⲡ
ⲛϫⲉ	ⲛϫⲉ
ϩⲁⲛⲭⲱⲣⲟⲥ	ϩⲁⲛ|ⲭⲱⲣⲟⲥ
ⲛⲁⲅⲅⲉⲗⲟⲥ	ⲛ|ⲁⲅⲅⲉⲗⲟⲥ
ⲉⲩⲟⲩⲁⲃ	ⲉ|ⲩ|ⲟⲩⲁⲃ
ⲉⲧⲉⲛⲁⲓ	ⲉⲧⲉ|ⲛⲁⲓ
ⲛⲓⲙⲟⲛⲁⲭⲟⲥ	ⲛⲓ|ⲙⲟⲛⲁⲭⲟⲥ
ⲉⲧⲥⲙⲁⲣⲱⲟⲩⲧ	ⲉⲧ|ⲥⲙⲁⲣⲱⲟⲩⲧ
ⲉⲧⲁⲩⲉⲣⲥⲧⲁⲩⲣⲱⲛⲉⲓⲛ	ⲉⲧ|ⲁ|ⲩ|ⲉⲣⲥⲧⲁⲩⲣⲱⲛⲉⲓⲛ
ⲛⲧⲟⲩⲥⲁⲣⲝ	ⲛ|ⲧⲟⲩ|ⲥⲁⲣⲝ
ϧⲉⲛⲛⲓϧⲓⲥⲓ	ϧⲉⲛ|ⲛⲓ|ϧⲓⲥⲓ
ⲛⲧⲉⲧⲁⲣⲉⲧⲏ	ⲛⲧⲉ|ⲧ|ⲁⲣⲉⲧⲏ
ⲉⲩϥⲁⲓ	ⲉ|ⲩ|ϥⲁⲓ
ϧⲁⲫⲙⲟⲩ	ϧⲁ|ⲫ|ⲙⲟⲩ
ⲛⲓⲏⲥⲟⲩⲥ	ⲛ|ⲓⲏⲥⲟⲩⲥ
ⲥⲏⲟⲩ	ⲥⲏⲟⲩ
ϧⲉⲛⲡⲟⲩⲥⲱⲙⲁ	ϧⲉⲛ|ⲡⲟⲩ|ⲥⲱⲙⲁ
ⲉⲡⲓⲱⲟⲩ	ⲉ|ⲡⲓ|ⲱⲟⲩ
ⲉⲑⲛⲁϭⲱⲣⲡ	ⲉⲑ|ⲛⲁ|ϭⲱⲣⲡ
ⲛⲱⲟⲩ	ⲛⲱ|ⲟⲩ
ⲕⲁⲧⲁⲫⲣⲏϯ	ⲕⲁⲧⲁ|ⲫ|ⲣⲏϯ
ⲉⲧⲥϧⲏⲟⲩⲧ	ⲉⲧ|ⲥϧⲏⲟⲩⲧ
ⲓⲥϫⲉ	ⲓⲥϫⲉ
ⲧⲉⲛϭⲓⲙⲕⲁϩ	ⲧⲉⲛ|ϭⲓⲙⲕⲁϩ
ⲧⲉⲛⲛⲁϭⲓⲱⲟⲩ	ⲧⲉⲛ|ⲛⲁ|ϭⲓⲱⲟⲩ
ⲉⲧⲁϥⲓ	ⲉⲧ|ⲁ|ϥ|ⲓ
ⲉϣⲓⲏⲧ	ⲉ|ϣⲓⲏⲧ
ⲁϥϫⲱⲓⲗⲓ	ⲁ|ϥ|ϫⲱⲓⲗⲓ
ⲙⲫⲙⲟⲛⲁⲥⲧⲏⲣⲓⲟⲛ	ⲙ|ⲫ|ⲙⲟⲛⲁⲥⲧⲏⲣⲓⲟⲛ
ⲙⲫⲁ	ⲙ|ⲫⲁ
ⲡⲓⲉⲣⲫⲙⲉⲩⲓ	ⲡⲓ|ⲉⲣⲫⲙⲉⲩⲓ
ⲉⲑⲛⲁⲛⲉϥ	ⲉⲑ|ⲛⲁⲛⲉ|ϥ
ⲍⲁⲭⲁⲣⲓⲁⲥ	ⲍⲁⲭⲁⲣⲓⲁⲥ
ⲡⲓⲡⲣⲉⲥⲃⲩⲧⲉⲣⲟⲥ	ⲡⲓ|ⲡⲣⲉⲥⲃⲩⲧⲉⲣⲟⲥ
ⲛϩⲏⲅⲟⲩⲙⲉⲛⲟⲥ	ⲛ|ϩⲏⲅⲟⲩⲙⲉⲛⲟⲥ
ⲛⲧⲉϯⲗⲁⲩⲣⲁ	ⲛⲧⲉ|ϯ|ⲗⲁⲩⲣⲁ
ⲛⲧⲉⲁⲃⲃⲁ	ⲛⲧⲉ|ⲁⲃⲃⲁ
ⲙⲁⲕⲁⲣⲓⲟⲥ	ⲙⲁⲕⲁⲣⲓⲟⲥ
ⲉⲧⲁϥⲉⲣⲉⲡⲓⲥⲕⲟⲡⲟⲥ	ⲉⲧ|ⲁ|ϥ|ⲉⲣⲉⲡⲓⲥⲕⲟⲡⲟⲥ
ⲉϯⲡⲟⲗⲓⲥ	ⲉ|ϯ|ⲡⲟⲗⲓⲥ
ⲥⲁⲓ	ⲥⲁⲓ
ⲉϥⲟⲩⲁⲃ	ⲉ|ϥ|ⲟⲩⲁⲃ
ⲉⲑⲛⲁⲩ	ⲉⲑ|ⲛⲁⲩ
ⲉϩⲁⲛϭⲱⲣⲡ	ⲉ|ϩⲁⲛ|ϭⲱⲣⲡ
ⲉⲧⲁϥⲛⲁⲩ	ⲉⲧ|ⲁ|ϥ|ⲛⲁⲩ
ⲛϫⲉⲡⲓϧⲉⲗⲗⲟ	ⲛϫⲉ|ⲡⲓ|ϧⲉⲗⲗⲟ
ⲉϥⲛⲏⲟⲩ	ⲉ|ϥ|ⲛⲏⲟⲩ
ϧⲁⲣⲟϥ	ϧⲁⲣⲟ|ϥ
ⲁⲡϭⲟⲉⲓⲥ	ⲁ|ⲡ|ϭⲟⲉⲓⲥ
ⲟⲩⲱⲛ	ⲟⲩⲱⲛ
ⲛⲛⲉϥⲃⲁⲗ	ⲛ|ⲛⲉϥ|ⲃⲁⲗ
ⲉⲫⲙⲏⲓⲛⲓ	ⲉ|ⲫ|ⲙⲏⲓⲛⲓ
ⲛⲟⲩⲥⲧⲁⲩⲣⲟⲥ	ⲛ|ⲟⲩ|ⲥⲧⲁⲩⲣⲟⲥ
ϩⲓϫⲉⲛⲧⲉϥⲁⲫⲉ	ϩⲓϫⲉⲛ|ⲧⲉϥ|ⲁⲫⲉ
ⲉⲡⲁⲓⲙⲏⲓⲛⲓ	ⲉ|ⲡⲁⲓ|ⲙⲏⲓⲛⲓ
ⲙⲡⲁⲣⲁⲇⲟⲝⲟⲛ	ⲙ|ⲡⲁⲣⲁⲇⲟⲝⲟⲛ
ⲁϥⲉⲣϣⲫⲏⲣⲓ	ⲁ|ϥ|ⲉⲣϣⲫⲏⲣⲓ
ϫⲉⲙⲫⲣⲏϯ	ϫⲉ|ⲙ|ⲫ|ⲣⲏϯ
ⲉⲧⲟⲩⲉⲣⲛⲓϣϯ	ⲉⲧ|ⲟⲩ|ⲉⲣⲛⲓϣϯ
ⲛϫⲉⲛⲉⲕϩⲃⲏⲟⲩⲓ	ⲛϫⲉ|ⲛⲉⲕ|ϩⲃⲏⲟⲩⲓ
ⲁⲩϣⲱⲕ	ⲁ|ⲩ|ϣⲱⲕ
ⲛϫⲉⲛⲉⲕⲙⲟⲕⲙⲉⲕ	ⲛϫⲉ|ⲛⲉⲕ|ⲙⲟⲕⲙⲉⲕ
ϫⲉⲟⲩ	ϫⲉ|ⲟⲩ
ϩⲁⲣⲁ	ϩⲁⲣⲁ
ⲡⲉⲧⲛⲁϣⲱⲡⲓ	ⲡ|ⲉⲧ|ⲛⲁ|ϣⲱⲡⲓ
ⲙⲡⲁⲓⲁⲗⲟⲩ	ⲙ|ⲡⲁⲓ|ⲁⲗⲟⲩ
ⲥⲁⲧⲟⲧϥ	ⲥⲁⲧⲟⲧ|ϥ
ⲁⲩϯ	ⲁ|ⲩ|ϯ
ⲛⲓⲁⲧϥ	ⲛ|ⲓⲁⲧ|ϥ
ϩⲓⲧⲉⲛⲟⲩⲁⲅⲅⲉⲗⲟⲥ	ϩⲓⲧⲉⲛ|ⲟⲩ|ⲁⲅⲅⲉⲗⲟⲥ
ⲛⲧⲉⲡϭⲟⲉⲓⲥ	ⲛⲧⲉ|ⲡ|ϭⲟⲉⲓⲥ
ϫⲉϩⲏⲡⲡⲉ	ϫⲉ|ϩⲏⲡⲡⲉ
ⲉⲣⲭⲁⲣⲓⲍⲉⲥⲑⲁⲓ	ⲉⲣⲭⲁⲣⲓⲍⲉⲥⲑⲁⲓ
ⲛⲇⲱⲣⲟⲛ	ⲛ|ⲇⲱⲣⲟⲛ
ⲉⲧⲉⲡⲁⲓⲁⲗⲟⲩ	ⲉⲧⲉ|ⲡⲁⲓ|ⲁⲗⲟⲩ
ϣⲁⲣⲟⲕ	ϣⲁⲣⲟ|ⲕ
ⲛⲟⲩⲙⲁ	ⲛ|ⲟⲩ|ⲙⲁ
ⲛⲧⲉⲡⲭⲣⲓⲥⲧⲟⲥ	ⲛⲧⲉ|ⲡ|ⲭⲣⲓⲥⲧⲟⲥ
ⲙⲡⲁⲧⲣⲓⲁⲣⲭⲏⲥ	ⲙ|ⲡⲁⲧⲣⲓⲁⲣⲭⲏⲥ
ⲛⲛⲓⲉⲡⲓⲥⲕⲟⲡⲟⲥ	ⲛ|ⲛⲓ|ⲉⲡⲓⲥⲕⲟⲡⲟⲥ
ⲉⲧⲁϥⲥⲟⲑⲙⲟⲩ	ⲉⲧ|ⲁ|ϥ|ⲥⲟⲑⲙ|ⲟⲩ
ⲙⲡⲓⲁⲅⲅⲉⲗⲟⲥ	ⲙ|ⲡⲓ|ⲁⲅⲅⲉⲗⲟⲥ
ⲛϫⲉⲛⲓϧⲉⲗⲗⲟ	ⲛϫⲉ|ⲛⲓ|ϧⲉⲗⲗⲟ
ⲁϥⲣⲁϣⲓ	ⲁ|ϥ|ⲣⲁϣⲓ
ϧⲁⲧⲟⲧϥ	ϧⲁⲧⲟⲧ|ϥ
ⲙⲡⲓϧⲉⲗⲗⲟ	ⲙ|ⲡⲓ|ϧⲉⲗⲗⲟ
ⲛⲁⲩⲅ	ⲛ|ⲁⲩ|ⲅ
ⲁϥⲥⲁϫⲓ	ⲁ|ϥ|ⲥⲁϫⲓ
ⲉⲑⲃⲉⲡⲉϥⲟⲩϫⲁⲓ	ⲉⲑⲃⲉ|ⲡⲉϥ|ⲟⲩϫⲁⲓ
ⲁϥⲟⲩⲟⲣⲡϥ	ⲁ|ϥ|ⲟⲩⲟⲣⲡ|ϥ
ⲉⲧⲉⲣⲉⲛⲟⲩϯ	ⲉ|ⲧⲉⲣⲉⲛⲟⲩϯ
ⲉⲫⲙⲁ	ⲉ|ⲫ|ⲙⲁ
ⲛⲟⲩⲁⲅⲁⲡⲏⲧⲟⲥ	ⲛ|ⲟⲩ|ⲁⲅⲁⲡⲏⲧⲟⲥ
ϫⲉⲛⲧⲉϥϣⲱⲡⲓ	ϫⲉ|ⲛⲧⲉ|ϥ|ϣⲱⲡⲓ
ϣⲁⲛⲧⲉϥⲉⲙⲓ	ϣⲁⲛⲧⲉ|ϥ|ⲉⲙⲓ
ⲉⲧⲉⲣⲉⲛⲉⲛⲓⲟϯ	ⲉⲧⲉⲣⲉ|ⲛⲉⲛ|ⲓⲟϯ
ⲛⲁⲁⲓϥ	ⲛⲁ|ⲁⲓ|ϥ
ⲉϥⲉⲣϩⲟϯ	ⲉ|ϥ|ⲉⲣϩⲟϯ
ⲛⲧⲟⲩϫⲉⲙϥ	ⲛⲧ|ⲟⲩ|ϫⲉⲙ|ϥ
ⲛⲧⲟⲩⲉⲣⲡⲉⲧϩⲱⲟⲩ	ⲛⲧ|ⲟⲩ|ⲉⲣ|ⲡ|ⲉⲧ|ϩⲱⲟⲩ
ⲉⲑⲃⲏⲧϥ	ⲉⲑⲃⲏⲧ|ϥ
ϫⲉⲛⲉⲡⲓϧⲉⲗⲗⲟ	ϫⲉ|ⲛⲉ|ⲡⲓ|ϧⲉⲗⲗⲟ
ⲟⲩⲣⲱⲙⲓ	ⲟⲩ|ⲣⲱⲙⲓ
ⲛⲥⲱⲓⲧ	ⲛ|ⲥⲱⲓⲧ
ⲉⲧⲁⲡⲁⲓⲁⲗⲟⲩ	ⲉⲧ|ⲁ|ⲡⲁⲓ|ⲁⲗⲟⲩ
ⲉⲡⲏⲓ	ⲉ|ⲡ|ⲏⲓ
ⲙⲡⲓⲣⲱⲙⲓ	ⲙ|ⲡⲓ|ⲣⲱⲙⲓ
ⲁⲩϫⲟⲥ	ⲁ|ⲩ|ϫⲟ|ⲥ
ⲛϫⲉⲛⲉⲛϣⲏⲣⲓ	ⲛϫⲉ|ⲛⲉⲛ|ϣⲏⲣⲓ
ϫⲉⲁⲡⲉⲛⲓⲱⲧ	ϫⲉ|ⲁ|ⲡⲉⲛ|ⲓⲱⲧ
ϩⲱⲗ	ϩⲱⲗ
ⲉⲧⲕⲟⲓ	ⲉ|ⲧ|ⲕⲟⲓ
ⲁⲡⲓⲁⲗⲟⲩ	ⲁ|ⲡⲓ|ⲁⲗⲟⲩ
ⲁϥϩⲱⲗ	ⲁ|ϥ|ϩⲱⲗ
ⲉⲡϣⲱⲓ	ⲉ|ⲡ|ϣⲱⲓ
ⲛⲧⲉⲡⲓⲣⲱⲙⲓ	ⲛⲧⲉ|ⲡⲓ|ⲣⲱⲙⲓ
ⲛⲟⲩϣⲟⲗ	ⲛ|ⲟⲩ|ϣⲟⲗ
ⲛⲥⲱⲟⲩⲃⲉⲛ	ⲛ|ⲥⲱⲟⲩⲃⲉⲛ
ⲁϥⲧⲁⲗⲟϥ	ⲁ|ϥ|ⲧⲁⲗⲟ|ϥ
ⲉϫⲱϥ	ⲉϫⲱ|ϥ
ⲁϥⲛⲕⲟⲧ	ⲁ|ϥ|ⲛⲕⲟⲧ
ⲉⲧⲁⲡⲓⲣⲱⲙⲓ	ⲉⲧ|ⲁ|ⲡⲓ|ⲣⲱⲙⲓ
ϧⲉⲛⲧⲕⲟⲓ	ϧⲉⲛ|ⲧ|ⲕⲟⲓ
ⲓⲱⲥⲏⲫ	ⲓⲱⲥⲏⲫ
ⲟⲩⲡⲣⲉⲥⲃⲩⲧⲉⲣⲟⲥ	ⲟⲩ|ⲡⲣⲉⲥⲃⲩⲧⲉⲣⲟⲥ
ⲉⲩⲉⲣⲙⲉⲑⲣⲉ	ⲉ|ⲩ|ⲉⲣⲙⲉⲑⲣⲉ
ⲛⲧⲉⲛⲟⲩⲙⲏϣ	ⲛⲧⲉⲛ|ⲟⲩ|ⲙⲏϣ
ϫⲉⲁϥϣⲱⲡⲓ	ϫⲉ|ⲁ|ϥ|ϣⲱⲡⲓ
ⲛϩⲟⲙⲟⲗⲟⲅⲏⲧⲏⲥ	ⲛ|ϩⲟⲙⲟⲗⲟⲅⲏⲧⲏⲥ
ⲉⲁⲩⲧⲁϩⲟϥ	ⲉ|ⲁ|ⲩ|ⲧⲁϩⲟ|ϥ
ⲉⲡⲓⲃⲏⲙⲁ	ⲉ|ⲡⲓ|ⲃⲏⲙⲁ
ⲛⲧⲉⲕⲩⲣⲟⲥ	ⲛⲧⲉ|ⲕⲩⲣⲟⲥ
ⲡⲓⲁⲥⲉⲃⲏⲥ	ⲡⲓ|ⲁⲥⲉⲃⲏⲥ
ⲟⲩⲙⲏϣ	ⲟⲩ|ⲙⲏϣ
ⲛϣⲁϣ	ⲛ|ϣⲁϣ
ⲉⲑⲃⲉⲧϩⲟⲙⲟⲗⲟⲅⲓⲁ	ⲉⲑⲃⲉ|ⲧ|ϩⲟⲙⲟⲗⲟⲅⲓⲁ
ⲙⲡⲓⲛⲁϩϯ	ⲙ|ⲡⲓ|ⲛⲁϩϯ
ⲉⲧⲁⲡⲓⲡⲣⲉⲥⲃⲩⲧⲉⲣⲟⲥ	ⲉⲧ|ⲁ|ⲡⲓ|ⲡⲣⲉⲥⲃⲩⲧⲉⲣⲟⲥ
ⲁϥⲭⲁϯⲓⲱ	ⲁ|ϥ|ⲭⲁ|ϯ|ⲓⲱ
ⲉⲡⲓⲟⲩⲟⲛϩϥ	ⲉ|ⲡⲓ|ⲟⲩⲟⲛϩϥ
ϫⲉⲛⲧⲉϥϯ	ϫⲉ|ⲛⲧⲉ|ϥ|ϯ
ⲟⲩϣⲟⲗ	ⲟⲩ|ϣⲟⲗ
ⲛⲥⲓⲙ	ⲛ|ⲥⲓⲙ
ⲛϯⲉⲱ	ⲛ|ϯ|ⲉⲱ
ⲉⲡⲓϣⲟⲗ	ⲉ|ⲡⲓ|ϣⲟⲗ
ⲉⲧⲧⲁⲗⲏⲟⲩⲧ	ⲉⲧ|ⲧⲁⲗⲏⲟⲩⲧ
ⲉⲣⲉⲡⲧⲩⲡⲟⲥ	ⲉⲣⲉ|ⲡ|ⲧⲩⲡⲟⲥ
ⲭⲏ	ⲭⲏ
ϩⲓϫⲱϥ	ϩⲓϫⲱ|ϥ
ⲉϥϩⲓ	ⲉ|ϥ|ϩⲓ
ⲉⲃⲣⲏϫ	ⲉⲃⲣⲏϫ
ⲉⲧⲁⲓⲟⲡⲧⲁⲥⲓⲁ	ⲉ|ⲧⲁⲓ|ⲟⲡⲧⲁⲥⲓⲁ
ⲛϣⲫⲏⲣⲓ	ⲛ|ϣⲫⲏⲣⲓ
ⲛϫⲉⲡⲓⲡⲣⲉⲥⲃⲩⲧⲉⲣⲟⲥ	ⲛϫⲉ|ⲡⲓ|ⲡⲣⲉⲥⲃⲩⲧⲉⲣⲟⲥ
ⲁϥⲧⲱⲙⲛⲧ	ⲁ|ϥ|ⲧⲱⲙⲛⲧ
ⲉϯ	ⲉ|ϯ
ⲡⲁϣⲏⲣⲓ	ⲡⲁ|ϣⲏⲣⲓ
ⲁϥⲧⲁⲙⲟϥ	ⲁ|ϥ|ⲧⲁⲙⲟ|ϥ
ⲉϯⲁⲓⲧⲓⲁ	ⲉ|ϯ|ⲁⲓⲧⲓⲁ
ⲛⲧⲉⲡⲓϩⲱⲃ	ⲛⲧⲉ|ⲡⲓ|ϩⲱⲃ
ϧⲉⲛϯⲟⲩⲛⲟⲩ	ϧⲉⲛ|ϯ|ⲟⲩⲛⲟⲩ
ⲁϥⲁⲙⲟⲛⲓ	ⲁ|ϥ|ⲁⲙⲟⲛⲓ
ⲛⲧⲁⲫⲉ	ⲛ|ⲧ|ⲁⲫⲉ
ⲁϥϯⲫⲓ	ⲁ|ϥ|ϯⲫⲓ
ⲉⲣⲱⲥ	ⲉ|ⲣⲱ|ⲥ
ϫⲉⲡⲥⲙⲟⲩ	ϫⲉ|ⲡ|ⲥⲙⲟⲩ
ⲙⲡⲓⲑⲙⲏⲓ	ⲙ|ⲡⲓ|ⲑⲙⲏⲓ
ⲉϫⲉⲛⲧⲟⲩⲁⲫⲉ	ⲉϫⲉⲛ|ⲧⲟⲩ|ⲁⲫⲉ
ⲟⲩⲥⲙⲟⲩ	ⲟⲩ|ⲥⲙⲟⲩ
ⲛⲉⲙⲟⲩⲑⲉⲗⲏⲗ	ⲛⲉⲙ|ⲟⲩ|ⲑⲉⲗⲏⲗ
ⲁⲡⲓϧⲉⲗⲗⲟ	ⲁ|ⲡⲓ|ϧⲉⲗⲗⲟ
ⲙⲡⲣⲉⲥⲃⲩⲧⲉⲣⲟⲥ	ⲙ|ⲡⲣⲉⲥⲃⲩⲧⲉⲣⲟⲥ
ⲭⲁϥ	ⲭⲁ|ϥ
ⲛϩⲁⲛⲉϩⲟⲟⲩ	ⲛ|ϩⲁⲛ|ⲉϩⲟⲟⲩ
ⲙⲁⲣⲉⲛⲧⲁⲥⲑⲟ	ⲙⲁⲣⲉ|ⲛ|ⲧⲁⲥⲑⲟ
ⲡⲓⲥⲁϫⲓ	ⲡⲓ|ⲥⲁϫⲓ
ⲉϫⲉⲛⲡⲓⲉϩⲟⲟⲩ	ⲉϫⲉⲛ|ⲡⲓ|ⲉϩⲟⲟⲩ
ϧⲉⲛⲡⲉϥⲏⲓ	ϧⲉⲛ|ⲡⲉϥ|ⲏⲓ
ⲧⲉⲛⲛⲁⲧⲁⲙⲱⲧⲉⲛ	ⲧⲉⲛ|ⲛⲁ|ⲧⲁⲙⲱ|ⲧⲉⲛ
ⲉⲡⲓϫⲱⲕ	ⲉ|ⲡⲓ|ϫⲱⲕ
ⲉⲧⲁⲩⲕⲱϯ	ⲉⲧ|ⲁ|ⲩ|ⲕⲱϯ
ⲉⲧⲉⲙⲡⲟⲩϫⲉⲙϥ	ⲉⲧⲉ|ⲙⲡ|ⲟⲩ|ϫⲉⲙ|ϥ
ⲛⲣⲓⲙⲓ	ⲛ|ⲣⲓⲙⲓ
ⲛⲉⲙⲟⲩϩⲏⲃⲓ	ⲛⲉⲙ|ⲟⲩ|ϩⲏⲃⲓ
ⲉⲛⲁϣⲱϥ	ⲉ|ⲛⲁϣⲱ|ϥ
ⲁⲡⲟⲩⲣⲁϣⲓ	ⲁ|ⲡⲟⲩ|ⲣⲁϣⲓ
ⲛϩⲏⲃⲓ	ⲛ|ϩⲏⲃⲓ
ⲉⲧⲁⲩⲙⲉϣⲧⲛⲓⲙⲟⲛⲁⲥⲧⲏⲣⲓⲟⲛ	ⲉⲧ|ⲁ|ⲩ|ⲙⲉϣⲧ|ⲛⲓ|ⲙⲟⲛⲁⲥⲧⲏⲣⲓⲟⲛ
ⲙⲡⲟⲩϫⲉⲙϥ	ⲙⲡ|ⲟⲩ|ϫⲉⲙ|ϥ
ⲁⲩⲓ	ⲁ|ⲩ|ⲓ
ⲉⲩⲕⲱϯ	ⲉ|ⲩ|ⲕⲱϯ
ⲙⲡⲟⲩⲟⲩⲟⲛϩϥ	ⲙⲡ|ⲟⲩ|ⲟⲩⲟⲛϩ|ϥ
ⲉⲡⲉⲓⲇⲏ	ⲉⲡⲉⲓⲇⲏ
ⲧⲟⲩⲥⲩⲛⲏⲑⲉⲓⲁ	ⲧⲟⲩ|ⲥⲩⲛⲏⲑⲉⲓⲁ
ⲑⲁⲓ	ⲑⲁⲓ
ⲉⲩϣⲉⲡϧⲓⲥⲓ	ⲉ|ⲩ|ϣⲉⲡϧⲓⲥⲓ
ⲉⲑⲣⲟⲩⲛⲁϩⲙⲟⲩ	ⲉ|ⲑⲣ|ⲟⲩ|ⲛⲁϩⲙ|ⲟⲩ
ϩⲗⲓ	ϩⲗⲓ
ⲛⲉⲡⲓⲑⲩⲙⲓⲁ	ⲛ|ⲉⲡⲓⲑⲩⲙⲓⲁ
ⲛⲧⲉⲡⲓⲕⲟⲥⲙⲟⲥ	ⲛⲧⲉ|ⲡⲓ|ⲕⲟⲥⲙⲟⲥ
ⲉⲩⲓⲣⲓ	ⲉ|ⲩ|ⲓⲣⲓ
ⲛⲧⲟⲩⲥⲡⲟⲩⲇⲏ	ⲛ|ⲧⲟⲩ|ⲥⲡⲟⲩⲇⲏ
ⲉⲑⲣⲟⲩϫⲱⲕ	ⲉ|ⲑⲣ|ⲟⲩ|ϫⲱⲕ
ⲙⲡⲥⲁϫⲓ	ⲙ|ⲡ|ⲥⲁϫⲓ
ⲙⲡⲓⲥⲱⲧⲏⲣ	ⲙ|ⲡⲓ|ⲥⲱⲧⲏⲣ
ϫⲉⲙⲙⲟⲛ	ϫⲉ|ⲙⲙⲟⲛ
ⲡⲉⲑⲛⲁⲁⲥ	ⲡ|ⲉⲑ|ⲛⲁⲁ|ⲥ
ⲉⲧⲁⲓⲁⲅⲁⲡⲏ	ⲉ|ⲧⲁⲓ|ⲁⲅⲁⲡⲏ
ⲛⲧⲉⲟⲩⲁⲓ	ⲛⲧⲉ|ⲟⲩⲁⲓ
ⲛⲧⲉϥⲯⲩⲭⲏ	ⲛ|ⲧⲉϥ|ⲯⲩⲭⲏ
ⲉϫⲉⲛⲡⲉϥϣⲫⲏⲣ	ⲉϫⲉⲛ|ⲡⲉϥ|ϣⲫⲏⲣ
ⲉⲧⲁⲩⲛⲁⲩ	ⲉⲧ|ⲁ|ⲩ|ⲛⲁⲩ
ϫⲉⲙⲡⲟⲩⲟⲩⲟⲛϩϥ	ϫⲉ|ⲙⲡ|ⲟⲩ|ⲟⲩⲟⲛϩ|ϥ
ⲁⲩϣⲉ	ⲁ|ⲩ|ϣⲉ
ⲉⲣⲁⲕⲟϯ	ⲉ|ⲣⲁⲕⲟϯ
ⲙⲡⲓⲁⲣⲭⲓⲉⲡⲓⲥⲕⲟⲡⲟⲥ	ⲙ|ⲡⲓ|ⲁⲣⲭⲓⲉⲡⲓⲥⲕⲟⲡⲟⲥ
ⲁⲩⲧⲁⲙⲟϥ	ⲁ|ⲩ|ⲧⲁⲙⲟ|ϥ
ⲉⲧⲁϥⲉⲣϩⲟϯ	ⲉⲧ|ⲁ|ϥ|ⲉⲣϩⲟϯ
ⲛϫⲉⲡⲓⲁⲣⲭⲓⲉⲡⲓⲥⲕⲟⲡⲟⲥ	ⲛϫⲉ|ⲡⲓ|ⲁⲣⲭⲓⲉⲡⲓⲥⲕⲟⲡⲟⲥ
ⲛⲧⲟⲩⲧⲁⲙⲉϯⲉⲝⲟⲩⲥⲓⲁ	ⲛⲧ|ⲟⲩ|ⲧⲁⲙⲉ|ϯ|ⲉⲝⲟⲩⲥⲓⲁ
ⲁϥⲟⲩⲱⲣⲡ	ⲁ|ϥ|ⲟⲩⲱⲣⲡ
ⲛⲟⲩⲉⲡⲓⲥⲧⲟⲗⲏ	ⲛ|ⲟⲩ|ⲉⲡⲓⲥⲧⲟⲗⲏ
ⲛⲛⲟⲩⲭⲁϥ	ⲛⲛ|ⲟⲩ|ⲭⲁ|ϥ
ⲥⲁⲡⲉⲙⲉⲛⲧ	ⲥⲁ|ⲡ|ⲉⲙⲉⲛⲧ
ⲙⲫⲓⲁⲣⲟ	ⲙ|ⲫ|ⲓⲁⲣⲟ
ⲉⲛⲓϫⲟⲣϫⲥ	ⲉ|ⲛⲓ|ϫⲟⲣϫⲥ
ⲛⲧⲉⲡⲓⲇⲓⲁⲃⲟⲗⲟⲥ	ⲛⲧⲉ|ⲡⲓ|ⲇⲓⲁⲃⲟⲗⲟⲥ
ⲁϥⲥⲟⲧⲡⲥ	ⲁ|ϥ|ⲥⲟⲧⲡ|ⲥ
ⲉϣⲉⲡϩⲁⲛⲑⲃⲁ	ⲉ|ϣⲉⲡ|ϩⲁⲛ|ⲑⲃⲁ
ⲛⲕⲓⲛⲇⲩⲛⲟⲥ	ⲛ|ⲕⲓⲛⲇⲩⲛⲟⲥ
ⲉϩⲟⲧⲉ	ⲉϩⲟⲧⲉ
ⲉⲧⲏⲓϥ	ⲉ|ⲧⲏⲓ|ϥ
ⲛⲛⲉϥⲕⲁⲧⲁⲥⲁⲣⲝ	ⲛ|ⲛⲉϥ|ⲕⲁⲧⲁ|ⲥⲁⲣⲝ
ⲛⲕⲉⲥⲟⲡ	ⲛ|ⲕⲉ|ⲥⲟⲡ
ⲉϥϫⲱⲕ	ⲉ|ϥ|ϫⲱⲕ
ⲉⲑⲛⲁϣⲉⲡⲟⲩⲁⲗⲟⲩ	ⲉⲑ|ⲛⲁ|ϣⲉⲡ|ⲟⲩ|ⲁⲗⲟⲩ
ϧⲉⲛⲡⲁⲣⲁⲛ	ϧⲉⲛ|ⲡⲁ|ⲣⲁⲛ
ⲉⲧⲉϥϣⲱⲡ	ⲉⲧⲉ|ϥ|ϣⲱⲡ
ⲉⲧⲁϥϣⲉⲡϫⲱϥ	ⲉⲧ|ⲁ|ϥ|ϣⲉⲡ|ϫⲱ|ϥ
ⲛϯϩⲉⲃⲥⲱ	ⲛ|ϯ|ϩⲉⲃⲥⲱ
ⲛⲧⲉⲛⲓⲙⲟⲛⲁⲭⲟⲥ	ⲛⲧⲉ|ⲛⲓ|ⲙⲟⲛⲁⲭⲟⲥ
ⲛⲛⲉϥⲙⲁⲑⲏⲧⲏⲥ	ⲛ|ⲛⲉϥ|ⲙⲁⲑⲏⲧⲏⲥ
ⲁⲃⲣⲁⲁⲙ	ⲁⲃⲣⲁⲁⲙ
ⲉⲟⲩⲁⲥⲕⲏⲧⲏⲥ	ⲉ|ⲟⲩ|ⲁⲥⲕⲏⲧⲏⲥ
ϫⲉⲧⲱⲛⲕ	ϫⲉ|ⲧⲱⲛ|ⲕ
ϭⲓ	ϭⲓ
ⲙⲁϣⲉ	ⲙⲁϣⲉ
ⲉⲡⲧⲱⲟⲩ	ⲉ|ⲡ|ⲧⲱⲟⲩ
ⲙⲡⲁⲙⲁϩⲟ	ⲙ|ⲡⲁⲙⲁϩⲟ
ⲛⲱⲧⲉⲛⲙⲙⲁⲩ	ⲛⲱ|ⲧⲉⲛ|ⲙⲙⲁⲩ
ϣⲁⲧⲉⲡϭⲟⲉⲓⲥ	ϣⲁⲧⲉ|ⲡ|ϭⲟⲉⲓⲥ
ⲑⲱⲧ	ⲑⲱⲧ
ⲙⲡϩⲏⲧ	ⲙ|ⲡ|ϩⲏⲧ
ϯⲛⲁⲟⲩⲱⲣⲡ	ϯ|ⲛⲁ|ⲟⲩⲱⲣⲡ
ⲛⲥⲁⲑⲏⲛⲟⲩ	ⲛⲥⲁ|ⲑⲏⲛⲟⲩ
ⲁⲩⲧⲱⲟⲩⲛⲟⲩ	ⲁ|ⲩ|ⲧⲱⲟⲩⲛ|ⲟⲩ
ⲉⲧⲁϥϫⲟⲥ	ⲉⲧ|ⲁ|ϥ|ϫⲟ|ⲥ
ⲛϫⲉⲡⲟⲩⲓⲱⲧ	ⲛϫⲉ|ⲡⲟⲩ|ⲓⲱⲧ
ⲉⲧⲁⲩϣⲱⲡⲓ	ⲉⲧ|ⲁ|ⲩ|ϣⲱⲡⲓ
ϧⲉⲛⲡⲓⲧⲱⲟⲩ	ϧⲉⲛ|ⲡⲓ|ⲧⲱⲟⲩ
ϣⲁⲋ	ϣⲁ|ⲋ
ⲛⲁⲃⲟⲧ	ⲛ|ⲁⲃⲟⲧ
ⲛⲉⲙⲡⲓϧⲉⲗⲗⲟ	ⲛⲉⲙ|ⲡⲓ|ϧⲉⲗⲗⲟ
ⲁⲙⲟⲩ	ⲁⲙⲟⲩ
ϣⲁⲛⲁⲓⲟϯ	ϣⲁ|ⲛⲁ|ⲓⲟϯ
ⲛⲧⲁⲟⲩⲟⲛϩⲧ	ⲛ|ⲧⲁ|ⲟⲩⲟⲛϩ|ⲧ
ⲁⲓϣⲧⲉⲙⲟⲩⲟⲛϩⲧ	ⲁ|ⲓ|ϣⲧⲉⲙ|ⲟⲩⲟⲛϩ|ⲧ
ⲥⲉⲛⲁⲁⲓⲧ	ⲥⲉ|ⲛⲁ|ⲁⲓ|ⲧ
ⲛⲣⲉⲙϩⲉ	ⲛ|ⲣⲉⲙϩⲉ
ⲉⲧⲁⲡⲓϧⲉⲗⲗⲟ	ⲉⲧ|ⲁ|ⲡⲓ|ϧⲉⲗⲗⲟ
ⲥⲱⲧⲉⲙ	ⲥⲱⲧⲉⲙ
ⲉⲛⲁⲓ	ⲉ|ⲛⲁⲓ
ⲛⲓⲥⲁⲁⲕ	ⲛ|ⲓⲥⲁⲁⲕ
ⲁϥⲉⲣⲙⲁϩ	ⲁ|ϥ|ⲉⲣ|ⲙⲁϩ
ⲛϩⲏⲧ	ⲛ|ϩⲏⲧ
ⲉϥⲙⲉⲩⲓ	ⲉ|ϥ|ⲙⲉⲩⲓ
ϫⲉⲁⲡⲓⲁⲗⲟⲩ	ϫⲉ|ⲁ|ⲡⲓ|ⲁⲗⲟⲩ
ⲟⲩⲱⲙ	ⲟⲩⲱⲙ
ⲛϩⲑⲏϥ	ⲛ|ϩⲑⲏ|ϥ
ⲉⲭⲁⲧⲟⲧϥ	ⲉ|ⲭⲁ|ⲧⲟⲧ|ϥ
ϯⲙⲉⲧⲙⲟⲛⲁⲭⲟⲥ	ϯ|ⲙⲉⲧⲙⲟⲛⲁⲭⲟⲥ
ⲉⲑⲃⲉⲛⲓϩⲟϫϩⲉϫ	ⲉⲑⲃⲉ|ⲛⲓ|ϩⲟϫϩⲉϫ
ⲉⲧⲁⲩⲓ	ⲉⲧ|ⲁ|ⲩ|ⲓ
ⲡⲓϧⲉⲗⲗⲟ	ⲡⲓ|ϧⲉⲗⲗⲟ
ⲥⲁϫⲓ	ⲥⲁϫⲓ
ϫⲉⲙⲡⲣⲉⲣⲕⲟⲩϫⲓ	ϫⲉ|ⲙⲡⲣ|ⲉⲣ|ⲕⲟⲩϫⲓ
ϧⲉⲛⲛⲓϩⲟϫϩⲉϫ	ϧⲉⲛ|ⲛⲓ|ϩⲟϫϩⲉϫ
ⲥⲥϧⲏⲟⲩⲧ	ⲥ|ⲥϧⲏⲟⲩⲧ
ϫⲉⲡⲓϩⲟϫϩⲉϫ	ϫⲉ|ⲡⲓ|ϩⲟϫϩⲉϫ
ⲁϥⲉⲣϩⲱⲃ	ⲁ|ϥ|ⲉⲣϩⲱⲃ
ⲉⲟⲩϩⲩⲡⲟⲙⲟⲛⲏ	ⲉ|ⲟⲩ|ϩⲩⲡⲟⲙⲟⲛⲏ
ϯϩⲩⲡⲟⲙⲟⲛⲏ	ϯ|ϩⲩⲡⲟⲙⲟⲛⲏ
ⲉⲟⲩⲇⲟⲕⲓⲙⲏ	ⲉ|ⲟⲩ|ⲇⲟⲕⲓⲙⲏ
ϯⲇⲟⲕⲓⲙⲏ	ϯ|ⲇⲟⲕⲓⲙⲏ
ⲉⲟⲩϩⲉⲗⲡⲓⲥ	ⲉ|ⲟⲩ|ϩⲉⲗⲡⲓⲥ
ϯϩⲉⲗⲡⲓⲥ	ϯ|ϩⲉⲗⲡⲓⲥ
ⲙⲡⲁⲥϭⲓϣⲓⲡⲓ	ⲙⲡⲁ|ⲥ|ϭⲓϣⲓⲡⲓ
ⲡⲁⲙⲉⲛⲣⲓⲧ	ⲡⲁ|ⲙⲉⲛⲣⲓⲧ
ⲛⲥⲟⲛ	ⲛ|ⲥⲟⲛ
ⲙⲁⲣⲉⲛⲉⲣϩⲩⲡⲟⲙⲉⲛⲉⲓⲛ	ⲙⲁⲣⲉ|ⲛ|ⲉⲣϩⲩⲡⲟⲙⲉⲛⲉⲓⲛ
ⲙⲡⲁⲓⲕⲟⲩϫⲓ	ⲙ|ⲡⲁⲓ|ⲕⲟⲩϫⲓ
ⲛⲥⲏⲟⲩ	ⲛ|ⲥⲏⲟⲩ
ⲉⲧⲉⲡϭⲟⲉⲓⲥ	ⲉⲧⲉ|ⲡ|ϭⲟⲉⲓⲥ
ⲙⲉⲓ	ⲙⲉⲓ
ϣⲁϥϯⲥⲃⲱ	ϣⲁ|ϥ|ϯⲥⲃⲱ
ϫⲉⲡⲁϣⲏⲣⲓ	ϫⲉ|ⲡⲁ|ϣⲏⲣⲓ
ⲉⲉⲣⲃⲱⲕ	ⲉ|ⲉⲣⲃⲱⲕ
ⲥⲉⲃⲧⲉⲧⲉⲕⲯⲩⲭⲏ	ⲥⲉⲃⲧⲉ|ⲧⲉⲕ|ⲯⲩⲭⲏ
ⲉϩⲁⲛⲡⲉⲓⲣⲁⲥⲙⲟⲥ	ⲉ|ϩⲁⲛ|ⲡⲉⲓⲣⲁⲥⲙⲟⲥ
ϫⲉⲁⲣⲓⲇⲟⲕⲓⲙⲁⲍⲉⲓⲛ	ϫⲉ|ⲁⲣⲓⲇⲟⲕⲓⲙⲁⲍⲉⲓⲛ
ⲁⲣⲓⲉⲓⲙⲉⲡⲁϩⲏⲧ	ⲁⲣⲓⲉⲓⲙⲉ|ⲡⲁ|ϩⲏⲧ
ⲁⲣⲉϣⲧⲉⲙⲫⲛⲟⲩϯ	ⲁⲣⲉ|ϣⲧⲉⲙ|ⲫ|ⲛⲟⲩϯ
ⲉⲣⲇⲟⲕⲓⲙⲁⲍⲉⲓⲛ	ⲉⲣⲇⲟⲕⲓⲙⲁⲍⲉⲓⲛ
ⲡⲱⲥ	ⲡⲱⲥ
ϥⲛⲁⲉⲙⲓ	ϥ|ⲛⲁ|ⲉⲙⲓ
ⲉⲡⲉⲛⲙⲉⲓ	ⲉ|ⲡⲉⲛ|ⲙⲉⲓ
ⲉⲧⲟⲛⲓ	ⲉⲧ|ⲟⲛⲓ
ⲁϥϫⲟⲧⲟⲩ	ⲁ|ϥ|ϫⲟⲧ|ⲟⲩ
ϫⲉⲕⲁⲗⲱⲥ	ϫⲉ|ⲕⲁⲗⲱⲥ
ⲁⲕϯⲥⲃⲱ	ⲁ|ⲕ|ϯⲥⲃⲱ
ⲡⲁⲓⲱⲧ	ⲡⲁ|ⲓⲱⲧ
ⲙⲟⲛⲟⲛ	ⲙⲟⲛⲟⲛ
ⲉϭⲟϫⲓ	ⲉ|ϭⲟϫⲓ
ⲛⲥⲱⲕ	ⲛⲥⲱ|ⲕ
ϯⲥⲉⲃⲧⲱⲧ	ϯ|ⲥⲉⲃⲧⲱⲧ
ⲉⲙⲟⲩ	ⲉ|ⲙⲟⲩ
ⲉϫⲉⲛⲫⲣⲁⲛ	ⲉϫⲉⲛ|ⲫ|ⲣⲁⲛ
ⲙⲡⲉⲛϭⲟⲉⲓⲥ	ⲙ|ⲡⲉⲛ|ϭⲟⲉⲓⲥ
ⲉⲧⲁⲓⲭⲁϩⲱⲃ	ⲉⲧ|ⲁ|ⲓ|ⲭⲁ|ϩⲱⲃ
ⲛⲥⲱⲓ	ⲛⲥⲱ|ⲓ
ⲁⲓⲟⲩⲁϩⲅ	ⲁ|ⲓ|ⲟⲩⲁϩ|ⲅ
ϯⲛⲁⲉⲣⲡⲉⲙⲡϣⲁ	ϯ|ⲛⲁ|ⲉⲣ|ⲡⲉ|ⲙⲡϣⲁ
ⲙⲡⲓⲱⲛϧ	ⲙ|ⲡⲓ|ⲱⲛϧ
ϩⲓⲧⲉⲛⲧⲉϥⲙⲉⲧⲁⲅⲁⲑⲟⲥ	ϩⲓⲧⲉⲛ|ⲧⲉϥ|ⲙⲉⲧⲁⲅⲁⲑⲟⲥ
ⲉⲧⲁϥⲥⲱⲧⲉⲙ	ⲉⲧ|ⲁ|ϥ|ⲥⲱⲧⲉⲙ
ⲙⲡⲃ	ⲙ|ⲡ|ⲃ
ϩⲓⲟⲩⲥⲟⲡ	ϩⲓ|ⲟⲩ|ⲥⲟⲡ
ⲁⲩⲙⲟϣⲓ	ⲁ|ⲩ|ⲙⲟϣⲓ
ⲉⲩⲉⲣⲙⲉⲗⲉⲧⲁⲛ	ⲉ|ⲩ|ⲉⲣⲙⲉⲗⲉⲧⲁⲛ
ϧⲉⲛⲡⲥⲁϫⲓ	ϧⲉⲛ|ⲡ|ⲥⲁϫⲓ
ϣⲁⲧⲟⲩⲫⲟϩ	ϣⲁⲧ|ⲟⲩ|ⲫⲟϩ
ⲉⲡⲓⲧⲓⲙⲓ	ⲉ|ⲡⲓ|ⲧⲓⲙⲓ
ⲟⲩⲟⲛ	ⲟⲩⲟⲛ
ⲟⲩⲧⲟⲡⲟⲥ	ⲟⲩ|ⲧⲟⲡⲟⲥ
ⲛⲧⲉⲛⲉϥⲓⲟϯ	ⲛⲧⲉ|ⲛⲉϥ|ⲓⲟϯ
ⲙⲡⲓⲧⲓⲙⲓ	ⲙ|ⲡⲓ|ⲧⲓⲙⲓ
ⲛϫⲉⲟⲩϧⲉⲗⲗⲟ	ⲛϫⲉ|ⲟⲩ|ϧⲉⲗⲗⲟ
ⲙⲙⲟⲛⲁⲭⲟⲥ	ⲙ|ⲙⲟⲛⲁⲭⲟⲥ
ⲁⲩϫⲱⲓⲗⲓ	ⲁ|ⲩ|ϫⲱⲓⲗⲓ
ⲉⲡⲓⲧⲟⲡⲟⲥ	ⲉ|ⲡⲓ|ⲧⲟⲡⲟⲥ
ⲛⲉⲁⲫⲣⲏ	ⲛⲉ|ⲁ|ⲫ|ⲣⲏ
ϩⲱⲧⲡ	ϩⲱⲧⲡ
ⲁϥϣⲟⲡⲟⲩ	ⲁ|ϥ|ϣⲟⲡ|ⲟⲩ
ϧⲉⲛⲟⲩⲣⲁϣⲓ	ϧⲉⲛ|ⲟⲩ|ⲣⲁϣⲓ
ⲙⲉⲛⲧⲟⲓ	ⲙⲉⲛⲧⲟⲓ
ⲙⲡⲉϥⲥⲟⲩⲱⲛⲟⲩ	ⲙⲡⲉ|ϥ|ⲥⲟⲩⲱⲛ|ⲟⲩ
ϫⲉⲁⲕⲉⲙⲓ	ϫⲉ|ⲁ|ⲕ|ⲉⲙⲓ
ϫⲉⲁⲩϫⲓⲙⲓ	ϫⲉ|ⲁ|ⲩ|ϫⲓⲙⲓ
ⲡⲓⲛⲟⲧⲁⲣⲓⲟⲥ	ⲡⲓ|ⲛⲟⲧⲁⲣⲓⲟⲥ
ϫⲉⲙⲫⲏ	ϫⲉ|ⲙⲫⲏ
ⲕⲁⲓ	ⲕⲁⲓ
ⲓⲥϫⲉⲛ	ⲓⲥϫⲉⲛ
ⲉⲧⲁϥϩⲱⲗ	ⲉⲧ|ⲁ|ϥ|ϩⲱⲗ
ϩⲓⲧⲟⲟⲧⲟⲩ	ϩⲓⲧⲟⲟⲧ|ⲟⲩ
ⲥⲉⲉⲣϩⲏⲃⲓ	ⲥⲉ|ⲉⲣϩⲏⲃⲓ
ϫⲉⲁⲛⲟⲕ	ϫⲉ|ⲁⲛⲟⲕ
ϧⲉⲛⲟⲩⲧⲱⲙⲛⲧ	ϧⲉⲛ|ⲟⲩ|ⲧⲱⲙⲛⲧ
ⲙⲉⲛⲉⲛⲥⲱⲥ	ⲙⲉⲛⲉⲛⲥⲱ|ⲥ
ⲁϥⲟⲩⲱϣⲧ	ⲁ|ϥ|ⲟⲩⲱϣⲧ
ⲁϥⲧⲁⲣⲕⲟϥ	ⲁ|ϥ|ⲧⲁⲣⲕⲟ|ϥ
ϫⲉⲙⲡⲣⲧⲁⲙⲉϩⲗⲓ	ϫⲉ|ⲙⲡⲣ|ⲧⲁⲙⲉ|ϩⲗⲓ
ⲟⲩⲥⲩⲅⲅⲉⲛⲏⲥ	ⲟⲩ|ⲥⲩⲅⲅⲉⲛⲏⲥ
ⲟⲩⲇⲓⲁⲕⲱⲛ	ⲟⲩ|ⲇⲓⲁⲕⲱⲛ
ⲫⲓⲗⲟⲑⲉⲟⲥ	ⲫⲓⲗⲟⲑⲉⲟⲥ
ⲛⲁϥⲭⲏ	ⲛⲁ|ϥ|ⲭⲏ
ϧⲁϫⲱⲟⲩ	ϧⲁϫⲱ|ⲟⲩ
ⲛⲛⲉϥⲥⲩⲅⲅⲉⲛⲏⲥ	ⲛ|ⲛⲉϥ|ⲥⲩⲅⲅⲉⲛⲏⲥ
ⲓⲱⲧ	ⲓⲱⲧ
ⲉⲧⲁϥⲟⲩⲱⲣⲡ	ⲉⲧ|ⲁ|ϥ|ⲟⲩⲱⲣⲡ
ϣⲁⲣⲟϥ	ϣⲁⲣⲟ|ϥ
ϫⲉⲓⲥϫⲉ	ϫⲉ|ⲓⲥϫⲉ
ⲁⲓϫⲓⲙⲓ	ⲁ|ⲓ|ϫⲓⲙⲓ
ⲛⲟⲩϩⲙⲟⲧ	ⲛ|ⲟⲩ|ϩⲙⲟⲧ
ⲙⲡⲉⲕⲙⲑⲟ	ⲙ|ⲡⲉⲕ|ⲙⲑⲟ
ⲉϫⲱⲓ	ⲉϫⲱ|ⲓ
ⲛⲁϩⲣⲉⲛⲛⲁⲓⲟϯ	ⲛⲁϩⲣⲉⲛ|ⲛⲁ|ⲓⲟϯ
ⲛⲧⲟⲩϣⲧⲉⲙⲧⲁϩⲛⲟ	ⲛⲧ|ⲟⲩ|ϣⲧⲉⲙ|ⲧⲁϩⲛⲟ
ⲉⲧⲁⲡⲓⲇⲓⲁⲕⲱⲛ	ⲉⲧ|ⲁ|ⲡⲓ|ⲇⲓⲁⲕⲱⲛ
ϩⲓⲧⲟⲧϥ	ϩⲓⲧⲟⲧ|ϥ
ⲛⲉⲙⲛⲉϥⲓⲟϯ	ⲛⲉⲙ|ⲛⲉϥ|ⲓⲟϯ
ⲁⲩⲱⲣⲕ	ⲁ|ⲩ|ⲱⲣⲕ
ⲙⲡⲓϩⲱⲃ	ⲙ|ⲡⲓ|ϩⲱⲃ
ⲉⲧⲁⲩⲥⲱⲧⲉⲙ	ⲉⲧ|ⲁ|ⲩ|ⲥⲱⲧⲉⲙ
ⲁⲩϣⲱⲡⲓ	ⲁ|ⲩ|ϣⲱⲡⲓ
ϧⲉⲛⲟⲩϧⲣⲱⲟⲩ	ϧⲉⲛ|ⲟⲩ|ϧⲣⲱⲟⲩ
ⲛⲣⲁϣⲓ	ⲛ|ⲣⲁϣⲓ
ⲛϫⲉⲟⲩϭⲟϫⲓ	ⲛϫⲉ|ⲟⲩ|ϭⲟϫⲓ
ⲛⲧⲉⲡⲓⲧⲓⲙⲓ	ⲛⲧⲉ|ⲡⲓ|ⲧⲓⲙⲓ
ⲉⲟⲩⲥⲟⲡ	ⲉ|ⲟⲩ|ⲥⲟⲡ
ⲉϫⲉⲛⲡⲓⲁⲗⲟⲩ	ⲉϫⲉⲛ|ⲡⲓ|ⲁⲗⲟⲩ
ⲙⲡⲟⲩⲉⲙⲓ	ⲙⲡ|ⲟⲩ|ⲉⲙⲓ
ⲉⲧⲟⲩⲛⲁⲁⲓϥ	ⲉⲧ|ⲟⲩ|ⲛⲁ|ⲁⲓ|ϥ
ⲛⲁⲩⲉⲙⲓ	ⲛⲁ|ⲩ|ⲉⲙⲓ
ⲉⲧⲟⲩⲛⲁϫⲟϥ	ⲉⲧ|ⲟⲩ|ⲛⲁ|ϫⲟ|ϥ
ⲙⲁⲗⲓⲥⲧⲁ	ⲙⲁⲗⲓⲥⲧⲁ
ⲛⲁⲩϣⲉⲣϩⲗⲓ	ⲛⲁ|ⲩ|ϣⲉⲣ|ϩⲗⲓ
ⲛϩⲱⲃ	ⲛ|ϩⲱⲃ
ⲉⲑⲃⲉⲡⲓⲁⲛⲁϣ	ⲉⲑⲃⲉ|ⲡⲓ|ⲁⲛⲁϣ
ⲉⲧⲁⲩⲱⲣⲕ	ⲉⲧ|ⲁ|ⲩ|ⲱⲣⲕ
ⲙⲡⲓⲇⲓⲁⲕⲱⲛ	ⲙ|ⲡⲓ|ⲇⲓⲁⲕⲱⲛ
ⲁⲩⲁⲙⲟⲛⲓ	ⲁ|ⲩ|ⲁⲙⲟⲛⲓ
ϧⲁⲧⲟⲧⲟⲩ	ϧⲁⲧⲟⲧ|ⲟⲩ
ⲛⲟⲩⲁⲃⲟⲧ	ⲛ|ⲟⲩ|ⲁⲃⲟⲧ
ϣⲁⲧⲟⲩⲥⲓ	ϣⲁⲧ|ⲟⲩ|ⲥⲓ
ⲙⲡⲉϥⲥⲁⲓ	ⲙ|ⲡⲉϥ|ⲥⲁⲓ
ϫⲉⲛⲉⲟⲩⲥⲁⲓⲉ	ϫⲉ|ⲛⲉ|ⲟⲩ|ⲥⲁⲓⲉ
ϧⲉⲛⲡⲉϥⲓⲛⲓ	ϧⲉⲛ|ⲡⲉϥ|ⲓⲛⲓ
ⲥⲭⲉⲇⲟⲛ	ⲥⲭⲉⲇⲟⲛ
ⲉϫⲟⲥ	ⲉ|ϫⲟ|ⲥ
ϫⲉⲟⲩⲁⲅⲅⲉⲗⲟⲥ	ϫⲉ|ⲟⲩ|ⲁⲅⲅⲉⲗⲟⲥ
ⲛⲁϥⲥⲁϫⲓ	ⲛⲁ|ϥ|ⲥⲁϫⲓ
ⲛⲉⲙⲱⲟⲩ	ⲛⲉⲙⲱ|ⲟⲩ
ⲉⲧⲉⲣⲛⲟϥⲣⲓ	ⲉⲧ|ⲉⲣⲛⲟϥⲣⲓ
ⲛⲛⲟⲩⲯⲩⲭⲏ	ⲛ|ⲛⲟⲩ|ⲯⲩⲭⲏ
ⲛⲓⲥⲁϫⲓ	ⲛⲓ|ⲥⲁϫⲓ
ϫⲉⲱ	ϫⲉ|ⲱ
ⲛⲁⲓⲟϯ	ⲛⲁ|ⲓⲟϯ
ⲙⲡⲣⲭⲁϩⲑⲏⲧⲉⲛ	ⲙⲡⲣ|ⲭⲁ|ϩⲑⲏ|ⲧⲉⲛ
ⲉⲧⲁⲓⲙⲉⲧⲣⲁⲙⲁⲟ	ⲉ|ⲧⲁⲓ|ⲙⲉⲧⲣⲁⲙⲁⲟ
ⲉⲧⲉⲛⲥⲙⲟⲛⲧ	ⲉⲧⲉ|ⲛ|ⲥⲙⲟⲛⲧ
ⲟⲩⲇⲉ	ⲟⲩⲇⲉ
ⲙⲡⲣϣⲟⲩϣⲟⲩ	ⲙⲡⲣ|ϣⲟⲩϣⲟⲩ
ϩⲓⲧⲉⲛⲡⲁϣⲁⲓ	ϩⲓⲧⲉⲛ|ⲡ|ⲁϣⲁⲓ
ⲛⲛⲉⲧⲉⲛϩⲩⲡⲁⲣⲭⲟⲛⲧⲁ	ⲛ|ⲛⲉⲧⲉⲛ|ϩⲩⲡⲁⲣⲭⲟⲛⲧⲁ
ϫⲉⲛⲁⲓ	ϫⲉ|ⲛⲁⲓ
ⲥⲉⲛⲁⲥⲓⲛⲓ	ⲥⲉ|ⲛⲁ|ⲥⲓⲛⲓ
ⲛⲭⲱⲗⲉⲙ	ⲛ|ⲭⲱⲗⲉⲙ
ⲙⲡⲉⲛⲑⲣⲉⲛⲓⲡⲣⲟⲥⲟⲩⲥⲏⲟⲩ	ⲙⲡⲉⲛⲑⲣⲉ|ⲛⲓ|ⲡⲣⲟⲥⲟⲩⲥⲏⲟⲩ
ⲧⲁⲕⲟ	ⲧⲁⲕⲟ
ⲛⲛⲓϣⲁⲉⲛⲉϩ	ⲛ|ⲛⲓ|ϣⲁⲉⲛⲉϩ
ⲛⲧⲟⲧⲑⲏⲛⲟⲩ	ⲛⲧⲟⲧ|ⲑⲏⲛⲟⲩ
ⲙⲁⲣⲉⲛⲓⲛⲉϫⲓ	ⲙⲁⲣⲉ|ⲛⲓ|ⲛⲉϫⲓ
ⲛⲧⲉⲛⲓϩⲏⲕⲓ	ⲛⲧⲉ|ⲛⲓ|ϩⲏⲕⲓ
ⲥⲏ	ⲥⲏ
ⲉⲧⲉⲛⲟⲩⲧⲉⲛ	ⲉⲧⲉ|ⲛⲟⲩⲧⲉⲛ
ⲡⲁⲓ	ⲡⲁⲓ
ⲣⲏϯ	ⲣⲏϯ
ϩⲓⲧⲉⲛⲛⲉϥⲓⲟϯ	ϩⲓⲧⲉⲛ|ⲛⲉϥ|ⲓⲟϯ
ⲉⲡϣⲁϥⲉ	ⲉ|ⲡ|ϣⲁϥⲉ
ϫⲉⲟⲩⲙⲏϣ	ϫⲉ|ⲟⲩ|ⲙⲏϣ
ⲉϥⲉⲛⲕⲟⲧ	ⲉ|ϥ|ⲉⲛⲕⲟⲧ
ϣⲁϥⲛⲁⲩ	ϣⲁ|ϥ|ⲛⲁⲩ
ⲉⲟⲩⲭⲉⲣⲟⲩⲃⲓⲙ	ⲉ|ⲟⲩ|ⲭⲉⲣⲟⲩⲃⲓⲙ
ⲉϥϩⲱⲃⲥ	ⲉ|ϥ|ϩⲱⲃⲥ
ⲛⲛⲉϥⲧⲉⲛϩ	ⲛ|ⲛⲉϥ|ⲧⲉⲛϩ
ϣⲁⲧⲉϥⲧⲱⲛϥ	ϣⲁⲧⲉ|ϥ|ⲧⲱⲛ|ϥ
ⲡⲓⲛⲕⲟⲧ	ⲡⲓ|ⲛⲕⲟⲧ
ⲡⲁⲓⲣⲏϯ	ⲡⲁⲓ|ⲣⲏϯ
ⲉϥϩⲱⲗ	ⲉ|ϥ|ϩⲱⲗ
ⲉⲛⲓⲫⲏⲟⲩⲓ	ⲉ|ⲛⲓ|ⲫⲏⲟⲩⲓ
ⲛⲓϩⲙⲟⲧ	ⲛⲓ|ϩⲙⲟⲧ
ⲛⲁⲧⲥⲁϫⲓ	ⲛ|ⲁⲧⲥⲁϫⲓ
ⲉⲣⲉⲫⲛⲟⲩϯ	ⲉⲣⲉ|ⲫ|ⲛⲟⲩϯ
ⲛⲛⲓϣⲏⲣⲓ	ⲛ|ⲛⲓ|ϣⲏⲣⲓ
ⲛⲧⲉⲛⲓⲣⲱⲙⲓ	ⲛⲧⲉ|ⲛⲓ|ⲣⲱⲙⲓ
ⲁⲙⲱⲓⲛⲓ	ⲁⲙⲱⲓⲛⲓ
ⲉⲡⲧⲁⲓⲟ	ⲉ|ⲡ|ⲧⲁⲓⲟ
ⲙⲡⲁⲓⲣⲱⲙⲓ	ⲙ|ⲡⲁⲓ|ⲣⲱⲙⲓ
ⲉⲣⲉⲛⲓⲭⲉⲣⲟⲩⲃⲓⲙ	ⲉⲣⲉ|ⲛⲓ|ⲭⲉⲣⲟⲩⲃⲓⲙ
ⲉⲣϧⲏⲓⲃⲓ	ⲉⲣϧⲏⲓⲃⲓ
ϫⲉⲓⲥϫⲉⲛⲛⲓⲉϩⲟⲟⲩ	ϫⲉ|ⲓⲥϫⲉⲛ|ⲛⲓ|ⲉϩⲟⲟⲩ
ⲉⲧⲁⲩϫⲫⲟϥ	ⲉⲧ|ⲁ|ⲩ|ϫⲫⲟ|ϥ
ϣⲁⲧⲉϥϣⲉ	ϣⲁⲧⲉ|ϥ|ϣⲉ
ϩⲁⲫⲛⲟⲩϯ	ϩⲁ|ⲫ|ⲛⲟⲩϯ
ⲙⲡⲉϩⲗⲓ	ⲙⲡⲉ|ϩⲗⲓ
ⲛⲥⲩⲛⲟⲩⲥⲓⲁ	ⲛ|ⲥⲩⲛⲟⲩⲥⲓⲁ
ⲛϩⲱⲟⲩⲧ	ⲛ|ϩⲱⲟⲩⲧ
ϫⲉϣⲁⲣⲉⲡⲁⲅⲅⲉⲗⲟⲥ	ϫⲉ|ϣⲁⲣⲉ|ⲡ|ⲁⲅⲅⲉⲗⲟⲥ
ϩⲓⲕⲟⲧ	ϩⲓⲕⲟⲧ
ⲙⲡⲕⲱϯ	ⲙ|ⲡ|ⲕⲱϯ
ⲛⲟⲩⲟⲛ	ⲛ|ⲟⲩⲟⲛ
ⲉⲧⲉⲣϩⲟϯ	ⲉⲧ|ⲉⲣϩⲟϯ
ϧⲁⲧⲉϥϩⲏ	ϧⲁ|ⲧⲉϥ|ϩⲏ
ϥⲛⲁⲛⲁϩⲙⲟⲩ	ϥ|ⲛⲁ|ⲛⲁϩⲙ|ⲟⲩ
ⲙⲉⲛⲉⲛⲥⲁⲡⲓⲁⲃⲟⲧ	ⲙⲉⲛⲉⲛⲥⲁ|ⲡⲓ|ⲁⲃⲟⲧ
ⲛⲁⲩⲉⲣϩⲙⲟⲧ	ⲛⲁ|ⲩ|ⲉⲣϩⲙⲟⲧ
ⲛⲁϥⲉⲣⲯⲁⲗⲗⲉⲓⲛ	ⲛⲁ|ϥ|ⲉⲣⲯⲁⲗⲗⲉⲓⲛ
ⲛⲉⲙⲡⲓⲡⲣⲟⲫⲏⲧⲏⲥ	ⲛⲉⲙ|ⲡⲓ|ⲡⲣⲟⲫⲏⲧⲏⲥ
ϫⲉϧⲉⲛⲡⲁⲛⲟⲩϯ	ϫⲉ|ϧⲉⲛ|ⲡⲁ|ⲛⲟⲩϯ
ϯⲛⲁⲟⲩⲱⲧⲉⲃ	ϯ|ⲛⲁ|ⲟⲩⲱⲧⲉⲃ
ⲡⲟⲩⲥⲟⲃⲧ	ⲡⲟⲩ|ⲥⲟⲃⲧ
ϫⲉⲡⲓⲫⲁϣ	ϫⲉ|ⲡⲓ|ⲫⲁϣ
ⲁϥϧⲟⲙϧⲉⲙ	ⲁ|ϥ|ϧⲟⲙϧⲉⲙ
ϫⲉⲧⲉⲕⲟⲩⲓⲛⲁⲙ	ϫⲉ|ⲧⲉⲕ|ⲟⲩⲓⲛⲁⲙ
ⲛϭⲟⲉⲓⲥ	ⲛ|ϭⲟⲉⲓⲥ
ⲁⲥⲓⲣⲓⲛⲟⲩϫⲟⲙ	ⲁ|ⲥ|ⲓⲣⲓ|ⲛ|ⲟⲩ|ϫⲟⲙ
ⲡⲓⲧⲱⲟⲩ	ⲡⲓ|ⲧⲱⲟⲩ
ⲛⲁϥϫⲱ	ⲛⲁ|ϥ|ϫⲱ
ⲙⲡⲓⲑⲉⲟⲗⲟⲅⲟⲥ	ⲙ|ⲡⲓ|ⲑⲉⲟⲗⲟⲅⲟⲥ
ϫⲉⲙⲟⲓ	ϫⲉ|ⲙⲟⲓ
ⲙⲡϣⲁϥⲉ	ⲙ|ⲡ|ϣⲁϥⲉ
ⲛⲉⲙⲡⲭⲣⲓⲥⲧⲟⲥ	ⲛⲉⲙ|ⲡ|ⲭⲣⲓⲥⲧⲟⲥ
ⲛϫⲉⲡⲉϥⲓⲱⲧ	ⲛϫⲉ|ⲡⲉϥ|ⲓⲱⲧ
ⲉϥϯ	ⲉ|ϥ|ϯ
ϧⲉⲛⲛⲉϥϩⲃⲏⲟⲩⲓ	ϧⲉⲛ|ⲛⲉϥ|ϩⲃⲏⲟⲩⲓ
ⲛⲓⲏⲥⲟⲩ	ⲛ|ⲓⲏⲥⲟⲩ
ⲉϥϣⲉⲙϣⲓ	ⲉ|ϥ|ϣⲉⲙϣⲓ
ⲙⲙⲱⲩⲥⲏⲥ	ⲙ|ⲙⲱⲩⲥⲏⲥ
ⲉϥⲛⲁⲩ	ⲉ|ϥ|ⲛⲁⲩ
ⲉⲧⲡⲟⲗⲓⲧⲉⲓⲁ	ⲉ|ⲧ|ⲡⲟⲗⲓⲧⲉⲓⲁ
ⲛⲛⲓⲥⲛⲏⲟⲩ	ⲛ|ⲛⲓ|ⲥⲛⲏⲟⲩ
ϧⲉⲛⲡⲓⲙⲟⲛⲁⲥⲧⲏⲣⲓⲟⲛ	ϧⲉⲛ|ⲡⲓ|ⲙⲟⲛⲁⲥⲧⲏⲣⲓⲟⲛ
ⲉⲩⲙⲟϣⲓ	ⲉ|ⲩ|ⲙⲟϣⲓ
ϧⲉⲛⲟⲩⲕⲱⲧ	ϧⲉⲛ|ⲟⲩ|ⲕⲱⲧ
ⲛⲉⲙⲟⲩⲁⲣⲉϩ	ⲛⲉⲙ|ⲟⲩ|ⲁⲣⲉϩ
ⲉⲩⲟⲩⲟⲧⲉⲃ	ⲉ|ⲩ|ⲟⲩⲟⲧⲉⲃ
ⲉⲛⲟⲩⲉⲣⲏⲩ	ⲉ|ⲛⲟⲩ|ⲉⲣⲏⲩ
ϧⲉⲛⲧⲁⲣⲉⲧⲏ	ϧⲉⲛ|ⲧ|ⲁⲣⲉⲧⲏ
ⲛϩⲁⲛϣϣⲏⲛ	ⲛ|ϩⲁⲛ|ϣϣⲏⲛ
ⲉⲩⲟⲡⲧ	ⲉ|ⲩ|ⲟⲡⲧ
ⲛⲕⲁⲣⲡⲟⲥ	ⲛ|ⲕⲁⲣⲡⲟⲥ
ⲛⲉϥⲁⲣⲉⲧⲏ	ⲛⲉϥ|ⲁⲣⲉⲧⲏ
ⲉⲧⲁϥⲟⲩⲟⲛϩ	ⲉⲧ|ⲁ|ϥ|ⲟⲩⲟⲛϩ
ⲛⲧⲉϥⲉⲣⲥⲁⲡϣⲱⲓ	ⲛⲧⲉ|ϥ|ⲉⲣ|ⲥⲁ|ⲡ|ϣⲱⲓ
ⲉⲧϧⲉⲛⲡⲓⲙⲟⲛⲁⲥⲧⲏⲣⲓⲟⲛ	ⲉⲧ|ϧⲉⲛ|ⲡⲓ|ⲙⲟⲛⲁⲥⲧⲏⲣⲓⲟⲛ
ϯⲥⲁⲣⲝ	ϯ|ⲥⲁⲣⲝ
ⲁϥⲑⲉⲃⲓⲟⲥ	ⲁ|ϥ|ⲑⲉⲃⲓⲟ|ⲥ
ϧⲓⲧⲉⲛⲡϧⲓⲥⲓ	ϧⲓⲧⲉⲛ|ⲡ|ϧⲓⲥⲓ
ⲛⲛⲓⲁⲥⲕⲏⲥⲓⲥ	ⲛ|ⲛⲓ|ⲁⲥⲕⲏⲥⲓⲥ
ⲛⲉⲟⲩⲣⲉⲙⲣⲁⲩϣ	ⲛⲉ|ⲟⲩ|ⲣⲉⲙⲣⲁⲩϣ
ⲛⲑⲉⲃⲓⲉ	ⲛ|ⲑⲉⲃⲓⲉ
ⲉϥⲉⲣⲕⲟⲥⲙⲉⲓⲛ	ⲉ|ϥ|ⲉⲣⲕⲟⲥⲙⲉⲓⲛ
ϧⲉⲛⲛⲓϩⲙⲟⲧ	ϧⲉⲛ|ⲛⲓ|ϩⲙⲟⲧ
ⲛⲧⲉⲡⲓⲡⲛⲉⲩⲙⲁ	ⲛⲧⲉ|ⲡⲓ|ⲡⲛⲉⲩⲙⲁ
ⲛⲉⲙⲡⲁϥϩⲱⲣⲡ	ⲛⲉ|ⲙⲡⲁ|ϥ|ϩⲱⲣⲡ
ⲛⲛⲁⲩ	ⲛ|ⲛⲁⲩ
ϧⲉⲛⲡⲓⲉϫⲱⲣϩ	ϧⲉⲛ|ⲡⲓ|ⲉϫⲱⲣϩ
ϯⲕⲩⲣⲓⲁⲕⲏ	ϯ|ⲕⲩⲣⲓⲁⲕⲏ
ⲙⲡⲁϥϩⲱⲣⲡ	ⲙⲡⲁ|ϥ|ϩⲱⲣⲡ
ⲉⲡⲧⲏⲣϥ	ⲉ|ⲡ|ⲧⲏⲣϥ
ⲉⲧⲥⲁϩϯ	ⲉⲧ|ⲥⲁϩϯ
ⲉϥⲫⲱⲣϫ	ⲉ|ϥ|ⲫⲱⲣϫ
ϧⲁⲣⲱⲟⲩ	ϧⲁⲣⲱ|ⲟⲩ
ⲉϥⲑⲟⲛⲧⲉⲛ	ⲉ|ϥ|ⲑⲟⲛⲧⲉⲛ
ⲉⲡⲓⲥⲱⲧⲏⲣ	ⲉ|ⲡⲓ|ⲥⲱⲧⲏⲣ
ⲉⲧϫⲱ	ⲉⲧ|ϫⲱ
ϫⲉⲡⲓⲛⲓϣϯ	ϫⲉ|ⲡⲓ|ⲛⲓϣϯ
ⲉⲧϧⲉⲛⲑⲏⲛⲟⲩ	ⲉⲧ|ϧⲉⲛ|ⲑⲏⲛⲟⲩ
ⲉϥⲉⲣⲃⲱⲕ	ⲉ|ϥ|ⲉⲣⲃⲱⲕ
ⲛⲁⲩⲛⲏⲟⲩ	ⲛⲁ|ⲩ|ⲛⲏⲟⲩ
ϩⲁⲣⲟϥ	ϩⲁⲣⲟ|ϥ
ⲛϫⲉⲛⲉϥⲥⲛⲏⲟⲩ	ⲛϫⲉ|ⲛⲉϥ|ⲥⲛⲏⲟⲩ
ⲉⲩⲓⲛⲓ	ⲉ|ⲩ|ⲓⲛⲓ
ⲛⲭⲣⲏⲙⲁ	ⲛ|ⲭⲣⲏⲙⲁ
ⲛⲉⲙϩⲁⲛϩⲃⲱⲥ	ⲛⲉⲙ|ϩⲁⲛ|ϩⲃⲱⲥ
ⲛⲁϥⲥⲱⲣ	ⲛⲁ|ϥ|ⲥⲱⲣ
ⲉⲧϧⲉⲛⲡⲓⲧⲟⲡⲟⲥ	ⲉⲧ|ϧⲉⲛ|ⲡⲓ|ⲧⲟⲡⲟⲥ
ⲛⲁϥϣⲟⲡ	ⲛⲁ|ϥ|ϣⲟⲡ
ⲛⲥⲟⲗⲥⲉⲗ	ⲛ|ⲥⲟⲗⲥⲉⲗ
ⲉⲩⲛⲏⲟⲩ	ⲉ|ⲩ|ⲛⲏⲟⲩ
ⲉⲩϭⲓ	ⲉ|ⲩ|ϭⲓ
ⲛⲟⲙϯ	ⲛ|ⲟⲙϯ
ⲁϥϩⲟⲛϩⲉⲛ	ⲁ|ϥ|ϩⲟⲛϩⲉⲛ
ⲉⲧⲟⲧⲟⲩ	ⲉⲧⲟⲧ|ⲟⲩ
ⲉⲧϧⲉⲛⲡⲓⲁⲃⲏⲧ	ⲉⲧ|ϧⲉⲛ|ⲡⲓ|ⲁⲃⲏⲧ
ϫⲉⲉϣⲱⲡ	ϫⲉ|ⲉϣⲱⲡ
ⲛⲧⲉⲓⲥⲁⲁⲕ	ⲛⲧⲉ|ⲓⲥⲁⲁⲕ
ⲛⲑⲏⲛⲟⲩ	ⲛ|ⲑⲏⲛⲟⲩ
ⲙⲡⲉϥⲧⲁⲙⲟϥ	ⲙⲡⲉ|ϥ|ⲧⲁⲙⲟ|ϥ
ϫⲉⲛⲛⲉϥϭⲓⲥⲓ	ϫⲉ|ⲛⲛⲉ|ϥ|ϭⲓⲥⲓ
ϧⲉⲛⲡϫⲓⲛⲑⲣⲉⲡϭⲟⲉⲓⲥ	ϧⲉⲛ|ⲡ|ϫⲓⲛⲑⲣⲉⲡϭⲟⲉⲓⲥ
ⲧⲁⲙⲉⲡⲓϧⲉⲗⲗⲟ	ⲧⲁⲙⲉ|ⲡⲓ|ϧⲉⲗⲗⲟ
ⲉⲛⲏ	ⲉ|ⲛⲏ
ⲉⲑⲛⲁϣⲱⲡⲓ	ⲉⲑ|ⲛⲁ|ϣⲱⲡⲓ
ϫⲉⲙⲏ	ϫⲉ|ⲙⲏ
ⲛⲁⲉⲣⲟⲩϩⲱⲃ	ⲛⲁ|ⲉⲣ|ⲟⲩ|ϩⲱⲃ
ⲉϣⲧⲉⲙⲧⲁⲙⲉⲛⲉϥⲉⲃⲓⲁⲓⲕ	ⲉ|ϣⲧⲉⲙ|ⲧⲁⲙⲉ|ⲛⲉϥ|ⲉⲃⲓⲁⲓⲕ
ⲁⲓϣⲁⲛϫⲟⲟⲥ	ⲁⲓϣⲁⲛ|ϫⲟⲟ|ⲥ
ⲉⲡⲁⲓϩⲁⲅⲓⲟⲥ	ⲉ|ⲡⲁⲓ|ϩⲁⲅⲓⲟⲥ
ϩⲱϥ	ϩⲱ|ϥ
ϫⲉⲁⲩⲫⲟⲣϫϥ	ϫⲉ|ⲁ|ⲩ|ⲫⲟⲣϫ|ϥ
ⲛⲉϥϧⲉⲛⲧⲛⲉϫⲓ	ⲛⲉ|ϥ|ϧⲉⲛ|ⲧ|ⲛⲉϫⲓ
ϯⲛⲁϣⲱϥⲧ	ϯ|ⲛⲁ|ϣⲱϥⲧ
ϯⲛⲁⲩ	ϯ|ⲛⲁⲩ
ⲉⲡⲓⲥⲁϫⲓ	ⲉ|ⲡⲓ|ⲥⲁϫⲓ
ⲉϥⲧⲟⲙⲓ	ⲉ|ϥ|ⲧⲟⲙⲓ
ⲉⲧⲁϥϯ	ⲉⲧ|ⲁ|ϥ|ϯ
ⲙⲡⲉϥϩⲏⲧ	ⲙ|ⲡⲉϥ|ϩⲏⲧ
ⲉⲛⲓⲅⲣⲁⲫⲏ	ⲉ|ⲛⲓ|ⲅⲣⲁⲫⲏ
ⲛⲍⲏⲧⲏⲙⲁ	ⲛ|ⲍⲏⲧⲏⲙⲁ
ⲉⲣⲁⲧϫⲟⲙ	ⲉⲣⲁⲧϫⲟⲙ
ⲛⲓⲗⲟⲅⲟⲥ	ⲛⲓ|ⲗⲟⲅⲟⲥ
ⲛⲧⲉⲛⲓⲥⲁϧ	ⲛⲧⲉ|ⲛⲓ|ⲥⲁϧ
ⲟⲩϧⲉⲗⲗⲟ	ⲟⲩ|ϧⲉⲗⲗⲟ
ⲉⲟⲩⲛⲓϣϯ	ⲉ|ⲟⲩ|ⲛⲓϣϯ
ⲛⲁⲥⲕⲏⲧⲏⲥ	ⲛ|ⲁⲥⲕⲏⲧⲏⲥ
ⲉⲑⲃⲉ	ⲉⲑⲃⲉ
ⲉⲫⲏ	ⲉ|ⲫⲏ
ⲉⲑⲙⲟϣⲓ	ⲉⲑ|ⲙⲟϣⲓ
ϫⲉⲓⲥ	ϫⲉ|ⲓⲥ
ⲟⲩⲓⲥⲣⲁⲏⲗⲓⲧⲏⲥ	ⲟⲩ|ⲓⲥⲣⲁⲏⲗⲓⲧⲏⲥ
ⲇⲟⲗⲟⲥ	ⲇⲟⲗⲟⲥ
ⲛⲟⲩⲁⲣⲭⲓⲉⲡⲓⲥⲕⲟⲡⲟⲥ	ⲛ|ⲟⲩ|ⲁⲣⲭⲓⲉⲡⲓⲥⲕⲟⲡⲟⲥ
ⲛϯⲡⲟⲗⲓⲥ	ⲛ|ϯ|ⲡⲟⲗⲓⲥ
ⲛⲛⲓϣϯ	ⲛ|ⲛⲓϣϯ
ⲙⲡⲉⲙⲑⲟ	ⲙ|ⲡⲉ|ⲙⲑⲟ
ⲛⲉϥⲥⲁϫⲓ	ⲛⲉϥ|ⲥⲁϫⲓ
ⲛⲁⲫⲟϩ	ⲛⲁ|ⲫⲟϩ
ϣⲁⲁⲩⲣⲏϫⲥ	ϣⲁ|ⲁⲩⲣⲏϫ|ⲥ
ⲛϯⲟⲓⲕⲟⲩⲙⲉⲛⲏ	ⲛ|ϯ|ⲟⲓⲕⲟⲩⲙⲉⲛⲏ
ⲛϫⲉⲛⲓⲥⲛⲏⲟⲩ	ⲛϫⲉ|ⲛⲓ|ⲥⲛⲏⲟⲩ
ⲁⲩⲉⲣϣⲫⲏⲣⲓ	ⲁ|ⲩ|ⲉⲣϣⲫⲏⲣⲓ
ⲁⲩϯⲱⲟⲩ	ⲁ|ⲩ|ϯⲱⲟⲩ
ⲉⲧϭⲱⲣⲡ	ⲉⲧ|ϭⲱⲣⲡ
ⲛⲛⲉϥⲙⲩⲥⲧⲏⲣⲓⲟⲛ	ⲛ|ⲛⲉϥ|ⲙⲩⲥⲧⲏⲣⲓⲟⲛ
ⲉⲧⲉⲙⲡϣⲁ	ⲉⲧⲉ|ⲙⲡϣⲁ
ϫⲉⲉⲩⲉⲛⲁⲩ	ϫⲉ|ⲉⲩⲉ|ⲛⲁⲩ
ⲛϫⲉⲛⲏ	ⲛϫⲉ|ⲛⲏ
ⲉⲧⲉⲙⲡⲟⲩⲛⲁⲩ	ⲉⲧⲉ|ⲙⲡ|ⲟⲩ|ⲛⲁⲩ
ⲙⲡⲟⲩⲕⲁϯ	ⲙⲡ|ⲟⲩ|ⲕⲁϯ
ⲛⲁϥⲉⲣⲡⲣⲟⲕⲟⲡⲧⲉⲓⲛ	ⲛⲁ|ϥ|ⲉⲣⲡⲣⲟⲕⲟⲡⲧⲉⲓⲛ
ϧⲉⲛⲛⲓⲁⲣⲉⲧⲏ	ϧⲉⲛ|ⲛⲓ|ⲁⲣⲉⲧⲏ
ⲛⲧⲟⲩⲥⲱⲧⲉⲙ	ⲛⲧ|ⲟⲩ|ⲥⲱⲧⲉⲙ
ⲉⲡⲉϥⲥⲱⲓⲧ	ⲉ|ⲡⲉϥ|ⲥⲱⲓⲧ
ϧⲉⲛⲭⲱⲣⲁ	ϧⲉⲛ|ⲭⲱⲣⲁ
ⲁⲟⲩⲙⲏϣ	ⲁ|ⲟⲩ|ⲙⲏϣ
ⲭⲁⲡⲓⲕⲟⲥⲙⲟⲥ	ⲭⲁ|ⲡⲓ|ⲕⲟⲥⲙⲟⲥ
ⲛⲥⲱⲟⲩ	ⲛⲥⲱ|ⲟⲩ
ⲁⲩⲉⲣⲙⲟⲛⲁⲭⲟⲥ	ⲁ|ⲩ|ⲉⲣⲙⲟⲛⲁⲭⲟⲥ
ⲛϧⲏⲧⲟⲩ	ⲛϧⲏⲧ|ⲟⲩ
ⲙⲉⲛⲉⲛⲥⲱⲛ	ⲙⲉⲛⲉⲛⲥⲱⲛ
ⲉⲛⲁϥⲟⲓ	ⲉ|ⲛⲁ|ϥ|ⲟⲓ
ϫⲉⲁⲫⲏ	ϫⲉ|ⲁ|ⲫⲏ
ⲉⲣⲁⲡⲟⲧⲁⲍⲉⲥⲑⲁⲓ	ⲉⲣⲁⲡⲟⲧⲁⲍⲉⲥⲑⲁⲓ
ⲙⲡⲓⲕⲟⲥⲙⲟⲥ	ⲙ|ⲡⲓ|ⲕⲟⲥⲙⲟⲥ
ⲁϥⲉⲣⲙⲟⲛⲁⲭⲟⲥ	ⲁ|ϥ|ⲉⲣⲙⲟⲛⲁⲭⲟⲥ
ⲓⲁⲛⲛⲏ	ⲓⲁⲛⲛⲏ
ⲟⲩⲅⲉⲛⲟⲥ	ⲟⲩ|ⲅⲉⲛⲟⲥ
ⲉⲧϭⲟⲥⲓ	ⲉⲧ|ϭⲟⲥⲓ
ⲛⲉⲟⲩⲉⲃⲟⲗ	ⲛⲉ|ⲟⲩ|ⲉⲃⲟⲗ
ϧⲉⲛⲧϩⲁⲓⲣⲉⲥⲓⲥ	ϧⲉⲛ|ⲧ|ϩⲁⲓⲣⲉⲥⲓⲥ
ⲛⲛⲓⲁⲧⲥⲙⲟⲩ	ⲛ|ⲛⲓ|ⲁⲧⲥⲙⲟⲩ
ϫⲉⲓⲥϫⲉⲛ	ϫⲉ|ⲓⲥϫⲉⲛ
ⲡⲓϩⲁⲅⲓⲟⲥ	ⲡⲓ|ϩⲁⲅⲓⲟⲥ
ⲇⲓⲟⲥⲕⲟⲣⲟⲥ	ⲇⲓⲟⲥⲕⲟⲣⲟⲥ
ⲙⲡⲉⲁⲣⲭⲓⲉⲡⲓⲥⲕⲟⲡⲟⲥ	ⲙⲡⲉ|ⲁⲣⲭⲓⲉⲡⲓⲥⲕⲟⲡⲟⲥ
ⲉϫⲱⲟⲩ	ⲉϫⲱ|ⲟⲩ
ⲁⲩⲡⲱⲣϫ	ⲁ|ⲩ|ⲡⲱⲣϫ
ⲛϩⲁⲓⲣⲉⲧⲓⲕⲟⲥ	ⲛ|ϩⲁⲓⲣⲉⲧⲓⲕⲟⲥ
ⲁϥⲁⲓϥ	ⲁ|ϥ|ⲁⲓ|ϥ
ⲛⲭⲣⲓⲥⲧⲓⲁⲛⲟⲥ	ⲛ|ⲭⲣⲓⲥⲧⲓⲁⲛⲟⲥ
ⲛⲟⲩϩⲁⲅⲓⲟⲥ	ⲛ|ⲟⲩ|ϩⲁⲅⲓⲟⲥ
ⲛⲥⲉⲁⲓϥ	ⲛ|ⲥⲉ|ⲁⲓ|ϥ
ⲛⲉⲡⲓⲥⲕⲟⲡⲟⲥ	ⲛ|ⲉⲡⲓⲥⲕⲟⲡⲟⲥ
ⲛⲓϣⲟⲣⲡ	ⲛⲓ|ϣⲟⲣⲡ
ⲉⲧⲁⲫⲏ	ⲉⲧ|ⲁ|ⲫⲏ
ⲉⲛⲟⲩ	ⲉⲛ|ⲟⲩ
ⲙⲡⲉⲡⲓⲡⲟⲛⲏⲣⲟⲥ	ⲙⲡⲉ|ⲡⲓ|ⲡⲟⲛⲏⲣⲟⲥ
ⲛⲇⲓⲁⲃⲟⲗⲟⲥ	ⲛ|ⲇⲓⲁⲃⲟⲗⲟⲥ
ϣⲛⲁⲩ	ϣ|ⲛⲁⲩ
ⲉϥⲉⲣⲡⲣⲟⲕⲟⲡⲧⲉⲓⲛ	ⲉ|ϥ|ⲉⲣⲡⲣⲟⲕⲟⲡⲧⲉⲓⲛ
ⲉⲣⲉⲫⲏ	ⲉⲣⲉ|ⲫⲏ
ⲁⲟⲩⲇⲁⲓⲙⲱⲛ	ⲁ|ⲟⲩ|ⲇⲁⲓⲙⲱⲛ
ⲛⲓϥⲓ	ⲛⲓϥⲓ
ⲉⲛⲉϥⲙⲁϣϫ	ⲉ|ⲛⲉϥ|ⲙⲁϣϫ
ⲉⲧⲁϥⲧⲱⲛϥ	ⲉⲧ|ⲁ|ϥ|ⲧⲱⲛ|ϥ
ϧⲉⲛⲡⲓⲛⲕⲟⲧ	ϧⲉⲛ|ⲡⲓ|ⲛⲕⲟⲧ
ⲙⲡⲉϥϣϫⲉⲙϫⲟⲙ	ⲙⲡⲉ|ϥ|ϣ|ϫⲉⲙϫⲟⲙ
ⲛϩⲉⲙⲥⲓ	ⲛ|ϩⲉⲙⲥⲓ
ⲁϥⲧⲁⲙⲉⲡⲉϥⲓⲱⲧ	ⲁ|ϥ|ⲧⲁⲙⲉ|ⲡⲉϥ|ⲓⲱⲧ
ⲉⲡⲓⲡⲟⲗⲉⲙⲟⲥ	ⲉ|ⲡⲓ|ⲡⲟⲗⲉⲙⲟⲥ
ⲁϥⲉⲣⲙⲕⲁϩ	ⲁ|ϥ|ⲉⲣ|ⲙⲕⲁϩ
ϫⲉⲉⲣⲉⲡⲓϧⲉⲗⲗⲟ	ϫⲉ|ⲉⲣⲉ|ⲡⲓ|ϧⲉⲗⲗⲟ
ϭⲟⲛⲧ	ϭⲟⲛⲧ
ϧⲉⲛⲡⲁⲓⲛⲓϣϯ	ϧⲉⲛ|ⲡⲁⲓ|ⲛⲓϣϯ
ⲙⲡⲟⲗⲉⲙⲟⲥ	ⲙ|ⲡⲟⲗⲉⲙⲟⲥ
ⲁϥϭⲓ	ⲁ|ϥ|ϭⲓ
ⲛϧⲓⲥⲓ	ⲛ|ϧⲓⲥⲓ
ⲛⲧⲟⲧⲟⲩ	ⲛⲧⲟⲧ|ⲟⲩ
ⲛⲛⲓⲇⲁⲓⲙⲱⲛ	ⲛ|ⲛⲓ|ⲇⲁⲓⲙⲱⲛ
ⲉⲣⲁϥ	ⲉⲣⲁ|ϥ
ⲙⲡⲓⲡⲟⲗⲉⲙⲟⲥ	ⲙ|ⲡⲓ|ⲡⲟⲗⲉⲙⲟⲥ
ⲡⲉϫⲉ	ⲡⲉϫⲉ
ϯⲛⲁϣϯⲉⲛⲧⲟⲗⲏ	ϯ|ⲛⲁ|ϣ|ϯⲉⲛⲧⲟⲗⲏ
ⲉⲧⲟⲧⲕ	ⲉⲧⲟⲧ|ⲕ
ⲉⲑⲃⲉⲡⲉⲕⲓⲱⲧ	ⲉⲑⲃⲉ|ⲡⲉⲕ|ⲓⲱⲧ
ⲟⲩϣⲏⲣⲓ	ⲟⲩ|ϣⲏⲣⲓ
ⲛⲕⲟⲓⲛⲱⲛⲓⲁ	ⲛ|ⲕⲟⲓⲛⲱⲛⲓⲁ
ⲙⲡⲉⲕⲉⲓⲱⲧ	ⲙ|ⲡⲉⲕ|ⲉⲓⲱⲧ
ⲉⲧⲉϥⲛⲁϫⲟϥ	ⲉⲧⲉ|ϥ|ⲛⲁ|ϫⲟ|ϥ
ⲁⲣⲓⲧϥ	ⲁⲣⲓⲧ|ϥ
ⲉⲫⲛⲟⲩϯ	ⲉ|ⲫ|ⲛⲟⲩϯ
ϫⲉⲭⲛⲁⲙⲧⲟⲛ	ϫⲉ|ⲭ|ⲛⲁ|ⲙⲧⲟⲛ
ⲉⲛⲉⲛⲥⲁϫⲓ	ⲉ|ⲛⲉⲛ|ⲥⲁϫⲓ
ϫⲉϩⲱⲗ	ϫⲉ|ϩⲱⲗ
ⲁⲣⲓⲕⲁⲑⲁⲣⲓⲍⲉⲓⲛ	ⲁⲣⲓⲕⲁⲑⲁⲣⲓⲍⲉⲓⲛ
ⲛⲛⲓⲙⲁ	ⲛ|ⲛⲓ|ⲙⲁ
ⲛⲧⲉⲛⲓⲥⲛⲏⲟⲩ	ⲛⲧⲉ|ⲛⲓ|ⲥⲛⲏⲟⲩ
ϯⲛⲁϩϯ	ϯ|ⲛⲁϩϯ
ϫⲉⲫⲛⲟⲩϯ	ϫⲉ|ⲫ|ⲛⲟⲩϯ
ⲛⲁϯⲙⲧⲟⲛ	ⲛⲁ|ϯⲙⲧⲟⲛ
ⲁϥϣⲉⲡⲡⲓⲥⲁϫⲓ	ⲁ|ϥ|ϣⲉⲡ|ⲡⲓ|ⲥⲁϫⲓ
ⲁϥϭⲟϫⲓ	ⲁ|ϥ|ϭⲟϫⲓ
ⲛⲥⲁⲡⲓⲑⲉⲃⲓⲟ	ⲛⲥⲁ|ⲡⲓ|ⲑⲉⲃⲓⲟ
ⲁϥϩⲉⲙⲥⲓ	ⲁ|ϥ|ϩⲉⲙⲥⲓ
ϧⲉⲛⲛⲁⲓϧⲓⲥⲓ	ϧⲉⲛ|ⲛⲁⲓ|ϧⲓⲥⲓ
ⲛⲥ	ⲛ|ⲥ
ⲉϥⲙⲁϩⲙⲱⲟⲩ	ⲉ|ϥ|ⲙⲁϩⲙⲱⲟⲩ
ⲙⲡⲓⲉϫⲱⲣϩ	ⲙ|ⲡⲓ|ⲉϫⲱⲣϩ
ⲉϥⲉⲣⲕⲁⲑⲁⲣⲓⲍⲉⲓⲛ	ⲉ|ϥ|ⲉⲣⲕⲁⲑⲁⲣⲓⲍⲉⲓⲛ
ⲙⲉⲛⲉⲛⲥⲁⲡⲁⲓⲡⲟⲗⲉⲙⲟⲥ	ⲙⲉⲛⲉⲛⲥⲁ|ⲡⲁⲓ|ⲡⲟⲗⲉⲙⲟⲥ
ⲉⲑⲛⲁϣⲧ	ⲉⲑ|ⲛⲁϣⲧ
ⲁⲫⲛⲟⲩϯ	ⲁ|ⲫ|ⲛⲟⲩϯ
ⲉⲣϩⲙⲟⲧ	ⲉⲣϩⲙⲟⲧ
ⲛϩⲁⲛⲧⲁⲗϭⲟ	ⲛ|ϩⲁⲛ|ⲧⲁⲗϭⲟ
ⲛⲟⲩⲥⲟⲡ	ⲛ|ⲟⲩ|ⲥⲟⲡ
ⲉⲧⲁⲩϣⲉ	ⲉⲧ|ⲁ|ⲩ|ϣⲉ
ⲉⲑⲃⲉϩⲁⲛⲕⲟⲩϫⲓ	ⲉⲑⲃⲉ|ϩⲁⲛ|ⲕⲟⲩϫⲓ
ⲛⲣⲟⲕϩ	ⲛ|ⲣⲟⲕϩ
ⲉⲧⲁⲩϫⲱⲕ	ⲉⲧ|ⲁ|ⲩ|ϫⲱⲕ
ⲙⲡⲟⲩϩⲱⲃ	ⲙ|ⲡⲟⲩ|ϩⲱⲃ
ⲉⲡⲟⲩⲙⲁ	ⲉ|ⲡⲟⲩ|ⲙⲁ
ϩⲓⲡⲓⲙⲱⲓⲧ	ϩⲓ|ⲡⲓ|ⲙⲱⲓⲧ
ⲁⲫⲏ	ⲁ|ⲫⲏ
ⲉⲣⲥⲁⲫⲁⲟⲩ	ⲉⲣⲥⲁⲫⲁⲟⲩ
ⲉϥϥⲱϫⲓ	ⲉ|ϥ|ϥⲱϫⲓ
ⲛⲥⲁⲛⲓⲥⲑⲟⲓ	ⲛⲥⲁ|ⲛⲓ|ⲥⲑⲟⲓ
ⲉϫⲉⲛⲟⲩⲃⲱ	ⲉϫⲉⲛ|ⲟⲩ|ⲃⲱ
ⲛⲥⲑⲟⲓ	ⲛ|ⲥⲑⲟⲓ
ϫⲉⲉϥⲛⲁϥⲟϫⲥ	ϫⲉ|ⲉ|ϥ|ⲛⲁ|ϥⲟϫ|ⲥ
ⲟⲩⲁϫⲱ	ⲟⲩ|ⲁϫⲱ
ϧⲉⲛⲧⲉⲥⲙⲏϯ	ϧⲉⲛ|ⲧⲉⲥ|ⲙⲏϯ
ⲁⲥⲭⲗⲟⲙⲗⲉⲙ	ⲁ|ⲥ|ⲭⲗⲟⲙⲗⲉⲙ
ⲉⲧⲉϥϫⲓϫ	ⲉ|ⲧⲉϥ|ϫⲓϫ
ⲁⲩⲉϣⲟⲩϧⲣⲱⲟⲩ	ⲁ|ⲩ|ⲉϣ|ⲟⲩ|ϧⲣⲱⲟⲩ
ⲉⲩⲙⲉⲩⲓ	ⲉ|ⲩ|ⲙⲉⲩⲓ
ϫⲉ	ϫⲉ
ϥⲛⲁⲙⲟⲩ	ϥ|ⲛⲁ|ⲙⲟⲩ
ⲛϯⲟⲩⲛⲟⲩ	ⲛ|ϯ|ⲟⲩⲛⲟⲩ
ⲁϥⲃⲉⲣⲃⲱⲣⲥ	ⲁ|ϥ|ⲃⲉⲣⲃⲱⲣ|ⲥ
ⲙⲡⲉⲧϩⲱⲟⲩ	ⲙ|ⲡ|ⲉⲧ|ϩⲱⲟⲩ
ⲧⲁϩⲟϥ	ⲧⲁϩⲟ|ϥ
ⲉⲡⲁⲓϩⲱⲃ	ⲉ|ⲡⲁⲓ|ϩⲱⲃ
ⲁⲩϩⲓⲧⲟⲩ	ⲁ|ⲩ|ϩⲓⲧ|ⲟⲩ
ⲉⲡⲉⲥⲏⲧ	ⲉ|ⲡ|ⲉⲥⲏⲧ
ⲁⲩⲟⲩⲱϣⲧ	ⲁ|ⲩ|ⲟⲩⲱϣⲧ
ⲧⲉⲧⲉⲛⲛⲁⲩ	ⲧⲉⲧⲉⲛ|ⲛⲁⲩ
ϫⲉⲁⲡⲁⲓϩⲁⲅⲓⲟⲥ	ϫⲉ|ⲁ|ⲡⲁⲓ|ϩⲁⲅⲓⲟⲥ
ⲛⲁⲗⲟⲩ	ⲛ|ⲁⲗⲟⲩ
ⲉϥⲧⲉⲛⲑⲱⲛⲧ	ⲉ|ϥ|ⲧⲉⲛⲑⲱⲛⲧ
ⲉⲛⲓⲁⲡⲟⲥⲧⲟⲗⲟⲥ	ⲉ|ⲛⲓ|ⲁⲡⲟⲥⲧⲟⲗⲟⲥ
ⲉϥⲟⲛⲓ	ⲉ|ϥ|ⲟⲛⲓ
ⲉⲧⲁⲡϭⲟⲉⲓⲥ	ⲉⲧ|ⲁ|ⲡ|ϭⲟⲉⲓⲥ
ϫⲟⲥ	ϫⲟ|ⲥ
ⲛⲛⲉϥⲁⲡⲟⲥⲧⲟⲗⲟⲥ	ⲛ|ⲛⲉϥ|ⲁⲡⲟⲥⲧⲟⲗⲟⲥ
ⲉⲧⲁⲣⲉϩ	ⲉⲧ|ⲁⲣⲉϩ
ⲉⲛⲁⲉⲛⲧⲟⲗⲏ	ⲉ|ⲛⲁ|ⲉⲛⲧⲟⲗⲏ
ⲛⲓⲙⲏⲓⲛⲓ	ⲛⲓ|ⲙⲏⲓⲛⲓ
ⲉⲧⲁⲓⲁⲓⲧⲟⲩ	ⲉⲧ|ⲁ|ⲓ|ⲁⲓⲧ|ⲟⲩ
ⲉϥⲉⲁⲓⲧⲟⲩ	ⲉϥⲉ|ⲁⲓⲧ|ⲟⲩ
ϩⲱⲟⲩ	ϩⲱ|ⲟⲩ
ⲉⲑⲃⲉⲛⲏ	ⲉⲑⲃⲉ|ⲛⲏ
ⲉⲧⲁⲣⲉⲧⲉⲛⲥϧⲏⲧⲟⲩ	ⲉⲧ|ⲁⲣⲉ|ⲧⲉⲛ|ⲥϧⲏⲧ|ⲟⲩ
ⲛⲁⲛⲉⲥ	ⲛⲁⲛⲉ|ⲥ
ⲉϣⲧⲉⲙϭⲓ	ⲉ|ϣⲧⲉⲙ|ϭⲓ
ⲛⲉⲙⲥϩⲓⲙⲓ	ⲛⲉⲙ|ⲥϩⲓⲙⲓ
ⲉⲑⲃⲉⲛⲓⲡⲟⲣⲛⲓⲁ	ⲉⲑⲃⲉ|ⲛⲓ|ⲡⲟⲣⲛⲓⲁ
ⲭⲁ	ⲭⲁ
ⲧⲉϥⲥϩⲓⲙⲓ	ⲧⲉϥ|ⲥϩⲓⲙⲓ
ⲙⲁⲣⲉϯⲟⲩⲓ	ⲙⲁⲣⲉ|ϯ|ⲟⲩⲓ
ϯⲟⲩⲓ	ϯ|ⲟⲩⲓ
ⲭⲁⲡⲉⲥϩⲁⲓ	ⲭⲁ|ⲡⲉⲥ|ϩⲁⲓ
ⲛⲁⲥ	ⲛⲁ|ⲥ
ⲡⲓϩⲁⲓ	ⲡⲓ|ϩⲁⲓ
ⲙⲁⲣⲉϥϯ	ⲙⲁⲣⲉ|ϥ|ϯ
ⲙⲡⲉⲧⲉⲣⲟϥ	ⲙ|ⲡ|ⲉⲧ|ⲉⲣⲟ|ϥ
ⲛϯⲥϩⲓⲙⲓ	ⲛ|ϯ|ⲥϩⲓⲙⲓ
ϯⲥϩⲓⲙⲓ	ϯ|ⲥϩⲓⲙⲓ
ⲙⲁⲣⲉⲥϯ	ⲙⲁⲣⲉ|ⲥ|ϯ
ⲙⲡⲉⲧⲉⲣⲟⲥ	ⲙ|ⲡ|ⲉⲧ|ⲉⲣⲟ|ⲥ
ⲙⲡⲉⲥϩⲁⲓ	ⲙ|ⲡⲉⲥ|ϩⲁⲓ
ⲙⲙⲟⲛⲧⲉⲥ	ⲙⲙⲟⲛⲧⲉ|ⲥ
ⲉⲣϣⲓϣⲓ	ⲉⲣϣⲓϣⲓ
ⲙⲡⲉⲥⲥⲱⲙⲁ	ⲙ|ⲡⲉⲥ|ⲥⲱⲙⲁ
ⲙⲙⲓⲛⲙⲙⲟⲥ	ⲙⲙⲓⲛⲙⲙⲟ|ⲥ
ⲡⲓⲕⲉϩⲁⲓ	ⲡⲓ|ⲕⲉ|ϩⲁⲓ
ⲙⲙⲟⲛⲧⲉϥ	ⲙⲙⲟⲛⲧⲉ|ϥ
ⲙⲡⲉϥⲥⲱⲙⲁ	ⲙ|ⲡⲉϥ|ⲥⲱⲙⲁ
ⲙⲙⲓⲛⲙⲙⲟϥ	ⲙⲙⲓⲛⲙⲙⲟ|ϥ
ⲙⲡⲉⲣϥⲉϫⲛⲉⲧⲉⲛⲉⲣⲏⲟⲩ	ⲙⲡⲉⲣ|ϥⲉϫ|ⲛⲉⲧⲉⲛ|ⲉⲣⲏⲟⲩ
ⲉⲃⲏⲗ	ⲉⲃⲏⲗ
ⲁⲣⲏⲟⲩ	ⲁⲣⲏⲟⲩ
ϧⲉⲛⲟⲩϯⲙⲁϯ	ϧⲉⲛ|ⲟⲩ|ϯⲙⲁϯ
ⲡⲣⲟⲥ	ⲡⲣⲟⲥ
ⲟⲩⲥⲏⲟⲩ	ⲟⲩ|ⲥⲏⲟⲩ
ⲛⲧⲉⲧⲉⲛⲥⲣⲟϥⲧ	ⲛⲧⲉ|ⲧⲉⲛ|ⲥⲣⲟϥⲧ
ⲉϯⲡⲣⲟⲥⲉⲩⲭⲏ	ⲉ|ϯ|ⲡⲣⲟⲥⲉⲩⲭⲏ
ⲛⲧⲉⲧⲉⲛⲓ	ⲛⲧⲉ|ⲧⲉⲛ|ⲓ
ⲉⲩⲙⲁ	ⲉ|ⲩ|ⲙⲁ
ⲛⲧⲉ	ⲛⲧⲉ
ⲉⲣⲡⲓⲣⲁⲍⲓⲛ	ⲉⲣⲡⲓⲣⲁⲍⲓⲛ
ⲉⲑⲃⲉⲧⲉⲧⲉⲛⲙⲉⲧⲁⲧⲑⲱⲧ	ⲉⲑⲃⲉ|ⲧⲉⲧⲉⲛ|ⲙⲉⲧⲁⲧⲑⲱⲧ
ϯϫⲱ	ϯ|ϫⲱ
ⲕⲁⲧⲁⲟⲩⲥⲩⲛⲅⲛⲱⲙⲏ	ⲕⲁⲧⲁ|ⲟⲩ|ⲥⲩⲛⲅⲛⲱⲙⲏ
ⲕⲁⲧⲁⲟⲩⲁϩⲥⲁϩⲛⲓ	ⲕⲁⲧⲁ|ⲟⲩⲁϩⲥⲁϩⲛⲓ
ⲛⲧⲉⲣⲱⲙⲓ	ⲛⲧⲉ|ⲣⲱⲙⲓ
ⲟⲩⲟⲛⲧⲉϥ	ⲟⲩⲟⲛⲧⲉ|ϥ
ⲟⲩϩⲙⲟⲧ	ⲟⲩ|ϩⲙⲟⲧ
ϩⲓⲧⲉⲛⲫⲛⲟⲩϯ	ϩⲓⲧⲉⲛ|ⲫ|ⲛⲟⲩϯ
ⲕⲉⲟⲩⲁⲓ	ⲕⲉ|ⲟⲩⲁⲓ
ⲙⲡⲁⲓⲕⲉⲣⲏϯ	ⲙ|ⲡⲁⲓ|ⲕⲉ|ⲣⲏϯ
ⲉⲧⲉⲙⲡⲟⲩϭⲓ	ⲉⲧⲉ|ⲙⲡ|ⲟⲩ|ϭⲓ
ⲛⲉⲙⲛⲓⲭⲏⲣⲁ	ⲛⲉⲙ|ⲛⲓ|ⲭⲏⲣⲁ
ϫⲉⲛⲁⲛⲉⲥ	ϫⲉ|ⲛⲁⲛⲉ|ⲥ
ⲁⲩϣⲁⲛϣⲱⲡⲓ	ⲁⲩϣⲁⲛ|ϣⲱⲡⲓ
ⲥⲉⲛⲁϣⲉⲣⲉⲅⲕⲣⲁⲧⲉⲩⲉⲥⲑⲉ	ⲥⲉ|ⲛⲁ|ϣ|ⲉⲣⲉⲅⲕⲣⲁⲧⲉⲩⲉⲥⲑⲉ
ⲙⲁⲣⲟⲩϭⲓ	ⲙⲁⲣ|ⲟⲩ|ϭⲓ
ⲛⲥⲉϭⲓⲭⲣⲱⲙ	ⲛ|ⲥⲉ|ϭⲓⲭⲣⲱⲙ
ⲉⲧⲁⲩϭⲓ	ⲉⲧ|ⲁ|ⲩ|ϭⲓ
ϯϩⲟⲛϩⲉⲛ	ϯ|ϩⲟⲛϩⲉⲛ
ⲡϭⲟⲓⲥ	ⲡ|ϭⲟⲓⲥ
ⲛⲧⲉⲥϣⲧⲉⲙⲫⲱⲣϫ	ⲛⲧⲉ|ⲥ|ϣⲧⲉⲙ|ⲫⲱⲣϫ
ⲕⲁⲛ	ⲕⲁⲛ
ⲁⲥϣⲁⲛⲫⲱⲣϫ	ⲁⲥϣⲁⲛ|ⲫⲱⲣϫ
ⲙⲁⲣⲉⲥⲟϩⲓ	ⲙⲁⲣⲉ|ⲥ|ⲟϩⲓ
ⲛⲟⲩⲉϣⲉⲛϭⲓ	ⲛⲟⲩⲉϣⲉⲛ|ϭⲓ
ⲙⲁⲣⲉⲥϩⲱⲧⲡ	ⲙⲁⲣⲉ|ⲥ|ϩⲱⲧⲡ
ⲉⲡⲉⲥϩⲁⲓ	ⲉ|ⲡⲉⲥ|ϩⲁⲓ
ⲛⲧⲉϥϣⲧⲉⲙⲭⲁϯⲥϩⲓⲙⲓ	ⲛⲧⲉ|ϥ|ϣⲧⲉⲙ|ⲭⲁ|ϯ|ⲥϩⲓⲙⲓ
ⲡⲥⲉⲡⲓ	ⲡ|ⲥⲉⲡⲓ
ⲉⲟⲩⲟⲛ	ⲉ|ⲟⲩⲟⲛ
ⲟⲩⲥⲟⲛ	ⲟⲩ|ⲥⲟⲛ
ⲉⲟⲩⲟⲛⲧⲉϥ	ⲉ|ⲟⲩⲟⲛⲧⲉ|ϥ
ⲟⲩⲥϩⲓⲙⲓ	ⲟⲩ|ⲥϩⲓⲙⲓ
ⲉⲥϯⲙⲁϯ	ⲉ|ⲥ|ϯⲙⲁϯ
ⲉϣⲱⲡⲓ	ⲉ|ϣⲱⲡⲓ
ⲙⲡⲉⲛⲑⲣⲉϥⲭⲁⲥ	ⲙⲡⲉⲛⲑⲣⲉ|ϥ|ⲭⲁ|ⲥ
ⲉⲟⲩⲟⲛⲧⲁⲥ	ⲉ|ⲟⲩⲟⲛⲧⲁ|ⲥ
ⲛⲟⲩϩⲁⲓ	ⲛ|ⲟⲩ|ϩⲁⲓ
ⲛⲁⲧⲛⲁϩϯ	ⲛ|ⲁⲧⲛⲁϩϯ
ⲉϥϯⲙⲁϯ	ⲉ|ϥ|ϯⲙⲁϯ
ⲛⲉⲙⲁⲥ	ⲛⲉⲙⲁ|ⲥ
ⲙⲡⲉⲛⲑⲣⲉⲥⲭⲁⲡⲓϩⲁⲓ	ⲙⲡⲉⲛⲑⲣⲉ|ⲥ|ⲭⲁ|ⲡⲓ|ϩⲁⲓ
ⲛⲥⲱⲥ	ⲛⲥⲱ|ⲥ
ⲁϥⲧⲟⲩⲃⲟ	ⲁ|ϥ|ⲧⲟⲩⲃⲟ
ⲛϫⲉⲡⲓϩⲁⲓ	ⲛϫⲉ|ⲡⲓ|ϩⲁⲓ
ϧⲉⲛϯⲥϩⲓⲙⲓ	ϧⲉⲛ|ϯ|ⲥϩⲓⲙⲓ
ⲁⲥⲧⲟⲩⲃⲟ	ⲁ|ⲥ|ⲧⲟⲩⲃⲟ
ⲛϫⲉϯⲥϩⲓⲙⲓ	ⲛϫⲉ|ϯ|ⲥϩⲓⲙⲓ
ϧⲉⲛⲡⲓⲥⲟⲛ	ϧⲉⲛ|ⲡⲓ|ⲥⲟⲛ
ⲛⲉⲧⲉⲛϣⲏⲣⲓ	ⲛⲉⲧⲉⲛ|ϣⲏⲣⲓ
ⲥⲉϭⲁϧⲉⲙ	ⲥⲉ|ϭⲁϧⲉⲙ
ⲥⲉⲟⲩⲁⲃ	ⲥⲉ|ⲟⲩⲁⲃ
ⲡⲓⲁⲑⲛⲁϩϯ	ⲡⲓ|ⲁⲑⲛⲁϩϯ
ⲛⲁⲫⲱⲣϫ	ⲛⲁ|ⲫⲱⲣϫ
ⲙⲁⲣⲉϥⲫⲱⲣϫ	ⲙⲁⲣⲉ|ϥ|ⲫⲱⲣϫ
ⲛϥⲟⲓ	ⲛ|ϥ|ⲟⲓ
ⲙⲃⲱⲕ	ⲙ|ⲃⲱⲕ
ⲛϫⲉⲡⲓⲥⲟⲛ	ⲛϫⲉ|ⲡⲓ|ⲥⲟⲛ
ϯⲥⲱⲛⲓ	ϯ|ⲥⲱⲛⲓ
ϧⲉⲛⲛⲁⲓ	ϧⲉⲛ|ⲛⲁⲓ
ⲁϥⲑⲁϩⲉⲙⲑⲏⲛⲟⲩ	ⲁ|ϥ|ⲑⲁϩⲉⲙ|ⲑⲏⲛⲟⲩ
ⲁⲣⲉⲉⲙⲓ	ⲁⲣⲉ|ⲉⲙⲓ
ϫⲉⲁⲣⲏⲟⲩ	ϫⲉ|ⲁⲣⲏⲟⲩ
ⲧⲉⲣⲁϣⲛⲟϩⲉⲙ	ⲧⲉⲣ|ⲁ|ϣ|ⲛⲟϩⲉⲙ
ⲙⲡⲉϩⲁⲓ	ⲙ|ⲡⲉ|ϩⲁⲓ
ⲁⲕⲥⲱⲟⲩⲛ	ⲁ|ⲕ|ⲥⲱⲟⲩⲛ
ⲡⲓⲣⲱⲙⲓ	ⲡⲓ|ⲣⲱⲙⲓ
ⲭⲛⲁϣⲛⲟϩⲉⲙ	ⲭ|ⲛⲁ|ϣ|ⲛⲟϩⲉⲙ
ⲛⲧⲉⲕⲥϩⲓⲙⲓ	ⲛ|ⲧⲉⲕ|ⲥϩⲓⲙⲓ
ⲓⲙⲏϯ	ⲓⲙⲏϯ
ⲉⲡⲓⲣⲏϯ	ⲉ|ⲡⲓ|ⲣⲏϯ
ⲉⲧⲁⲡϭⲟⲓⲥ	ⲉⲧ|ⲁ|ⲡ|ϭⲟⲓⲥ
ⲑⲁϣϥ	ⲑⲁϣ|ϥ
ⲙⲡⲓⲟⲩⲁⲓ	ⲙ|ⲡⲓ|ⲟⲩⲁⲓ
ⲑⲁϩⲉⲙⲫⲟⲩⲁⲓ	ⲑⲁϩⲉⲙ|ⲫ|ⲟⲩⲁⲓ
ⲫⲟⲩⲁⲓ	ⲫ|ⲟⲩⲁⲓ
ⲙⲁⲣⲉϥⲙⲟϣⲓ	ⲙⲁⲣⲉ|ϥ|ⲙⲟϣⲓ
ⲉⲧⲓⲟⲩⲁϩⲥⲁϩⲛⲓ	ⲉⲧ|ⲓ|ⲟⲩⲁϩⲥⲁϩⲛⲓ
ϧⲉⲛⲛⲓⲉⲕⲕⲗⲏⲥⲓⲁ	ϧⲉⲛ|ⲛⲓ|ⲉⲕⲕⲗⲏⲥⲓⲁ
ⲁⲩⲑⲁϩⲉⲙⲟⲩⲁⲓ	ⲁ|ⲩ|ⲑⲁϩⲉⲙ|ⲟⲩⲁⲓ
ⲉϥⲥⲟⲩⲃⲏⲧ	ⲉ|ϥ|ⲥⲟⲩⲃⲏⲧ
ⲙⲡⲉⲛⲑⲣⲉϥⲥⲉⲕϯⲙⲉⲧⲁⲧⲥⲉⲃⲓ	ⲙⲡⲉⲛⲑⲣⲉ|ϥ|ⲥⲉⲕ|ϯ|ⲙⲉⲧⲁⲧⲥⲉⲃⲓ
ϧⲉⲛϯⲙⲉⲧⲁⲧⲥⲉⲃⲓ	ϧⲉⲛ|ϯ|ⲙⲉⲧⲁⲧⲥⲉⲃⲓ
ⲙⲡⲉⲛⲑⲣⲉϥⲥⲟⲩⲃⲏⲧϥ	ⲙⲡⲉⲛⲑⲣⲉ|ϥ|ⲥⲟⲩⲃⲏⲧ|ϥ
ϯⲙⲉⲧⲁⲧⲥⲉⲃⲓ	ϯ|ⲙⲉⲧⲁⲧⲥⲉⲃⲓ
ⲡⲓⲁⲣⲉϩ	ⲡⲓ|ⲁⲣⲉϩ
ⲉⲛⲓⲉⲛⲧⲟⲗⲏ	ⲉ|ⲛⲓ|ⲉⲛⲧⲟⲗⲏ
ϧⲉⲛⲡⲓⲑⲱϩⲉⲙ	ϧⲉⲛ|ⲡⲓ|ⲑⲱϩⲉⲙ
ⲉⲧⲁⲩⲑⲁϩⲙⲉϥ	ⲉⲧ|ⲁ|ⲩ|ⲑⲁϩⲙⲉ|ϥ
ⲁⲩⲑⲁϩⲙⲉⲕ	ⲁ|ⲩ|ⲑⲁϩⲙⲉ|ⲕ
ⲉⲕⲟⲓ	ⲉ|ⲕ|ⲟⲓ
ⲙⲡⲉⲛⲑⲣⲉⲥⲉⲣⲙⲉⲗⲓ	ⲙⲡⲉⲛⲑⲣⲉ|ⲥ|ⲉⲣⲙⲉⲗⲓ
ⲟⲩⲟⲛϣϫⲟⲙ	ⲟⲩⲟⲛ|ϣϫⲟⲙ
ⲉⲉⲣⲣⲉⲙϩⲉ	ⲉ|ⲉⲣⲣⲉⲙϩⲉ
ⲡⲓⲃⲱⲕ	ⲡⲓ|ⲃⲱⲕ
ⲟⲩⲁⲡⲉⲗⲉⲩⲑⲉⲣⲟⲥ	ⲟⲩ|ⲁⲡⲉⲗⲉⲩⲑⲉⲣⲟⲥ
ⲡⲓⲣⲉⲙϩⲉ	ⲡⲓ|ⲣⲉⲙϩⲉ
ⲟⲩⲃⲱⲕ	ⲟⲩ|ⲃⲱⲕ
ⲁⲩϣⲉⲡⲑⲏⲛⲟⲩ	ⲁ|ⲩ|ϣⲉⲡ|ⲑⲏⲛⲟⲩ
ϧⲁⲟⲩⲧⲓⲙⲏ	ϧⲁ|ⲟⲩ|ⲧⲓⲙⲏ
ⲙⲡⲉⲣⲉⲣⲃⲱⲕ	ⲙⲡⲉⲣ|ⲉⲣⲃⲱⲕ
ⲛⲛⲓⲣⲱⲙⲓ	ⲛ|ⲛⲓ|ⲣⲱⲙⲓ
ϧⲉⲛⲫⲏ	ϧⲉⲛ|ⲫⲏ
ϧⲁⲧⲉⲛⲫⲛⲟⲩϯ	ϧⲁⲧⲉⲛ|ⲫ|ⲛⲟⲩϯ
ⲉⲑⲃⲉⲛⲓⲡⲁⲣⲑⲉⲛⲟⲥ	ⲉⲑⲃⲉ|ⲛⲓ|ⲡⲁⲣⲑⲉⲛⲟⲥ
ⲙⲙⲟⲛⲧⲓ	ⲙⲙⲟⲛⲧ|ⲓ
ⲛⲧⲉⲛⲡϭⲟⲓⲥ	ⲛⲧⲉⲛ|ⲡ|ϭⲟⲓⲥ
ⲟⲩⲅⲛⲱⲙⲏ	ⲟⲩ|ⲅⲛⲱⲙⲏ
ⲡⲉⲧⲓϯ	ⲡ|ⲉⲧ|ⲓ|ϯ
ⲉⲁⲩⲛⲁⲓ	ⲉ|ⲁ|ⲩ|ⲛⲁⲓ
ϩⲓⲧⲉⲛⲡϭⲟⲓⲥ	ϩⲓⲧⲉⲛ|ⲡ|ϭⲟⲓⲥ
ⲉⲑⲣⲓϣⲱⲡⲓ	ⲉ|ⲑⲣ|ⲓ|ϣⲱⲡⲓ
ⲙⲡⲓⲥⲧⲟⲥ	ⲙ|ⲡⲓⲥⲧⲟⲥ
ϯⲙⲉⲩⲓ	ϯ|ⲙⲉⲩⲓ
ϫⲉⲛⲁⲛⲉⲫⲁⲓ	ϫⲉ|ⲛⲁⲛⲉ|ⲫⲁⲓ
ⲉⲑⲣⲉϥϣⲱⲡⲓ	ⲉ|ⲑⲣⲉ|ϥ|ϣⲱⲡⲓ
ⲉⲑⲃⲉϯⲁⲛⲁⲅⲕⲏ	ⲉⲑⲃⲉ|ϯ|ⲁⲛⲁⲅⲕⲏ
ⲕⲥⲟⲛϩ	ⲕ|ⲥⲟⲛϩ
ⲉⲥϩⲓⲙⲓ	ⲉ|ⲥϩⲓⲙⲓ
ⲙⲡⲉⲣⲕⲱϯ	ⲙⲡⲉⲣ|ⲕⲱϯ
ⲛⲥⲁⲃⲟⲗⲕ	ⲛⲥⲁ|ⲃⲟⲗ|ⲕ
ⲕⲃⲏⲗ	ⲕ|ⲃⲏⲗ
ⲛⲥϩⲓⲙⲓ	ⲛ|ⲥϩⲓⲙⲓ
ⲛⲥⲁⲥϩⲓⲙⲓ	ⲛⲥⲁ|ⲥϩⲓⲙⲓ
ⲁⲕϣⲁⲛϭⲓ	ⲁⲕϣⲁⲛ|ϭⲓ
ⲙⲡⲉⲕⲉⲣⲛⲟⲃⲓ	ⲙⲡⲉ|ⲕ|ⲉⲣⲛⲟⲃⲓ
ⲁⲥϣⲁⲛϭⲓ	ⲁⲥϣⲁⲛ|ϭⲓ
ⲛϫⲉϯⲡⲁⲣⲑⲉⲛⲟⲥ	ⲛϫⲉ|ϯ|ⲡⲁⲣⲑⲉⲛⲟⲥ
ⲙⲡⲁⲥⲉⲣⲛⲟⲃⲓ	ⲙⲡⲁ|ⲥ|ⲉⲣⲛⲟⲃⲓ
ⲉⲩⲉϭⲓ	ⲉⲩⲉ|ϭⲓ
ⲛϫⲉⲛⲁⲓ	ⲛϫⲉ|ⲛⲁⲓ
ϯϯⲁⲥⲟ	ϯ|ϯⲁⲥⲟ
ϫⲉⲡⲥⲏⲟⲩ	ϫⲉ|ⲡ|ⲥⲏⲟⲩ
ⲙⲡⲱⲣϥ	ⲙ|ⲡ|ⲱⲣϥ
ⲧⲟⲗⲟⲓⲡⲟⲛ	ⲧⲟⲗⲟⲓⲡⲟⲛ
ⲉⲧⲉⲟⲩⲟⲛⲧⲟⲩⲥϩⲓⲙⲓ	ⲉⲧⲉ|ⲟⲩⲟⲛⲧ|ⲟⲩ|ⲥϩⲓⲙⲓ
ⲛⲥⲉⲉⲣ	ⲛ|ⲥⲉ|ⲉⲣ
ⲉⲧⲉⲙⲙⲟⲛⲧⲱⲟⲩ	ⲉⲧⲉ|ⲙⲙⲟⲛⲧⲱ|ⲟⲩ
ⲉⲧⲣⲓⲙⲓ	ⲉⲧ|ⲣⲓⲙⲓ
ⲛⲥⲉⲣⲓⲙⲓ	ⲛ|ⲥⲉ|ⲣⲓⲙⲓ
ⲉⲧⲣⲁϣⲓ	ⲉⲧ|ⲣⲁϣⲓ
ⲛⲥⲉⲣⲁϣⲓ	ⲛ|ⲥⲉ|ⲣⲁϣⲓ
ⲉⲧϣⲱⲡ	ⲉⲧ|ϣⲱⲡ
ⲛⲥⲉⲁⲙⲟⲛⲓ	ⲛ|ⲥⲉ|ⲁⲙⲟⲛⲓ
ⲉⲧⲉⲣⲭⲣⲁⲥⲑⲉ	ⲉⲧ|ⲉⲣⲭⲣⲁⲥⲑⲉ
ⲛⲥⲉⲉⲣⲕⲁⲧⲁⲭⲣⲁⲥⲑⲉ	ⲛ|ⲥⲉ|ⲉⲣⲕⲁⲧⲁⲭⲣⲁⲥⲑⲉ
ϥⲛⲁⲥⲓⲛⲓ	ϥ|ⲛⲁ|ⲥⲓⲛⲓ
ⲉⲧⲉⲙⲡⲉϥϭⲓ	ⲉⲧⲉ|ⲙⲡⲉ|ϥ|ϭⲓ
ⲁϥϥⲓⲣⲱⲟⲩϣ	ⲁ|ϥ|ϥⲓⲣⲱⲟⲩϣ
ϧⲁⲛⲁⲡϭⲟⲓⲥ	ϧⲁ|ⲛⲁ|ⲡ|ϭⲟⲓⲥ
ϫⲉⲡⲱⲥ	ϫⲉ|ⲡⲱⲥ
ϥⲛⲁⲣⲁⲛⲁϥ	ϥ|ⲛⲁ|ⲣ|ⲁⲛⲁ|ϥ
ⲙⲡϭⲟⲓⲥ	ⲙ|ⲡ|ϭⲟⲓⲥ
ⲉⲧⲁϥϭⲓ	ⲉⲧ|ⲁ|ϥ|ϭⲓ
ϧⲁⲡⲓⲕⲟⲥⲙⲟⲥ	ϧⲁ|ⲡⲓ|ⲕⲟⲥⲙⲟⲥ
ϥⲛⲁⲣⲁⲛⲁⲥ	ϥ|ⲛⲁ|ⲣ|ⲁⲛⲁ|ⲥ
ⲛⲧⲉϥⲥϩⲓⲙⲓ	ⲛ|ⲧⲉϥ|ⲥϩⲓⲙⲓ
ϥⲫⲏϣ	ϥ|ⲫⲏϣ
ⲉⲧⲉⲙⲡⲉⲥϭⲓ	ⲉⲧⲉ|ⲙⲡⲉ|ⲥ|ϭⲓ
ⲛⲉⲙϯⲡⲁⲣⲑⲉⲛⲟⲥ	ⲛⲉⲙ|ϯ|ⲡⲁⲣⲑⲉⲛⲟⲥ
ⲑⲏ	ⲑⲏ
ⲁⲥϥⲓⲣⲱⲟⲩϣ	ⲁ|ⲥ|ϥⲓⲣⲱⲟⲩϣ
ⲛⲧⲉⲥϣⲱⲡⲓ	ⲛⲧⲉ|ⲥ|ϣⲱⲡⲓ
ϧⲉⲛⲡⲉⲥⲥⲱⲙⲁ	ϧⲉⲛ|ⲡⲉⲥ|ⲥⲱⲙⲁ
ⲛⲉⲙⲡⲉⲥⲡⲛⲉⲩⲙⲁ	ⲛⲉⲙ|ⲡⲉⲥ|ⲡⲛⲉⲩⲙⲁ
ⲉⲧⲁⲥϭⲓ	ⲉⲧ|ⲁ|ⲥ|ϭⲓ
ϧⲁⲛⲁⲡⲓⲕⲟⲥⲙⲟⲥ	ϧⲁ|ⲛⲁ|ⲡⲓ|ⲕⲟⲥⲙⲟⲥ
ⲥⲛⲁⲣⲁⲛⲁϥ	ⲥ|ⲛⲁ|ⲣ|ⲁⲛⲁ|ϥ
ⲉⲑⲃⲉⲡⲉⲧⲉⲣⲛⲟϥⲣⲓ	ⲉⲑⲃⲉ|ⲡ|ⲉⲧ|ⲉⲣⲛⲟϥⲣⲓ
ⲟⲩⲭⲓ	ⲟⲩⲭⲓ
ⲛⲧⲁϩⲓⲟⲩⲓ	ⲛ|ⲧⲁ|ϩⲓⲟⲩⲓ
ⲛⲟⲩϩⲁϫⲓ	ⲛ|ⲟⲩ|ϩⲁϫⲓ
ϧⲉⲛⲑⲏⲛⲟⲩ	ϧⲉⲛ|ⲑⲏⲛⲟⲩ
ⲛⲧⲉⲡⲉⲧⲉⲛⲥⲭⲏⲙⲁ	ⲛⲧⲉ|ⲡⲉⲧⲉⲛ|ⲥⲭⲏⲙⲁ
ⲛⲧⲉⲧⲉⲛⲙⲧⲟⲛ	ⲛⲧⲉ|ⲧⲉⲛ|ⲙⲧⲟⲛ
ⲙⲙⲟⲩⲛ	ⲙ|ⲙⲟⲩⲛ
ⲉⲡϭⲟⲓⲥ	ⲉ|ⲡ|ϭⲟⲓⲥ
ϧⲉⲛⲟⲩⲙⲉⲧⲁⲧϭⲓϩⲣⲁϥ	ϧⲉⲛ|ⲟⲩ|ⲙⲉⲧⲁⲧϭⲓϩⲣⲁϥ
ⲟⲩⲟⲛⲟⲩⲁⲓ	ⲟⲩⲟⲛ|ⲟⲩⲁⲓ
ⲙⲉⲩⲓ	ⲙⲉⲩⲓ
ⲉϭⲓϣⲓⲡⲓ	ⲉ|ϭⲓϣⲓⲡⲓ
ⲉϫⲉⲛⲧⲉϥⲡⲁⲣⲑⲉⲛⲟⲥ	ⲉϫⲉⲛ|ⲧⲉϥ|ⲡⲁⲣⲑⲉⲛⲟⲥ
ⲁϥϣⲁⲛⲉⲣⲁⲕⲙⲏ	ⲁϥϣⲁⲛ|ⲉⲣⲁⲕⲙⲏ
ⲛ	ⲛ
ϩⲟⲩⲟ	ϩⲟⲩⲟ
ⲡⲉⲧⲉⲙⲡϣⲁ	ⲡ|ⲉⲧ|ⲉⲙⲡϣⲁ
ⲛⲧⲉϥϣⲱⲡⲓ	ⲛⲧⲉ|ϥ|ϣⲱⲡⲓ
ⲡⲉⲧⲉϩⲛⲁϥ	ⲡ|ⲉⲧⲉ|ϩⲛⲁ|ϥ
ⲙⲁⲣⲉϥⲁⲓϥ	ⲙⲁⲣⲉ|ϥ|ⲁⲓ|ϥ
ⲛϥⲉⲣⲛⲟⲃⲓ	ⲛ|ϥ|ⲉⲣⲛⲟⲃⲓ
ⲉⲧⲟϩⲓ	ⲉⲧ|ⲟϩⲓ
ϧⲉⲛⲡⲉϥϩⲏⲧ	ϧⲉⲛ|ⲡⲉϥ|ϩⲏⲧ
ⲉϥⲧⲁϫⲣⲏⲟⲩⲧ	ⲉ|ϥ|ⲧⲁϫⲣⲏⲟⲩⲧ
ⲙⲙⲟⲛⲁⲛⲁⲅⲕⲏ	ⲙⲙⲟⲛ|ⲁⲛⲁⲅⲕⲏ
ⲧⲟⲓ	ⲧⲟⲓ
ⲉⲑⲃⲉⲡⲉⲧⲉϩⲛⲁϥ	ⲉⲑⲃⲉ|ⲡ|ⲉⲧⲉ|ϩⲛⲁ|ϥ
ϥϯϩⲁⲡ	ϥ|ϯϩⲁⲡ
ⲉⲁⲣⲉϩ	ⲉ|ⲁⲣⲉϩ
ⲉⲧⲉϥⲡⲁⲣⲑⲉⲛⲟⲥ	ⲉ|ⲧⲉϥ|ⲡⲁⲣⲑⲉⲛⲟⲥ
ⲕⲁⲗⲱⲥ	ⲕⲁⲗⲱⲥ
ϥⲛⲁⲁⲓⲥ	ϥ|ⲛⲁ|ⲁⲓ|ⲥ
ⲉⲧϯ	ⲉⲧ|ϯ
ⲛⲧⲉϥⲡⲁⲣⲑⲉⲛⲟⲥ	ⲛ|ⲧⲉϥ|ⲡⲁⲣⲑⲉⲛⲟⲥ
ⲉⲩⲅⲁⲙⲟⲥ	ⲉ|ⲩ|ⲅⲁⲙⲟⲥ
ϥⲣⲁ	ϥ|ⲣⲁ
ⲉⲧⲉⲛϥϯ	ⲉⲧⲉ|ⲛ|ϥ|ϯ
ⲛⲑⲱϥ	ⲛ|ⲑⲱϥ
ⲟⲩϩⲟⲩⲟ	ⲟⲩ|ϩⲟⲩⲟ
ⲡⲉⲧⲉϥⲛⲁⲁⲓϥ	ⲡ|ⲉⲧⲉ|ϥ|ⲛⲁ|ⲁⲓ|ϥ
ⲥⲟⲛϩ	ⲥⲟⲛϩ
ⲉⲡϩⲟⲥⲟⲛ	ⲉ|ⲡ|ϩⲟⲥⲟⲛ
ⲭⲣⲟⲛⲟⲛ	ⲭⲣⲟⲛⲟⲛ
ⲉϥⲟⲛϧ	ⲉ|ϥ|ⲟⲛϧ
ⲁϥϣⲁⲛⲉⲛⲕⲟⲧ	ⲁϥϣⲁⲛ|ⲉⲛⲕⲟⲧ
ⲛϫⲉⲡⲉⲥϩⲁⲓ	ⲛϫⲉ|ⲡⲉⲥ|ϩⲁⲓ
ⲟⲩⲣⲉⲙϩⲏ	ⲟⲩ|ⲣⲉⲙϩⲏ
ⲙⲡⲉⲧⲉϩⲛⲁⲥ	ⲙ|ⲡ|ⲉⲧⲉ|ϩⲛⲁ|ⲥ
ⲱⲟⲩⲛⲓⲁⲧ	ⲱⲟⲩⲛⲓⲁⲧ
ⲥ	ⲥ
ⲁⲥϣⲁⲛⲟϩⲓ	ⲁⲥϣⲁⲛ|ⲟϩⲓ
ⲕⲁⲧⲁⲧⲁⲅⲛⲱⲙⲏ	ⲕⲁⲧⲁ|ⲧⲁ|ⲅⲛⲱⲙⲏ
ϫⲉⲟⲩⲟⲛⲟⲩⲡⲛⲉⲩⲙⲁ	ϫⲉ|ⲟⲩⲟⲛ|ⲟⲩ|ⲡⲛⲉⲩⲙⲁ
ⲛϧⲏⲧ	ⲛϧⲏⲧ
ⲁⲓϣⲁⲛⲥⲁϫⲓ	ⲁⲓϣⲁⲛ|ⲥⲁϫⲓ
ϧⲉⲛⲫⲗⲁⲥ	ϧⲉⲛ|ⲫ|ⲗⲁⲥ
ⲛⲉⲙⲫⲁⲛⲓⲁⲅⲅⲉⲗⲟⲥ	ⲛⲉⲙ|ⲫⲁ|ⲛⲓ|ⲁⲅⲅⲉⲗⲟⲥ
ⲙⲙⲟⲛϯ	ⲙⲙⲟⲛ|ϯ
ⲁⲅⲁⲡⲏ	ⲁⲅⲁⲡⲏ
ⲁⲓⲉⲣ	ⲁ|ⲓ|ⲉⲣ
ⲛⲟⲩϩⲟⲙⲧ	ⲛ|ⲟⲩ|ϩⲟⲙⲧ
ⲉϥⲥⲉⲛⲥⲉⲛ	ⲉ|ϥ|ⲥⲉⲛⲥⲉⲛ
ⲟⲩⲕⲩⲙⲃⲁⲗⲟⲛ	ⲟⲩ|ⲕⲩⲙⲃⲁⲗⲟⲛ
ⲉϥⲉϣⲗⲏⲗⲟⲩⲓ	ⲉ|ϥ|ⲉϣⲗⲏⲗⲟⲩⲓ
ⲛⲧⲏⲓ	ⲛⲧⲏ|ⲓ
ⲛⲟⲩⲡⲣⲟⲫⲏⲧⲓⲁ	ⲛ|ⲟⲩ|ⲡⲣⲟⲫⲏⲧⲓⲁ
ⲉⲓⲥⲱⲟⲩⲛ	ⲉ|ⲓ|ⲥⲱⲟⲩⲛ
ⲛⲛⲓⲙⲩⲥⲧⲏⲣⲓⲟⲛ	ⲛ|ⲛⲓ|ⲙⲩⲥⲧⲏⲣⲓⲟⲛ
ⲛⲉⲙⲡⲉⲙⲓ	ⲛⲉⲙ|ⲡ|ⲉⲙⲓ
ⲉⲣⲉⲫⲛⲁϩϯ	ⲉⲣⲉ|ⲫ|ⲛⲁϩϯ
ⲛⲧⲟⲧ	ⲛⲧⲟⲧ
ⲉⲟⲩⲱⲧⲉⲃ	ⲉ|ⲟⲩⲱⲧⲉⲃ
ⲛϩⲁⲛⲧⲱⲟⲩ	ⲛ|ϩⲁⲛ|ⲧⲱⲟⲩ
ⲁⲓϣⲁⲛϯ	ⲁⲓϣⲁⲛ|ϯ
ⲉⲧⲉⲛⲟⲩⲓ	ⲉⲧⲉ|ⲛⲟⲩⲓ
ⲉⲑⲣⲟⲩⲟⲩⲟⲙⲟⲩ	ⲉ|ⲑⲣⲟ|ⲩ|ⲟⲩⲟⲙ|ⲟⲩ
ⲛⲧⲁϯ	ⲛ|ⲧⲁ|ϯ
ⲙⲡⲁⲕⲉⲥⲱⲙⲁ	ⲙ|ⲡⲁ|ⲕⲉ|ⲥⲱⲙⲁ
ⲛⲧⲁϣⲟⲩϣⲟⲩ	ⲛ|ⲧⲁ|ϣⲟⲩϣⲟⲩ
ⲛϯϫⲉⲙϩⲏⲟⲩ	ⲛ|ϯ|ϫⲉⲙϩⲏⲟⲩ
ⲛϩⲗⲓ	ⲛ|ϩⲗⲓ
ϯⲁⲅⲁⲡⲏ	ϯ|ⲁⲅⲁⲡⲏ
ϣⲁⲥⲱⲟⲩ	ϣⲁ|ⲥ|ⲱⲟⲩ
ϣⲁⲥⲉⲣϩⲉⲗϫⲉ	ϣⲁ|ⲥ|ⲉⲣϩⲉⲗϫⲉ
ⲙⲡⲁⲥⲭⲟϩ	ⲙⲡⲁ|ⲥ|ⲭⲟϩ
ⲙⲡⲁⲥⲉⲣⲡⲉⲣⲡⲉⲣⲟⲥ	ⲙⲡⲁ|ⲥ|ⲉⲣⲡⲉⲣⲡⲉⲣⲟⲥ
ⲙⲡⲁⲥϭⲓⲥⲓ	ⲙⲡⲁ|ⲥ|ϭⲓⲥⲓ
ⲙⲡⲁⲥⲕⲱϯ	ⲙⲡⲁ|ⲥ|ⲕⲱϯ
ⲛⲥⲁⲛⲏ	ⲛⲥⲁ|ⲛⲏ
ⲉⲧⲉⲛⲟⲩⲥ	ⲉⲧⲉ|ⲛⲟⲩⲥ
ⲙⲡⲁⲥϫⲱⲛⲧ	ⲙⲡⲁ|ⲥ|ϫⲱⲛⲧ
ⲙⲡⲁⲥⲙⲉⲩⲓ	ⲙⲡⲁ|ⲥ|ⲙⲉⲩⲓ
ⲉⲡⲓⲡⲉⲧϩⲱⲟⲩ	ⲉ|ⲡⲓ|ⲡⲉⲧϩⲱⲟⲩ
ⲙⲡⲁⲥⲣⲁϣⲓ	ⲙⲡⲁ|ⲥ|ⲣⲁϣⲓ
ⲉϫⲉⲛⲑⲙⲉⲧϭⲓ	ⲉϫⲉⲛ|ⲑⲙⲉⲧϭⲓ
ϣⲁⲥⲣⲁϣⲓ	ϣⲁ|ⲥ|ⲣⲁϣⲓ
ⲉϫⲉⲛⲑⲙⲏⲓ	ⲉϫⲉⲛ|ⲑⲙⲏⲓ
ϧⲉⲛϩⲱⲃ	ϧⲉⲛ|ϩⲱⲃ
ϣⲁⲥⲛⲁϩϯ	ϣⲁ|ⲥ|ⲛⲁϩϯ
ϣⲁⲥⲉⲣϩⲉⲗⲡⲓⲥ	ϣⲁ|ⲥ|ⲉⲣϩⲉⲗⲡⲓⲥ
ϣⲁⲥⲁⲙⲟⲛⲓ	ϣⲁ|ⲥ|ⲁⲙⲟⲛⲓ
ⲛⲧⲟⲧⲥ	ⲛⲧⲟⲧ|ⲥ
ⲙⲡⲁⲥϩⲉⲓ	ⲙⲡⲁ|ⲥ|ϩⲉⲓ
ⲉⲛⲉϩ	ⲉⲛⲉϩ
ⲓⲧⲉ	ⲓⲧⲉ
ⲛⲓⲡⲣⲟⲫⲏⲧⲓⲁ	ⲛⲓ|ⲡⲣⲟⲫⲏⲧⲓⲁ
ⲥⲉⲛⲁⲕⲱⲣϥ	ⲥⲉ|ⲛⲁ|ⲕⲱⲣϥ
ⲛⲓⲗⲁⲥ	ⲛⲓ|ⲗⲁⲥ
ⲥⲉⲛⲁⲗⲟϫⲟⲩ	ⲥⲉ|ⲛⲁ|ⲗⲟϫ|ⲟⲩ
ⲟⲩⲉⲙⲓ	ⲟⲩ|ⲉⲙⲓ
ϥⲛⲁⲕⲱⲣϥ	ϥ|ⲛⲁ|ⲕⲱⲣϥ
ϧⲉⲛⲟⲩⲙⲉⲣⲟⲥ	ϧⲉⲛ|ⲟⲩ|ⲙⲉⲣⲟⲥ
ⲧⲉⲛⲉⲙⲓ	ⲧⲉⲛ|ⲉⲙⲓ
ⲧⲉⲛⲉⲣⲡⲣⲟⲫⲏⲧⲉⲩⲓⲛ	ⲧⲉⲛ|ⲉⲣⲡⲣⲟⲫⲏⲧⲉⲩⲓⲛ
ⲁϥϣⲁⲛⲓ	ⲁϥϣⲁⲛ|ⲓ
ⲛϫⲉⲡⲓⲧⲉⲗⲓⲟⲛ	ⲛϫⲉ|ⲡⲓ|ⲧⲉⲗⲓⲟⲛ
ⲡⲓⲁⲡⲟⲙⲉⲣⲟⲥ	ⲡⲓ|ⲁⲡⲟⲙⲉⲣⲟⲥ
ⲉⲓⲟⲓ	ⲉ|ⲓ|ⲟⲓ
ⲛⲁⲓⲥⲁϫⲓ	ⲛⲁ|ⲓ|ⲥⲁϫⲓ
ⲛⲟⲩⲁⲗⲟⲩ	ⲛ|ⲟⲩ|ⲁⲗⲟⲩ
ⲛⲁⲓⲥⲟϭⲛⲓ	ⲛⲁ|ⲓ|ⲥⲟϭⲛⲓ
ⲛⲁⲓⲙⲉⲩⲓ	ⲛⲁ|ⲓ|ⲙⲉⲩⲓ
ϩⲟⲧⲉ	ϩⲟⲧⲉ
ⲉⲧⲁⲓⲉⲣⲣⲱⲙⲓ	ⲉⲧ|ⲁ|ⲓ|ⲉⲣⲣⲱⲙⲓ
ⲁⲓⲕⲱⲣϥ	ⲁ|ⲓ|ⲕⲱⲣϥ
ⲛⲛⲁϯⲙⲉⲧⲁⲗⲟⲩ	ⲛ|ⲛⲁ|ϯ|ⲙⲉⲧⲁⲗⲟⲩ
ⲧⲉⲛⲛⲁⲩ	ⲧⲉⲛ|ⲛⲁⲩ
ϩⲓⲧⲉⲛⲟⲩⲓⲁⲗ	ϩⲓⲧⲉⲛ|ⲟⲩ|ⲓⲁⲗ
ϧⲉⲛⲟⲩⲑⲟⲛⲧⲉⲛ	ϧⲉⲛ|ⲟⲩ|ⲑⲟⲛⲧⲉⲛ
ⲧⲉⲛⲛⲁⲛⲁⲩ	ⲧⲉⲛ|ⲛⲁ|ⲛⲁⲩ
ⲛϩⲟ	ⲛ|ϩⲟ
ⲟⲩⲃⲉϩⲟ	ⲟⲩⲃⲉ|ϩⲟ
ⲁⲓⲉⲙⲓ	ⲁ|ⲓ|ⲉⲙⲓ
ϧⲉⲛⲡⲓⲥⲏⲟⲩ	ϧⲉⲛ|ⲡⲓ|ⲥⲏⲟⲩ
ϯⲛⲁⲉⲙⲓ	ϯ|ⲛⲁ|ⲉⲙⲓ
ⲉⲧⲁⲩⲥⲟⲩⲱⲛⲧ	ⲉⲧ|ⲁ|ⲩ|ⲥⲟⲩⲱⲛ|ⲧ
ⲡⲁⲓⲅ	ⲡⲁⲓ|ⲅ
ⲥⲉⲥⲙⲟⲛⲧ	ⲥⲉ|ⲥⲙⲟⲛⲧ
ⲫⲛⲁϩϯ	ⲫ|ⲛⲁϩϯ
ⲧⲁⲅⲁⲡⲏ	ⲧ|ⲁⲅⲁⲡⲏ
ⲡⲉⲧⲛⲁⲁϥ	ⲡ|ⲉⲧ|ⲛⲁⲁ|ϥ
ⲉⲑⲃⲉⲛⲓⲡⲛⲉⲩⲙⲁⲧⲓⲕⲟⲛ	ⲉⲑⲃⲉ|ⲛⲓ|ⲡⲛⲉⲩⲙⲁⲧⲓⲕⲟⲛ
ⲛⲁⲥⲛⲏⲩ	ⲛⲁ|ⲥⲛⲏⲩ
ⲛϯⲟⲩⲉϣⲑⲏⲛⲟⲩ	ⲛ|ϯ|ⲟⲩⲉϣ|ⲑⲏⲛⲟⲩ
ⲛⲁⲧⲉⲙⲓ	ⲛ|ⲁⲧⲉⲙⲓ
ⲧⲉⲧⲉⲛⲉⲙⲓ	ⲧⲉⲧⲉⲛ|ⲉⲙⲓ
ϫⲉⲉⲣⲉⲧⲉⲛⲟⲓ	ϫⲉ|ⲉⲣⲉ|ⲧⲉⲛ|ⲟⲓ
ⲛⲉⲑⲛⲟⲥ	ⲛ|ⲉⲑⲛⲟⲥ
ⲉⲣⲉⲧⲉⲛⲭⲏ	ⲉⲣⲉ|ⲧⲉⲛ|ⲭⲏ
ϧⲁⲛⲓⲓⲇⲱⲗⲟⲛ	ϧⲁ|ⲛⲓ|ⲓⲇⲱⲗⲟⲛ
ⲛⲁⲧϧⲣⲱⲟⲩ	ⲛ|ⲁⲧϧⲣⲱⲟⲩ
ⲛⲁⲣⲉⲧⲉⲛⲙⲟϣⲓ	ⲛⲁⲣⲉ|ⲧⲉⲛ|ⲙⲟϣⲓ
ⲉⲧⲁⲩⲉⲛⲑⲏⲛⲟⲩ	ⲉⲧ|ⲁ|ⲩ|ⲉⲛ|ⲑⲏⲛⲟⲩ
ⲉⲑⲃⲉⲫⲁⲓ	ⲉⲑⲃⲉ|ⲫⲁⲓ
ϯⲧⲁⲙⲟ	ϯ|ⲧⲁⲙⲟ
ⲉϥⲥⲁϫⲓ	ⲉ|ϥ|ⲥⲁϫⲓ
ϧⲉⲛⲡⲓⲡⲛⲉⲩⲙⲁ	ϧⲉⲛ|ⲡⲓ|ⲡⲛⲉⲩⲙⲁ
ϫⲉⲟⲩⲟⲛⲟⲩⲁⲛⲁⲑⲉⲙⲁ	ϫⲉ|ⲟⲩⲟⲛ|ⲟⲩ|ⲁⲛⲁⲑⲉⲙⲁ
ϣϫⲟⲙ	ϣϫⲟⲙ
ⲛⲧⲉϩⲗⲓ	ⲛⲧⲉ|ϩⲗⲓ
ϫⲉⲡϭⲟⲓⲥ	ϫⲉ|ⲡ|ϭⲟⲓⲥ
ϧⲉⲛⲟⲩⲡⲛⲉⲩⲙⲁ	ϧⲉⲛ|ⲟⲩ|ⲡⲛⲉⲩⲙⲁ
ⲟⲩⲟⲛϩⲁⲛⲧⲟⲓ	ⲟⲩⲟⲛ|ϩⲁⲛ|ⲧⲟⲓ
ⲙⲫⲱϣ	ⲙ|ⲫⲱϣ
ⲉⲩϣⲟⲡ	ⲉ|ⲩ|ϣⲟⲡ
ⲛⲧⲉϩⲁⲛϩⲙⲟⲧ	ⲛⲧⲉ|ϩⲁⲛ|ϩⲙⲟⲧ
ⲉⲡⲁⲓⲡⲛⲉⲩⲙⲁ	ⲉ|ⲡⲁⲓ|ⲡⲛⲉⲩⲙⲁ
ⲛⲧⲉϩⲁⲛⲇⲓⲁⲕⲱⲛⲓⲁ	ⲛⲧⲉ|ϩⲁⲛ|ⲇⲓⲁⲕⲱⲛⲓⲁ
ⲉⲡⲁⲓϭⲟⲓⲥ	ⲉ|ⲡⲁⲓ|ϭⲟⲓⲥ
ⲛⲧⲉϩⲁⲛϩⲃⲏⲟⲩⲓ	ⲛⲧⲉ|ϩⲁⲛ|ϩⲃⲏⲟⲩⲓ
ⲉⲡⲁⲓⲛⲟⲩϯ	ⲉ|ⲡⲁⲓ|ⲛⲟⲩϯ
ⲉⲧⲉⲣϩⲱⲃ	ⲉⲧ|ⲉⲣϩⲱⲃ
ⲛⲉⲛⲭⲁⲓ	ⲛ|ⲉⲛⲭⲁⲓ
ϧⲉⲛⲟⲩⲟⲛ	ϧⲉⲛ|ⲟⲩⲟⲛ
ⲥⲉϯ	ⲥⲉ|ϯ
ⲙⲫⲟⲩⲱⲛϩ	ⲙ|ⲫ|ⲟⲩⲱⲛϩ
ⲕⲁⲧⲁⲡⲉⲧⲉⲣⲛⲟϥⲣⲓ	ⲕⲁⲧⲁ|ⲡ|ⲉⲧ|ⲉⲣⲛⲟϥⲣⲓ
ϣⲁⲩϯ	ϣⲁ|ⲩ|ϯ
ⲛⲥⲟⲫⲓⲁ	ⲛ|ⲥⲟⲫⲓⲁ
ⲛⲉⲙⲓ	ⲛ|ⲉⲙⲓ
ⲕⲁⲧⲁⲡⲁⲓⲡⲛⲉⲩⲙⲁ	ⲕⲁⲧⲁ|ⲡⲁⲓ|ⲡⲛⲉⲩⲙⲁ
ⲛⲟⲩⲛⲁϩϯ	ⲛ|ⲟⲩ|ⲛⲁϩϯ
ϧⲉⲛⲡⲁⲓⲡⲛⲉⲩⲙⲁ	ϧⲉⲛ|ⲡⲁⲓ|ⲡⲛⲉⲩⲙⲁ
ⲛϩⲁⲛϩⲙⲟⲧ	ⲛ|ϩⲁⲛ|ϩⲙⲟⲧ
ⲛⲧⲁⲗϭⲟ	ⲛ|ⲧⲁⲗϭⲟ
ⲛϩⲁⲛϩⲃⲏⲟⲩⲓ	ⲛ|ϩⲁⲛ|ϩⲃⲏⲟⲩⲓ
ⲛϫⲟⲙ	ⲛ|ϫⲟⲙ
ⲟⲩⲡⲣⲟⲫⲏⲧⲓⲁ	ⲟⲩ|ⲡⲣⲟⲫⲏⲧⲓⲁ
ϩⲁⲛⲃⲱⲗ	ϩⲁⲛ|ⲃⲱⲗ
ⲙⲡⲛⲉⲩⲙⲁ	ⲙ|ⲡⲛⲉⲩⲙⲁ
ϩⲁⲛⲅⲉⲛⲟⲥ	ϩⲁⲛ|ⲅⲉⲛⲟⲥ
ⲛⲗⲁⲥ	ⲛ|ⲗⲁⲥ
ⲟⲩⲉⲣⲙⲏⲛⲓⲁ	ⲟⲩ|ⲉⲣⲙⲏⲛⲓⲁ
ⲡⲁⲓⲡⲛⲉⲩⲙⲁ	ⲡⲁⲓ|ⲡⲛⲉⲩⲙⲁ
ⲉϥⲫⲱϣ	ⲉ|ϥ|ⲫⲱϣ
ⲉⲧⲉϩⲛⲁϥ	ⲉⲧ|ⲉϩⲛⲁ|ϥ
ⲉⲧⲉⲡⲓⲥⲱⲙⲁ	ⲉⲧⲉ|ⲡⲓ|ⲥⲱⲙⲁ
ⲟⲩⲟⲛⲧⲁϥ	ⲟⲩⲟⲛⲧⲁ|ϥ
ⲙⲙⲉⲗⲟⲥ	ⲙ|ⲙⲉⲗⲟⲥ
ⲛⲓⲙⲉⲗⲟⲥ	ⲛⲓ|ⲙⲉⲗⲟⲥ
ⲛⲧⲉⲡⲓⲥⲱⲙⲁ	ⲛⲧⲉ|ⲡⲓ|ⲥⲱⲙⲁ
ⲉⲩⲟⲓ	ⲉ|ⲩ|ⲟⲓ
ⲛⲥⲱⲙⲁ	ⲛ|ⲥⲱⲙⲁ
ⲕⲉ	ⲕⲉ
ⲁⲛⲟⲛ	ⲁⲛⲟⲛ
ⲧⲏⲣⲉⲛ	ⲧⲏⲣ|ⲉⲛ
ⲉⲧⲁⲛϭⲓⲱⲙⲥ	ⲉⲧ|ⲁ|ⲛ|ϭⲓⲱⲙⲥ
ⲛⲟⲩⲱⲧ	ⲛ|ⲟⲩⲱⲧ
ⲉⲩⲥⲱⲙⲁ	ⲉ|ⲩ|ⲥⲱⲙⲁ
ⲛⲓⲓⲟⲩⲇⲁⲓ	ⲛⲓ|ⲓⲟⲩⲇⲁⲓ
ⲛⲓⲟⲩⲉⲓⲛⲓⲛ	ⲛⲓ|ⲟⲩⲉⲓⲛⲓⲛ
ⲃⲱⲕ	ⲃⲱⲕ
ⲣⲉⲙϩⲉ	ⲣⲉⲙϩⲉ
ⲁⲩⲧⲥⲟⲛ	ⲁ|ⲩ|ⲧⲥⲟ|ⲛ
ⲛⲟⲩⲡⲛⲉⲩⲙⲁ	ⲛ|ⲟⲩ|ⲡⲛⲉⲩⲙⲁ
ⲡⲓⲥⲱⲙⲁ	ⲡⲓ|ⲥⲱⲙⲁ
ⲛⲟⲩⲙⲉⲗⲟⲥ	ⲛ|ⲟⲩ|ⲙⲉⲗⲟⲥ
ⲁⲣⲉϣⲁⲛϯϭⲁⲗⲟϫ	ⲁⲣⲉϣⲁⲛ|ϯ|ϭⲁⲗⲟϫ
ⲟⲩϫⲓϫ	ⲟⲩ|ϫⲓϫ
ϧⲉⲛⲡⲓⲥⲱⲙⲁ	ϧⲉⲛ|ⲡⲓ|ⲥⲱⲙⲁ
ⲡⲁⲣⲁ	ⲡⲁⲣⲁ
ⲧⲟⲩⲧⲟ	ⲧⲟⲩⲧⲟ
ⲁⲣⲉϣⲁⲛⲡⲓⲙⲁϣϫ	ⲁⲣⲉϣⲁⲛ|ⲡⲓ|ⲙⲁϣϫ
ⲟⲩⲃⲁⲗ	ⲟⲩ|ⲃⲁⲗ
ⲉⲛⲉⲡⲓⲥⲱⲙⲁ	ⲉⲛⲉ|ⲡⲓ|ⲥⲱⲙⲁ
ⲡⲓⲥⲱⲧⲉⲙ	ⲡⲓ|ⲥⲱⲧⲉⲙ
ⲉⲛⲉⲟⲩⲥⲱⲧⲉⲙ	ⲉⲛⲉ|ⲟⲩ|ⲥⲱⲧⲉⲙ
ⲁϥⲑⲱⲛ	ⲁ|ϥ|ⲑⲱⲛ
ⲡⲓϣⲱⲗⲉⲙ	ⲡⲓ|ϣⲱⲗⲉⲙ
ⲛⲛⲓⲙⲉⲗⲟⲥ	ⲛ|ⲛⲓ|ⲙⲉⲗⲟⲥ
ⲉⲧⲁϥⲟⲩⲱϣ	ⲉⲧ|ⲁ|ϥ|ⲟⲩⲱϣ
ⲉⲛⲉⲟⲩⲙⲉⲗⲟⲥ	ⲉⲛⲉ|ⲟⲩ|ⲙⲉⲗⲟⲥ
ⲛⲧⲉⲡⲓⲃⲁⲗ	ⲛⲧⲉ|ⲡⲓ|ⲃⲁⲗ
ⲛϯϫⲓϫ	ⲛ|ϯ|ϫⲓϫ
ϫⲉϯⲉⲣⲭⲣⲓⲁ	ϫⲉ|ϯ|ⲉⲣⲭⲣⲓⲁ
ⲙⲙⲟ	ⲙⲙⲟ
ϯⲁⲫⲉ	ϯ|ⲁⲫⲉ
ⲛⲛⲓϭⲁⲗⲁⲩϫ	ⲛ|ⲛⲓ|ϭⲁⲗⲁⲩϫ
ⲉⲧⲟⲩⲙⲉⲩⲓ	ⲉⲧ|ⲟⲩ|ⲙⲉⲩⲓ
ϫⲉⲥⲉⲟⲓ	ϫⲉ|ⲥⲉ|ⲟⲓ
ⲛϫⲱⲃ	ⲛ|ϫⲱⲃ
ϩⲁⲛⲁⲛⲁⲅⲕⲉⲟⲛ	ϩⲁⲛ|ⲁⲛⲁⲅⲕⲉⲟⲛ
ⲛϩⲟⲩⲟ	ⲛ|ϩⲟⲩⲟ
ⲉⲧⲉⲛⲙⲉⲩⲓ	ⲉⲧ|ⲉⲛ|ⲙⲉⲩⲓ
ϫⲉⲥⲉϣⲏϣ	ϫⲉ|ⲥⲉ|ϣⲏϣ
ⲛϯ	ⲛ|ϯ
ⲛⲟⲩⲧⲁⲓⲟ	ⲛ|ⲟⲩ|ⲧⲁⲓⲟ
ⲉⲧⲁϫⲁⲓⲱⲟⲩ	ⲉⲧ|ⲁ|ϫⲁⲓⲱⲟⲩ
ⲛⲧⲁⲛ	ⲛⲧⲁ|ⲛ
ⲟⲩⲟⲛⲛⲧⲱⲟⲩ	ⲟⲩⲟⲛ|ⲛⲧⲱ|ⲟⲩ
ⲉⲥⲁⲓ	ⲉ|ⲥⲁⲓ
ⲉⲧⲥⲁⲓⲱⲟⲩ	ⲉⲧ|ⲥⲁⲓⲱⲟⲩ
ⲥⲉⲉⲣⲭⲣⲓⲁ	ⲥⲉ|ⲉⲣⲭⲣⲓⲁ
ⲁϥⲑⲉⲧ	ⲁ|ϥ|ⲑⲉⲧ
ⲉⲁϥϯ	ⲉ|ⲁ|ϥ|ϯ
ⲛⲟⲩϩⲟⲩⲟ	ⲛ|ⲟⲩ|ϩⲟⲩⲟ
ⲧⲁⲓⲟ	ⲧⲁⲓⲟ
ⲉⲧϣⲁⲧ	ⲉⲧ|ϣⲁⲧ
ⲛⲧⲉϣⲧⲉⲙⲫⲱⲣϫ	ⲛⲧⲉ|ϣⲧⲉⲙ|ⲫⲱⲣϫ
ⲛⲧⲉⲛⲓⲙⲉⲗⲟⲥ	ⲛⲧⲉ|ⲛⲓ|ⲙⲉⲗⲟⲥ
ϥⲓⲣⲱⲟⲩϣ	ϥⲓⲣⲱⲟⲩϣ
ϧⲁⲛⲟⲩⲉⲣⲏⲩ	ϧⲁ|ⲛⲟⲩ|ⲉⲣⲏⲩ
ⲉⲟⲩⲟⲛⲟⲩⲙⲉⲗⲟⲥ	ⲉ|ⲟⲩⲟⲛ|ⲟⲩ|ⲙⲉⲗⲟⲥ
ϭⲓⲙⲕⲁϩ	ϭⲓⲙⲕⲁϩ
ϣⲁⲣⲉⲛⲓⲙⲉⲗⲟⲥ	ϣⲁⲣⲉ|ⲛⲓ|ⲙⲉⲗⲟⲥ
ⲟⲩⲙⲉⲗⲟⲥ	ⲟⲩ|ⲙⲉⲗⲟⲥ
ϭⲓⲱⲟⲩ	ϭⲓⲱⲟⲩ
ⲣⲁϣⲓ	ⲣⲁϣⲓ
ⲡⲥⲱⲙⲁ	ⲡ|ⲥⲱⲙⲁ
ⲙⲡⲭⲣⲓⲥⲧⲟⲥ	ⲙ|ⲡ|ⲭⲣⲓⲥⲧⲟⲥ
ⲛⲉⲙⲛⲉϥⲙⲉⲗⲟⲥ	ⲛⲉⲙ|ⲛⲉϥ|ⲙⲉⲗⲟⲥ
ⲭⲁⲩ	ⲭⲁ|ⲩ
ϣⲟⲣⲡ	ϣⲟⲣⲡ
ϩⲁⲛⲁⲡⲟⲥⲧⲟⲗⲟⲥ	ϩⲁⲛ|ⲁⲡⲟⲥⲧⲟⲗⲟⲥ
ⲫⲙⲁϩⲃ	ⲫ|ⲙⲁϩⲃ
ϩⲁⲛⲡⲣⲟⲫⲏⲧⲏⲥ	ϩⲁⲛ|ⲡⲣⲟⲫⲏⲧⲏⲥ
ⲫⲙⲁϩⲅ	ⲫ|ⲙⲁϩⲅ
ϩⲁⲛⲣⲉϥϯⲥⲃⲱ	ϩⲁⲛ|ⲣⲉϥϯⲥⲃⲱ
ⲙⲉⲛⲉⲛⲥⲁⲛⲁⲓ	ⲙⲉⲛⲉⲛⲥⲁ|ⲛⲁⲓ
ϩⲁⲛϫⲟⲙ	ϩⲁⲛ|ϫⲟⲙ
ⲓⲧⲁ	ⲓⲧⲁ
ϩⲁⲛϩⲙⲟⲧ	ϩⲁⲛ|ϩⲙⲟⲧ
ϩⲁⲛⲙⲉⲧⲣⲉϥϯⲧⲟⲧⲟⲩ	ϩⲁⲛ|ⲙⲉⲧⲣⲉϥϯⲧⲟⲧ|ⲟⲩ
ϩⲁⲛⲙⲉⲧⲣⲉϥⲉⲣϩⲉⲙⲓ	ϩⲁⲛ|ⲙⲉⲧⲣⲉϥⲉⲣϩⲉⲙⲓ
ⲥⲉⲛⲁⲉⲣⲁⲡⲟⲥⲧⲟⲗⲟⲥ	ⲥⲉ|ⲛⲁ|ⲉⲣⲁⲡⲟⲥⲧⲟⲗⲟⲥ
ⲥⲉⲛⲁⲉⲣⲡⲣⲟⲫⲏⲧⲏⲥ	ⲥⲉ|ⲛⲁ|ⲉⲣⲡⲣⲟⲫⲏⲧⲏⲥ
ⲥⲉⲛⲁⲉⲣⲣⲉϥϯⲥⲃⲱ	ⲥⲉ|ⲛⲁ|ⲉⲣⲣⲉϥϯⲥⲃⲱ
ⲥⲉⲛⲁⲉⲣϫⲟⲙ	ⲥⲉ|ⲛⲁ|ⲉⲣϫⲟⲙ
ⲥⲉⲛⲁⲥⲁϫⲓ	ⲥⲉ|ⲛⲁ|ⲥⲁϫⲓ
ϧⲉⲛϩⲁⲛⲗⲁⲥ	ϧⲉⲛ|ϩⲁⲛ|ⲗⲁⲥ
ⲥⲉⲛⲁⲉⲣⲙⲉⲛⲉⲩⲓⲛ	ⲥⲉ|ⲛⲁ|ⲉⲣⲙⲉⲛⲉⲩⲓⲛ
ⲭⲟϩ	ⲭⲟϩ
ⲉⲛⲓϩⲙⲟⲧ	ⲉ|ⲛⲓ|ϩⲙⲟⲧ
ⲉⲧⲛⲁⲁⲩ	ⲉⲧ|ⲛⲁ|ⲁ|ⲩ
ϯⲛⲁⲧⲁⲙⲱⲧⲉⲛ	ϯ|ⲛⲁ|ⲧⲁⲙⲱ|ⲧⲉⲛ
ⲉⲕⲉⲙⲱⲓⲧ	ⲉ|ⲕⲉ|ⲙⲱⲓⲧ
ⲉⲛⲁⲁϥ	ⲉ|ⲛⲁ|ⲁ|ϥ
ⲡⲁⲡⲟⲥⲧⲟⲗⲟⲥ	ⲡ|ⲁⲡⲟⲥⲧⲟⲗⲟⲥ
ⲉⲧⲑⲁϩⲉⲙ	ⲉⲧ|ⲑⲁϩⲉⲙ
ⲛⲧⲉⲓⲏⲥⲟⲩⲥ	ⲛⲧⲉ|ⲓⲏⲥⲟⲩⲥ
ϩⲓⲧⲉⲛⲫⲟⲩⲱϣ	ϩⲓⲧⲉⲛ|ⲫ|ⲟⲩⲱϣ
ⲛⲉⲙⲥⲱⲥⲑⲉⲛⲏⲥ	ⲛⲉⲙ|ⲥⲱⲥⲑⲉⲛⲏⲥ
ⲛϯⲉⲕⲕⲗⲏⲥⲓⲁ	ⲛ|ϯ|ⲉⲕⲕⲗⲏⲥⲓⲁ
ϧⲉⲛⲕⲟⲣⲓⲛⲑⲟⲥ	ϧⲉⲛ|ⲕⲟⲣⲓⲛⲑⲟⲥ
ⲉⲧⲁⲩⲧⲟⲩⲃⲱⲟⲩ	ⲉⲧ|ⲁ|ⲩ|ⲧⲟⲩⲃⲱ|ⲟⲩ
ⲉⲑⲙⲟⲩϯ	ⲉⲑ|ⲙⲟⲩϯ
ⲉⲫⲣⲁⲛ	ⲉ|ⲫ|ⲣⲁⲛ
ϧⲉⲛⲙⲁⲓ	ϧⲉⲛ|ⲙⲁⲓ
ⲛⲉⲙⲛⲧⲁⲛ	ⲛⲉⲙ|ⲛⲧⲁ|ⲛ
ⲛⲉⲙⲧϩⲓⲣⲏⲛⲏ	ⲛⲉⲙ|ⲧ|ϩⲓⲣⲏⲛⲏ
ⲡⲉⲛⲓⲱⲧ	ⲡⲉⲛ|ⲓⲱⲧ
ⲛⲉⲙⲡⲉⲛϭⲟⲓⲥ	ⲛⲉⲙ|ⲡⲉⲛ|ϭⲟⲓⲥ
ϯϣⲉⲡϩⲙⲟⲧ	ϯ|ϣⲉⲡϩⲙⲟⲧ
ⲛⲧⲉⲛⲡⲁⲛⲟⲩϯ	ⲛⲧⲉⲛ|ⲡⲁ|ⲛⲟⲩϯ
ⲉϫⲉⲛⲑⲏⲛⲟⲩ	ⲉϫⲉⲛ|ⲑⲏⲛⲟⲩ
ⲛⲉⲙⲉϫⲉⲛⲡⲓϩⲙⲟⲧ	ⲛⲉⲙ|ⲉϫⲉⲛ|ⲡⲓ|ϩⲙⲟⲧ
ⲉⲧⲁⲩⲧⲏⲓϥ	ⲉⲧ|ⲁ|ⲩ|ⲧⲏⲓ|ϥ
ϫⲉϧⲉⲛϩⲱⲃ	ϫⲉ|ϧⲉⲛ|ϩⲱⲃ
ⲁⲧⲉⲧⲉⲛⲉⲣⲣⲁⲙⲁⲟ	ⲁ|ⲧⲉⲧⲉⲛ|ⲉⲣⲣⲁⲙⲁⲟ
ϧⲉⲛⲥⲁϫⲓ	ϧⲉⲛ|ⲥⲁϫⲓ
ⲛⲉⲙⲉⲙⲓ	ⲛⲉⲙ|ⲉⲙⲓ
ⲉⲧⲁϯⲙⲉⲧⲙⲉⲑⲣⲉ	ⲉⲧ|ⲁ|ϯ|ⲙⲉⲧⲙⲉⲑⲣⲉ
ⲧⲁϫⲣⲟ	ⲧⲁϫⲣⲟ
ⲛⲧⲉⲧⲉⲛϣⲱⲡⲓ	ⲛⲧⲉ|ⲧⲉⲛ|ϣⲱⲡⲓ
ⲛⲧⲉⲧⲉⲛϣⲁⲧ	ⲛ|ⲧⲉⲧⲉⲛ|ϣⲁⲧ
ϧⲉⲛϩⲗⲓ	ϧⲉⲛ|ϩⲗⲓ
ⲛϩⲙⲟⲧ	ⲛ|ϩⲙⲟⲧ
ⲉⲣⲉⲧⲉⲛϫⲟⲩϣⲧ	ⲉⲣⲉ|ⲧⲉⲛ|ϫⲟⲩϣⲧ
ⲙⲡⲓϭⲱⲣⲡ	ⲙ|ⲡⲓ|ϭⲱⲣⲡ
ⲛⲧⲉⲡⲉⲛϭⲟⲓⲥ	ⲛⲧⲉ|ⲡⲉⲛ|ϭⲟⲓⲥ
ⲉⲧⲉⲉϥⲉⲧⲁϫⲣⲉⲑⲏⲛⲟⲩ	ⲉⲧⲉ|ⲉϥⲉ|ⲧⲁϫⲣⲉ|ⲑⲏⲛⲟⲩ
ϣⲁⲉⲃⲟⲗ	ϣⲁ|ⲉⲃⲟⲗ
ⲛⲁⲧⲁⲣⲓⲕⲓ	ⲛ|ⲁⲧⲁⲣⲓⲕⲓ
ϥⲉⲛϩⲟⲧ	ϥ|ⲉⲛϩⲟⲧ
ⲉⲧⲁϥⲑⲁϩⲉⲙⲑⲏⲛⲟⲩ	ⲉⲧ|ⲁ|ϥ|ⲑⲁϩⲉⲙ|ⲑⲏⲛⲟⲩ
ⲉϯⲙⲉⲧϣⲫⲏⲣ	ⲉ|ϯ|ⲙⲉⲧϣⲫⲏⲣ
ⲛⲧⲉⲡⲉϥϣⲏⲣⲓ	ⲛⲧⲉ|ⲡⲉϥ|ϣⲏⲣⲓ
ⲡⲉⲛϭⲟⲓⲥ	ⲡⲉⲛ|ϭⲟⲓⲥ
ϩⲓⲧⲉⲛⲫⲣⲁⲛ	ϩⲓⲧⲉⲛ|ⲫ|ⲣⲁⲛ
ⲟⲩⲥⲁϫⲓ	ⲟⲩ|ⲥⲁϫⲓ
ⲉⲣⲉⲧⲉⲛϫⲱ	ⲉⲣⲉ|ⲧⲉⲛ|ϫⲱ
ⲛⲧⲉϣⲧⲉⲙϩⲁⲛⲫⲱⲣϫ	ⲛⲧⲉ|ϣⲧⲉⲙ|ϩⲁⲛ|ⲫⲱⲣϫ
ⲉⲣⲉⲧⲉⲛⲥⲉⲃⲧⲱⲧ	ⲉⲣⲉ|ⲧⲉⲛ|ⲥⲉⲃⲧⲱⲧ
ϧⲉⲛⲟⲩϩⲏⲧ	ϧⲉⲛ|ⲟⲩ|ϩⲏⲧ
ⲛⲉⲙⲟⲩⲅⲛⲱⲙⲏ	ⲛⲉⲙ|ⲟⲩ|ⲅⲛⲱⲙⲏ
ⲁⲩⲧⲁⲙⲟⲓ	ⲁ|ⲩ|ⲧⲁⲙⲟ|ⲓ
ⲉⲑⲃⲉⲑⲏⲛⲟⲩ	ⲉⲑⲃⲉ|ⲑⲏⲛⲟⲩ
ϩⲓⲧⲉⲛⲛⲁⲭⲗⲟⲏⲥ	ϩⲓⲧⲉⲛ|ⲛⲁ|ⲭⲗⲟⲏⲥ
ϫⲉⲟⲩⲟⲛϩⲁⲛϣϭⲛⲏⲛ	ϫⲉ|ⲟⲩⲟⲛ|ϩⲁⲛ|ϣϭⲛⲏⲛ
ϫⲉⲡⲓⲟⲩⲁⲓ	ϫⲉ|ⲡⲓ|ⲟⲩⲁⲓ
ⲫⲁⲡⲁⲩⲗⲟⲥ	ⲫⲁ|ⲡⲁⲩⲗⲟⲥ
ⲫⲁⲁⲡⲟⲗⲗⲱ	ⲫⲁ|ⲁⲡⲟⲗⲗⲱ
ⲫⲁⲕⲏⲫⲁ	ⲫⲁ|ⲕⲏⲫⲁ
ⲫⲁⲡⲭⲣⲓⲥⲧⲟⲥ	ⲫⲁ|ⲡ|ⲭⲣⲓⲥⲧⲟⲥ
ⲁⲩⲫⲉϣ	ⲁ|ⲩ|ⲫⲉϣ
ⲁⲩⲁϣϥ	ⲁ|ⲩ|ⲁϣ|ϥ
ⲁⲣⲉⲧⲉⲛϭⲓⲱⲙⲥ	ⲁⲣⲉ|ⲧⲉⲛ|ϭⲓⲱⲙⲥ
ⲙⲡⲁⲩⲗⲟⲥ	ⲙ|ⲡⲁⲩⲗⲟⲥ
ϫⲉⲙⲡⲓϯⲱⲙⲥ	ϫⲉ|ⲙⲡ|ⲓ|ϯⲱⲙⲥ
ⲉⲕⲣⲓⲥⲡⲟⲥ	ⲉ|ⲕⲣⲓⲥⲡⲟⲥ
ⲛⲉⲙⲅⲁⲓⲟⲥ	ⲛⲉⲙ|ⲅⲁⲓⲟⲥ
ⲛⲧⲉϣⲧⲉⲙⲟⲩⲁⲓ	ⲛⲧⲉ|ϣⲧⲉⲙ|ⲟⲩⲁⲓ
ϫⲉⲁⲣⲉⲧⲉⲛϭⲓⲱⲙⲥ	ϫⲉ|ⲁⲣⲉ|ⲧⲉⲛ|ϭⲓⲱⲙⲥ
ⲉⲡⲁⲣⲁⲛ	ⲉ|ⲡⲁ|ⲣⲁⲛ
ⲁⲓϯⲱⲙⲥ	ⲁ|ⲓ|ϯⲱⲙⲥ
ⲙⲡⲕⲉⲏⲓ	ⲙ|ⲡ|ⲕⲉ|ⲏⲓ
ⲛϯⲉⲙⲓ	ⲛ|ϯ|ⲉⲙⲓ
ϫⲉⲁⲛ	ϫⲉ|ⲁⲛ
ⲛⲕⲉⲟⲩⲁⲓ	ⲛ|ⲕⲉ|ⲟⲩⲁⲓ
ⲛⲉⲧⲁϥⲧⲁⲟⲩⲟⲓ	ⲛ|ⲉⲧ|ⲁ|ϥ|ⲧⲁⲟⲩⲟ|ⲓ
ⲛϫⲉⲡⲭⲣⲓⲥⲧⲟⲥ	ⲛϫⲉ|ⲡ|ⲭⲣⲓⲥⲧⲟⲥ
ⲉϯⲱⲙⲥ	ⲉ|ϯⲱⲙⲥ
ⲉϩⲓϣⲉⲛⲛⲟⲩϥⲓ	ⲉ|ϩⲓϣⲉⲛⲛⲟⲩϥⲓ
ϧⲉⲛⲟⲩⲥⲃⲱ	ϧⲉⲛ|ⲟⲩ|ⲥⲃⲱ
ⲛⲥⲁϫⲓ	ⲛ|ⲥⲁϫⲓ
ⲛⲧⲉϥϣⲧⲉⲙϣⲱⲡⲓ	ⲛⲧⲉ|ϥ|ϣⲧⲉⲙ|ϣⲱⲡⲓ
ⲉϥϣⲟⲩⲓⲧ	ⲉ|ϥ|ϣⲟⲩⲓⲧ
ⲛϫⲉⲡⲓⲥⲧⲁⲩⲣⲟⲥ	ⲛϫⲉ|ⲡⲓ|ⲥⲧⲁⲩⲣⲟⲥ
ⲛⲧⲉⲡⲓⲥⲧⲁⲩⲣⲟⲥ	ⲛⲧⲉ|ⲡⲓ|ⲥⲧⲁⲩⲣⲟⲥ
ⲛⲧⲉⲛⲛⲏ	ⲛⲧⲉⲛ|ⲛⲏ
ⲉⲑⲛⲁⲧⲁⲕⲟ	ⲉⲑ|ⲛⲁ|ⲧⲁⲕⲟ
ⲟⲩⲙⲉⲧⲥⲟϫ	ⲟⲩ|ⲙⲉⲧⲥⲟϫ
ⲛⲁⲛ	ⲛⲁ|ⲛ
ⲉⲑⲛⲁⲛⲟϩⲉⲙ	ⲉⲑ|ⲛⲁ|ⲛⲟϩⲉⲙ
ⲟⲩϫⲟⲙ	ⲟⲩ|ϫⲟⲙ
ϫⲉϯⲛⲁⲧⲁⲕⲟ	ϫⲉ|ϯ|ⲛⲁ|ⲧⲁⲕⲟ
ⲛⲧⲥⲟⲫⲓⲁ	ⲛ|ⲧ|ⲥⲟⲫⲓⲁ
ⲛⲧⲉⲛⲓⲥⲁⲃⲉⲩ	ⲛⲧⲉ|ⲛⲓ|ⲥⲁⲃⲉⲩ
ⲡⲉⲙⲓ	ⲡ|ⲉⲙⲓ
ⲛⲧⲉⲛⲓⲕⲁⲧϩⲏⲧ	ⲛⲧⲉ|ⲛⲓ|ⲕⲁⲧϩⲏⲧ
ϯⲛⲁϣⲟϣϥ	ϯ|ⲛⲁ|ϣⲟϣ|ϥ
ⲟⲩⲥⲁⲃⲉ	ⲟⲩ|ⲥⲁⲃⲉ
ⲟⲩⲥⲁϧ	ⲟⲩ|ⲥⲁϧ
ⲟⲩⲣⲉϥϧⲟⲧϧⲉⲧ	ⲟⲩ|ⲣⲉϥϧⲟⲧϧⲉⲧ
ⲛⲧⲉⲡⲁⲓⲉⲛⲉϩ	ⲛⲧⲉ|ⲡⲁⲓ|ⲉⲛⲉϩ
ⲙⲡⲉⲫⲛⲟⲩϯ	ⲙⲡⲉ|ⲫ|ⲛⲟⲩϯ
ⲉⲣⲧⲥⲟⲫⲓⲁ	ⲉⲣ|ⲧ|ⲥⲟⲫⲓⲁ
ⲛⲥⲟϫ	ⲛ|ⲥⲟϫ
ⲉⲡⲓⲇⲏ	ⲉⲡⲓⲇⲏ
ϧⲉⲛϯⲥⲟⲫⲓⲁ	ϧⲉⲛ|ϯ|ⲥⲟⲫⲓⲁ
ⲙⲡⲉⲡⲓⲕⲟⲥⲙⲟⲥ	ⲙⲡⲉ|ⲡⲓ|ⲕⲟⲥⲙⲟⲥ
ⲥⲟⲩⲉⲛ	ⲥⲟⲩⲉⲛ
ϩⲓⲧⲉⲛϯⲥⲟⲫⲓⲁ	ϩⲓⲧⲉⲛ|ϯ|ⲥⲟⲫⲓⲁ
ⲁϥϯⲙⲁϯ	ⲁ|ϥ|ϯⲙⲁϯ
ϩⲓⲧⲉⲛϯⲙⲉⲧⲥⲟϫ	ϩⲓⲧⲉⲛ|ϯ|ⲙⲉⲧⲥⲟϫ
ⲛⲧⲉⲡⲓϩⲓⲱⲓϣ	ⲛⲧⲉ|ⲡⲓ|ϩⲓⲱⲓϣ
ⲉⲛⲟϩⲉⲙ	ⲉ|ⲛⲟϩⲉⲙ
ⲉⲑⲛⲁϩϯ	ⲉⲑ|ⲛⲁϩϯ
ⲥⲉⲉⲣⲉⲧⲓⲛ	ⲥⲉ|ⲉⲣⲉⲧⲓⲛ
ⲛϩⲁⲛⲙⲏⲓⲛⲓ	ⲛ|ϩⲁⲛ|ⲙⲏⲓⲛⲓ
ⲥⲉⲕⲱϯ	ⲥⲉ|ⲕⲱϯ
ⲛⲥⲁϯⲥⲟⲫⲓⲁ	ⲛⲥⲁ|ϯ|ⲥⲟⲫⲓⲁ
ⲧⲉⲛϩⲓⲱⲓϣ	ⲧⲉⲛ|ϩⲓⲱⲓϣ
ⲉⲁⲩⲁϣϥ	ⲉ|ⲁ|ⲩ|ⲁϣ|ϥ
ⲟⲩⲥⲕⲁⲛⲇⲁⲗⲟⲛ	ⲟⲩ|ⲥⲕⲁⲛⲇⲁⲗⲟⲛ
ⲛⲓⲉⲑⲛⲟⲥ	ⲛⲓ|ⲉⲑⲛⲟⲥ
ⲛⲉⲙⲛⲓⲟⲩⲉⲓⲛⲓⲛ	ⲛⲉⲙ|ⲛⲓ|ⲟⲩⲉⲓⲛⲓⲛ
ⲛⲉⲙⲟⲩⲥⲟⲫⲓⲁ	ⲛⲉⲙ|ⲟⲩ|ⲥⲟⲫⲓⲁ
ϫⲉϯⲙⲉⲧⲥⲟϫ	ϫⲉ|ϯ|ⲙⲉⲧⲥⲟϫ
ⲥⲟⲓ	ⲥ|ⲟⲓ
ⲛⲥⲁⲃⲉ	ⲛ|ⲥⲁⲃⲉ
ⲛⲓⲣⲱⲙⲓ	ⲛⲓ|ⲣⲱⲙⲓ
ϯⲙⲉⲧⲁⲥⲑⲏⲛⲏⲥ	ϯ|ⲙⲉⲧⲁⲥⲑⲏⲛⲏⲥ
ⲛϫⲱⲣⲓ	ⲛ|ϫⲱⲣⲓ
ⲉⲡⲉⲧⲉⲛⲑⲱϩⲉⲙ	ⲉ|ⲡⲉⲧⲉⲛ|ⲑⲱϩⲉⲙ
ⲕⲁⲧⲁⲥⲁⲣⲝ	ⲕⲁⲧⲁ|ⲥⲁⲣⲝ
ⲛⲉⲩⲅⲉⲛⲏⲥ	ⲛ|ⲉⲩⲅⲉⲛⲏⲥ
ⲛⲓⲥⲟϫ	ⲛⲓ|ⲥⲟϫ
ⲁϥⲥⲟⲧⲡⲟⲩ	ⲁ|ϥ|ⲥⲟⲧⲡ|ⲟⲩ
ⲛⲧⲉϥϯϣⲓⲡⲓ	ⲛⲧⲉ|ϥ|ϯϣⲓⲡⲓ
ⲛⲛⲓⲥⲁⲃⲉⲩ	ⲛ|ⲛⲓ|ⲥⲁⲃⲉⲩ
ⲛⲓⲙⲉⲧϫⲱⲃ	ⲛⲓ|ⲙⲉⲧϫⲱⲃ
ⲛⲛⲓϫⲱⲣⲓ	ⲛ|ⲛⲓ|ϫⲱⲣⲓ
ⲛⲓⲙⲉⲧⲁⲅⲉⲛⲏⲥ	ⲛⲓ|ⲙⲉⲧⲁⲅⲉⲛⲏⲥ
ⲉⲧϣⲟϣϥ	ⲉⲧ|ϣⲟϣϥ
ⲉⲧⲉⲛⲥⲉϣⲟⲡ	ⲉⲧⲉ|ⲛ|ⲥⲉ|ϣⲟⲡ
ⲛⲧⲉϥⲕⲟⲣϥ	ⲛⲧⲉ|ϥ|ⲕⲟⲣϥ
ϩⲟⲡⲱⲥ	ϩⲟⲡⲱⲥ
ⲛⲧⲉϣⲧⲉⲙⲥⲁⲣⲝ	ⲛⲧⲉ|ϣⲧⲉⲙ|ⲥⲁⲣⲝ
ϣⲟⲩϣⲟⲩ	ϣⲟⲩϣⲟⲩ
ⲛⲟⲩⲥⲟⲫⲓⲁ	ⲛ|ⲟⲩ|ⲥⲟⲫⲓⲁ
ⲟⲩⲙⲉⲑⲙⲏⲓ	ⲟⲩ|ⲙⲉⲑⲙⲏⲓ
ⲛⲉⲙⲟⲩⲧⲟⲩⲃⲟ	ⲛⲉⲙ|ⲟⲩ|ⲧⲟⲩⲃⲟ
ⲛⲉⲙⲟⲩⲥⲱϯ	ⲛⲉⲙ|ⲟⲩ|ⲥⲱϯ
ϫⲉⲡⲉⲧϣⲟⲩϣⲟⲩ	ϫⲉ|ⲡ|ⲉⲧ|ϣⲟⲩϣⲟⲩ
ⲙⲁⲣⲉϥϣⲟⲩϣⲟⲩ	ⲙⲁⲣⲉ|ϥ|ϣⲟⲩϣⲟⲩ
ⲁⲩⲑⲱⲟⲩϯ	ⲁ|ⲩ|ⲑⲱⲟⲩϯ
ⲛϫⲉⲛⲓⲫⲁⲣⲓⲥⲁⲓⲟⲥ	ⲛϫⲉ|ⲛⲓ|ⲫⲁⲣⲓⲥⲁⲓⲟⲥ
ⲛⲉⲙϩⲁⲛⲟⲩⲟⲛ	ⲛⲉⲙ|ϩⲁⲛ|ⲟⲩⲟⲛ
ϧⲉⲛⲛⲓⲥⲁϧ	ϧⲉⲛ|ⲛⲓ|ⲥⲁϧ
ⲉⲁⲩⲓ	ⲉ|ⲁ|ⲩ|ⲓ
ϧⲉⲛϩⲓⲉⲣⲟⲩⲥⲁⲗⲏⲙ	ϧⲉⲛ|ϩⲓⲉⲣⲟⲩⲥⲁⲗⲏⲙ
ⲉϩⲁⲛⲟⲩⲟⲛ	ⲉ|ϩⲁⲛ|ⲟⲩⲟⲛ
ⲛⲧⲉⲛⲉϥⲙⲁⲑⲏⲧⲏⲥ	ⲛⲧⲉ|ⲛⲉϥ|ⲙⲁⲑⲏⲧⲏⲥ
ϫⲉⲥⲉⲟⲩⲱⲙ	ϫⲉ|ⲥⲉ|ⲟⲩⲱⲙ
ⲛⲛⲓⲱⲓⲕ	ⲛ|ⲛⲓ|ⲱⲓⲕ
ⲉⲣⲉⲛⲟⲩϫⲓϫ	ⲉⲣⲉ|ⲛⲟⲩ|ϫⲓϫ
ⲑⲱⲗⲉⲃ	ⲑⲱⲗⲉⲃ
ⲉⲧⲉⲫⲁⲓ	ⲉⲧⲉ|ⲫⲁⲓ
ϫⲉⲛⲁⲧⲓⲁⲧⲟⲧⲟⲩ	ϫⲉ|ⲛ|ⲁⲧⲓⲁⲧⲟⲧⲟⲩ
ⲛⲓⲫⲁⲣⲓⲥⲁⲓⲟⲥ	ⲛⲓ|ⲫⲁⲣⲓⲥⲁⲓⲟⲥ
ⲛⲉⲙⲛⲓⲓⲟⲩⲇⲁⲓ	ⲛⲉⲙ|ⲛⲓ|ⲓⲟⲩⲇⲁⲓ
ⲙⲡⲁⲩⲟⲩⲱⲙ	ⲙⲡⲁ|ⲩ|ⲟⲩⲱⲙ
ⲁⲩϣⲧⲉⲙⲓⲁⲧⲟⲧⲟⲩ	ⲁ|ⲩ|ϣⲧⲉⲙ|ⲓⲁ|ⲧⲟⲧ|ⲟⲩ
ⲉⲩⲁⲙⲟⲛⲓ	ⲉ|ⲩ|ⲁⲙⲟⲛⲓ
ⲛϯⲡⲁⲣⲁⲇⲟⲥⲓⲥ	ⲛ|ϯ|ⲡⲁⲣⲁⲇⲟⲥⲓⲥ
ⲛⲧⲉⲛⲓⲡⲣⲉⲥⲃⲩⲧⲉⲣⲟⲥ	ⲛⲧⲉ|ⲛⲓ|ⲡⲣⲉⲥⲃⲩⲧⲉⲣⲟⲥ
ⲁⲩϣⲧⲉⲙⲟⲙⲥⲟⲩ	ⲁ|ⲩ|ϣⲧⲉⲙ|ⲟⲙⲥ|ⲟⲩ
ϧⲉⲛϯⲁⲅⲟⲣⲁ	ϧⲉⲛ|ϯ|ⲁⲅⲟⲣⲁ
ϩⲁⲛⲕⲉⲙⲏϣ	ϩⲁⲛ|ⲕⲉ|ⲙⲏϣ
ⲉⲁⲩϭⲓⲧⲟⲩ	ⲉ|ⲁ|ⲩ|ϭⲓⲧ|ⲟⲩ
ⲉⲁⲩⲁⲙⲟⲛⲓ	ⲉ|ⲁ|ⲩ|ⲁⲙⲟⲛⲓ
ϩⲁⲛⲱⲙⲥ	ϩⲁⲛ|ⲱⲙⲥ
ⲛⲧⲉϩⲁⲛⲁⲫⲟⲧ	ⲛⲧⲉ|ϩⲁⲛ|ⲁⲫⲟⲧ
ⲛⲉⲙϩⲁⲛⲝⲉⲥⲧⲏⲥ	ⲛⲉⲙ|ϩⲁⲛ|ⲝⲉⲥⲧⲏⲥ
ⲛⲉⲙϩⲁⲛⲭⲁⲗⲕⲓⲛ	ⲛⲉⲙ|ϩⲁⲛ|ⲭⲁⲗⲕⲓⲛ
ⲁⲩϣⲉⲛϥ	ⲁ|ⲩ|ϣⲉⲛ|ϥ
ⲛⲉⲙⲛⲓⲥⲁϧ	ⲛⲉⲙ|ⲛⲓ|ⲥⲁϧ
ⲥⲉⲙⲟϣⲓ	ⲥⲉ|ⲙⲟϣⲓ
ⲛϫⲉⲛⲉⲕⲙⲁⲑⲏⲧⲏⲥ	ⲛϫⲉ|ⲛⲉⲕ|ⲙⲁⲑⲏⲧⲏⲥ
ⲕⲁⲧⲁϯⲡⲁⲣⲁⲇⲟⲥⲓⲥ	ⲕⲁⲧⲁ|ϯ|ⲡⲁⲣⲁⲇⲟⲥⲓⲥ
ϧⲉⲛϩⲁⲛϫⲓϫ	ϧⲉⲛ|ϩⲁⲛ|ϫⲓϫ
ⲉⲩⲑⲟⲗⲉⲃ	ⲉ|ⲩ|ⲑⲟⲗⲉⲃ
ⲥⲉⲟⲩⲱⲙ	ⲥⲉ|ⲟⲩⲱⲙ
ⲙⲡⲓⲱⲓⲕ	ⲙ|ⲡⲓ|ⲱⲓⲕ
ⲁϥⲉⲣⲡⲣⲟⲫⲏⲧⲉⲩⲓⲛ	ⲁ|ϥ|ⲉⲣⲡⲣⲟⲫⲏⲧⲉⲩⲓⲛ
ⲛϫⲉⲏⲥⲁⲓⲁⲥ	ⲛϫⲉ|ⲏⲥⲁⲓⲁⲥ
ϧⲁⲛⲓϣⲟⲃⲓ	ϧⲁ|ⲛⲓ|ϣⲟⲃⲓ
ϫⲉⲡⲁⲓⲗⲁⲟⲥ	ϫⲉ|ⲡⲁⲓ|ⲗⲁⲟⲥ
ⲉⲣⲧⲓⲙⲁⲛ	ⲉⲣⲧⲓⲙⲁⲛ
ϧⲉⲛⲛⲟⲩⲥⲫⲟⲧⲟⲩ	ϧⲉⲛ|ⲛⲟⲩ|ⲥⲫⲟⲧⲟⲩ
ⲡⲟⲩϩⲏⲧ	ⲡⲟⲩ|ϩⲏⲧ
ϥⲟⲩⲏⲟⲩ	ϥ|ⲟⲩⲏⲟⲩ
ⲉⲩⲉⲣⲥⲉⲃⲉⲥⲑⲉ	ⲉ|ⲩ|ⲉⲣⲥⲉⲃⲉⲥⲑⲉ
ⲉⲫⲗⲏⲟⲩ	ⲉ|ⲫ|ⲗⲏⲟⲩ
ⲉⲩϯⲥⲃⲱ	ⲉ|ⲩ|ϯⲥⲃⲱ
ⲛϩⲁⲛⲥⲃⲱ	ⲛ|ϩⲁⲛ|ⲥⲃⲱ
ⲛϩⲟⲛϩⲉⲛ	ⲛ|ϩⲟⲛϩⲉⲛ
ⲛⲣⲱⲙⲓ	ⲛ|ⲣⲱⲙⲓ
ⲉⲁⲧⲉⲧⲛⲭⲁϯⲉⲛⲧⲟⲗⲏ	ⲉ|ⲁ|ⲧⲉⲧⲛ|ⲭⲁ|ϯ|ⲉⲛⲧⲟⲗⲏ
ⲧⲉⲧⲛⲁⲙⲟⲛⲓ	ⲧⲉⲧⲛ|ⲁⲙⲟⲛⲓ
ⲧⲉⲧⲛⲉⲣⲁⲑⲉⲧⲓⲛ	ⲧⲉⲧⲛ|ⲉⲣⲁⲑⲉⲧⲓⲛ
ⲛϯⲉⲛⲧⲟⲗⲏ	ⲛ|ϯ|ⲉⲛⲧⲟⲗⲏ
ⲛⲧⲉⲧⲉⲛⲁⲣⲉϩ	ⲛ|ⲧⲉⲧⲉⲛ|ⲁⲣⲉϩ
ⲉⲧⲉⲧⲉⲛⲡⲁⲣⲁⲇⲟⲥⲓⲥ	ⲉ|ⲧⲉⲧⲉⲛ|ⲡⲁⲣⲁⲇⲟⲥⲓⲥ
ⲙⲱⲩⲥⲏⲥ	ⲙⲱⲩⲥⲏⲥ
ⲁϥϫⲟⲥ	ⲁ|ϥ|ϫⲟ|ⲥ
ϫⲉⲁⲣⲓⲧⲓⲙⲁⲛ	ϫⲉ|ⲁⲣⲓⲧⲓⲙⲁⲛ
ⲛⲉⲙⲧⲉⲕⲙⲁⲩ	ⲛⲉⲙ|ⲧⲉⲕ|ⲙⲁⲩ
ⲉϥϩⲱⲟⲩ	ⲉ|ϥ|ϩⲱⲟⲩ
ⲛⲥⲁⲡⲉϥⲉⲓⲱⲧ	ⲛⲥⲁ|ⲡⲉϥ|ⲉⲓⲱⲧ
ⲛⲉⲙⲧⲉϥⲙⲁⲩ	ⲛⲉⲙ|ⲧⲉϥ|ⲙⲁⲩ
ⲙⲁⲣⲉϥⲙⲟⲩ	ⲙⲁⲣⲉ|ϥ|ⲙⲟⲩ
ⲧⲉⲧⲉⲛϫⲱ	ⲧⲉⲧⲉⲛ|ϫⲱ
ϫⲉⲁⲣⲉϣⲁⲛⲟⲩⲣⲱⲙⲓ	ϫⲉ|ⲁⲣⲉϣⲁⲛ|ⲟⲩ|ⲣⲱⲙⲓ
ϫⲉⲕⲟⲣⲃⲁⲛ	ϫⲉ|ⲕⲟⲣⲃⲁⲛ
ⲉⲧⲉⲟⲩⲧⲁⲓⲟ	ⲉⲧⲉ|ⲟⲩ|ⲧⲁⲓⲟ
ⲁⲕϣⲁⲛϫⲉⲙϩⲏⲟⲩ	ⲁⲕϣⲁⲛ|ϫⲉⲙϩⲏⲟⲩ
ⲛⲧⲉⲧⲉⲛⲭⲱ	ⲛ|ⲧⲉⲧⲉⲛ|ⲭⲱ
ⲉⲉⲣϩⲗⲓ	ⲉ|ⲉⲣ|ϩⲗⲓ
ⲉⲣⲉⲧⲉⲛⲕⲱⲣϥ	ⲉⲣⲉ|ⲧⲉⲛ|ⲕⲱⲣϥ
ⲙⲡⲓⲥⲁϫⲓ	ⲙ|ⲡⲓ|ⲥⲁϫⲓ
ϧⲉⲛⲧⲉⲧⲛⲡⲁⲣⲁⲇⲟⲥⲓⲥ	ϧⲉⲛ|ⲧⲉⲧⲛ|ⲡⲁⲣⲁⲇⲟⲥⲓⲥ
ⲉⲧⲁⲣⲉⲧⲉⲛⲧⲏⲓⲥ	ⲉⲧ|ⲁⲣⲉ|ⲧⲉⲛ|ⲧⲏⲓ|ⲥ
ϩⲁⲛⲙⲏϣ	ϩⲁⲛ|ⲙⲏϣ
ⲉⲩⲟⲛⲓ	ⲉ|ⲩ|ⲟⲛⲓ
ⲛⲛⲁⲓ	ⲛ|ⲛⲁⲓ
ⲧⲉⲧⲉⲛⲣⲁ	ⲧⲉⲧⲉⲛ|ⲣⲁ
ⲉⲡⲓⲙⲏϣ	ⲉ|ⲡⲓ|ⲙⲏϣ
ϫⲉⲥⲱⲧⲉⲙ	ϫⲉ|ⲥⲱⲧⲉⲙ
ⲕⲁϯ	ⲕⲁϯ
ⲉϥⲛⲁ	ⲉ|ϥ|ⲛⲁ
ⲉⲣⲱϥ	ⲉ|ⲣⲱ|ϥ
ⲉⲥⲟϥϥ	ⲉ|ⲥⲟϥ|ϥ
ϧⲉⲛⲣⲱϥ	ϧⲉⲛ|ⲣⲱ|ϥ
ⲉⲧⲉ	ⲉⲧⲉ
ⲙⲁϣϫ	ⲙⲁϣϫ
ⲉⲥⲱⲧⲉⲙ	ⲉ|ⲥⲱⲧⲉⲙ
ⲙⲁⲣⲉϥⲥⲱⲧⲉⲙ	ⲙⲁⲣⲉ|ϥ|ⲥⲱⲧⲉⲙ
ⲉⲡⲓⲏⲓ	ⲉ|ⲡⲓ|ⲏⲓ
ϩⲁⲡⲓⲙⲏϣ	ϩⲁ|ⲡⲓ|ⲙⲏϣ
ⲛⲁⲩϣⲓⲛⲓ	ⲛⲁ|ⲩ|ϣⲓⲛⲓ
ⲛϫⲉⲛⲉϥⲙⲁⲑⲏⲧⲏⲥ	ⲛϫⲉ|ⲛⲉϥ|ⲙⲁⲑⲏⲧⲏⲥ
ⲉϯⲡⲁⲣⲁⲃⲟⲗⲏ	ⲉ|ϯ|ⲡⲁⲣⲁⲃⲟⲗⲏ
ϫⲉⲡⲁⲓⲣⲏϯ	ϫⲉ|ⲡⲁⲓ|ⲣⲏϯ
ϩⲁⲛⲁⲧⲕⲁϯ	ϩⲁⲛ|ⲁⲧⲕⲁϯ
ⲙⲡⲉⲧⲉⲛⲕⲁϯ	ⲙⲡⲉ|ⲧⲉⲛ|ⲕⲁϯ
ϫⲉϩⲱⲃ	ϫⲉ|ϩⲱⲃ
ⲉⲧⲥⲁⲃⲟⲗ	ⲉⲧ|ⲥⲁⲃⲟⲗ
ⲉⲑⲛⲁ	ⲉⲑ|ⲛⲁ
ϫⲉⲥⲉⲛⲁ	ϫⲉ|ⲥⲉ|ⲛⲁ
ⲉⲡⲉϥϩⲏⲧ	ⲉ|ⲡⲉϥ|ϩⲏⲧ
ⲧⲉϥⲛⲉϫⲓ	ⲧⲉϥ|ⲛⲉϫⲓ
ϣⲁⲩϣⲉ	ϣⲁ|ⲩ|ϣⲉ
ⲉⲛⲓⲙⲁ	ⲉ|ⲛⲓ|ⲙⲁ
ⲉϥⲧⲟⲩⲃⲟ	ⲉ|ϥ|ⲧⲟⲩⲃⲟ
ⲛⲛⲓϧⲣⲏⲟⲩⲓ	ⲛ|ⲛⲓ|ϧⲣⲏⲟⲩⲓ
ϫⲉⲡⲉⲑⲛⲏⲟⲩ	ϫⲉ|ⲡ|ⲉⲑ|ⲛⲏⲟⲩ
ⲙⲡⲓⲣⲱⲓⲙⲓ	ⲙ|ⲡⲓ|ⲣⲱⲓⲙⲓ
ⲉⲧⲥⲱϥ	ⲉⲧ|ⲥⲱϥ
ϧⲉⲛⲡⲓϩⲏⲧ	ϧⲉⲛ|ⲡⲓ|ϩⲏⲧ
ϣⲁⲩⲓ	ϣⲁ|ⲩ|ⲓ
ⲛϫⲉⲡⲓⲙⲟⲕⲙⲉⲕ	ⲛϫⲉ|ⲡⲓ|ⲙⲟⲕⲙⲉⲕ
ⲉⲧϩⲱⲟⲩ	ⲉⲧ|ϩⲱⲟⲩ
ⲛⲓⲡⲟⲣⲛⲓⲁ	ⲛⲓ|ⲡⲟⲣⲛⲓⲁ
ⲛⲓϭⲓⲟⲩⲓ	ⲛⲓ|ϭⲓⲟⲩⲓ
ⲛⲓϧⲱⲧⲉⲃ	ⲛⲓ|ϧⲱⲧⲉⲃ
ⲛⲓⲙⲉⲧⲛⲱⲓⲕ	ⲛⲓ|ⲙⲉⲧⲛⲱⲓⲕ
ⲛⲓⲙⲉⲧϭⲓⲛϫⲟⲛⲥ	ⲛⲓ|ⲙⲉⲧϭⲓⲛϫⲟⲛⲥ
ⲛⲓⲙⲉⲧⲡⲉⲧϩⲱⲟⲩ	ⲛⲓ|ⲙⲉⲧⲡⲉⲧϩⲱⲟⲩ
ⲛⲓⲙⲉⲧⲇⲟⲗⲟⲥ	ⲛⲓ|ⲙⲉⲧⲇⲟⲗⲟⲥ
ⲛⲓⲥⲱϥ	ⲛⲓ|ⲥⲱϥ
ⲛⲓⲃⲁⲗ	ⲛⲓ|ⲃⲁⲗ
ⲛⲓϫⲉⲟⲩⲁ	ⲛⲓ|ϫⲉⲟⲩⲁ
ⲟⲩϭⲓⲥⲓ	ⲟⲩ|ϭⲓⲥⲓ
ⲟⲩⲙⲉⲧⲁⲧⲕⲁϯ	ⲟⲩ|ⲙⲉⲧⲁⲧⲕⲁϯ
ⲥⲉⲥⲱϥ	ⲥⲉ|ⲥⲱϥ
ⲉⲛⲓⲥⲁ	ⲉ|ⲛⲓ|ⲥⲁ
ⲛⲧⲉⲧⲩⲣⲟⲥ	ⲛⲧⲉ|ⲧⲩⲣⲟⲥ
ⲛⲉⲙⲧⲥⲓⲇⲱⲛ	ⲛⲉⲙ|ⲧ|ⲥⲓⲇⲱⲛ
ⲉⲧⲁϥϣⲉ	ⲉⲧ|ⲁ|ϥ|ϣⲉ
ⲉⲟⲩⲏⲓ	ⲉ|ⲟⲩ|ⲏⲓ
ⲛⲁϥⲟⲩⲱϣ	ⲛⲁ|ϥ|ⲟⲩⲱϣ
ⲉⲙⲓ	ⲉⲙⲓ
ⲛⲱⲃϣ	ⲛ|ⲱⲃϣ
ⲥⲁⲧⲟⲧⲥ	ⲥⲁⲧⲟⲧ|ⲥ
ⲁⲥⲥⲱⲧⲉⲙ	ⲁ|ⲥ|ⲥⲱⲧⲉⲙ
ⲛϫⲉⲟⲩⲥϩⲓⲙⲓ	ⲛϫⲉ|ⲟⲩ|ⲥϩⲓⲙⲓ
ⲉⲧⲉⲟⲩⲟⲛ	ⲉⲧⲉ|ⲟⲩⲟⲛ
ⲟⲩⲡⲛⲉⲩⲙⲁ	ⲟⲩ|ⲡⲛⲉⲩⲙⲁ
ⲛⲁⲕⲁⲑⲁⲣⲧⲟⲛ	ⲛ|ⲁⲕⲁⲑⲁⲣⲧⲟⲛ
ⲛⲉⲙⲧⲉⲥϣⲉⲣⲓ	ⲛⲉⲙ|ⲧⲉⲥ|ϣⲉⲣⲓ
ⲉⲧⲁⲥⲓ	ⲉⲧ|ⲁ|ⲥ|ⲓ
ⲁⲥϩⲓⲧⲥ	ⲁ|ⲥ|ϩⲓⲧ|ⲥ
ϧⲁⲛⲉϥϭⲁⲗⲁⲩϫ	ϧⲁ|ⲛⲉϥ|ϭⲁⲗⲁⲩϫ
ⲛⲉⲟⲩⲉⲓⲛⲓⲛ	ⲛⲉ|ⲟⲩⲉⲓⲛⲓⲛ
ⲛⲧⲉⲛⲥⲩⲣⲓⲁ	ⲛⲧⲉⲛ|ⲥⲩⲣⲓⲁ
ⲡⲉⲥⲅⲉⲛⲟⲥ	ⲡⲉⲥ|ⲅⲉⲛⲟⲥ
ϧⲉⲛϯⲫⲟⲓⲛⲓⲕⲏ	ϧⲉⲛ|ϯ|ⲫⲟⲓⲛⲓⲕⲏ
ⲛⲁⲥϯϩⲟ	ⲛⲁ|ⲥ|ϯϩⲟ
ⲛⲧⲉϥϩⲓⲇⲉⲙⲱⲛ	ⲛⲧⲉ|ϥ|ϩⲓⲇⲉⲙⲱⲛ
ⲛⲧⲉⲥϣⲉⲣⲓ	ⲛ|ⲧⲉⲥ|ϣⲉⲣⲓ
ϫⲉⲭⲁⲥ	ϫⲉ|ⲭⲁ|ⲥ
ⲛⲧⲟⲩⲥⲓ	ⲛⲧ|ⲟⲩ|ⲥⲓ
ⲛϫⲉⲛⲓϣⲏⲣⲓ	ⲛϫⲉ|ⲛⲓ|ϣⲏⲣⲓ
ⲉⲉⲗⲡⲱⲓⲕ	ⲉ|ⲉⲗ|ⲡ|ⲱⲓⲕ
ⲛⲛⲓⲟⲩϩⲱⲣ	ⲛ|ⲛⲓ|ⲟⲩϩⲱⲣ
ⲛⲑⲟⲥ	ⲛⲑⲟⲥ
ⲁⲥⲉⲣⲟⲩⲱ	ⲁ|ⲥ|ⲉⲣⲟⲩⲱ
ⲡⲉϫⲁⲥ	ⲡⲉϫⲁ|ⲥ
ϫⲉⲥⲉ	ϫⲉ|ⲥⲉ
ⲡⲁϭⲟⲓⲥ	ⲡⲁ|ϭⲟⲓⲥ
ⲛⲓⲕⲉⲟⲩϩⲱⲣ	ⲛⲓ|ⲕⲉ|ⲟⲩϩⲱⲣ
ⲛϯⲧⲣⲁⲡⲉⲍⲁ	ⲛ|ϯ|ⲧⲣⲁⲡⲉⲍⲁ
ϧⲉⲛⲛⲓⲗⲉϥⲗⲓϥⲓ	ϧⲉⲛ|ⲛⲓ|ⲗⲉϥⲗⲓϥⲓ
ⲛⲧⲉⲛⲓⲁⲗⲱⲟⲩⲓ	ⲛⲧⲉ|ⲛⲓ|ⲁⲗⲱⲟⲩⲓ
ϫⲉⲉⲑⲃⲉⲡⲁⲓⲥⲁϫⲓ	ϫⲉ|ⲉⲑⲃⲉ|ⲡⲁⲓ|ⲥⲁϫⲓ
ϩⲓⲧⲉϣⲉⲣⲓ	ϩⲓ|ⲧⲉ|ϣⲉⲣⲓ
ⲛϫⲉⲡⲓⲇⲁⲓⲙⲱⲛ	ⲛϫⲉ|ⲡⲓ|ⲇⲁⲓⲙⲱⲛ
ⲉⲧⲁⲥϣⲉ	ⲉⲧ|ⲁ|ⲥ|ϣⲉ
ⲉⲡⲉⲥⲏⲓ	ⲉ|ⲡⲉⲥ|ⲏⲓ
ⲁⲥϫⲓⲙⲓ	ⲁ|ⲥ|ϫⲓⲙⲓ
ⲛϯⲁⲗⲟⲩ	ⲛ|ϯ|ⲁⲗⲟⲩ
ϩⲓϫⲉⲛⲡⲓϭⲗⲟϫ	ϩⲓϫⲉⲛ|ⲡⲓ|ϭⲗⲟϫ
ⲡⲓⲇⲁⲓⲙⲱⲛ	ⲡⲓ|ⲇⲁⲓⲙⲱⲛ
ϩⲓⲱⲧⲥ	ϩⲓⲱⲧ|ⲥ
ϧⲉⲛⲛⲓⲑⲟϣ	ϧⲉⲛ|ⲛⲓ|ⲑⲟϣ
ⲛⲁϥⲥⲓⲛⲓ	ⲛⲁ|ϥ|ⲥⲓⲛⲓ
ϩⲓⲧⲉⲛⲧⲥⲓⲇⲱⲛ	ϩⲓⲧⲉⲛ|ⲧ|ⲥⲓⲇⲱⲛ
ⲉⲫⲓⲟⲙ	ⲉ|ⲫ|ⲓⲟⲙ
ⲛⲧⲉϯⲅⲁⲗⲓⲗⲉⲁ	ⲛⲧⲉ|ϯ|ⲅⲁⲗⲓⲗⲉⲁ
ⲟⲩⲧⲉ	ⲟⲩⲧⲉ
ⲛⲓⲑⲟϣ	ⲛⲓ|ⲑⲟϣ
ⲛⲧⲉϯⲙⲏϯ	ⲛⲧⲉ|ϯ|ⲙⲏϯ
ⲙⲃⲁⲕⲓ	ⲙ|ⲃⲁⲕⲓ
ⲁⲩⲓⲛⲓ	ⲁ|ⲩ|ⲓⲛⲓ
ⲛⲟⲩⲕⲟⲩⲣ	ⲛ|ⲟⲩ|ⲕⲟⲩⲣ
ⲛⲉⲃⲟ	ⲛ|ⲉⲃⲟ
ⲁⲩϯϩⲟ	ⲁ|ⲩ|ϯϩⲟ
ⲛⲧⲉϥⲭⲁϫⲓϫ	ⲛⲧⲉ|ϥ|ⲭⲁϫⲓϫ
ⲁϥⲟⲗϥ	ⲁ|ϥ|ⲟⲗ|ϥ
ⲥⲁⲡⲥⲁ	ⲥⲁ|ⲡ|ⲥⲁ
ⲁϥϩⲓⲛⲉϥⲧⲏⲃ	ⲁ|ϥ|ϩⲓ|ⲛⲉϥ|ⲧⲏⲃ
ⲉⲧⲁϥϩⲓⲑⲁϥ	ⲉⲧ|ⲁ|ϥ|ϩⲓⲑⲁϥ
ⲛⲉⲙⲡⲉϥⲗⲁⲥ	ⲛⲉⲙ|ⲡⲉϥ|ⲗⲁⲥ
ⲉⲧⲁϥϫⲟⲩϣⲧ	ⲉⲧ|ⲁ|ϥ|ϫⲟⲩϣⲧ
ⲉⲧⲫⲉ	ⲉ|ⲧ|ⲫⲉ
ⲁϥϥⲓⲁϩⲟⲙ	ⲁ|ϥ|ϥⲓⲁϩⲟⲙ
ϫⲉⲉⲡⲫⲁⲑⲁ	ϫⲉ|ⲉⲡⲫⲁⲑⲁ
ϫⲉⲁⲟⲩⲱⲛ	ϫⲉ|ⲁⲟⲩⲱⲛ
ⲛϫⲉⲛⲉϥⲙⲁϣϫ	ⲛϫⲉ|ⲛⲉϥ|ⲙⲁϣϫ
ⲁϥϯⲟⲩⲱ	ⲁ|ϥ|ϯⲟⲩⲱ
ⲛϫⲉⲡⲓⲥⲛⲁϩ	ⲛϫⲉ|ⲡⲓ|ⲥⲛⲁϩ
ⲛⲧⲉⲡⲉϥⲗⲁⲥ	ⲛⲧⲉ|ⲡⲉϥ|ⲗⲁⲥ
ⲉϥⲥⲟⲩⲧⲱⲛ	ⲉ|ϥ|ⲥⲟⲩⲧⲱⲛ
ⲛⲧⲟⲩϣⲧⲉⲙϫⲟⲥ	ⲛⲧ|ⲟⲩ|ϣⲧⲉⲙ|ϫⲟ|ⲥ
ϩⲟⲥⲇⲉ	ϩⲟⲥⲇⲉ
ⲛⲁⲩϩⲓⲱⲓϣ	ⲛⲁ|ⲩ|ϩⲓⲱⲓϣ
ⲛⲁⲩⲉⲣϣⲫⲏⲣⲓ	ⲛⲁ|ⲩ|ⲉⲣϣⲫⲏⲣⲓ
ⲁϥⲁⲓⲧⲟⲩ	ⲁ|ϥ|ⲁⲓⲧ|ⲟⲩ
ⲉⲧⲁϥⲑⲣⲉⲛⲓⲕⲟⲩⲣ	ⲉⲧ|ⲁ|ϥ|ⲑⲣⲉ|ⲛⲓ|ⲕⲟⲩⲣ
ⲛⲓⲁⲧⲥⲁϫⲓ	ⲛⲓ|ⲁⲧⲥⲁϫⲓ
ⲛⲧⲟⲩⲥⲁϫⲓ	ⲛⲧ|ⲟⲩ|ⲥⲁϫⲓ
ⲉⲧⲉϥⲃⲁⲕⲓ	ⲉ|ⲧⲉϥ|ⲃⲁⲕⲓ
ⲛϫⲉⲟⲩⲥⲁⲃⲃⲁⲧⲟⲛ	ⲛϫⲉ|ⲟⲩ|ⲥⲁⲃⲃⲁⲧⲟⲛ
ⲁϥⲉⲣϩⲏⲧⲥ	ⲁ|ϥ|ⲉⲣ|ϩⲏⲧ|ⲥ
ⲛϯⲥⲃⲱ	ⲛ|ϯⲥⲃⲱ
ϧⲉⲛϯⲥⲩⲛⲁⲅⲱⲅⲏ	ϧⲉⲛ|ϯ|ⲥⲩⲛⲁⲅⲱⲅⲏ
ⲁⲩⲥⲱⲧⲉⲙ	ⲁ|ⲩ|ⲥⲱⲧⲉⲙ
ϫⲉⲉⲧⲁⲫⲁⲓ	ϫⲉ|ⲉⲧ|ⲁ|ⲫⲁⲓ
ϫⲉⲙⲛⲁⲓ	ϫⲉ|ⲙ|ⲛⲁⲓ
ⲧⲁⲓⲥⲟⲫⲓⲁ	ⲧⲁⲓ|ⲥⲟⲫⲓⲁ
ⲉⲧⲁⲩⲧⲏⲓⲥ	ⲉⲧ|ⲁ|ⲩ|ⲧⲏⲓ|ⲥ
ⲙⲫⲁⲓ	ⲙ|ⲫⲁⲓ
ⲛⲉⲙⲛⲁⲓⲕⲉϫⲟⲙ	ⲛⲉⲙ|ⲛⲁⲓ|ⲕⲉ|ϫⲟⲙ
ϩⲓⲧⲉⲛⲛⲉϥϫⲓϫ	ϩⲓⲧⲉⲛ|ⲛⲉϥ|ϫⲓϫ
ⲡⲓⲁⲙϣⲉ	ⲡⲓ|ⲁⲙϣⲉ
ⲡϣⲏⲣⲓ	ⲡ|ϣⲏⲣⲓ
ⲙⲙⲁⲣⲓⲁ	ⲙ|ⲙⲁⲣⲓⲁ
ⲡⲥⲟⲛ	ⲡ|ⲥⲟⲛ
ⲛⲓⲁⲕⲱⲃⲟⲥ	ⲛ|ⲓⲁⲕⲱⲃⲟⲥ
ⲛⲉⲙⲓⲱⲥⲏⲧⲟⲥ	ⲛⲉⲙ|ⲓⲱⲥⲏⲧⲟⲥ
ⲛⲉⲙⲓⲟⲩⲇⲁⲥ	ⲛⲉⲙ|ⲓⲟⲩⲇⲁⲥ
ⲛⲉⲙⲥⲓⲙⲱⲛ	ⲛⲉⲙ|ⲥⲓⲙⲱⲛ
ⲛⲉϥⲥⲱⲛⲓ	ⲛⲉϥ|ⲥⲱⲛⲓ
ⲛⲁⲩϩⲁⲙⲛⲁⲓ	ⲛⲁ|ⲩ|ϩⲁ|ⲙⲛⲁⲓ
ϩⲁⲣⲟⲛ	ϩⲁⲣⲟ|ⲛ
ⲛⲁⲩⲉⲣⲥⲕⲁⲛⲇⲁⲗⲓⲍⲉⲥⲑⲉ	ⲛⲁ|ⲩ|ⲉⲣⲥⲕⲁⲛⲇⲁⲗⲓⲍⲉⲥⲑⲉ
ⲛϫⲉⲓⲏⲥⲟⲩⲥ	ⲛϫⲉ|ⲓⲏⲥⲟⲩⲥ
ⲟⲩⲡⲣⲟⲫⲏⲧⲏⲥ	ⲟⲩ|ⲡⲣⲟⲫⲏⲧⲏⲥ
ⲉϥϣⲏϣ	ⲉ|ϥ|ϣⲏϣ
ϧⲉⲛⲧⲉϥⲃⲁⲕⲓ	ϧⲉⲛ|ⲧⲉϥ|ⲃⲁⲕⲓ
ⲛⲉⲙⲧⲉϥⲥⲩⲅⲅⲉⲛⲓⲁ	ⲛⲉⲙ|ⲧⲉϥ|ⲥⲩⲅⲅⲉⲛⲓⲁ
ⲛⲉⲙⲡⲉϥⲏⲓ	ⲛⲉⲙ|ⲡⲉϥ|ⲏⲓ
ⲉⲓⲣⲓ	ⲉ|ⲓⲣⲓ
ⲟⲩⲓ	ⲟⲩⲓ
ⲉⲟⲩⲙⲏϣ	ⲉ|ⲟⲩ|ⲙⲏϣ
ⲛⲣⲉϥϣⲱⲛⲓ	ⲛ|ⲣⲉϥϣⲱⲛⲓ
ⲉⲁϥⲭⲁϫⲓϫ	ⲉ|ⲁ|ϥ|ⲭⲁϫⲓϫ
ⲁϥⲉⲣⲫⲁϧⲣⲓ	ⲁ|ϥ|ⲉⲣⲫⲁϧⲣⲓ
ⲉⲑⲃⲉⲧⲟⲩⲙⲉⲧⲁⲑⲛⲁϩϯ	ⲉⲑⲃⲉ|ⲧⲟⲩ|ⲙⲉⲧⲁⲑⲛⲁϩϯ
ⲁϥⲙⲟⲩϣϯ	ⲁ|ϥ|ⲙⲟⲩϣϯ
ⲛⲛⲓϯⲙⲓ	ⲛ|ⲛⲓ|ϯⲙⲓ
ⲉⲧⲉⲙⲡⲕⲱϯ	ⲉⲧⲉ|ⲙ|ⲡ|ⲕⲱϯ
ⲉϥϯⲥⲃⲱ	ⲉ|ϥ|ϯⲥⲃⲱ
ⲉⲡⲓⲓⲃ	ⲉ|ⲡⲓ|ⲓⲃ
ⲛⲟⲩⲟⲣⲡⲟⲩ	ⲛ|ⲟⲩⲟⲣⲡ|ⲟⲩ
ⲛⲃ	ⲛ|ⲃ
ⲁϥϯⲉⲣϣⲓϣⲓ	ⲁ|ϥ|ϯⲉⲣϣⲓϣⲓ
ⲉϫⲉⲛⲛⲓⲡⲛⲉⲩⲙⲁ	ⲉϫⲉⲛ|ⲛⲓ|ⲡⲛⲉⲩⲙⲁ
ⲉϣⲧⲉⲙⲉⲗϩⲗⲓ	ⲉ|ϣⲧⲉⲙ|ⲉⲗ|ϩⲗⲓ
ⲉⲟⲩϣⲃⲱⲧ	ⲉ|ⲟⲩ|ϣⲃⲱⲧ
ⲙⲙⲁⲩⲁⲧϥ	ⲙⲙⲁⲩⲁⲧ|ϥ
ⲱⲓⲕ	ⲱⲓⲕ
ⲡⲏⲣⲁ	ⲡⲏⲣⲁ
ϩⲟⲙⲧ	ϩⲟⲙⲧ
ϧⲉⲛⲛⲉⲧⲉⲛⲙⲟϫϧ	ϧⲉⲛ|ⲛⲉⲧⲉⲛ|ⲙⲟϫϧ
ⲉⲣⲉϩⲁⲛⲥⲁⲛⲇⲁⲗⲓⲟⲛ	ⲉⲣⲉ|ϩⲁⲛ|ⲥⲁⲛⲇⲁⲗⲓⲟⲛ
ⲙⲡⲉⲣϯϣⲑⲏⲛ	ⲙⲡⲉⲣ|ϯ|ϣⲑⲏⲛ
ⲥⲛⲟⲩϯ	ⲥⲛⲟⲩϯ
ϩⲓⲑⲏⲛⲟⲩ	ϩⲓ|ⲑⲏⲛⲟⲩ
ϫⲉⲡⲓⲙⲁ	ϫⲉ|ⲡⲓ|ⲙⲁ
ⲉⲧⲉⲧⲉⲛⲛⲁϣⲉ	ⲉ|ⲧⲉⲧⲉⲛ|ⲛⲁ|ϣⲉ
ϣⲁⲧⲉⲧⲉⲛⲓ	ϣⲁⲧⲉ|ⲧⲉⲛ|ⲓ
ⲙⲁ	ⲙⲁ
ⲉⲧⲉⲛϥⲛⲁϣⲉⲡⲑⲏⲛⲟⲩ	ⲉⲧⲉ|ⲛ|ϥ|ⲛⲁ|ϣⲉⲡ|ⲑⲏⲛⲟⲩ
ⲛⲧⲟⲩϣⲧⲉⲙⲥⲱⲧⲉⲙ	ⲛⲧ|ⲟⲩ|ϣⲧⲉⲙ|ⲥⲱⲧⲉⲙ
ⲉⲣⲉⲧⲉⲛⲛⲏⲟⲩ	ⲉⲣⲉ|ⲧⲉⲛ|ⲛⲏⲟⲩ
ⲛⲉϩⲡϣⲱⲓϣ	ⲛⲉϩ|ⲡ|ϣⲱⲓϣ
ⲉⲧⲥⲁⲉϧⲣⲏⲓ	ⲉⲧ|ⲥⲁ|ⲉϧⲣⲏⲓ
ⲛⲛⲉⲧⲉⲛϭⲁⲗⲁⲩϫ	ⲛ|ⲛⲉⲧⲉⲛ|ϭⲁⲗⲁⲩϫ
ⲉⲩⲙⲉⲧⲙⲉⲑⲣⲉ	ⲉ|ⲩ|ⲙⲉⲧⲙⲉⲑⲣⲉ
ⲁⲩϩⲓⲱⲓϣ	ⲁ|ⲩ|ϩⲓⲱⲓϣ
ⲛⲥⲉⲉⲣⲙⲉⲧⲁⲛⲟⲓⲛ	ⲛ|ⲥⲉ|ⲉⲣⲙⲉⲧⲁⲛⲟⲓⲛ
ⲁⲩϩⲓⲟⲩⲙⲏϣ	ⲁ|ⲩ|ϩⲓ|ⲟⲩ|ⲙⲏϣ
ⲛⲇⲁⲓⲙⲱⲛ	ⲛ|ⲇⲁⲓⲙⲱⲛ
ⲛⲁⲩⲑⲱϩⲥ	ⲛⲁ|ⲩ|ⲑⲱϩⲥ
ⲛⲛⲉϩ	ⲛ|ⲛⲉϩ
ⲛⲁⲩⲉⲣⲫⲁϧⲣⲓ	ⲛⲁ|ⲩ|ⲉⲣⲫⲁϧⲣⲓ
ⲁϥⲥⲱⲧⲉⲙ	ⲁ|ϥ|ⲥⲱⲧⲉⲙ
ⲛϫⲉⲡⲟⲩⲣⲟ	ⲛϫⲉ|ⲡ|ⲟⲩⲣⲟ
ⲏⲣⲱⲇⲏⲥ	ⲏⲣⲱⲇⲏⲥ
ⲡⲉϥⲣⲁⲛ	ⲡⲉϥ|ⲣⲁⲛ
ⲁϥⲟⲩⲟⲛϩϥ	ⲁ|ϥ|ⲟⲩⲟⲛϩ|ϥ
ϫⲉⲓⲱⲁⲛⲛⲏⲥ	ϫⲉ|ⲓⲱⲁⲛⲛⲏⲥ
ⲡⲓⲣⲉϥϯⲱⲙⲥ	ⲡⲓ|ⲣⲉϥϯⲱⲙⲥ
ⲁϥⲧⲱⲛϥ	ⲁ|ϥ|ⲧⲱⲛ|ϥ
ⲉⲑⲙⲱⲟⲩⲧ	ⲉⲑ|ⲙⲱⲟⲩⲧ
ⲛⲓϫⲟⲙ	ⲛⲓ|ϫⲟⲙ
ⲥⲉⲉⲣϩⲱⲃ	ⲥⲉ|ⲉⲣϩⲱⲃ
ϩⲁⲛⲕⲉⲭⲱⲟⲩⲛⲓ	ϩⲁⲛ|ⲕⲉ|ⲭⲱⲟⲩⲛⲓ
ⲛⲁⲩϫⲱ	ⲛⲁ|ⲩ|ϫⲱ
ϫⲉⲏⲗⲓⲁⲥ	ϫⲉ|ⲏⲗⲓⲁⲥ
ϫⲉⲟⲩⲡⲣⲟⲫⲏⲧⲏⲥ	ϫⲉ|ⲟⲩ|ⲡⲣⲟⲫⲏⲧⲏⲥ
ⲛⲛⲓⲡⲣⲟⲫⲏⲧⲏⲥ	ⲛ|ⲛⲓ|ⲡⲣⲟⲫⲏⲧⲏⲥ
ⲛⲁⲣⲭⲉⲟⲥ	ⲛ|ⲁⲣⲭⲉⲟⲥ
ⲛϫⲉⲏⲣⲱⲇⲏⲥ	ⲛϫⲉ|ⲏⲣⲱⲇⲏⲥ
ⲉⲧⲁⲓⲉⲗⲧⲉϥⲛⲁϩⲃⲓ	ⲉⲧ|ⲁ|ⲓ|ⲉⲗ|ⲧⲉϥ|ⲛⲁϩⲃⲓ
ⲡⲉⲧⲁϥⲧⲱⲛϥ	ⲡ|ⲉⲧ|ⲁ|ϥ|ⲧⲱⲛ|ϥ
ⲛⲉⲁϥⲁⲙⲟⲛⲓ	ⲛⲉ|ⲁ|ϥ|ⲁⲙⲟⲛⲓ
ⲛⲓⲱⲁⲛⲛⲏⲥ	ⲛ|ⲓⲱⲁⲛⲛⲏⲥ
ⲁϥⲥⲟⲛϩϥ	ⲁ|ϥ|ⲥⲟⲛϩ|ϥ
ϧⲉⲛⲡⲓϣⲧⲉⲕⲟ	ϧⲉⲛ|ⲡⲓ|ϣⲧⲉⲕⲟ
ⲉⲑⲃⲉⲏⲣⲱⲇⲓⲁⲥ	ⲉⲑⲃⲉ|ⲏⲣⲱⲇⲓⲁⲥ
ⲧⲥϩⲓⲙⲓ	ⲧ|ⲥϩⲓⲙⲓ
ⲙⲫⲓⲗⲓⲡⲡⲟⲥ	ⲙ|ⲫⲓⲗⲓⲡⲡⲟⲥ
ⲡⲉϥⲥⲟⲛ	ⲡⲉϥ|ⲥⲟⲛ
ⲛⲉⲁϥϭⲓⲧⲥ	ⲛⲉ|ⲁ|ϥ|ϭⲓⲧ|ⲥ
ⲛϫⲉⲓⲱⲁⲛⲛⲏⲥ	ⲛϫⲉ|ⲓⲱⲁⲛⲛⲏⲥ
ⲛⲏⲣⲱⲇⲏⲥ	ⲛ|ⲏⲣⲱⲇⲏⲥ
ϫⲉⲥϣⲉ	ϫⲉ|ⲥ|ϣⲉ
ⲉϭⲓⲧⲥϩⲓⲙⲓ	ⲉ|ϭⲓ|ⲧ|ⲥϩⲓⲙⲓ
ⲙⲡⲉⲕⲥⲟⲛ	ⲙ|ⲡⲉⲕ|ⲥⲟⲛ
ⲏⲣⲱⲇⲓⲁⲥ	ⲏⲣⲱⲇⲓⲁⲥ
ⲛⲁⲥⲙⲃⲟⲛ	ⲛⲁ|ⲥ|ⲙⲃⲟⲛ
ⲛⲁⲥⲟⲩⲱϣ	ⲛⲁ|ⲥ|ⲟⲩⲱϣ
ⲉϧⲟⲑⲃⲉϥ	ⲉ|ϧⲟⲑⲃⲉ|ϥ
ⲛⲁⲥϣϫⲉⲙϫⲟⲙ	ⲛⲁ|ⲥ|ϣ|ϫⲉⲙϫⲟⲙ
ⲁϥⲉⲣϩⲟϯ	ⲁ|ϥ|ⲉⲣϩⲟϯ
ⲉϥⲥⲱⲟⲩⲛ	ⲉ|ϥ|ⲥⲱⲟⲩⲛ
ϫⲉⲟⲩⲣⲱⲙⲓ	ϫⲉ|ⲟⲩ|ⲣⲱⲙⲓ
ⲛⲇⲓⲕⲉⲟⲥ	ⲛ|ⲇⲓⲕⲉⲟⲥ
ϥⲟⲩⲁⲃ	ϥ|ⲟⲩⲁⲃ
ⲛⲁϥⲁⲣⲉϩ	ⲛⲁ|ϥ|ⲁⲣⲉϩ
ⲛⲁϥⲥⲱⲧⲉⲙ	ⲛⲁ|ϥ|ⲥⲱⲧⲉⲙ
ⲉϩⲁⲛⲙⲏϣ	ⲉ|ϩⲁⲛ|ⲙⲏϣ
ⲛⲁϥϣⲟⲗϩ	ⲛⲁ|ϥ|ϣⲟⲗϩ
ϩⲏⲇⲉⲱⲥ	ϩⲏⲇⲉⲱⲥ
ⲉⲧⲁⲟⲩⲉϩⲟⲟⲩ	ⲉⲧ|ⲁ|ⲟⲩ|ⲉϩⲟⲟⲩ
ⲛⲉⲩⲕⲉⲣⲓⲁ	ⲛ|ⲉⲩⲕⲉⲣⲓⲁ
ⲉⲧⲁⲏⲣⲱⲇⲏⲥ	ⲉⲧ|ⲁ|ⲏⲣⲱⲇⲏⲥ
ϧⲉⲛⲡⲉϥⲉϩⲟⲟⲩ	ϧⲉⲛ|ⲡⲉϥ|ⲉϩⲟⲟⲩ
ⲙⲙⲓⲥⲓ	ⲙ|ⲙⲓⲥⲓ
ⲑⲁⲙⲓⲉⲟⲩⲇⲓⲡⲛⲟⲛ	ⲑⲁⲙⲓⲉ|ⲟⲩ|ⲇⲓⲡⲛⲟⲛ
ⲛⲛⲉϥⲛⲓϣϯ	ⲛ|ⲛⲉϥ|ⲛⲓϣϯ
ⲛⲉⲙⲛⲓⲭⲓⲗⲓⲁⲣⲭⲟⲥ	ⲛⲉⲙ|ⲛⲓ|ⲭⲓⲗⲓⲁⲣⲭⲟⲥ
ⲛⲉⲙⲛⲓϩⲟⲩⲁϯ	ⲛⲉⲙ|ⲛⲓ|ϩⲟⲩⲁϯ
ⲛϫⲉⲧϣⲉⲣⲓ	ⲛϫⲉ|ⲧ|ϣⲉⲣⲓ
ⲛⲏⲣⲱⲇⲓⲁⲥ	ⲛ|ⲏⲣⲱⲇⲓⲁⲥ
ⲉⲧⲁⲥϭⲟⲥϫⲉⲥ	ⲉⲧ|ⲁ|ⲥ|ϭⲟⲥϫⲉⲥ
ⲁⲥⲣⲁⲛⲁϥ	ⲁ|ⲥ|ⲣ|ⲁⲛⲁ|ϥ
ⲉⲑⲣⲟⲧⲉⲃ	ⲉⲑ|ⲣⲟⲧⲉⲃ
ⲡⲉϫⲉⲡⲟⲩⲣⲟ	ⲡⲉϫⲉ|ⲡ|ⲟⲩⲣⲟ
ϫⲉⲁⲣⲓⲉⲧⲓⲛ	ϫⲉ|ⲁⲣⲓⲉⲧⲓⲛ
ⲙⲡⲉⲧⲉⲟⲩⲁϣϥ	ⲙ|ⲡ|ⲉⲧ|ⲉ|ⲟⲩⲁϣ|ϥ
ⲛⲧⲁⲧⲏⲓϥ	ⲛ|ⲧⲁ|ⲧⲏⲓ|ϥ
ⲁϥⲱⲣⲕ	ⲁ|ϥ|ⲱⲣⲕ
ⲉⲧⲉⲣⲁⲉⲣⲉⲧⲓⲛ	ⲉ|ⲧⲉ|ⲣⲁ|ⲉⲣⲉⲧⲓⲛ
ϯⲛⲁϯ	ϯ|ⲛⲁ|ϯ
ϣⲁⲧⲫⲁϣⲓ	ϣⲁ|ⲧ|ⲫⲁϣⲓ
ⲛⲧⲁⲙⲉⲧⲟⲩⲣⲟ	ⲛ|ⲧⲁ|ⲙⲉⲧⲟⲩⲣⲟ
ⲛⲧⲉⲥⲙⲁⲩ	ⲛ|ⲧⲉⲥ|ⲙⲁⲩ
ⲡⲉⲧⲓⲛⲁⲉⲣⲉⲧⲓⲛ	ⲡ|ⲉⲧ|ⲓ|ⲛⲁ|ⲉⲣⲉⲧⲓⲛ
ϫⲉⲧⲁⲫⲉ	ϫⲉ|ⲧ|ⲁⲫⲉ
ϧⲉⲛⲟⲩⲥⲡⲟⲩⲇⲏ	ϧⲉⲛ|ⲟⲩ|ⲥⲡⲟⲩⲇⲏ
ϩⲁⲡⲟⲩⲣⲟ	ϩⲁ|ⲡ|ⲟⲩⲣⲟ
ⲁⲥⲉⲣⲉⲧⲓⲛ	ⲁ|ⲥ|ⲉⲣⲉⲧⲓⲛ
ⲉⲥϫⲱ	ⲉ|ⲥ|ϫⲱ
ϫⲉϯⲟⲩⲱϣ	ϫⲉ|ϯ|ⲟⲩⲱϣ
ⲛⲧⲉⲕϯ	ⲛⲧⲉ|ⲕ|ϯ
ϩⲓⲟⲩⲃⲓⲛⲁϫ	ϩⲓ|ⲟⲩ|ⲃⲓⲛⲁϫ
ⲉⲧⲁⲡϩⲏⲧ	ⲉⲧ|ⲁ|ⲡ|ϩⲏⲧ
ⲙⲡⲟⲩⲣⲟ	ⲙ|ⲡ|ⲟⲩⲣⲟ
ⲙⲕⲁϩ	ⲙⲕⲁϩ
ⲉⲑⲃⲉⲛⲓⲁⲛⲁⲩϣ	ⲉⲑⲃⲉ|ⲛⲓ|ⲁⲛⲁⲩϣ
ⲙⲡⲉϥⲟⲩⲱϣ	ⲙⲡⲉ|ϥ|ⲟⲩⲱϣ
ⲉϥⲟϫⲥ	ⲉ|ϥⲟϫ|ⲥ
ⲛⲟⲩⲥⲕⲉⲡⲱⲗⲁⲧⲟⲣ	ⲛ|ⲟⲩ|ⲥⲕⲉⲡⲱⲗⲁⲧⲟⲣ
ⲁϥⲟⲩⲁϩⲥⲁϩⲛⲓ	ⲁ|ϥ|ⲟⲩⲁϩⲥⲁϩⲛⲓ
ⲛⲧⲉϥⲓⲛⲓ	ⲛⲧⲉ|ϥ|ⲓⲛⲓ
ⲛⲧⲉϥⲁⲫⲉ	ⲛ|ⲧⲉϥ|ⲁⲫⲉ
ϩⲓⲡⲓⲃⲓⲛⲁϫ	ϩⲓ|ⲡⲓ|ⲃⲓⲛⲁϫ
ⲁϥⲧⲏⲓⲥ	ⲁ|ϥ|ⲧⲏⲓ|ⲥ
ⲁϯⲁⲗⲟⲩ	ⲁ|ϯ|ⲁⲗⲟⲩ
ⲧⲏⲓⲥ	ⲧⲏⲓ|ⲥ
ⲁⲩⲱⲗⲓ	ⲁ|ⲩ|ⲱⲗⲓ
ⲙⲡⲓⲥⲱⲙⲁ	ⲙ|ⲡⲓ|ⲥⲱⲙⲁ
ⲁⲩⲭⲁϥ	ⲁ|ⲩ|ⲭⲁ|ϥ
ⲛϧⲟⲩⲛ	ⲛϧⲟⲩⲛ
ϧⲉⲛⲟⲩⲙϩⲁⲩ	ϧⲉⲛ|ⲟⲩ|ⲙϩⲁⲩ
ⲛϫⲉⲛⲓⲁⲡⲟⲥⲧⲟⲗⲟⲥ	ⲛϫⲉ|ⲛⲓ|ⲁⲡⲟⲥⲧⲟⲗⲟⲥ
ϩⲁⲓⲏⲥⲟⲩⲥ	ϩⲁ|ⲓⲏⲥⲟⲩⲥ
ⲉϩⲱⲃ	ⲉ|ϩⲱⲃ
ⲉⲧⲁⲩⲁⲓϥ	ⲉⲧ|ⲁ|ⲩ|ⲁⲓ|ϥ
ⲛⲉⲙⲫⲏ	ⲛⲉⲙ|ⲫⲏ
ⲉⲧⲁⲩϯⲥⲃⲱ	ⲉⲧ|ⲁ|ⲩ|ϯⲥⲃⲱ
ϫⲉⲁⲙⲱⲓⲛⲓ	ϫⲉ|ⲁⲙⲱⲓⲛⲓ
ⲉⲟⲩⲙⲁ	ⲉ|ⲟⲩ|ⲙⲁ
ⲛϣⲁϥⲉ	ⲛ|ϣⲁϥⲉ
ⲙⲧⲟⲛ	ⲙⲧⲟⲛ
ⲛⲟⲩⲕⲟⲩϫⲓ	ⲛ|ⲟⲩ|ⲕⲟⲩϫⲓ
ⲉⲑⲛⲏⲟⲩ	ⲉⲑ|ⲛⲏⲟⲩ
ⲛⲁⲩⲟϣ	ⲛⲁ|ⲩ|ⲟϣ
ⲛⲁⲩϫⲉⲙⲉⲩⲕⲉⲣⲓⲁ	ⲛⲁ|ⲩ|ϫⲉⲙⲉⲩⲕⲉⲣⲓⲁ
ⲉⲉⲣⲡⲕⲉⲟⲩⲱⲙ	ⲉ|ⲉⲣ|ⲡ|ⲕⲉ|ⲟⲩⲱⲙ
ϩⲓⲡⲓϫⲟⲉⲓ	ϩⲓ|ⲡⲓ|ϫⲟⲉⲓ
ⲁⲩⲛⲁⲩ	ⲁ|ⲩ|ⲛⲁⲩ
ⲉⲩϩⲏⲗ	ⲉ|ⲩ|ϩⲏⲗ
ⲁⲩⲥⲱⲟⲩⲛⲟⲩ	ⲁ|ⲩ|ⲥⲱⲟⲩⲛ|ⲟⲩ
ⲛϫⲉⲟⲩⲙⲏϣ	ⲛϫⲉ|ⲟⲩ|ⲙⲏϣ
ⲁⲩϭⲟϫⲓ	ⲁ|ⲩ|ϭⲟϫⲓ
ⲛⲣⲁⲧⲟⲩ	ⲛ|ⲣⲁⲧ|ⲟⲩ
ϧⲉⲛⲃⲁⲕⲓ	ϧⲉⲛ|ⲃⲁⲕⲓ
ⲁⲩⲉⲣϣⲟⲣⲡ	ⲁ|ⲩ|ⲉⲣϣⲟⲣⲡ
ⲁϥϣⲉⲛϩⲏⲧ	ⲁ|ϥ|ϣⲉⲛϩⲏⲧ
ϫⲉⲛⲁⲩⲟⲓ	ϫⲉ|ⲛⲁ|ⲩ|ⲟⲓ
ⲛϩⲁⲛⲉⲥⲱⲟⲩ	ⲛ|ϩⲁⲛ|ⲉⲥⲱⲟⲩ
ⲙⲙⲟⲛⲧⲟⲩ	ⲙⲙⲟⲛⲧ|ⲟⲩ
ⲛϩⲁⲛⲙⲏϣ	ⲛ|ϩⲁⲛ|ⲙⲏϣ
ϩⲏⲇⲏ	ϩⲏⲇⲏ
ⲉⲧⲁ	ⲉⲧ|ⲁ
ⲛⲟⲩⲛⲟⲩ	ⲛ|ⲟⲩⲛⲟⲩ
ⲟⲩϣⲁϥⲉ	ⲟⲩ|ϣⲁϥⲉ
ϯⲟⲩⲛⲟⲩ	ϯ|ⲟⲩⲛⲟⲩ
ⲁⲥⲥⲓⲛⲓ	ⲁ|ⲥ|ⲥⲓⲛⲓ
ⲛⲧⲟⲩϣⲉ	ⲛⲧ|ⲟⲩ|ϣⲉ
ⲉⲛⲓⲓⲟϩⲓ	ⲉ|ⲛⲓ|ⲓⲟϩⲓ
ⲉⲧⲕⲱϯ	ⲉⲧ|ⲕⲱϯ
ⲛⲉⲙⲛⲓϯⲙⲓ	ⲛⲉⲙ|ⲛⲓ|ϯⲙⲓ
ⲛⲧⲟⲩϣⲱⲡ	ⲛⲧ|ⲟⲩ|ϣⲱⲡ
ⲙⲡⲉⲧⲟⲩⲛⲁⲟⲩⲟⲙϥ	ⲙ|ⲡ|ⲉⲧ|ⲟⲩ|ⲛⲁ|ⲟⲩⲟⲙ|ϥ
ⲙⲁⲣⲟⲩⲟⲩⲱⲙ	ⲙⲁⲣ|ⲟⲩ|ⲟⲩⲱⲙ
ⲡⲉϫⲱⲟⲩ	ⲡⲉϫⲱ|ⲟⲩ
ϫⲉⲧⲉⲛⲛⲁϣⲉ	ϫⲉ|ⲧⲉⲛ|ⲛⲁ|ϣⲉ
ⲛⲧⲉⲛϣⲉⲡ	ⲛⲧⲉ|ⲛ|ϣⲉⲡ
ⲛⲥⲁⲑⲉⲣⲓ	ⲛ|ⲥⲁⲑⲉⲣⲓ
ⲛⲱⲓⲕ	ⲛ|ⲱⲓⲕ
ⲛⲧⲉⲛϯ	ⲛⲧⲉ|ⲛ|ϯ
ⲉⲟⲩⲱⲙ	ⲉ|ⲟⲩⲱⲙ
ϫⲉⲟⲩⲟⲛ	ϫⲉ|ⲟⲩⲟⲛ
ⲟⲩⲏⲣ	ⲟⲩⲏⲣ
ⲛⲧⲉⲛⲑⲏⲛⲟⲩ	ⲛⲧⲉⲛ|ⲑⲏⲛⲟⲩ
ⲉⲧⲁⲩⲉⲙⲓ	ⲉⲧ|ⲁ|ⲩ|ⲉⲙⲓ
ϫⲉⲉ	ϫⲉ|ⲉ
ⲛⲉⲙⲧⲉⲃⲧ	ⲛⲉⲙ|ⲧⲉⲃⲧ
ⲛⲧⲟⲩⲣⲱⲧⲉⲃ	ⲛⲧ|ⲟⲩ|ⲣⲱⲧⲉⲃ
ⲛⲥⲩⲙⲡⲟⲥⲓⲟⲛ	ⲛ|ⲥⲩⲙⲡⲟⲥⲓⲟⲛ
ⲥⲩⲙⲡⲟⲥⲓⲟⲛ	ⲥⲩⲙⲡⲟⲥⲓⲟⲛ
ϩⲓϫⲉⲛⲡⲓⲥⲓⲙ	ϩⲓϫⲉⲛ|ⲡⲓ|ⲥⲓⲙ
ⲉⲧϩⲟⲩⲉⲧⲟⲩⲱⲧ	ⲉⲧ|ϩⲟⲩⲉⲧⲟⲩⲱⲧ
ⲁⲩⲣⲱⲧⲉⲃ	ⲁ|ⲩ|ⲣⲱⲧⲉⲃ
ⲕⲁⲧⲁⲣ	ⲕⲁⲧⲁ|ⲣ
ⲣ	ⲣ
ⲛⲉⲙⲕⲁⲧⲁⲛ	ⲛⲉⲙ|ⲕⲁⲧⲁ|ⲛ
ⲙⲡⲓⲉ	ⲙ|ⲡⲓ|ⲉ
ⲛⲉⲙⲛⲓⲧⲉⲃⲧ	ⲛⲉⲙ|ⲛⲓ|ⲧⲉⲃⲧ
ⲁϥⲥⲙⲟⲩ	ⲁ|ϥ|ⲥⲙⲟⲩ
ⲁϥⲫⲱϣ	ⲁ|ϥ|ⲫⲱϣ
ⲛⲛⲓⲙⲁⲑⲏⲧⲏⲥ	ⲛ|ⲛⲓ|ⲙⲁⲑⲏⲧⲏⲥ
ⲛⲧⲟⲩⲭⲱ	ⲛⲧ|ⲟⲩ|ⲭⲱ
ⲛⲁϩⲣⲁⲩ	ⲛⲁϩⲣⲁ|ⲩ
ⲛⲉⲙⲛⲓⲕⲉⲧⲉⲃⲧ	ⲛⲉⲙ|ⲛⲓ|ⲕⲉ|ⲧⲉⲃⲧ
ⲁϥⲫⲁϣⲟⲩ	ⲁ|ϥ|ⲫⲁϣ|ⲟⲩ
ⲉϩⲣⲁⲩ	ⲉϩⲣⲁ|ⲩ
ⲁⲩⲟⲩⲱⲙ	ⲁ|ⲩ|ⲟⲩⲱⲙ
ⲁⲩⲥⲓ	ⲁ|ⲩ|ⲥⲓ
ⲙⲓⲃ	ⲙ|ⲓⲃ
ⲛⲗⲁⲕϩ	ⲛ|ⲗⲁⲕϩ
ⲉⲩⲙⲉϩ	ⲉ|ⲩ|ⲙⲉϩ
ⲛⲉⲙⲉⲃⲟⲗ	ⲛⲉⲙ|ⲉⲃⲟⲗ
ϧⲉⲛⲛⲓⲕⲉⲧⲉⲃⲧ	ϧⲉⲛ|ⲛⲓ|ⲕⲉ|ⲧⲉⲃⲧ
ⲉⲛⲁⲩⲟⲩⲱⲙ	ⲉ|ⲛⲁ|ⲩ|ⲟⲩⲱⲙ
ⲛⲁⲩⲉⲣⲛϣⲟ	ⲛⲁ|ⲩ|ⲉⲣ|ⲛ|ϣⲟ
ⲁϥⲉⲣⲁⲛⲁⲅⲕⲁⲍⲓⲛ	ⲁ|ϥ|ⲉⲣⲁⲛⲁⲅⲕⲁⲍⲓⲛ
ⲉⲁⲗⲏⲓ	ⲉ|ⲁⲗⲏⲓ
ⲉⲡⲓϫⲟⲉⲓ	ⲉ|ⲡⲓ|ϫⲟⲉⲓ
ⲛⲧⲟⲩⲥⲱⲕ	ⲛⲧ|ⲟⲩ|ⲥⲱⲕ
ⲉⲙⲏⲣ	ⲉ|ⲙⲏⲣ
ⲉⲃⲏⲑⲥⲁⲓⲇⲁ	ⲉ|ⲃⲏⲑⲥⲁⲓⲇⲁ
ϣⲁⲧⲉϥⲭⲁⲡⲓⲙⲏϣ	ϣⲁⲧⲉ|ϥ|ⲭⲁ|ⲡⲓ|ⲙⲏϣ
ⲉⲧⲁϥⲉⲣⲁⲡⲟⲧⲁⲍⲉⲥⲑⲉ	ⲉⲧ|ⲁ|ϥ|ⲉⲣⲁⲡⲟⲧⲁⲍⲉⲥⲑⲉ
ⲉⲉⲣⲡⲣⲟⲥⲉⲩⲭⲉⲥⲑⲉ	ⲉ|ⲉⲣⲡⲣⲟⲥⲉⲩⲭⲉⲥⲑⲉ
ⲉⲧⲁⲣⲟⲩϩⲓ	ⲉⲧ|ⲁ|ⲣⲟⲩϩⲓ
ⲛⲁⲣⲉⲡⲓϫⲟⲉⲓ	ⲛⲁⲣⲉ|ⲡⲓ|ϫⲟⲉⲓ
ⲙⲫⲓⲟⲙ	ⲙ|ⲫ|ⲓⲟⲙ
ϩⲓⲡⲓⲭⲣⲟ	ϩⲓ|ⲡⲓ|ⲭⲣⲟ
ⲉⲩⲧϩⲉⲙⲕⲏⲟⲩⲧ	ⲉ|ⲩ|ⲧϩⲉⲙⲕⲏⲟⲩⲧ
ϧⲉⲛⲡⲓϫⲓⲛⲥⲱⲕ	ϧⲉⲛ|ⲡⲓ|ϫⲓⲛⲥⲱⲕ
ⲛⲁⲣⲉⲡⲓⲑⲏⲟⲩ	ⲛⲁⲣⲉ|ⲡⲓ|ⲑⲏⲟⲩ
ϧⲉⲛϯⲙⲁϩⲇ	ϧⲉⲛ|ϯ|ⲙⲁϩⲇ
ⲛⲟⲩⲉⲣϣⲓ	ⲛ|ⲟⲩⲉⲣϣⲓ
ⲛⲧⲉⲡⲓⲉϫⲱⲣϩ	ⲛⲧⲉ|ⲡⲓ|ⲉϫⲱⲣϩ
ⲉϥⲙⲟϣⲓ	ⲉ|ϥ|ⲙⲟϣⲓ
ϩⲓϫⲉⲛⲫⲓⲟⲙ	ϩⲓϫⲉⲛ|ⲫ|ⲓⲟⲙ
ⲉⲥⲉⲛⲟⲩ	ⲉ|ⲥⲉⲛ|ⲟⲩ
ⲛⲁⲩⲙⲉⲩⲓ	ⲛⲁ|ⲩ|ⲙⲉⲩⲓ
ϫⲉⲟⲩϩⲟⲣⲧϥ	ϫⲉ|ⲟⲩ|ϩⲟⲣⲧϥ
ⲁⲩⲱϣ	ⲁ|ⲩ|ⲱϣ
ⲛⲉⲁⲩⲛⲁⲩ	ⲛⲉ|ⲁ|ⲩ|ⲛⲁⲩ
ⲁⲩϣⲑⲟⲣⲧⲉⲣ	ⲁ|ⲩ|ϣⲑⲟⲣⲧⲉⲣ
ϫⲉϫⲉⲙⲛⲟⲙϯ	ϫⲉ|ϫⲉⲙⲛⲟⲙϯ
ⲙⲡⲣⲉⲣϩⲟϯ	ⲙⲡⲣ|ⲉⲣϩⲟϯ
ⲁϥⲁⲗⲏⲓ	ⲁ|ϥ|ⲁⲗⲏⲓ
ⲁϥϩⲉⲣⲓ	ⲁ|ϥ|ϩⲉⲣⲓ
ⲛϫⲉⲡⲓⲑⲏⲟⲩ	ⲛϫⲉ|ⲡⲓ|ⲑⲏⲟⲩ
ⲛⲁⲩⲧⲱⲙⲧ	ⲛⲁ|ⲩ|ⲧⲱⲙⲧ
ⲉϫⲉⲛⲛⲓⲱⲓⲕ	ⲉϫⲉⲛ|ⲛⲓ|ⲱⲓⲕ
ⲛⲁⲣⲉⲡⲟⲩϩⲏⲧ	ⲛⲁⲣⲉ|ⲡⲟⲩ|ϩⲏⲧ
ⲑⲏⲙ	ⲑⲏⲙ
ⲉⲧⲁⲩⲉⲣϫⲓⲛⲓⲟⲣ	ⲉⲧ|ⲁ|ⲩ|ⲉⲣϫⲓⲛⲓⲟⲣ
ⲉⲅⲉⲛⲛⲏⲥⲁⲣⲉⲑ	ⲉ|ⲅⲉⲛⲛⲏⲥⲁⲣⲉⲑ
ⲁⲩⲙⲟⲛⲓ	ⲁ|ⲩ|ⲙⲟⲛⲓ
ⲁⲩⲥⲟⲩⲱⲛϥ	ⲁ|ⲩ|ⲥⲟⲩⲱⲛ|ϥ
ⲥⲁⲧⲟⲧⲟⲩ	ⲥⲁⲧⲟⲧ|ⲟⲩ
ϧⲉⲛϯⲭⲱⲣⲁ	ϧⲉⲛ|ϯ|ⲭⲱⲣⲁ
ⲁⲩⲉⲣϩⲏⲧⲥ	ⲁ|ⲩ|ⲉⲣ|ϩⲏⲧ|ⲥ
ⲙϥⲁⲓ	ⲙ|ϥⲁⲓ
ⲉⲧⲧϩⲉⲙⲕⲏⲟⲩⲧ	ⲉⲧ|ⲧϩⲉⲙⲕⲏⲟⲩⲧ
ϩⲓϩⲁⲛϭⲗⲟϫ	ϩⲓ|ϩⲁⲛ|ϭⲗⲟϫ
ⲉϣⲁⲩⲥⲱⲧⲉⲙ	ⲉ|ϣⲁ|ⲩ|ⲥⲱⲧⲉⲙ
ϫⲉϥⲉⲙⲙⲁⲩ	ϫⲉ|ϥ|ⲉⲙⲙⲁⲩ
ⲡⲓⲙⲁ	ⲡⲓ|ⲙⲁ
ⲉϣⲁϥϣⲉ	ⲉ|ϣⲁ|ϥ|ϣⲉ
ⲉⲛⲓϯⲙⲓ	ⲉ|ⲛⲓ|ϯⲙⲓ
ⲛⲓⲃⲁⲕⲓ	ⲛⲓ|ⲃⲁⲕⲓ
ⲛⲓⲓⲟϩⲓ	ⲛⲓ|ⲓⲟϩⲓ
ⲛⲁⲩⲭⲱ	ⲛⲁ|ⲩ|ⲭⲱ
ⲉⲧϣⲱⲛⲓ	ⲉⲧ|ϣⲱⲛⲓ
ϩⲓⲛⲓⲁⲅⲟⲣⲁ	ϩⲓ|ⲛⲓ|ⲁⲅⲟⲣⲁ
ⲛⲁⲩϯϩⲟ	ⲛⲁ|ⲩ|ϯϩⲟ
ⲛⲧⲟⲩϭⲓ	ⲛⲧ|ⲟⲩ|ϭⲓ
ⲛⲉⲙⲡⲓϣⲧⲁϯ	ⲛⲉⲙ|ⲡⲓ|ϣⲧⲁϯ
ⲛⲧⲉⲛⲉϥϩⲃⲱⲥ	ⲛⲧⲉ|ⲛⲉϥ|ϩⲃⲱⲥ
ⲉϣⲁⲩϭⲓ	ⲉ|ϣⲁ|ⲩ|ϭⲓ
ϣⲁⲩⲟⲩϫⲁⲓ	ϣⲁ|ⲩ|ⲟⲩϫⲁⲓ
ⲛⲉⲡⲓⲡⲁⲥⲭⲁ	ⲛⲉ|ⲡⲓ|ⲡⲁⲥⲭⲁ
ⲛⲉⲙⲛⲓⲁⲧϣⲉⲙⲏⲣ	ⲛⲉⲙ|ⲛⲓ|ⲁⲧϣⲉⲙⲏⲣ
ⲙⲉⲛⲉⲛⲥⲁⲉϩⲟⲟⲩ	ⲙⲉⲛⲉⲛⲥⲁ|ⲉϩⲟⲟⲩ
ⲛⲁⲩⲕⲱϯ	ⲛⲁ|ⲩ|ⲕⲱϯ
ⲛϫⲉⲛⲓⲁⲣⲭⲓⲉⲣⲉⲩⲥ	ⲛϫⲉ|ⲛⲓ|ⲁⲣⲭⲓⲉⲣⲉⲩⲥ
ⲛⲧⲟⲩⲁⲙⲟⲛⲓ	ⲛⲧ|ⲟⲩ|ⲁⲙⲟⲛⲓ
ϧⲉⲛⲟⲩⲭⲣⲟϥ	ϧⲉⲛ|ⲟⲩ|ⲭⲣⲟϥ
ⲛⲧⲟⲩϧⲟⲑⲃϥ	ⲛⲧ|ⲟⲩ|ϧⲟⲑⲃ|ϥ
ϫⲉⲙⲡⲉⲛⲑⲣⲉⲛⲁⲓⲥ	ϫⲉ|ⲙⲡⲉⲛⲑⲣⲉ|ⲛ|ⲁⲓ|ⲥ
ϧⲉⲛⲡϣⲁⲓ	ϧⲉⲛ|ⲡ|ϣⲁⲓ
ⲙⲏⲡⲟⲧⲉ	ⲙⲏⲡⲟⲧⲉ
ⲛⲧⲉⲟⲩϣⲑⲟⲣⲧⲉⲣ	ⲛⲧⲉ|ⲟⲩ|ϣⲑⲟⲣⲧⲉⲣ
ϧⲉⲛⲡⲓⲗⲁⲟⲥ	ϧⲉⲛ|ⲡⲓ|ⲗⲁⲟⲥ
ⲉϥⲭⲏ	ⲉ|ϥ|ⲭⲏ
ϧⲉⲛⲃⲏⲑⲁⲛⲓⲁ	ϧⲉⲛ|ⲃⲏⲑⲁⲛⲓⲁ
ⲛⲥⲓⲙⲱⲛ	ⲛ|ⲥⲓⲙⲱⲛ
ⲡⲓⲕⲁⲕⲥⲉϩⲧ	ⲡⲓ|ⲕⲁⲕⲥⲉϩⲧ
ⲉϥⲣⲱⲧⲉⲃ	ⲉ|ϥ|ⲣⲱⲧⲉⲃ
ⲁⲥⲓ	ⲁ|ⲥ|ⲓ
ⲉⲣⲉⲟⲩⲟⲛ	ⲉⲣⲉ|ⲟⲩⲟⲛ
ⲟⲩⲙⲟⲕⲓ	ⲟⲩ|ⲙⲟⲕⲓ
ⲛⲥⲟϫⲉⲛ	ⲛ|ⲥⲟϫⲉⲛ
ⲛⲛⲁⲣⲇⲟⲥ	ⲛ|ⲛⲁⲣⲇⲟⲥ
ⲙⲡⲓⲥⲧⲓⲕⲏ	ⲙ|ⲡⲓⲥⲧⲓⲕⲏ
ⲉⲛⲁϣⲉ	ⲉ|ⲛⲁϣⲉ
ⲛⲥⲟⲩⲉⲛϥ	ⲛ|ⲥⲟⲩⲉⲛ|ϥ
ⲉⲁⲥϧⲟⲙϧⲉⲙ	ⲉ|ⲁ|ⲥ|ϧⲟⲙϧⲉⲙ
ⲙⲡⲓⲙⲟⲕⲓ	ⲙ|ⲡⲓ|ⲙⲟⲕⲓ
ⲉⲁⲥϫⲟϣϥ	ⲉ|ⲁ|ⲥ|ϫⲟϣ|ϥ
ⲉϫⲉⲛⲧⲉϥⲁⲫⲉ	ⲉϫⲉⲛ|ⲧⲉϥ|ⲁⲫⲉ
ⲛⲁⲣⲉϩⲁⲛⲟⲩⲟⲛ	ⲛⲁⲣⲉ|ϩⲁⲛ|ⲟⲩⲟⲛ
ⲭⲣⲉⲙⲣⲉⲙ	ⲭⲣⲉⲙⲣⲉⲙ
ⲁⲡⲁⲓ	ⲁ|ⲡⲁⲓ
ⲛⲧⲉⲡⲁⲓⲥⲟϫⲉⲛ	ⲛⲧⲉ|ⲡⲁⲓ|ⲥⲟϫⲉⲛ
ⲥⲁⲡϣⲱⲓ	ⲥⲁ|ⲡ|ϣⲱⲓ
ⲛⲧ	ⲛ|ⲧ
ⲛⲧⲟⲩⲧⲏⲓⲧⲟⲩ	ⲛⲧ|ⲟⲩ|ⲧⲏⲓⲧ|ⲟⲩ
ⲛⲛⲓϩⲏⲕⲓ	ⲛ|ⲛⲓ|ϩⲏⲕⲓ
ⲛⲁⲩⲙⲃⲟⲛ	ⲛⲁ|ⲩ|ⲙⲃⲟⲛ
ⲁϧⲱⲧⲉⲛ	ⲁϧⲱ|ⲧⲉⲛ
ⲧⲉⲧⲉⲛϯϧⲓⲥⲓ	ⲧⲉⲧⲉⲛ|ϯϧⲓⲥⲓ
ⲟⲩϩⲱⲃ	ⲟⲩ|ϩⲱⲃ
ⲉⲛⲁⲛⲉϥ	ⲉ|ⲛⲁⲛⲉ|ϥ
ⲉⲧⲁⲥⲉⲣϩⲱⲃ	ⲉⲧ|ⲁ|ⲥ|ⲉⲣϩⲱⲃ
ⲛⲓϩⲏⲕⲓ	ⲛⲓ|ϩⲏⲕⲓ
ⲥⲉⲛⲉⲙⲱⲧⲉⲛ	ⲥⲉ|ⲛⲉⲙⲱ|ⲧⲉⲛ
ⲛⲧⲉⲧⲉⲛⲟⲩⲱϣ	ⲛⲧⲉ|ⲧⲉⲛ|ⲟⲩⲱϣ
_warn:empty_norm_	_warn:empty_norm_
ϯⲛⲉⲙⲱⲧⲉⲛ	ϯ|ⲛⲉⲙⲱ|ⲧⲉⲛ
ⲉⲧⲁⲥϭⲓⲧϥ	ⲉⲧ|ⲁ|ⲥ|ϭⲓⲧ|ϥ
ⲁⲥⲁⲓϥ	ⲁ|ⲥ|ⲁⲓ|ϥ
ⲁⲥⲉⲣϣⲟⲣⲡ	ⲁ|ⲥ|ⲉⲣϣⲟⲣⲡ
ⲛⲑⲁϩⲥⲡⲁⲥⲱⲙⲁ	ⲛ|ⲑⲁϩⲥ|ⲡⲁ|ⲥⲱⲙⲁ
ⲙⲡⲁⲓⲥⲟϫⲉⲛ	ⲙⲡⲁⲓ|ⲥⲟϫⲉⲛ
ⲉⲡϫⲓⲛⲕⲟⲥⲧ	ⲉ|ⲡ|ϫⲓⲛⲕⲟⲥⲧ
ⲉⲧⲟⲩⲛⲁϩⲓⲱⲓϣ	ⲉⲧ|ⲟⲩ|ⲛⲁ|ϩⲓⲱⲓϣ
ⲙⲡⲁⲓⲉⲩⲁⲅⲅⲉⲗⲓⲟⲛ	ⲙ|ⲡⲁⲓ|ⲉⲩⲁⲅⲅⲉⲗⲓⲟⲛ
ⲉⲧⲉⲑⲁⲓ	ⲉⲧⲉ|ⲑⲁⲓ
ⲉⲩⲉⲥⲁϫⲓ	ⲉⲩⲉ|ⲥⲁϫⲓ
ⲓⲟⲩⲇⲁⲥ	ⲓⲟⲩⲇⲁⲥ
ⲡⲓⲥⲕⲁⲣⲓⲱⲧⲏⲥ	ⲡ|ⲓⲥⲕⲁⲣⲓⲱⲧⲏⲥ
ⲛⲧⲉⲡⲓⲓ	ⲛ|ⲧⲉ|ⲡⲓ|ⲓ
ϩⲁⲛⲓⲁⲣⲭⲓⲉⲣⲉⲩⲥ	ϩⲁ|ⲛⲓ|ⲁⲣⲭⲓⲉⲣⲉⲩⲥ
ⲛⲧⲉϥⲧⲏⲓϥ	ⲛⲧⲉ|ϥ|ⲧⲏⲓ|ϥ
ⲁⲩⲣⲁϣⲓ	ⲁ|ⲩ|ⲣⲁϣⲓ
ⲛⲟⲩϩⲁⲧ	ⲛ|ⲟⲩ|ϩⲁⲧ
ⲛⲁϥⲕⲱϯ	ⲛⲁ|ϥ|ⲕⲱϯ
ϥⲛⲁⲧⲏⲓϥ	ϥ|ⲛⲁ|ⲧⲏⲓ|ϥ
ϧⲉⲛⲟⲩⲉⲩⲕⲉⲣⲓⲁ	ϧⲉⲛ|ⲟⲩ|ⲉⲩⲕⲉⲣⲓⲁ
ⲡⲓϩⲟⲩⲓⲧ	ⲡⲓ|ϩⲟⲩⲓⲧ
ⲛⲧⲉⲛⲓⲁⲧϣⲉⲙⲏⲣ	ⲛⲧⲉ|ⲛⲓ|ⲁⲧϣⲉⲙⲏⲣ
ⲉⲩϣⲱⲧ	ⲉ|ⲩ|ϣⲱⲧ
ⲙⲡⲓⲡⲁⲥⲭⲁ	ⲙ|ⲡⲓ|ⲡⲁⲥⲭⲁ
ϫⲉⲭⲟⲩⲱϣ	ϫⲉ|ⲭ|ⲟⲩⲱϣ
ⲛⲧⲉⲛϣⲉ	ⲛⲧⲉ|ⲛ|ϣⲉ
ⲉⲧϩⲱⲛ	ⲉ|ⲧϩⲱⲛ
ⲛⲧⲉⲛⲥⲟⲃϯ	ⲛⲧⲉ|ⲛ|ⲥⲟⲃϯ
ⲛⲧⲉⲕⲟⲩⲱⲙ	ⲛⲧⲉ|ⲕ|ⲟⲩⲱⲙ
ⲉϯⲃⲁⲕⲓ	ⲉ|ϯ|ⲃⲁⲕⲓ
ϥⲛⲁⲉⲣⲁⲡⲁⲛⲧⲁⲛ	ϥ|ⲛⲁ|ⲉⲣⲁⲡⲁⲛⲧⲁⲛ
ⲛϫⲉⲟⲩⲣⲱⲙⲓ	ⲛϫⲉ|ⲟⲩ|ⲣⲱⲙⲓ
ⲉϥϥⲁⲓ	ⲉ|ϥ|ϥⲁⲓ
ⲛⲟⲩϣⲟϣⲟⲩ	ⲛ|ⲟⲩ|ϣⲟϣⲟⲩ
ⲙⲟϣⲓ	ⲙⲟϣⲓ
ⲉⲧⲉϥⲛⲁϣⲉ	ⲉⲧⲉ|ϥ|ⲛⲁ|ϣⲉ
ⲁϫⲟⲥ	ⲁϫⲟ|ⲥ
ⲙⲡⲓⲛⲉⲃⲏⲓ	ⲙ|ⲡⲓ|ⲛⲉⲃⲏⲓ
ϫⲉⲡⲉϫⲉ	ϫⲉ|ⲡⲉϫⲉ
ⲡⲓⲣⲉϥϯⲥⲃⲱ	ⲡⲓ|ⲣⲉϥϯⲥⲃⲱ
ϫⲉⲁϥⲑⲱⲛ	ϫⲉ|ⲁ|ϥ|ⲑⲱⲛ
ⲛⲙⲧⲟⲛ	ⲛ|ⲙⲧⲟⲛ
ⲉϯⲛⲁⲟⲩⲱⲙ	ⲉ|ϯ|ⲛⲁ|ⲟⲩⲱⲙ
ⲛⲉⲙⲛⲁⲙⲁⲑⲏⲧⲏⲥ	ⲛⲉⲙ|ⲛⲁ|ⲙⲁⲑⲏⲧⲏⲥ
ϥⲛⲁⲧⲁⲙⲉⲑⲏⲛⲟⲩ	ϥ|ⲛⲁ|ⲧⲁⲙⲉ|ⲑⲏⲛⲟⲩ
ⲉϥϭⲟⲥⲓ	ⲉ|ϥ|ϭⲟⲥⲓ
ⲉϥⲫⲟⲣϣ	ⲉ|ϥ|ⲫⲟⲣϣ
ⲉϥⲥⲉⲃⲧⲱⲧ	ⲉ|ϥ|ⲥⲉⲃⲧⲱⲧ
ⲥⲉⲃⲧⲱⲧϥ	ⲥⲉⲃⲧⲱⲧ|ϥ
ⲁⲩϫⲓⲙⲓ	ⲁ|ⲩ|ϫⲓⲙⲓ
ⲁⲩⲥⲉⲃⲧⲉ	ⲁ|ⲩ|ⲥⲉⲃⲧⲉ
ⲡⲓⲡⲁⲥⲭⲁ	ⲡⲓ|ⲡⲁⲥⲭⲁ
ⲛⲉⲙⲡⲓⲓⲃ	ⲛⲉⲙ|ⲡⲓ|ⲓⲃ
ⲉⲩⲣⲟⲧⲉⲃ	ⲉ|ⲩ|ⲣⲟⲧⲉⲃ
ⲉⲩⲟⲩⲱⲙ	ⲉ|ⲩ|ⲟⲩⲱⲙ
ϫⲉⲁⲙⲏⲛ	ϫⲉ|ⲁⲙⲏⲛ
ϫⲉⲟⲩⲁⲓ	ϫⲉ|ⲟⲩⲁⲓ
ⲡⲉⲧⲛⲁⲧⲏⲓⲧ	ⲡ|ⲉⲧ|ⲛⲁ|ⲧⲏⲓ|ⲧ
ⲉⲧⲟⲩⲱⲙ	ⲉⲧ|ⲟⲩⲱⲙ
ⲛⲉⲣⲙⲕⲁϩ	ⲛ|ⲉⲣ|ⲙⲕⲁϩ
ϫⲉⲙⲏⲧⲓ	ϫⲉ|ⲙⲏⲧⲓ
ⲛⲧⲉⲡⲓⲓⲃ	ⲛⲧⲉ|ⲡⲓ|ⲓⲃ
ⲉⲧⲁϥⲥⲉⲡⲧⲉϥϫⲓϫ	ⲉⲧ|ⲁ|ϥ|ⲥⲉⲡ|ⲧⲉϥ|ϫⲓϫ
ϧⲉⲛϯϫⲏ	ϧⲉⲛ|ϯ|ϫⲏ
ϫⲉⲡϣⲏⲣⲓ	ϫⲉ|ⲡ|ϣⲏⲣⲓ
ⲙⲫⲣⲱⲙⲓ	ⲙ|ⲫ|ⲣⲱⲙⲓ
ϥⲛⲁϣⲉ	ϥ|ⲛⲁ|ϣⲉ
ⲉⲧⲟⲩⲛⲁϯ	ⲉⲧ|ⲟⲩ|ⲛⲁ|ϯ
ⲙⲡϣⲏⲣⲓ	ⲙ|ⲡ|ϣⲏⲣⲓ
ⲙⲡⲟⲩⲙⲁⲥϥ	ⲙⲡ|ⲟⲩ|ⲙⲁⲥ|ϥ
ⲛⲟⲩⲱⲓⲕ	ⲛ|ⲟⲩ|ⲱⲓⲕ
ⲉⲧⲁϥⲥⲙⲟⲩ	ⲉⲧ|ⲁ|ϥ|ⲥⲙⲟⲩ
ⲁϥⲫⲁϣϥ	ⲁ|ϥ|ⲫⲁϣ|ϥ
ϫⲉϭⲓ	ϫⲉ|ϭⲓ
ⲡⲁⲥⲱⲙⲁ	ⲡⲁ|ⲥⲱⲙⲁ
ⲛⲟⲩⲁⲫⲟⲧ	ⲛ|ⲟⲩ|ⲁⲫⲟⲧ
ⲁϥϣⲉⲡϩⲙⲟⲧ	ⲁ|ϥ|ϣⲉⲡϩⲙⲟⲧ
ⲁⲩⲥⲱ	ⲁ|ⲩ|ⲥⲱ
ϫⲉⲡϩⲁⲓ	ϫⲉ|ⲡϩⲁⲓ
ⲡⲁⲥⲛⲟϥ	ⲡⲁ|ⲥⲛⲟϥ
ⲛⲧⲉϯⲇⲓⲁⲑⲏⲕⲏ	ⲛⲧⲉ|ϯ|ⲇⲓⲁⲑⲏⲕⲏ
ⲉⲧⲟⲩⲛⲁⲫⲟⲛϥ	ⲉⲧ|ⲟⲩ|ⲛⲁ|ⲫⲟⲛ|ϥ
ⲉⲡϫⲓⲛⲭⲱ	ⲉ|ⲡ|ϫⲓⲛⲭⲱ
ⲛⲧⲉⲛⲟⲩⲛⲟⲃⲓ	ⲛⲧⲉ|ⲛⲟⲩ|ⲛⲟⲃⲓ
ϫⲉⲛⲛⲁⲥⲱ	ϫⲉ|ⲛⲛ|ⲁ|ⲥⲱ
ϧⲉⲛⲡⲟⲩⲧⲁϩ	ϧⲉⲛ|ⲡ|ⲟⲩⲧⲁϩ
ⲛⲧⲉⲧⲁⲓⲃⲱ	ⲛⲧⲉ|ⲧⲁⲓ|ⲃⲱ
ϣⲁⲡⲓⲉϩⲟⲟⲩ	ϣⲁ|ⲡⲓ|ⲉϩⲟⲟⲩ
ⲉⲧⲧⲏ	ⲉⲧ|ⲧⲏ
ϩⲟⲧⲁⲛ	ϩⲟⲧⲁⲛ
ⲁⲓϣⲁⲛⲥⲟϥ	ⲁⲓϣⲁⲛ|ⲥⲟ|ϥ
ⲙⲃⲉⲣⲓ	ⲙ|ⲃⲉⲣⲓ
ϧⲉⲛϯⲙⲉⲧⲟⲩⲣⲟ	ϧⲉⲛ|ϯ|ⲙⲉⲧⲟⲩⲣⲟ
ⲉⲧⲁⲩⲥⲙⲟⲩ	ⲉⲧ|ⲁ|ⲩ|ⲥⲙⲟⲩ
ⲛⲧⲉⲛⲓϫⲱⲓⲧ	ⲛⲧⲉ|ⲛⲓ|ϫⲱⲓⲧ
ϫⲉⲧⲉⲧⲉⲛⲛⲁⲉⲣⲥⲕⲁⲛⲇⲁⲗⲓⲍⲉⲥⲑⲉ	ϫⲉ|ⲧⲉⲧⲉⲛ|ⲛⲁ|ⲉⲣⲥⲕⲁⲛⲇⲁⲗⲓⲍⲉⲥⲑⲉ
ϫⲉϯⲛⲁϣⲁⲣⲓ	ϫⲉ|ϯ|ⲛⲁ|ϣⲁⲣⲓ
ⲛⲥⲉϫⲱⲣ	ⲛ|ⲥⲉ|ϫⲱⲣ
ⲙⲉⲛⲉⲛⲥⲁⲑⲣⲓⲧⲱⲛⲧ	ⲙⲉⲛⲉⲛⲥⲁ|ⲑⲣ|ⲓ|ⲧⲱⲛ|ⲧ
ϯⲛⲁⲉⲣϣⲟⲣⲡ	ϯ|ⲛⲁ|ⲉⲣϣⲟⲣⲡ
ⲉϯⲅⲁⲗⲓⲗⲉⲁ	ⲉ|ϯ|ⲅⲁⲗⲓⲗⲉⲁ
ⲡⲉⲧⲣⲟⲥ	ⲡⲉⲧⲣⲟⲥ
ϫⲉⲕⲁⲛ	ϫⲉ|ⲕⲁⲛ
ⲁⲩϣⲁⲛⲉⲣⲥⲕⲁⲛⲇⲁⲗⲓⲍⲉⲥⲑⲉ	ⲁⲩϣⲁⲛ|ⲉⲣⲥⲕⲁⲛⲇⲁⲗⲓⲍⲉⲥⲑⲉ
ϧⲉⲛⲡⲁⲓⲉϫⲱⲣϩ	ϧⲉⲛ|ⲡⲁⲓ|ⲉϫⲱⲣϩ
ⲙⲡⲁⲧⲉⲟⲩⲁⲗⲉⲕⲧⲱⲣ	ⲙⲡⲁⲧⲉ|ⲟⲩ|ⲁⲗⲉⲕⲧⲱⲣ
ⲙⲟⲩϯ	ⲙⲟⲩϯ
ⲭⲛⲁϫⲟⲗⲧ	ⲭ|ⲛⲁ|ϫⲟⲗ|ⲧ
ⲛⲅ	ⲛ|ⲅ
ϧⲉⲛⲟⲩⲙⲉⲧϩⲟⲩⲟ	ϧⲉⲛ|ⲟⲩ|ⲙⲉⲧϩⲟⲩⲟ
ⲁⲥϣⲁⲛⲫⲟϩ	ⲁⲥϣⲁⲛ|ⲫⲟϩ
ⲛⲧⲁⲙⲟⲩ	ⲛⲧ|ⲁ|ⲙⲟⲩ
ⲛⲉⲙⲁⲕ	ⲛⲉⲙⲁ|ⲕ
ⲛⲛⲁϫⲟⲗⲕ	ⲛⲛ|ⲁ|ϫⲟⲗ|ⲕ
ⲉⲩⲓⲟϩⲓ	ⲉ|ⲩ|ⲓⲟϩⲓ
ⲅⲉⲑⲥⲏⲙⲁⲛⲓ	ⲅⲉⲑⲥⲏⲙⲁⲛⲓ
ϫⲉϩⲉⲙⲥⲓ	ϫⲉ|ϩⲉⲙⲥⲓ
ϩⲁⲙⲛⲁⲓ	ϩⲁ|ⲙⲛⲁⲓ
ϯⲉⲣⲡⲣⲟⲥⲉⲩⲭⲉⲥⲑⲉ	ϯ|ⲉⲣⲡⲣⲟⲥⲉⲩⲭⲉⲥⲑⲉ
ⲙⲡⲉⲧⲣⲟⲥ	ⲙ|ⲡⲉⲧⲣⲟⲥ
ⲛⲉⲙⲓⲁⲕⲱⲃⲟⲥ	ⲛⲉⲙ|ⲓⲁⲕⲱⲃⲟⲥ
ⲛⲉⲙⲓⲱⲁⲛⲛⲏⲥ	ⲛⲉⲙ|ⲓⲱⲁⲛⲛⲏⲥ
ⲛϣⲑⲟⲣⲧⲉⲣ	ⲛ|ϣⲑⲟⲣⲧⲉⲣ
ϫⲉⲧⲁⲯⲩⲭⲏ	ϫⲉ|ⲧⲁ|ⲯⲩⲭⲏ
ⲙⲟⲕϩ	ⲙⲟⲕϩ
ϣⲁⲉϧⲣⲏⲓ	ϣⲁ|ⲉϧⲣⲏⲓ
ⲉⲫⲙⲟⲩ	ⲉ|ⲫ|ⲙⲟⲩ
ⲙⲡⲁⲓⲙⲁ	ⲙ|ⲡⲁⲓ|ⲙⲁ
ⲉⲧⲁϥⲥⲓⲛⲓ	ⲉⲧ|ⲁ|ϥ|ⲥⲓⲛⲓ
ⲉⲧϩⲏ	ⲉ|ⲧ|ϩⲏ
ⲛⲁϥϩⲓ	ⲛⲁ|ϥ|ϩⲓ
ⲉϫⲉⲛⲡⲕⲁϩⲓ	ⲉϫⲉⲛ|ⲡ|ⲕⲁϩⲓ
ⲛⲁϥⲉⲣⲡⲣⲟⲥⲉⲩⲭⲉⲥⲑⲉ	ⲛⲁ|ϥ|ⲉⲣⲡⲣⲟⲥⲉⲩⲭⲉⲥⲑⲉ
ⲥⲓⲛⲓ	ⲥⲓⲛⲓ
ϫⲉⲁⲃⲃⲁ	ϫⲉ|ⲁⲃⲃⲁ
ⲫⲓⲱⲧ	ⲫ|ⲓⲱⲧ
ϧⲁⲧⲟⲧⲕ	ϧⲁⲧⲟⲧ|ⲕ
ⲙⲁⲣⲉⲡⲓⲁⲫⲟⲧ	ⲙⲁⲣⲉ|ⲡⲓ|ⲁⲫⲟⲧ
ⲉⲧⲉϩⲛⲏⲓ	ⲉⲧⲉ|ϩⲛⲏ|ⲓ
ⲉⲧⲉϩⲛⲁⲕ	ⲉⲧⲉ|ϩⲛⲁ|ⲕ
ⲁϥϫⲉⲙⲟⲩ	ⲁ|ϥ|ϫⲉⲙ|ⲟⲩ
ⲉⲩⲛⲕⲟⲧ	ⲉ|ⲩ|ⲛⲕⲟⲧ
ϫⲉⲥⲓⲙⲱⲛ	ϫⲉ|ⲥⲓⲙⲱⲛ
ⲕⲛⲕⲟⲧ	ⲕ|ⲛⲕⲟⲧ
ⲙⲡⲉⲕϣϫⲉⲙϫⲟⲙ	ⲙⲡⲉ|ⲕ|ϣϫⲉⲙϫⲟⲙ
ⲛⲣⲱⲓⲥ	ⲛ|ⲣⲱⲓⲥ
ⲛⲟⲩⲟⲩⲛⲟⲩ	ⲛ|ⲟⲩ|ⲟⲩⲛⲟⲩ
ⲁⲣⲓⲡⲣⲟⲥⲉⲩⲭⲉⲥⲑⲉ	ⲁⲣⲓⲡⲣⲟⲥⲉⲩⲭⲉⲥⲑⲉ
ⲛⲧⲉⲧⲉⲛϣⲧⲉⲙⲓ	ⲛⲧⲉ|ⲧⲉⲛ|ϣⲧⲉⲙ|ⲓ
ⲉⲡⲓⲣⲁⲥⲙⲟⲥ	ⲉ|ⲡⲓⲣⲁⲥⲙⲟⲥ
ⲡⲓⲡⲛⲉⲩⲙⲁ	ⲡⲓ|ⲡⲛⲉⲩⲙⲁ
ϥⲣⲱⲟⲩⲧ	ϥ|ⲣⲱⲟⲩⲧ
ⲟⲩⲁⲥⲑⲉⲛⲏⲥ	ⲟⲩ|ⲁⲥⲑⲉⲛⲏⲥ
ⲁϥϫⲉⲡⲁⲓⲥⲁϫⲓ	ⲁ|ϥ|ϫⲉ|ⲡⲁⲓ|ⲥⲁϫⲓ
ⲛⲁⲣⲉⲛⲟⲩⲃⲁⲗ	ⲛⲁⲣⲉ|ⲛⲟⲩ|ⲃⲁⲗ
ϩⲟⲣϣ	ϩⲟⲣϣ
ⲡⲉⲧⲟⲩⲛⲁⲉⲣⲟⲩⲱ	ⲡ|ⲉⲧ|ⲟⲩ|ⲛⲁ|ⲉⲣⲟⲩⲱ
ⲙⲡⲓⲙⲁϩⲅ	ⲙ|ⲡⲓ|ⲙⲁϩⲅ
ϫⲉⲛⲕⲟⲧ	ϫⲉ|ⲛⲕⲟⲧ
ϫⲉⲁⲥⲓ	ϫⲉ|ⲁ|ⲥ|ⲓ
ⲛϫⲉϯⲟⲩⲛⲟⲩ	ⲛϫⲉ|ϯ|ⲟⲩⲛⲟⲩ
ϩⲏⲡⲡⲉ	ϩⲏⲡⲡⲉ
ⲥⲉⲛⲁϯ	ⲥⲉ|ⲛⲁ|ϯ
ⲉⲛⲉⲛϫⲓϫ	ⲉ|ⲛⲉⲛ|ϫⲓϫ
ⲛⲧⲉⲛⲓⲣⲉϥⲉⲣⲛⲟⲃⲓ	ⲛⲧⲉ|ⲛⲓ|ⲣⲉϥⲉⲣⲛⲟⲃⲓ
ⲧⲉⲛⲑⲏⲛⲟⲩ	ⲧⲉⲛ|ⲑⲏⲛⲟⲩ
ⲙⲁⲣⲟⲛ	ⲙⲁⲣⲟ|ⲛ
ⲁϥϧⲱⲛⲧ	ⲁ|ϥ|ϧⲱⲛⲧ
ⲉⲧⲛⲁⲧⲏⲓⲧ	ⲉⲧ|ⲛⲁ|ⲧⲏⲓ|ⲧ
ⲛϫⲉⲓⲟⲩⲇⲁⲥ	ⲛϫⲉ|ⲓⲟⲩⲇⲁⲥ
ϧⲉⲛⲡⲓⲓⲃ	ϧⲉⲛ|ⲡⲓ|ⲓⲃ
ⲛⲉⲙϩⲁⲛⲥⲏϥⲓ	ⲛⲉⲙ|ϩⲁⲛ|ⲥⲏϥⲓ
ⲛⲉⲙϩⲁⲛϣⲉ	ⲛⲉⲙ|ϩⲁⲛ|ϣⲉ
ⲛⲉⲙⲛⲓⲡⲣⲉⲥⲃⲩⲧⲉⲣⲟⲥ	ⲛⲉⲙ|ⲛⲓ|ⲡⲣⲉⲥⲃⲩⲧⲉⲣⲟⲥ
ϫⲉⲁϥϯ	ϫⲉ|ⲁ|ϥ|ϯ
ⲛⲟⲩⲙⲏⲓⲛⲓ	ⲛ|ⲟⲩ|ⲙⲏⲓⲛⲓ
ⲉⲧⲛⲁⲧⲏⲓϥ	ⲉⲧ|ⲛⲁ|ⲧⲏⲓ|ϥ
ⲉϯⲛⲁϯ	ⲉ|ϯ|ⲛⲁ|ϯ
ⲛⲟⲩⲫⲓ	ⲛ|ⲟⲩ|ⲫⲓ
ⲁⲙⲟⲛⲓ	ⲁⲙⲟⲛⲓ
ⲁⲥⲫⲁⲗⲱⲥ	ⲁⲥⲫⲁⲗⲱⲥ
ϫⲉⲣⲁⲃⲃⲓ	ϫⲉ|ⲣⲁⲃⲃⲓ
ⲁⲩⲉⲛⲛⲟⲩϫⲓϫ	ⲁ|ⲩ|ⲉⲛ|ⲛⲟⲩ|ϫⲓϫ
ⲛⲧⲉⲛⲏ	ⲛⲧⲉ|ⲛⲏ
ⲉⲣⲁⲧⲟⲩ	ⲉⲣⲁⲧ|ⲟⲩ
ⲁϥⲑⲉⲕⲉⲙϯⲥⲏϥⲓ	ⲁ|ϥ|ⲑⲉⲕⲉⲙ|ϯ|ⲥⲏϥⲓ
ⲛⲟⲩϣⲁϣ	ⲛ|ⲟⲩ|ϣⲁϣ
ⲙⲫⲃⲱⲕ	ⲙ|ⲫ|ⲃⲱⲕ
ⲙⲡⲓⲁⲣⲭⲓⲉⲣⲉⲩⲥ	ⲙ|ⲡⲓ|ⲁⲣⲭⲓⲉⲣⲉⲩⲥ
ⲙⲡⲉϥⲙⲁϣϫ	ⲙ|ⲡⲉϥ|ⲙⲁϣϫ
ϫⲉⲉⲧⲁⲣⲉⲧⲉⲛⲓ	ϫⲉ|ⲉⲧ|ⲁⲣⲉ|ⲧⲉⲛ|ⲓ
ⲛⲥⲁⲟⲩⲥⲟⲛⲓ	ⲛⲥⲁ|ⲟⲩ|ⲥⲟⲛⲓ
ⲉⲧⲁϩⲟⲓ	ⲉ|ⲧⲁϩⲟ|ⲓ
ⲛⲁⲓⲭⲏ	ⲛⲁ|ⲓ|ⲭⲏ
ⲉⲓϯⲥⲃⲱ	ⲉ|ⲓ|ϯⲥⲃⲱ
ϧⲉⲛⲡⲓⲉⲣⲫⲉⲓ	ϧⲉⲛ|ⲡⲓ|ⲉⲣⲫⲉⲓ
ⲙⲡⲉⲧⲉⲛⲁⲙⲟⲛⲓ	ⲙⲡⲉ|ⲧⲉⲛ|ⲁⲙⲟⲛⲓ
ⲛⲧⲟⲩϫⲱⲕ	ⲛⲧ|ⲟⲩ|ϫⲱⲕ
ⲛϫⲉⲛⲓⲅⲣⲁⲫⲏ	ⲛϫⲉ|ⲛⲓ|ⲅⲣⲁⲫⲏ
ⲉⲧⲁⲩⲭⲁϥ	ⲉⲧ|ⲁ|ⲩ|ⲭⲁ|ϥ
ⲁⲩⲫⲱⲧ	ⲁ|ⲩ|ⲫⲱⲧ
ⲟⲩϧⲉⲗϣⲓⲣⲓ	ⲟⲩ|ϧⲉⲗϣⲓⲣⲓ
ⲉϥϫⲏⲗ	ⲉ|ϥ|ϫⲏⲗ
ⲛⲟⲩⲥⲩⲛⲇⲟⲛⲓⲟⲛ	ⲛ|ⲟⲩ|ⲥⲩⲛⲇⲟⲛⲓⲟⲛ
ⲉϫⲉⲛⲡⲉϥⲃⲱϣ	ⲉϫⲉⲛ|ⲡⲉϥ|ⲃⲱϣ
ⲁϥⲥⲱϫⲡ	ⲁ|ϥ|ⲥⲱϫⲡ
ⲛϯⲥⲩⲛⲇⲟⲛⲓⲟⲛ	ⲛ|ϯ|ⲥⲩⲛⲇⲟⲛⲓⲟⲛ
ⲁϥⲫⲱⲧ	ⲁ|ϥ|ⲫⲱⲧ
ⲉϥⲃⲏϣ	ⲉ|ϥ|ⲃⲏϣ
ⲁⲩϭⲓ	ⲁ|ⲩ|ϭⲓ
ϩⲁⲛⲓⲁⲣⲭⲉⲓⲣⲉⲩⲥ	ϩⲁ|ⲛⲓ|ⲁⲣⲭⲉⲓⲣⲉⲩⲥ
ⲛⲁϥⲙⲟϣⲓ	ⲛⲁ|ϥ|ⲙⲟϣⲓ
ϩⲓⲫⲟⲩⲉⲓ	ϩⲓ|ⲫ|ⲟⲩⲉⲓ
ϣⲁⲉϧⲟⲩⲛ	ϣⲁ|ⲉϧⲟⲩⲛ
ⲉϯⲁⲩⲗⲏ	ⲉ|ϯ|ⲁⲩⲗⲏ
ⲛⲧⲉⲡⲓⲁⲣⲭⲓⲉⲣⲉⲩⲥ	ⲛⲧⲉ|ⲡⲓ|ⲁⲣⲭⲓⲉⲣⲉⲩⲥ
ⲛⲁϥⲉⲣϣⲫⲏⲣ	ⲛⲁ|ϥ|ⲉⲣϣⲫⲏⲣ
ⲛⲉⲙⲛⲓϩⲩⲡⲏⲣⲉⲧⲏⲥ	ⲛⲉⲙ|ⲛⲓ|ϩⲩⲡⲏⲣⲉⲧⲏⲥ
ⲉϥⲧϧⲙⲟⲙ	ⲉ|ϥ|ⲧϧⲙⲟⲙ
ϧⲁⲧⲉⲛⲡⲓⲟⲩⲱⲓⲛⲓ	ϧⲁⲧⲉⲛ|ⲡⲓ|ⲟⲩⲱⲓⲛⲓ
ⲡⲓⲁⲣⲭⲓⲉⲣⲉⲩⲥ	ⲡⲓ|ⲁⲣⲭⲓⲉⲣⲉⲩⲥ
ⲛⲉⲙⲡⲓⲙⲁ	ⲛⲉⲙ|ⲡⲓ|ⲙⲁ
ⲛϯϩⲁⲡ	ⲛ|ϯϩⲁⲡ
ⲛⲥⲁⲟⲩⲙⲉⲧⲙⲉⲑⲣⲉ	ⲛⲥⲁ|ⲟⲩ|ⲙⲉⲧⲙⲉⲑⲣⲉ
ϧⲁⲓⲏⲥⲟⲩⲥ	ϧⲁ|ⲓⲏⲥⲟⲩⲥ
ⲉⲡϫⲓⲛϧⲟⲑⲃⲉϥ	ⲉ|ⲡ|ϫⲓⲛϧⲟⲑⲃⲉϥ
ⲛⲁⲩϫⲓⲙⲓ	ⲛⲁ|ⲩ|ϫⲓⲙⲓ
ⲛⲁⲣⲉⲟⲩⲙⲏϣ	ⲛⲁⲣⲉ|ⲟⲩ|ⲙⲏϣ
ⲛⲛⲟⲩϫ	ⲛ|ⲛⲟⲩϫ
ⲛⲁⲩⲟⲓ	ⲛⲁ|ⲩ|ⲟⲓ
ⲛϩⲩⲥⲟⲥ	ⲛ|ϩⲩⲥⲟⲥ
ⲛϫⲉⲛⲟⲩⲙⲉⲧⲙⲉⲑⲣⲉ	ⲛϫⲉ|ⲛⲟⲩ|ⲙⲉⲧⲙⲉⲑⲣⲉ
ⲉⲧⲁⲩⲧⲱⲟⲩⲛⲟⲩ	ⲉⲧ|ⲁ|ⲩ|ⲧⲱⲟⲩⲛ|ⲟⲩ
ⲛϫⲉϩⲁⲛⲟⲩⲟⲛ	ⲛϫⲉ|ϩⲁⲛ|ⲟⲩⲟⲛ
ⲁⲩⲉⲣⲙⲉⲑⲣⲉ	ⲁ|ⲩ|ⲉⲣ|ⲙⲉⲑⲣⲉ
ϫⲉⲁⲛⲟⲛ	ϫⲉ|ⲁⲛⲟⲛ
ⲁⲛⲥⲱⲧⲉⲙ	ⲁ|ⲛ|ⲥⲱⲧⲉⲙ
ϯⲛⲁⲃⲱⲗ	ϯ|ⲛⲁ|ⲃⲱⲗ
ⲙⲡⲁⲓⲉⲣⲫⲉⲓ	ⲙ|ⲡⲁⲓ|ⲉⲣⲫⲉⲓ
ⲡⲁⲓⲙⲟⲩⲛⲕ	ⲡⲁⲓ|ⲙⲟⲩⲛⲕ
ⲛϫⲓϫ	ⲛ|ϫⲓϫ
ϩⲓⲧⲉⲛⲅ	ϩⲓⲧⲉⲛ|ⲅ
ⲛⲁⲑⲙⲟⲩⲛⲕ	ⲛ|ⲁⲑⲙⲟⲩⲛⲕ
ϯⲛⲁⲕⲟⲧϥ	ϯ|ⲛⲁ|ⲕⲟⲧ|ϥ
ⲛⲁⲥⲟⲓ	ⲛⲁ|ⲥ|ⲟⲓ
ⲛϫⲉⲧⲟⲩⲙⲉⲧⲙⲉⲑⲣⲉ	ⲛϫⲉ|ⲧⲟⲩ|ⲙⲉⲧⲙⲉⲑⲣⲉ
ⲛϫⲉⲡⲓⲁⲣⲭⲓⲉⲣⲉⲩⲥ	ⲛϫⲉ|ⲡⲓ|ⲁⲣⲭⲓⲉⲣⲉⲩⲥ
ⲉⲧⲙⲏϯ	ⲉ|ⲧ|ⲙⲏϯ
ⲁϥϣⲉⲛⲓⲏⲥⲟⲩⲥ	ⲁ|ϥ|ϣⲉⲛ|ⲓⲏⲥⲟⲩⲥ
ϫⲉⲛⲕⲉⲣⲟⲩⲱ	ϫⲉ|ⲛ|ⲕ|ⲉⲣⲟⲩⲱ
ϧⲁⲣⲟⲕ	ϧⲁⲣⲟ|ⲕ
ⲛⲁϥⲭⲱ	ⲛⲁ|ϥ|ⲭⲱ
ⲛⲣⲱϥ	ⲛ|ⲣⲱ|ϥ
ⲙⲡⲉϥⲉⲣⲟⲩⲱ	ⲙⲡⲉ|ϥ|ⲉⲣⲟⲩⲱ
ⲁⲡⲓⲁⲣⲭⲓⲉⲣⲉⲩⲥ	ⲁ|ⲡⲓ|ⲁⲣⲭⲓⲉⲣⲉⲩⲥ
ϣⲉⲛϥ	ϣⲉⲛ|ϥ
ⲉⲣⲉⲧⲉⲛⲉⲛⲁⲩ	ⲉⲣⲉⲧⲉⲛⲉ|ⲛⲁⲩ
ⲉⲡϣⲏⲣⲓ	ⲉ|ⲡ|ϣⲏⲣⲓ
ⲉϥϩⲉⲙⲥⲓ	ⲉ|ϥ|ϩⲉⲙⲥⲓ
ⲥⲁⲟⲩⲓⲛⲁⲙ	ⲥⲁ|ⲟⲩⲓⲛⲁⲙ
ⲛϯϫⲟⲙ	ⲛ|ϯ|ϫⲟⲙ
ⲛⲉⲙⲛⲓϭⲏⲡⲓ	ⲛⲉⲙ|ⲛⲓ|ϭⲏⲡⲓ
ⲛⲧⲉⲧⲫⲉ	ⲛⲧⲉ|ⲧ|ⲫⲉ
ⲉⲧⲁϥⲫⲱϧ	ⲉⲧ|ⲁ|ϥ|ⲫⲱϧ
ⲛⲛⲉϥϩⲃⲱⲥ	ⲛ|ⲛⲉϥ|ϩⲃⲱⲥ
ⲉⲧⲉⲧⲉⲛⲉⲣⲭⲣⲓⲁ	ⲉⲧⲉ|ⲧⲉⲛ|ⲉⲣⲭⲣⲓⲁ
ⲙⲙⲉⲑⲣⲉ	ⲙ|ⲙⲉⲑⲣⲉ
ⲁⲧⲉⲧⲉⲛⲥⲱⲧⲉⲙ	ⲁ|ⲧⲉⲧⲉⲛ|ⲥⲱⲧⲉⲙ
ⲉⲡⲓϫⲉⲟⲩⲁ	ⲉ|ⲡⲓ|ϫⲉⲟⲩⲁ
ⲉⲧⲟⲩⲟⲛϩ	ⲉⲧ|ⲟⲩⲟⲛϩ
ⲁⲩⲉⲣⲕⲁⲧⲁⲕⲣⲓⲛⲓⲛ	ⲁ|ⲩ|ⲉⲣⲕⲁⲧⲁⲕⲣⲓⲛⲓⲛ
ϫⲉϥⲟⲓ	ϫⲉ|ϥ|ⲟⲓ
ⲛⲉⲛⲟⲭⲟⲥ	ⲛ|ⲉⲛⲟⲭⲟⲥ
ⲉⲧⲁⲩⲉⲣϩⲏⲧⲥ	ⲉⲧ|ⲁ|ⲩ|ⲉⲣ|ϩⲏⲧ|ⲥ
ⲉϩⲓⲑⲁϥ	ⲉ|ϩⲓⲑⲁϥ
ϧⲉⲛϩⲣⲁϥ	ϧⲉⲛ|ϩⲣⲁ|ϥ
ⲉϩⲱⲃⲥ	ⲉ|ϩⲱⲃⲥ
ⲙⲡⲉϥϩⲟ	ⲙ|ⲡⲉϥ|ϩⲟ
ⲉϯⲕⲉϩ	ⲉ|ϯⲕⲉϩ
ϫⲉⲁⲣⲓⲡⲣⲟⲫⲏⲧⲉⲩⲓⲛ	ϫⲉ|ⲁⲣⲓⲡⲣⲟⲫⲏⲧⲉⲩⲓⲛ
ϫⲉⲛⲓⲙ	ϫⲉ|ⲛⲓⲙ
ⲡⲉⲧⲁϥϩⲓⲟⲩⲓ	ⲡ|ⲉⲧ|ⲁ|ϥ|ϩⲓⲟⲩⲓ
ⲛⲓϩⲩⲡⲏⲣⲉⲧⲏⲥ	ⲛⲓ|ϩⲩⲡⲏⲣⲉⲧⲏⲥ
ⲛϩⲁⲛⲁⲗⲱϫ	ⲛ|ϩⲁⲛ|ⲁⲗⲱϫ
ⲉⲣⲉⲡⲉⲧⲣⲟⲥ	ⲉⲣⲉ|ⲡⲉⲧⲣⲟⲥ
ϧⲉⲛϯⲁⲩⲗⲏ	ϧⲉⲛ|ϯ|ⲁⲩⲗⲏ
ⲛϫⲉⲟⲩⲓ	ⲛϫⲉ|ⲟⲩⲓ
ⲛⲛⲓⲃⲱⲕⲓ	ⲛ|ⲛⲓ|ⲃⲱⲕⲓ
ⲉⲡⲉⲧⲣⲟⲥ	ⲉ|ⲡⲉⲧⲣⲟⲥ
ⲉⲧⲁⲥϫⲟⲩϣⲧ	ⲉⲧ|ⲁ|ⲥ|ϫⲟⲩϣⲧ
ϩⲱⲕ	ϩⲱ|ⲕ
ⲛⲁⲕⲭⲏ	ⲛⲁ|ⲕ|ⲭⲏ
ⲛⲉⲙⲓⲏⲥⲟⲩⲥ	ⲛⲉⲙ|ⲓⲏⲥⲟⲩⲥ
ⲡⲓⲛⲁⲍⲱⲣⲉⲟⲥ	ⲡⲓ|ⲛⲁⲍⲱⲣⲉⲟⲥ
ⲁϥϫⲱⲗ	ⲁ|ϥ|ϫⲱⲗ
ϫⲉⲟⲩⲇⲉ	ϫⲉ|ⲟⲩⲇⲉ
ⲛϯⲥⲱⲟⲩⲛ	ⲛ|ϯ|ⲥⲱⲟⲩⲛ
ⲛⲧϩⲟ	ⲛⲧϩⲟ
ⲡⲉⲧⲉϫⲱ	ⲡ|ⲉⲧ|ⲉ|ϫⲱ
ⲛⲧⲉϯⲁⲩⲗⲏ	ⲛⲧⲉ|ϯ|ⲁⲩⲗⲏ
ⲛϫⲉϯⲭⲉϯ	ⲛϫⲉ|ϯ|ⲭⲉϯ
ⲙⲉⲛⲉⲛⲥⲁⲟⲩⲕⲟⲩϫⲓ	ⲙⲉⲛⲉⲛⲥⲁ|ⲟⲩ|ⲕⲟⲩϫⲓ
ϫⲉⲁⲗⲏⲑⲱⲥ	ϫⲉ|ⲁⲗⲏⲑⲱⲥ
ⲟⲩⲅⲁⲗⲓⲗⲉⲟⲥ	ⲟⲩ|ⲅⲁⲗⲓⲗⲉⲟⲥ
ⲛⲉⲣⲁⲛⲁⲑⲉⲙⲁⲧⲓⲍⲓⲛ	ⲛ|ⲉⲣⲁⲛⲁⲑⲉⲙⲁⲧⲓⲍⲓⲛ
ⲛⲉⲙⲱⲣⲕ	ⲛⲉⲙ|ⲱⲣⲕ
ϫⲉϯⲥⲱⲟⲩⲛ	ϫⲉ|ϯ|ⲥⲱⲟⲩⲛ
ⲉⲧⲉⲧⲉⲛϫⲱ	ⲉⲧⲉ|ⲧⲉⲛ|ϫⲱ
ⲛϫⲉⲟⲩⲁⲗⲉⲕⲧⲱⲣ	ⲛϫⲉ|ⲟⲩ|ⲁⲗⲉⲕⲧⲱⲣ
ⲙⲫⲙⲁϩⲥⲟⲡ	ⲙ|ⲫ|ⲙⲁϩⲥⲟⲡ
ⲁϥⲉⲣⲫⲙⲉⲩⲓ	ⲁ|ϥ|ⲉⲣ|ⲫ|ⲙⲉⲩⲓ
ⲛϫⲉⲡⲉⲧⲣⲟⲥ	ⲛϫⲉ|ⲡⲉⲧⲣⲟⲥ
ϫⲉⲙⲡⲁⲧⲉⲟⲩⲁⲗⲉⲕⲧⲱⲣ	ϫⲉ|ⲙⲡⲁⲧⲉ|ⲟⲩ|ⲁⲗⲉⲕⲧⲱⲣ
ⲉⲧⲁϥϩⲓⲧⲟⲧϥ	ⲉⲧ|ⲁ|ϥ|ϩⲓ|ⲧⲟⲧ|ϥ
ⲁϥⲣⲓⲙⲓ	ⲁ|ϥ|ⲣⲓⲙⲓ
ϩⲁⲛⲟⲩⲟⲛ	ϩⲁⲛ|ⲟⲩⲟⲛ
ⲛⲥⲉⲛⲁϫⲉⲙϯⲡⲓ	ⲛ|ⲥⲉ|ⲛⲁ|ϫⲉⲙϯⲡⲓ
ⲙⲫⲙⲟⲩ	ⲙ|ⲫ|ⲙⲟⲩ
ϣⲁⲧⲟⲩⲛⲁⲩ	ϣⲁⲧ|ⲟⲩ|ⲛⲁⲩ
ⲉϯⲙⲉⲧⲟⲩⲣⲟ	ⲉ|ϯ|ⲙⲉⲧⲟⲩⲣⲟ
ϧⲉⲛⲟⲩϫⲟⲙ	ϧⲉⲛ|ⲟⲩ|ϫⲟⲙ
ⲙⲉⲛⲉⲛⲥⲁⲋ	ⲙⲉⲛⲉⲛⲥⲁ|ⲋ
ⲁϥⲟⲗⲟⲩ	ⲁ|ϥ|ⲟⲗ|ⲟⲩ
ⲉϫⲉⲛⲟⲩⲧⲱⲟⲩ	ⲉϫⲉⲛ|ⲟⲩ|ⲧⲱⲟⲩ
ⲙⲙⲁⲩⲁⲧⲟⲩ	ⲙⲙⲁⲩⲁⲧ|ⲟⲩ
ⲁϥϣⲟⲃⲧϥ	ⲁ|ϥ|ϣⲟⲃⲧ|ϥ
ⲙⲡⲟⲩⲙⲑⲟ	ⲙ|ⲡⲟⲩ|ⲙⲑⲟ
ⲛⲉϥϩⲃⲱⲥ	ⲛⲉϥ|ϩⲃⲱⲥ
ⲉⲩⲫⲟⲣⲉⲓ	ⲉ|ⲩ|ⲫⲟⲣⲉⲓ
ⲛⲟⲩⲭⲓⲱⲛ	ⲛ|ⲟⲩ|ⲭⲓⲱⲛ
ⲉⲩⲟⲩⲟⲃϣ	ⲉ|ⲩ|ⲟⲩⲟⲃϣ
ⲛⲧⲉⲣⲁϧⲧ	ⲛⲧⲉ|ⲣⲁϧⲧ
ⲉⲧϩⲓϫⲉⲛⲡⲓⲕⲁϩⲓ	ⲉⲧ|ϩⲓϫⲉⲛ|ⲡⲓ|ⲕⲁϩⲓ
ⲉⲑⲣⲉⲟⲩⲟⲛ	ⲉ|ⲑⲣⲉ|ⲟⲩⲟⲛ
ⲟⲩⲃⲁϣ	ⲟⲩⲃⲁϣ
ⲁⲩⲟⲩⲟⲛϩⲟⲩ	ⲁ|ⲩ|ⲟⲩⲟⲛϩ|ⲟⲩ
ⲛϫⲉⲏⲗⲓⲁⲥ	ⲛϫⲉ|ⲏⲗⲓⲁⲥ
ⲛⲉⲙⲙⲱⲩⲥⲏⲥ	ⲛⲉⲙ|ⲙⲱⲩⲥⲏⲥ
ⲛⲁⲩⲥⲁϫⲓ	ⲛⲁ|ⲩ|ⲥⲁϫⲓ
ⲉⲧⲁϥⲉⲣⲟⲩⲱ	ⲉⲧ|ⲁ|ϥ|ⲉⲣⲟⲩⲱ
ⲛⲧⲉⲛϣⲱⲡⲓ	ⲛⲧⲉ|ⲛ|ϣⲱⲡⲓ
ⲛⲧⲉⲛⲑⲁⲙⲓⲟ	ⲛⲧⲉ|ⲛ|ⲑⲁⲙⲓⲟ
ⲛⲥⲕⲩⲛⲏ	ⲛ|ⲥⲕⲩⲛⲏ
ⲛⲉⲙⲟⲩⲓ	ⲛⲉⲙ|ⲟⲩⲓ
ⲛⲏⲗⲓⲁⲥ	ⲛ|ⲏⲗⲓⲁⲥ
ⲛⲁϥⲉⲙⲓ	ⲛⲁ|ϥ|ⲉⲙⲓ
ⲡⲉⲧⲉϥⲛⲁⲉⲣⲟⲩⲱ	ⲡ|ⲉⲧⲉ|ϥ|ⲛⲁ|ⲉⲣⲟⲩⲱ
ⲛϩⲟϯ	ⲛ|ϩⲟϯ
ⲛϫⲉⲟⲩϭⲏⲡⲓ	ⲛϫⲉ|ⲟⲩ|ϭⲏⲡⲓ
ⲉⲥⲉⲣϧⲏⲓⲃⲓ	ⲉ|ⲥ|ⲉⲣϧⲏⲓⲃⲓ
ⲛϫⲉⲟⲩⲥⲙⲏ	ⲛϫⲉ|ⲟⲩ|ⲥⲙⲏ
ϧⲉⲛϯϭⲏⲡⲓ	ϧⲉⲛ|ϯ|ϭⲏⲡⲓ
ϫⲉⲫⲁⲓ	ϫⲉ|ⲫⲁⲓ
ⲉⲧⲁⲩϫⲟⲩϣⲧ	ⲉⲧ|ⲁ|ⲩ|ϫⲟⲩϣⲧ
ⲉⲝⲁⲡⲓⲛⲁ	ⲉⲝⲁⲡⲓⲛⲁ
ⲙⲡⲟⲩⲛⲁⲩ	ⲙⲡ|ⲟⲩ|ⲛⲁⲩ
ⲉϩⲗⲓ	ⲉ|ϩⲗⲓ
ⲉⲓⲏⲥⲟⲩⲥ	ⲉ|ⲓⲏⲥⲟⲩⲥ
ϩⲓⲡⲓⲧⲱⲟⲩ	ϩⲓ|ⲡⲓ|ⲧⲱⲟⲩ
ⲛⲧⲟⲩϣⲧⲉⲙⲥⲁϫⲓ	ⲛⲧ|ⲟⲩ|ϣⲧⲉⲙ|ⲥⲁϫⲓ
ϧⲁⲧⲉⲛϩⲗⲓ	ϧⲁⲧⲉⲛ|ϩⲗⲓ
ⲙⲡⲉⲧⲁⲩⲛⲁⲩ	ⲙ|ⲡ|ⲉⲧ|ⲁ|ⲩ|ⲛⲁⲩ
ⲛⲧⲉⲡϣⲏⲣⲓ	ⲛⲧⲉ|ⲡ|ϣⲏⲣⲓ
ⲧⲱⲛϥ	ⲧⲱⲛ|ϥ
ⲡⲓⲧⲱⲛϥ	ⲡⲓ|ⲧⲱⲛϥ
ⲛⲓⲥⲁϧ	ⲛⲓ|ⲥⲁϧ
ⲥⲉϫⲱ	ⲥⲉ|ϫⲱ
ϫⲉϩⲱϯ	ϫⲉ|ϩⲱϯ
ⲛⲧⲉⲏⲗⲓⲁⲥ	ⲛⲧⲉ|ⲏⲗⲓⲁⲥ
ϥⲛⲁⲧⲫⲉ	ϥ|ⲛⲁ|ⲧⲫⲉ
ⲥϧⲏⲟⲩⲧ	ⲥϧⲏⲟⲩⲧ
ⲉϫⲉⲛⲡϣⲏⲣⲓ	ⲉϫⲉⲛ|ⲡ|ϣⲏⲣⲓ
ⲛⲧⲉϥϭⲓ	ⲛⲧⲉ|ϥ|ϭⲓ
ⲛⲧⲟⲩϣⲟϣϥ	ⲛⲧ|ⲟⲩ|ϣⲟϣ|ϥ
ⲁⲩⲓⲣⲓ	ⲁ|ⲩ|ⲓⲣⲓ
ⲙⲡⲉⲧⲟⲩⲟⲩⲁϣϥ	ⲙ|ⲡ|ⲉⲧ|ⲟⲩ|ⲟⲩⲁϣ|ϥ
ϩⲁⲛⲓⲙⲁⲑⲏⲧⲏⲥ	ϩⲁ|ⲛⲓ|ⲙⲁⲑⲏⲧⲏⲥ
ⲙⲡⲟⲩⲕⲱϯ	ⲙ|ⲡⲟⲩ|ⲕⲱϯ
ϩⲁⲛⲥⲁϧ	ϩⲁⲛ|ⲥⲁϧ
ⲡⲓⲙⲏϣ	ⲡⲓ|ⲙⲏϣ
ⲁⲩⲉⲣϩⲟϯ	ⲁ|ⲩ|ⲉⲣϩⲟϯ
ⲉⲧⲁⲩϭⲟϫⲓ	ⲉⲧ|ⲁ|ⲩ|ϭⲟϫⲓ
ⲁⲩⲉⲣⲁⲥⲡⲁⲍⲉⲥⲑⲉ	ⲁ|ⲩ|ⲉⲣⲁⲥⲡⲁⲍⲉⲥⲑⲉ
ⲁϥϣⲉⲛⲟⲩ	ⲁ|ϥ|ϣⲉⲛ|ⲟⲩ
ϫⲉⲁⲣⲉⲧⲉⲛⲕⲱϯ	ϫⲉ|ⲁⲣⲉ|ⲧⲉⲛ|ⲕⲱϯ
ⲛⲥⲁⲟⲩ	ⲛⲥⲁ|ⲟⲩ
ⲛϫⲉⲟⲩⲁⲓ	ⲛϫⲉ|ⲟⲩⲁⲓ
ϧⲉⲛⲡⲓⲙⲏϣ	ϧⲉⲛ|ⲡⲓ|ⲙⲏϣ
ϫⲉⲫⲣⲉϥϯⲥⲃⲱ	ϫⲉ|ⲫ|ⲣⲉϥϯⲥⲃⲱ
ⲁⲓⲉⲛⲡⲁϣⲏⲣⲓ	ⲁ|ⲓ|ⲉⲛ|ⲡⲁ|ϣⲏⲣⲓ
ϩⲁⲣⲟⲕ	ϩⲁⲣⲟ|ⲕ
ⲉⲧⲉϥⲛⲁⲧⲁϩⲟϥ	ⲉⲧⲉ|ϥ|ⲛⲁ|ⲧⲁϩⲟ|ϥ
ϣⲁϥⲉⲛϥ	ϣⲁ|ϥ|ⲉⲛ|ϥ
ⲛⲧⲉⲣⲱϥ	ⲛⲧⲉ|ⲣⲱ|ϥ
ϫⲉϣⲥⲫⲏⲓϯ	ϫⲉϣⲥⲫⲏⲓϯ
ⲉϥϧⲣⲁϫⲣⲉϫ	ⲉ|ϥ|ϧⲣⲁϫⲣⲉϫ
ⲛⲛⲉϥⲛⲁϫϩⲓ	ⲛ|ⲛⲉϥ|ⲛⲁϫϩⲓ
ϣⲁϥϣⲱⲟⲩⲓ	ϣⲁ|ϥ|ϣⲱⲟⲩⲓ
ⲁⲓϫⲟⲥ	ⲁ|ⲓ|ϫⲟ|ⲥ
ⲛⲛⲉⲕⲙⲁⲑⲏⲧⲏⲥ	ⲛ|ⲛⲉⲕ|ⲙⲁⲑⲏⲧⲏⲥ
ⲛⲧⲟⲩϩⲓⲧϥ	ⲛⲧ|ⲟⲩ|ϩⲓⲧ|ϥ
ⲙⲡⲟⲩϣϫⲉⲙϫⲟⲙ	ⲙⲡ|ⲟⲩ|ϣ|ϫⲉⲙϫⲟⲙ
ϫⲉⲱⲡⲓϫⲱⲟⲩ	ϫⲉ|ⲱ|ⲡⲓ|ϫⲱⲟⲩ
ϯⲛⲁⲉⲣⲁⲛⲉⲭⲉⲥⲑⲉ	ϯ|ⲛⲁ|ⲉⲣⲁⲛⲉⲭⲉⲥⲑⲉ
ⲁⲛⲓⲧϥ	ⲁⲛⲓⲧ|ϥ
ⲛϫⲉⲡⲓⲡⲛⲉⲩⲙⲁ	ⲛϫⲉ|ⲡⲓ|ⲡⲛⲉⲩⲙⲁ
ⲁϥϣⲧⲉⲣⲑⲱⲣϥ	ⲁ|ϥ|ϣⲧⲉⲣⲑⲱⲣ|ϥ
ⲉⲧⲁϥϩⲉⲓ	ⲉⲧ|ⲁ|ϥ|ϩⲉⲓ
ⲛⲁϥⲥⲑⲉⲣⲧⲉⲣ	ⲛⲁ|ϥ|ⲥⲑⲉⲣⲧⲉⲣ
ⲉⲣⲉⲣⲱϥ	ⲉⲣⲉ|ⲣⲱ|ϥ
ⲁϥϣⲉⲛ	ⲁ|ϥ|ϣⲉⲛ
ⲡⲉϥⲉⲓⲱⲧ	ⲡⲉϥ|ⲉⲓⲱⲧ
ⲛⲭⲣⲟⲛⲟⲥ	ⲛ|ⲭⲣⲟⲛⲟⲥ
ⲓⲥϫⲉⲛⲉⲧⲁⲫⲁⲓ	ⲓⲥϫⲉⲛ|ⲉⲧ|ⲁ|ⲫⲁⲓ
ϫⲉⲓⲥϫⲉⲛⲧⲉϥⲙⲉⲧⲁⲗⲟⲩ	ϫⲉ|ⲓⲥϫⲉⲛ|ⲧⲉϥ|ⲙⲉⲧⲁⲗⲟⲩ
ϣⲁϥϩⲓⲧϥ	ϣⲁ|ϥ|ϩⲓⲧ|ϥ
ⲉⲡⲓⲭⲣⲱⲙ	ⲉ|ⲡⲓ|ⲭⲣⲱⲙ
ⲛⲉⲙⲡⲓⲙⲱⲟⲩ	ⲛⲉⲙ|ⲡⲓ|ⲙⲱⲟⲩ
ⲛⲧⲉϥⲧⲁⲕⲟϥ	ⲛⲧⲉ|ϥ|ⲧⲁⲕⲟ|ϥ
ⲡⲉⲧⲉⲟⲩⲟⲛ	ⲡ|ⲉⲧⲉ|ⲟⲩⲟⲛ
ⲁⲣⲓⲃⲟⲏⲑⲓⲛ	ⲁⲣⲓⲃⲟⲏⲑⲓⲛ
ⲉⲣⲟⲛ	ⲉⲣⲟ|ⲛ
ⲉⲁⲕϣⲉⲛϩⲏⲧ	ⲉ|ⲁ|ⲕ|ϣⲉⲛϩⲏⲧ
ⲉϫⲱⲛ	ⲉϫⲱ|ⲛ
ⲛϫⲉⲫⲓⲱⲧ	ⲛϫⲉ|ⲫ|ⲓⲱⲧ
ϫⲉϯⲛⲁϩϯ	ϫⲉ|ϯ|ⲛⲁϩϯ
ⲉⲧⲁⲙⲉⲧⲁⲑⲛⲁϩϯ	ⲉ|ⲧⲁ|ⲙⲉⲧⲁⲑⲛⲁϩϯ
ϫⲉⲡⲓⲙⲏϣ	ϫⲉ|ⲡⲓ|ⲙⲏϣ
ϭⲟϫⲓ	ϭⲟϫⲓ
ⲁϥⲉⲣⲉⲡⲓⲧⲓⲙⲁⲛ	ⲁ|ϥ|ⲉⲣⲉⲡⲓⲧⲓⲙⲁⲛ
ⲙⲡⲓⲡⲛⲉⲩⲙⲁ	ⲙ|ⲡⲓ|ⲡⲛⲉⲩⲙⲁ
ϫⲉⲡⲓⲁⲧⲥⲁϫⲓ	ϫⲉ|ⲡⲓ|ⲁⲧⲥⲁϫⲓ
ⲛⲕⲟⲩⲣ	ⲛ|ⲕⲟⲩⲣ
ⲡⲉⲧⲓⲟⲩⲁϩⲥⲁϩⲛⲓ	ⲡ|ⲉⲧ|ⲓ|ⲟⲩⲁϩⲥⲁϩⲛⲓ
ⲙⲡⲣϣⲉ	ⲙⲡⲣ|ϣⲉ
ⲉⲧⲁϥⲱϣ	ⲉⲧ|ⲁ|ϥ|ⲱϣ
ⲉⲧⲁϥϣⲧⲉⲣⲑⲱⲣϥ	ⲉⲧ|ⲁ|ϥ|ϣⲧⲉⲣⲑⲱⲣ|ϥ
ⲁϥⲉⲣⲙⲫⲣⲏϯ	ⲁ|ϥ|ⲉⲣ|ⲙ|ⲫ|ⲣⲏϯ
ⲛⲟⲩⲣⲉϥⲙⲱⲟⲩⲧ	ⲛ|ⲟⲩ|ⲣⲉϥⲙⲱⲟⲩⲧ
ⲛⲧⲉⲟⲩⲙⲏϣ	ⲛⲧⲉ|ⲟⲩ|ⲙⲏϣ
ϫⲉⲁϥⲙⲟⲩ	ϫⲉ|ⲁ|ϥ|ⲙⲟⲩ
ⲛⲧⲉϥϫⲓϫ	ⲛ|ⲧⲉϥ|ϫⲓϫ
ⲁϥⲧⲟⲩⲛⲟⲥϥ	ⲁ|ϥ|ⲧⲟⲩⲛⲟⲥ|ϥ
ⲁⲛⲉϥⲙⲁⲑⲏⲧⲏⲥ	ⲁ|ⲛⲉϥ|ⲙⲁⲑⲏⲧⲏⲥ
ⲙⲡⲉⲛϣϫⲉⲙϫⲟⲙ	ⲙⲡⲉ|ⲛ|ϣ|ϫⲉⲙϫⲟⲙ
ⲛϩⲓⲧϥ	ⲛ|ϩⲓⲧ|ϥ
ϫⲉⲡⲁⲓⲅⲉⲛⲟⲥ	ϫⲉ|ⲡⲁⲓ|ⲅⲉⲛⲟⲥ
ϧⲉⲛⲟⲩⲡⲣⲟⲥⲉⲩⲭⲏ	ϧⲉⲛ|ⲟⲩ|ⲡⲣⲟⲥⲉⲩⲭⲏ
ⲛⲉⲙⲟⲩⲛⲏⲥⲧⲓⲁ	ⲛⲉⲙ|ⲟⲩ|ⲛⲏⲥⲧⲓⲁ
ⲛⲁϥⲥⲓⲛⲓⲱⲟⲩ	ⲛⲁ|ϥ|ⲥⲓⲛⲓⲱⲟⲩ
ϩⲓⲧⲉⲛϯⲅⲁⲗⲓⲗⲉⲁ	ϩⲓⲧⲉⲛ|ϯ|ⲅⲁⲗⲓⲗⲉⲁ
ⲁϥⲟⲩⲱϣ	ⲁ|ϥ|ⲟⲩⲱϣ
ⲛⲁϥϯⲥⲃⲱ	ⲛⲁ|ϥ|ϯⲥⲃⲱ
ⲥⲉⲛⲁⲧⲏⲓϥ	ⲥⲉ|ⲛⲁ|ⲧⲏⲓ|ϥ
ⲥⲉⲛⲁϧⲟⲑⲃϥ	ⲥⲉ|ⲛⲁ|ϧⲟⲑⲃ|ϥ
ⲙⲉⲛⲉⲛⲥⲁⲅ	ⲙⲉⲛⲉⲛⲥⲁ|ⲅ
ϥⲛⲁⲧⲱⲛϥ	ϥ|ⲛⲁ|ⲧⲱⲛ|ϥ
ⲛⲁⲩⲉⲣϩⲟϯ	ⲛⲁ|ⲩ|ⲉⲣϩⲟϯ
ⲉϣⲉⲛϥ	ⲉ|ϣⲉⲛ|ϥ
ⲉⲕⲁⲫⲁⲣⲛⲁⲟⲩⲙ	ⲉ|ⲕⲁⲫⲁⲣⲛⲁⲟⲩⲙ
ⲛⲁϥϣⲓⲛⲓ	ⲛⲁ|ϥ|ϣⲓⲛⲓ
ⲉⲛⲁⲣⲉⲧⲉⲛⲙⲟⲕⲙⲉⲕ	ⲉ|ⲛⲁⲣⲉ|ⲧⲉⲛ|ⲙⲟⲕⲙⲉⲕ
ⲁⲩⲭⲱ	ⲁ|ⲩ|ⲭⲱ
ⲛⲣⲱⲟⲩ	ⲛ|ⲣⲱ|ⲟⲩ
ⲉⲧⲁϥϩⲉⲙⲥⲓ	ⲉⲧ|ⲁ|ϥ|ϩⲉⲙⲥⲓ
ⲉⲧⲟⲩⲱϣ	ⲉⲧ|ⲟⲩⲱϣ
ⲉⲉⲣϩⲟⲩⲓⲧ	ⲉ|ⲉⲣϩⲟⲩⲓⲧ
ⲉϥⲉⲉⲣϧⲁⲉ	ⲉϥⲉ|ⲉⲣ|ϧⲁⲉ
ⲛⲉⲙⲇⲓⲁⲕⲱⲛ	ⲛⲉⲙ|ⲇⲓⲁⲕⲱⲛ
ⲁϥⲧⲁϩⲟϥ	ⲁ|ϥ|ⲧⲁϩⲟ|ϥ
ϧⲉⲛⲧⲟⲩⲙⲏϯ	ϧⲉⲛ|ⲧⲟⲩ|ⲙⲏϯ
ⲉⲧⲁϥⲁⲙⲟⲛⲓ	ⲉⲧ|ⲁ|ϥ|ⲁⲙⲟⲛⲓ
ⲉⲧⲛⲁϣⲉⲡⲟⲩⲁⲓ	ⲉⲧ|ⲛⲁ|ϣⲉⲡ|ⲟⲩⲁⲓ
ⲛⲛⲁⲓⲁⲗⲱⲟⲩⲓ	ⲛ|ⲛⲁⲓ|ⲁⲗⲱⲟⲩⲓ
ⲡⲉⲧⲉϥϣⲱⲡ	ⲡ|ⲉⲧⲉ|ϥ|ϣⲱⲡ
ⲁϥϣⲱⲡ	ⲁ|ϥ|ϣⲱⲡ
ⲉⲧⲁϥⲧⲁⲟⲩⲟⲓ	ⲉⲧ|ⲁ|ϥ|ⲧⲁⲟⲩⲟ|ⲓ
ⲁⲛⲛⲁⲩ	ⲁ|ⲛ|ⲛⲁⲩ
ⲉϥϩⲓⲇⲉⲙⲱⲛ	ⲉ|ϥ|ϩⲓⲇⲉⲙⲱⲛ
ϧⲉⲛⲡⲉⲕⲣⲁⲛ	ϧⲉⲛ|ⲡⲉⲕ|ⲣⲁⲛ
ⲁⲛⲧⲁϩⲛⲟ	ⲁ|ⲛ|ⲧⲁϩⲛⲟ
ϫⲉⲛϥⲟⲩⲉϩ	ϫⲉ|ⲛ|ϥ|ⲟⲩⲉϩ
ⲛⲥⲱⲛ	ⲛⲥⲱ|ⲛ
ϫⲉⲙⲡⲣⲧⲁϩⲛⲟ	ϫⲉ|ⲙⲡⲣ|ⲧⲁϩⲛⲟ
ⲉⲑⲛⲁⲓⲣⲓ	ⲉⲑ|ⲛⲁ|ⲓⲣⲓ
ⲛⲟⲩϫⲟⲙ	ⲛ|ⲟⲩ|ϫⲟⲙ
ⲉϫⲉⲛⲡⲁⲣⲁⲛ	ⲉϫⲉⲛ|ⲡⲁ|ⲣⲁⲛ
ⲛⲧⲉϥϣϫⲉⲙϫⲟⲙ	ⲛⲧⲉ|ϥ|ϣ|ϫⲉⲙϫⲟⲙ
ⲉⲥⲁϫⲓ	ⲉ|ⲥⲁϫⲓ
ϧⲁⲣⲟⲓ	ϧⲁⲣⲟ|ⲓ
ⲉⲧⲉⲛϥⲟⲩⲃⲏⲛ	ⲉⲧⲉ|ⲛ|ϥ|ⲟⲩⲃⲏ|ⲛ
ⲉⲧⲛⲁⲧⲥⲉⲑⲏⲛⲟⲩ	ⲉⲧ|ⲛⲁ|ⲧⲥⲉ|ⲑⲏⲛⲟⲩ
ϫⲉⲛⲑⲱⲧⲉⲛ	ϫⲉ|ⲛⲑⲱⲧⲉⲛ
ⲛⲁⲡⲭⲣⲓⲥⲧⲟⲥ	ⲛⲁ|ⲡ|ⲭⲣⲓⲥⲧⲟⲥ
ϫⲉⲛⲛⲉϥⲧⲁⲕⲟ	ϫⲉ|ⲛⲛⲉ|ϥ|ⲧⲁⲕⲟ
ⲛϫⲉⲡⲉϥⲃⲉⲭⲉ	ⲛϫⲉ|ⲡⲉϥ|ⲃⲉⲭⲉ
ⲉⲑⲛⲁⲉⲣⲥⲕⲁⲛⲇⲁⲗⲓⲍⲉⲥⲑⲉ	ⲉⲑ|ⲛⲁ|ⲉⲣⲥⲕⲁⲛⲇⲁⲗⲓⲍⲉⲥⲑⲉ
ⲛⲛⲁⲓⲕⲟⲩϫⲓ	ⲛ|ⲛⲁⲓ|ⲕⲟⲩϫⲓ
ⲉⲉϣⲟⲩⲱⲛⲓ	ⲉ|ⲉϣ|ⲟⲩ|ⲱⲛⲓ
ⲙⲙⲟⲩⲗⲟⲛ	ⲙ|ⲙⲟⲩⲗⲟⲛ
ⲉϧⲏⲧϥ	ⲉ|ϧⲏⲧ|ϥ
ⲛⲧⲉⲧⲉⲕϫⲓϫ	ⲛⲧⲉ|ⲧⲉⲕ|ϫⲓϫ
ⲉⲣⲥⲕⲁⲛⲇⲁⲗⲓⲍⲉⲥⲑⲉ	ⲉⲣⲥⲕⲁⲛⲇⲁⲗⲓⲍⲉⲥⲑⲉ
ϫⲟϫⲥ	ϫⲟϫ|ⲥ
ⲛⲧⲉⲕⲓ	ⲛⲧⲉ|ⲕ|ⲓ
ⲉⲡⲓⲱⲛϧ	ⲉ|ⲡⲓ|ⲱⲛϧ
ⲛϫⲁϭⲏ	ⲛ|ϫⲁϭⲏ
ⲉⲣⲉϫⲓϫ	ⲉⲣⲉ|ϫⲓϫ
ⲛⲧⲉⲕϣⲉ	ⲛⲧⲉ|ⲕ|ϣⲉ
ⲉϯⲅⲉⲉⲛⲛⲁ	ⲉ|ϯ|ⲅⲉⲉⲛⲛⲁ
ⲛⲁⲧϭⲉⲛⲟ	ⲛ|ⲁⲧϭⲉⲛⲟ
...	...
ⲛⲧⲉⲧⲉⲕϭⲁⲗⲟϫ	ⲛⲧⲉ|ⲧⲉⲕ|ϭⲁⲗⲟϫ
ϩⲓⲧⲥ	ϩⲓⲧ|ⲥ
ⲛϭⲁⲗⲉ	ⲛ|ϭⲁⲗⲉ
ϭⲁⲗⲟϫ	ϭⲁⲗⲟϫ
ⲛⲥⲉϩⲓⲧⲕ	ⲛ|ⲥⲉ|ϩⲓⲧ|ⲕ
ⲛⲧⲉⲡⲉⲕⲃⲁⲗ	ⲛⲧⲉ|ⲡⲉⲕ|ⲃⲁⲗ
ⲫⲟⲣⲕϥ	ⲫⲟⲣⲕ|ϥ
ⲉⲟⲩⲃⲁⲗ	ⲉ|ⲟⲩ|ⲃⲁⲗ
ⲉⲧⲉⲣⲟⲕ	ⲉⲧ|ⲉⲣⲟ|ⲕ
ⲃⲁⲗ	ⲃⲁⲗ
ⲉⲧⲉⲙⲡⲁⲣⲉⲡⲟⲩϥⲉⲛⲧ	ⲉⲧⲉ|ⲙⲡⲁⲣⲉ|ⲡⲟⲩ|ϥⲉⲛⲧ
ⲙⲟⲩ	ⲙⲟⲩ
ⲡⲟⲩⲭⲣⲱⲙ	ⲡⲟⲩ|ⲭⲣⲱⲙ
ⲙⲡⲁϥϭⲉⲛⲟ	ⲙⲡⲁ|ϥ|ϭⲉⲛⲟ
ϣⲁⲩⲙⲟⲗϩϥ	ϣⲁ|ⲩ|ⲙⲟⲗϩ|ϥ
ⲙⲡⲓⲭⲣⲱⲙ	ⲙ|ⲡⲓ|ⲭⲣⲱⲙ
ⲛⲁⲛⲉ	ⲛⲁⲛⲉ
ⲡⲓϩⲙⲟⲩ	ⲡⲓ|ϩⲙⲟⲩ
ⲛⲧⲉⲡⲓϩⲙⲟⲩ	ⲛⲧⲉ|ⲡⲓ|ϩⲙⲟⲩ
ⲉⲣⲁⲧϩⲙⲟⲩ	ⲉⲣⲁⲧϩⲙⲟⲩ
ⲉϣⲁⲩⲙⲟⲗϩϥ	ⲉ|ϣⲁ|ⲩ|ⲙⲟⲗϩ|ϥ
ϧⲉⲛⲟⲩ	ϧⲉⲛ|ⲟⲩ
ⲙⲁⲣⲉϩⲙⲟⲩ	ⲙⲁⲣⲉ|ϩⲙⲟⲩ
ⲁⲣⲓϩⲓⲣⲏⲛⲏ	ⲁⲣⲓϩⲓⲣⲏⲛⲏ
ϧⲉⲛⲛⲉⲧⲛⲉⲣⲏⲩ	ϧⲉⲛ|ⲛⲉⲧⲛ|ⲉⲣⲏⲩ
ϫⲉⲛⲉⲛⲓⲟϯ	ϫⲉ|ⲛⲉⲛ|ⲓⲟϯ
ⲛⲁⲩⲭⲏ	ⲛⲁ|ⲩ|ⲭⲏ
ϧⲁϯϭⲏⲡⲓ	ϧⲁ|ϯ|ϭⲏⲡⲓ
ⲁⲩⲥⲓⲛⲓ	ⲁ|ⲩ|ⲥⲓⲛⲓ
ϩⲓⲧⲉⲛⲫⲓⲟⲙ	ϩⲓⲧⲉⲛ|ⲫ|ⲓⲟⲙ
ⲁⲩϭⲓⲱⲙⲥ	ⲁ|ⲩ|ϭⲓⲱⲙⲥ
ⲉⲙⲱⲩⲥⲏⲥ	ⲉ|ⲙⲱⲩⲥⲏⲥ
ⲛⲉⲙϧⲉⲛⲫⲓⲟⲙ	ⲛⲉⲙ|ϧⲉⲛ|ⲫ|ⲓⲟⲙ
ⲧⲁⲓϧⲣⲉ	ⲧⲁⲓ|ϧⲣⲉ
ⲁⲩⲟⲩⲟⲙⲥ	ⲁ|ⲩ|ⲟⲩⲟⲙ|ⲥ
ⲡⲁⲓⲥⲱ	ⲡⲁⲓ|ⲥⲱ
ⲁⲩⲥⲟϥ	ⲁ|ⲩ|ⲥⲟ|ϥ
ⲛⲁⲩⲥⲱ	ⲛⲁ|ⲩ|ⲥⲱ
ϧⲉⲛⲟⲩⲡⲛⲉⲩⲙⲁⲧⲓⲕⲏ	ϧⲉⲛ|ⲟⲩ|ⲡⲛⲉⲩⲙⲁⲧⲓⲕⲏ
ⲙⲡⲉⲧⲣⲁ	ⲙ|ⲡⲉⲧⲣⲁ
ⲉⲥⲙⲟϣⲓ	ⲉ|ⲥ|ⲙⲟϣⲓ
ϯⲡⲉⲧⲣⲁ	ϯ|ⲡⲉⲧⲣⲁ
ⲛⲉⲡⲭⲣⲓⲥⲧⲟⲥ	ⲛⲉ|ⲡ|ⲭⲣⲓⲥⲧⲟⲥ
ϯⲙⲁϯ	ϯⲙⲁϯ
ϧⲉⲛⲡⲟⲩϩⲟⲩⲟ	ϧⲉⲛ|ⲡⲟⲩ|ϩⲟⲩⲟ
ⲁⲩⲫⲱϣ	ⲁ|ⲩ|ⲫⲱϣ
ϩⲓⲡϣⲁϥⲉ	ϩⲓ|ⲡ|ϣⲁϥⲉ
ⲛϩⲁⲛⲧⲩⲡⲟⲥ	ⲛ|ϩⲁⲛ|ⲧⲩⲡⲟⲥ
ϫⲉⲛⲧⲉⲛϣⲧⲉⲙϣⲱⲡⲓ	ϫⲉ|ⲛⲧⲉ|ⲛ|ϣⲧⲉⲙ|ϣⲱⲡⲓ
ⲉⲛⲟⲓ	ⲉ|ⲛ|ⲟⲓ
ⲛⲣⲉϥⲉⲣⲉⲡⲓⲑⲩⲙⲓⲛ	ⲛ|ⲣⲉϥⲉⲣⲉⲡⲓⲑⲩⲙⲓⲛ
ⲛϩⲁⲛⲡⲉⲧϩⲱⲟⲩ	ⲛ|ϩⲁⲛ|ⲡⲉⲧϩⲱⲟⲩ
ⲉⲧⲁⲛⲏⲉⲣⲉⲡⲓⲑⲩⲙⲓⲛ	ⲉⲧ|ⲁ|ⲛⲏ|ⲉⲣⲉⲡⲓⲑⲩⲙⲓⲛ
ⲙⲡⲣϣⲱⲡⲓ	ⲙⲡⲣ|ϣⲱⲡⲓ
ⲛϣⲁⲙϣⲉ	ⲛ|ϣⲁⲙϣⲉ
ⲓⲇⲱⲗⲟⲛ	ⲓⲇⲱⲗⲟⲛ
ⲛϩⲁⲛⲟⲩⲟⲛ	ⲛ|ϩⲁⲛ|ⲟⲩⲟⲛ
ϫⲉⲁϥϩⲉⲙⲥⲓ	ϫⲉ|ⲁ|ϥ|ϩⲉⲙⲥⲓ
ⲛϫⲉⲡⲓⲗⲁⲟⲥ	ⲛϫⲉ|ⲡⲓ|ⲗⲁⲟⲥ
ⲛⲉⲙⲉⲥⲱ	ⲛⲉⲙ|ⲉ|ⲥⲱ
ⲉⲥⲱⲃⲓ	ⲉ|ⲥⲱⲃⲓ
ⲙⲡⲉⲛⲑⲣⲉⲛⲉⲣⲡⲟⲣⲛⲉⲩⲓⲛ	ⲙⲡⲉⲛⲑⲣⲉ|ⲛ|ⲉⲣⲡⲟⲣⲛⲉⲩⲓⲛ
ⲉⲁⲩⲉⲣⲡⲟⲣⲛⲉⲩⲓⲛ	ⲉ|ⲁ|ⲩ|ⲉⲣⲡⲟⲣⲛⲉⲩⲓⲛ
ⲁⲩϩⲉⲓ	ⲁ|ⲩ|ϩⲉⲓ
ϧⲉⲛⲟⲩⲉϩⲟⲟⲩ	ϧⲉⲛ|ⲟⲩ|ⲉϩⲟⲟⲩ
ⲛϫⲉⲕⲅ	ⲛϫⲉ|ⲕⲅ
ⲛϣⲟ	ⲛ|ϣⲟ
ⲙⲡⲉⲛⲑⲣⲉⲛⲉⲣⲡⲓⲣⲁⲍⲓⲛ	ⲙⲡⲉⲛⲑⲣⲉ|ⲛ|ⲉⲣⲡⲓⲣⲁⲍⲓⲛ
ⲉⲁⲩⲉⲣⲡⲓⲣⲁⲍⲓⲛ	ⲉ|ⲁ|ⲩ|ⲉⲣⲡⲓⲣⲁⲍⲓⲛ
ⲁⲩⲧⲁⲕⲟ	ⲁ|ⲩ|ⲧⲁⲕⲟ
ϩⲓⲧⲟⲧⲟⲩ	ϩⲓⲧⲟⲧ|ⲟⲩ
ⲛⲛⲓϩⲟϥ	ⲛ|ⲛⲓ|ϩⲟϥ
ⲙⲡⲉⲛⲑⲣⲉⲛⲉⲣⲣⲉϥⲉⲣⲭⲣⲉⲙⲣⲉⲙ	ⲙⲡⲉⲛⲑⲣⲉ|ⲛ|ⲉⲣⲣⲉϥⲉⲣⲭⲣⲉⲙⲣⲉⲙ
ⲉⲁⲩⲭⲣⲉⲙⲣⲉⲙ	ⲉ|ⲁ|ⲩ|ⲭⲣⲉⲙⲣⲉⲙ
ⲙⲡⲓⲣⲉϥⲧⲁⲕⲟ	ⲙ|ⲡⲓ|ⲣⲉϥⲧⲁⲕⲟ
ⲛⲧⲩⲡⲟⲥ	ⲛ|ⲧⲩⲡⲟⲥ
ⲁⲩⲥϧⲏⲧⲟⲩ	ⲁ|ⲩ|ⲥϧⲏⲧ|ⲟⲩ
ⲉⲩⲥⲃⲱ	ⲉ|ⲩ|ⲥⲃⲱ
ⲉⲧⲁⲡϫⲱⲕ	ⲉⲧ|ⲁ|ⲡ|ϫⲱⲕ
ⲛⲛⲓⲉⲛⲉϩ	ⲛ|ⲛⲓ|ⲉⲛⲉϩ
ⲉⲣⲕⲁⲧⲁⲛⲧⲁⲛ	ⲉⲣⲕⲁⲧⲁⲛⲧⲁⲛ
ⲉⲧⲙⲉⲩⲓ	ⲉⲧ|ⲙⲉⲩⲓ
ϫⲉϥⲟϩⲓ	ϫⲉ|ϥ|ⲟϩⲓ
ⲙⲁⲣⲉϥⲛⲁⲩ	ⲙⲁⲣⲉ|ϥ|ⲛⲁⲩ
ⲛⲧⲉϥϩⲉⲓ	ⲛⲧⲉ|ϥ|ϩⲉⲓ
ⲙⲡⲉⲡⲓⲣⲁⲥⲙⲟⲥ	ⲙⲡⲉ|ⲡⲓⲣⲁⲥⲙⲟⲥ
ⲧⲁϩⲉ	ⲧⲁϩⲉ
ⲉⲧⲉⲛϥⲛⲁⲭⲁ	ⲉⲧⲉ|ⲛ|ϥ|ⲛⲁ|ⲭⲁ
ⲉⲑⲣⲟⲩⲉⲣⲡⲓⲣⲁⲍⲓⲛ	ⲉ|ⲑⲣⲟⲩ|ⲉⲣⲡⲓⲣⲁⲍⲓⲛ
ⲉⲧⲉⲟⲩⲟⲛϣϫⲟⲙ	ⲉⲧⲉ|ⲟⲩⲟⲛϣϫⲟⲙ
ⲉϥⲉϯⲧⲟⲧϥ	ⲉϥⲉ|ϯⲧⲟⲧ|ϥ
ϧⲉⲛⲡⲓⲣⲁⲥⲙⲟⲥ	ϧⲉⲛ|ⲡⲓⲣⲁⲥⲙⲟⲥ
ⲛⲧⲉⲧⲉⲛϣϫⲉⲙϫⲟⲙ	ⲛⲧⲉ|ⲧⲉⲛ|ϣϫⲉⲙϫⲟⲙ
ⲛϥⲁⲓ	ⲛ|ϥⲁⲓ
ϣⲁⲧⲉⲧⲛⲓ	ϣⲁⲧⲉ|ⲧⲛ|ⲓ
ⲫⲱⲧ	ⲫⲱⲧ
ϩⲁϯⲙⲉⲧϣⲁⲙϣⲉ	ϩⲁ|ϯ|ⲙⲉⲧϣⲁⲙϣⲉ
ⲁⲓϫⲱ	ⲁ|ⲓ|ϫⲱ
ⲛϩⲁⲛⲥⲁⲃⲉⲩ	ⲛ|ϩⲁⲛ|ⲥⲁⲃⲉⲩ
ⲉⲡⲉϯϫⲱ	ⲉ|ⲡⲉ|ϯϫⲱ
ⲡⲓⲁⲫⲟⲧ	ⲡⲓ|ⲁⲫⲟⲧ
ⲛⲧⲉϯⲉⲩⲗⲟⲅⲓⲁ	ⲛⲧⲉ|ϯ|ⲉⲩⲗⲟⲅⲓⲁ
ⲉⲧⲉⲛⲥⲙⲟⲩ	ⲉⲧ|ⲉⲛ|ⲥⲙⲟⲩ
ϯⲙⲉⲧϣⲫⲏⲣ	ϯ|ⲙⲉⲧϣⲫⲏⲣ
ⲛⲧⲉⲡⲥⲛⲟϥ	ⲛⲧⲉ|ⲡ|ⲥⲛⲟϥ
ⲡⲓⲱⲓⲕ	ⲡⲓ|ⲱⲓⲕ
ⲉⲧⲉⲛⲫⲱϣ	ⲉⲧ|ⲉⲛ|ⲫⲱϣ
ⲛⲧⲉⲡⲥⲱⲙⲁ	ⲛⲧⲉ|ⲡ|ⲥⲱⲙⲁ
ⲧⲉⲛⲟⲓ	ⲧⲉⲛ|ⲟⲓ
ϧⲁⲛⲓⲙⲏϣ	ϧⲁ|ⲛⲓ|ⲙⲏϣ
ⲧⲉⲛϭⲓ	ⲧⲉⲛ|ϭⲓ
ϧⲉⲛⲡⲁⲓⲱⲓⲕ	ϧⲉⲛ|ⲡⲁⲓ|ⲱⲓⲕ
ⲉⲡⲓⲥⲗ	ⲉ|ⲡ|ⲓⲥⲗ
ⲛⲛⲓϣⲟⲩϣⲱⲟⲩϣⲓ	ⲛ|ⲛⲓ|ϣⲟⲩϣⲱⲟⲩϣⲓ
ⲉⲡⲓⲙⲁⲛⲉⲣϣⲱⲟⲩϣⲓ	ⲉ|ⲡⲓ|ⲙⲁⲛⲉⲣϣⲱⲟⲩϣⲓ
ϫⲉⲡⲉⲧϯϫⲱ	ϫⲉ|ⲡ|ⲉⲧ|ϯ|ϫⲱ
ϫⲉϣⲱⲧ	ϫⲉ|ϣⲱⲧ
ⲛⲓⲇⲱⲗⲟⲛ	ⲛ|ⲓⲇⲱⲗⲟⲛ
ϫⲉⲛⲉⲧⲟⲩϣⲱⲧ	ϫⲉ|ⲛ|ⲉⲧ|ⲟⲩ|ϣⲱⲧ
ⲛϫⲉⲛⲓⲉⲑⲛⲟⲥ	ⲛϫⲉ|ⲛⲓ|ⲉⲑⲛⲟⲥ
ⲁⲩϣⲱⲧ	ⲁ|ⲩ|ϣⲱⲧ
ⲛⲛⲓⲓⲇⲱⲗⲟⲛ	ⲛ|ⲛⲓ|ⲓⲇⲱⲗⲟⲛ
ⲛϯⲟⲩⲉϣ	ⲛ|ϯ|ⲟⲩⲉϣ
ⲙⲙⲟⲛϣϫⲟⲙ	ⲙⲙⲟⲛ|ϣϫⲟⲙ
ⲉⲥⲱ	ⲉ|ⲥⲱ
ϧⲉⲛⲡⲓⲁⲫⲟⲧ	ϧⲉⲛ|ⲡⲓ|ⲁⲫⲟⲧ
ⲛⲉⲙⲡⲓⲁⲫⲟⲧ	ⲛⲉⲙ|ⲡⲓ|ⲁⲫⲟⲧ
ⲛⲧⲉⲛⲓⲇⲁⲓⲙⲱⲛ	ⲛⲧⲉ|ⲛⲓ|ⲇⲁⲓⲙⲱⲛ
ϧⲉⲛϯⲧⲣⲁⲡⲉⲍⲁ	ϧⲉⲛ|ϯ|ⲧⲣⲁⲡⲉⲍⲁ
ⲛⲉⲙϯⲧⲣⲁⲡⲉⲍⲁ	ⲛⲉⲙ|ϯ|ⲧⲣⲁⲡⲉⲍⲁ
ϣⲁⲛ	ϣⲁⲛ
ⲁⲛⲛⲁϯⲭⲟϩ	ⲁⲛⲛⲁ|ϯⲭⲟϩ
ϩⲁⲛϫⲱⲣⲓ	ϩⲁⲛ|ϫⲱⲣⲓ
ⲉϩⲟⲧⲉⲣⲟϥ	ⲉϩⲟⲧⲉⲣⲟ|ϥ
ⲥϣⲉ	ⲥϣⲉ
ⲛⲉⲣϩⲱⲃ	ⲛ|ⲉⲣϩⲱⲃ
ⲥⲉⲣⲛⲟϥⲣⲓ	ⲥⲉ|ⲣⲛⲟϥⲣⲓ
ⲉⲝⲉⲥⲧⲓⲛ	ⲉⲝⲉⲥⲧⲓⲛ
ⲥⲉⲕⲱⲧ	ⲥⲉ|ⲕⲱⲧ
ⲕⲱϯ	ⲕⲱϯ
ⲛⲥⲁⲡⲉⲧⲉⲫⲱϥ	ⲛⲥⲁ|ⲡ|ⲉⲧⲉ|ⲫⲱϥ
ⲛⲥⲁⲫⲁⲡⲉϥϣⲫⲏⲣ	ⲛⲥⲁ|ⲫⲁ|ⲡⲉϥ|ϣⲫⲏⲣ
ⲉⲛⲭⲁⲓ	ⲉⲛⲭⲁⲓ
ⲉⲧⲟⲩϯ	ⲉⲧ|ⲟⲩ|ϯ
ϧⲉⲛⲡⲓⲙⲁⲕⲉⲗⲗⲟⲥ	ϧⲉⲛ|ⲡⲓ|ⲙⲁⲕⲉⲗⲗⲟⲥ
ⲟⲩⲙⲟⲩ	ⲟⲩ|ⲙⲟⲩ
ⲛⲧⲉⲧⲉⲛϧⲟⲧϧⲉⲧ	ⲛⲧⲉ|ⲧⲉⲛ|ϧⲟⲧϧⲉⲧ
ⲉⲑⲃⲉϯⲥⲩⲛⲏⲇⲉⲥⲓⲥ	ⲉⲑⲃⲉ|ϯ|ⲥⲩⲛⲏⲇⲉⲥⲓⲥ
ⲫⲁⲡϭⲟⲓⲥ	ⲫⲁ|ⲡ|ϭⲟⲓⲥ
ⲡⲓⲕⲁϩⲓ	ⲡⲓ|ⲕⲁϩⲓ
ⲛⲉⲙⲡⲉϥⲙⲟϩ	ⲛⲉⲙ|ⲡⲉϥ|ⲙⲟϩ
ⲓⲥϫⲉⲟⲩⲟⲛⲟⲩⲁⲓ	ⲓⲥϫⲉ|ⲟⲩⲟⲛ|ⲟⲩⲁⲓ
ⲛⲛⲓⲁⲑⲛⲁϩϯ	ⲛ|ⲛⲓ|ⲁⲑⲛⲁϩϯ
ⲑⲱϩⲉⲙ	ⲑⲱϩⲉⲙ
ⲧⲉⲧⲉⲛⲟⲩⲱϣ	ⲧⲉⲧⲉⲛ|ⲟⲩⲱϣ
ⲉⲧⲟⲩⲛⲁⲭⲁⲩ	ⲉⲧ|ⲟⲩ|ⲛⲁ|ⲭⲁ|ⲩ
ⲟⲩⲟⲙⲟⲩ	ⲟⲩⲟⲙ|ⲟⲩ
ⲁⲣⲉϣⲁⲛⲟⲩⲁⲓ	ⲁⲣⲉϣⲁⲛ|ⲟⲩⲁⲓ
ϫⲉⲟⲩϣⲱⲧ	ϫⲉ|ⲟⲩ|ϣⲱⲧ
ⲙⲡⲣⲟⲩⲱⲙ	ⲙⲡⲣ|ⲟⲩⲱⲙ
ⲉⲑⲃⲉⲫⲏ	ⲉⲑⲃⲉ|ⲫⲏ
ⲉⲧⲁϥⲧⲁⲙⲱⲧⲉⲛ	ⲉⲧ|ⲁ|ϥ|ⲧⲁⲙⲱ|ⲧⲉⲛ
ⲛⲉⲙⲉⲑⲃⲉϯⲥⲩⲛⲏⲇⲉⲥⲓⲥ	ⲛⲉⲙ|ⲉⲑⲃⲉ|ϯ|ⲥⲩⲛⲏⲇⲉⲥⲓⲥ
ⲉⲑⲃⲉⲟⲩⲥⲩⲛⲏⲇⲉⲥⲓⲥ	ⲉⲑⲃⲉ|ⲟⲩ|ⲥⲩⲛⲏⲇⲉⲥⲓⲥ
ⲛⲑⲱⲕ	ⲛ|ⲑⲱⲕ
ⲑⲁⲡⲉⲕϣⲫⲏⲣ	ⲑⲁ|ⲡⲉⲕ|ϣⲫⲏⲣ
ⲉⲑⲃⲉⲟⲩ	ⲉⲑⲃⲉ|ⲟⲩ
ⲧⲁⲙⲉⲧⲣⲉⲙϩⲉ	ⲧⲁⲙⲉⲧⲣⲉⲙϩⲉ
ⲥⲉⲛⲁϯϩⲁⲡ	ⲥⲉ|ⲛⲁ|ϯϩⲁⲡ
ϩⲓⲧⲉⲛⲕⲉⲥⲩⲛⲏⲇⲉⲥⲓⲥ	ϩⲓⲧⲉⲛ|ⲕⲉ|ⲥⲩⲛⲏⲇⲉⲥⲓⲥ
ⲓⲥϫⲉⲁⲛⲟⲕ	ⲓⲥϫⲉ|ⲁⲛⲟⲕ
ϯϭⲓ	ϯ|ϭⲓ
ϧⲉⲛⲟⲩϣⲉⲡϩⲙⲟⲧ	ϧⲉⲛ|ⲟⲩ|ϣⲉⲡϩⲙⲟⲧ
ⲥⲉϫⲉⲟⲩⲁ	ⲥⲉ|ϫⲉⲟⲩⲁ
ⲉϫⲉⲛⲫⲏ	ⲉϫⲉⲛ|ⲫⲏ
ⲉϯϣⲉⲡϩⲙⲟⲧ	ⲉ|ϯ|ϣⲉⲡϩⲙⲟⲧ
ⲧⲉⲧⲉⲛⲟⲩⲱⲙ	ⲧⲉⲧⲉⲛ|ⲟⲩⲱⲙ
ⲧⲉⲧⲉⲛⲥⲱ	ⲧⲉⲧⲉⲛ|ⲥⲱ
ⲧⲉⲧⲉⲛⲓⲣⲓ	ⲧⲉⲧⲉⲛ|ⲓⲣⲓ
ⲛⲕⲉϩⲱⲃ	ⲛ|ⲕⲉ|ϩⲱⲃ
ⲁⲣⲓ	ⲁⲣⲓ
ⲉⲡϯⲱⲟⲩ	ⲉ|ⲡ|ϯⲱⲟⲩ
ⲛⲁⲧϭⲣⲟⲡ	ⲛ|ⲁⲧϭⲣⲟⲡ
ⲛⲛⲓⲓⲟⲩⲇⲁⲓ	ⲛ|ⲛⲓ|ⲓⲟⲩⲇⲁⲓ
ⲉⲧⲉϧⲉⲛϩⲱⲃ	ⲉⲧⲉ|ϧⲉⲛ|ϩⲱⲃ
ϯⲣⲁⲛⲁϥ	ϯ|ⲣ|ⲁⲛⲁ|ϥ
ⲛϯⲕⲱϯ	ⲛ|ϯ|ⲕⲱϯ
ⲛⲥⲁⲧⲁⲛⲟϥⲣⲓ	ⲛⲥⲁ|ⲧⲁ|ⲛⲟϥⲣⲓ
ⲑⲁⲛⲓⲙⲏϣ	ⲑⲁ|ⲛⲓ|ⲙⲏϣ
ⲛⲥⲉⲛⲟϩⲉⲙ	ⲛ|ⲥⲉ|ⲛⲟϩⲉⲙ
ϧⲉⲛⲛⲓⲉϩⲟⲟⲩ	ϧⲉⲛ|ⲛⲓ|ⲉϩⲟⲟⲩ
ⲡⲉⲧⲟⲩⲛⲁⲟⲩⲟⲙϥ	ⲡ|ⲉⲧ|ⲟⲩ|ⲛⲁ|ⲟⲩⲟⲙ|ϥ
ⲉⲛⲓⲙⲁⲑⲏⲧⲏⲥ	ⲉ|ⲛⲓ|ⲙⲁⲑⲏⲧⲏⲥ
ϫⲉϯϣⲉⲛϩⲏⲧ	ϫⲉ|ϯ|ϣⲉⲛϩⲏⲧ
ϧⲁⲡⲁⲓⲙⲏϣ	ϧⲁ|ⲡⲁⲓ|ⲙⲏϣ
ⲅ	ⲅ
ⲥⲉⲟϩⲓ	ⲥⲉ|ⲟϩⲓ
ⲁⲓϣⲁⲛⲭⲁⲩ	ⲁⲓϣⲁⲛ|ⲭⲁ|ⲩ
ⲉⲡⲟⲩⲏⲓ	ⲉ|ⲡⲟⲩ|ⲏⲓ
ⲛⲁⲧⲟⲩⲱⲙ	ⲛ|ⲁⲧⲟⲩⲱⲙ
ⲥⲉⲛⲁⲃⲱⲗ	ⲥⲉ|ⲛⲁ|ⲃⲱⲗ
ϩⲁⲛⲕⲉⲟⲩⲟⲛ	ϩⲁⲛ|ⲕⲉ|ⲟⲩⲟⲛ
ⲛⲁⲩϩⲓⲫⲟⲩⲉⲓ	ⲛⲁ|ⲩ|ϩⲓ|ⲫ|ⲟⲩⲉⲓ
ⲁⲩⲉⲣⲟⲩⲱ	ⲁ|ⲩ|ⲉⲣⲟⲩⲱ
ⲛϫⲉⲛⲓⲙⲁⲑⲏⲧⲏⲥ	ⲛϫⲉ|ⲛⲓ|ⲙⲁⲑⲏⲧⲏⲥ
ⲉⲑⲣⲉⲛⲁⲓ	ⲉ|ⲑⲣⲉ|ⲛⲁⲓ
ⲥⲓ	ⲥⲓ
ϫⲉⲍ	ϫⲉ|ⲍ
ⲙⲡⲓⲙⲏϣ	ⲙ|ⲡⲓ|ⲙⲏϣ
ⲛⲥⲉⲣⲱⲧⲉⲃ	ⲛ|ⲥⲉ|ⲣⲱⲧⲉⲃ
ϩⲓϫⲉⲛⲡⲓⲕⲁϩⲓ	ϩⲓϫⲉⲛ|ⲡⲓ|ⲕⲁϩⲓ
ⲙⲡⲓⲍ	ⲙ|ⲡⲓ|ⲍ
ⲛⲁϩⲣⲉⲛⲡⲓⲙⲏϣ	ⲛⲁϩⲣⲉⲛ|ⲡⲓ|ⲙⲏϣ
ϩⲁⲛⲕⲉⲕⲟⲩϫⲓ	ϩⲁⲛ|ⲕⲉ|ⲕⲟⲩϫⲓ
ⲛⲧⲉⲃⲧ	ⲛ|ⲧⲉⲃⲧ
ⲉⲑⲣⲟⲩⲭⲱ	ⲉ|ⲑⲣ|ⲟⲩ|ⲭⲱ
ⲛⲛⲁⲓⲕⲉⲭⲱⲟⲩⲛⲓ	ⲛ|ⲛⲁⲓ|ⲕⲉ|ⲭⲱⲟⲩⲛⲓ
ⲛⲛⲓϩⲟⲩⲟ	ⲛ|ⲛⲓ|ϩⲟⲩⲟ
ⲛⲧⲉⲛⲓⲗⲁⲕϩ	ⲛⲧⲉ|ⲛⲓ|ⲗⲁⲕϩ
ⲍ	ⲍ
ⲙⲃⲓⲣ	ⲙ|ⲃⲓⲣ
ⲛⲁⲩⲓⲣⲓ	ⲛⲁ|ⲩ|ⲓⲣⲓ
ⲛⲇ	ⲛ|ⲇ
ⲁϥⲭⲁⲩ	ⲁ|ϥ|ⲭⲁ|ⲩ
ⲛⲧⲉⲇⲁⲗⲙⲁⲛⲟⲩⲑⲁ	ⲛⲧⲉ|ⲇⲁⲗⲙⲁⲛⲟⲩⲑⲁ
ⲛϫⲉⲛⲓⲫⲁⲣⲓⲥⲉⲟⲥ	ⲛϫⲉ|ⲛⲓ|ⲫⲁⲣⲓⲥⲉⲟⲥ
ⲛⲕⲱϯ	ⲛ|ⲕⲱϯ
ⲛⲥⲁⲟⲩⲙⲏⲓⲛⲓ	ⲛⲥⲁ|ⲟⲩ|ⲙⲏⲓⲛⲓ
ϧⲉⲛⲧⲫⲉ	ϧⲉⲛ|ⲧ|ⲫⲉ
ⲉⲩⲉⲣⲡⲓⲣⲁⲍⲓⲛ	ⲉ|ⲩ|ⲉⲣⲡⲓⲣⲁⲍⲓⲛ
ⲉⲧⲁϥϥⲓⲁϩⲟⲙ	ⲉⲧ|ⲁ|ϥ|ϥⲓⲁϩⲟⲙ
ϧⲉⲛⲡⲉϥⲡⲛⲉⲩⲙⲁ	ϧⲉⲛ|ⲡⲉϥ|ⲡⲛⲉⲩⲙⲁ
ϫⲉⲁϧⲟ	ϫⲉ|ⲁϧⲟ
ⲡⲁⲓϫⲱⲟⲩ	ⲡⲁⲓ|ϫⲱⲟⲩ
ϥⲕⲱϯ	ϥ|ⲕⲱϯ
ⲙⲡⲁⲓϫⲱⲟⲩ	ⲙ|ⲡⲁⲓ|ϫⲱⲟⲩ
ⲉⲧⲁϥⲭⲁⲩ	ⲉⲧ|ⲁ|ϥ|ⲭⲁ|ⲩ
ⲁⲩⲉⲣⲡⲱⲃϣ	ⲁ|ⲩ|ⲉⲣ|ⲡ|ⲱⲃϣ
ⲉϭⲓⲱⲓⲕ	ⲉ|ϭⲓⲱⲓⲕ
ⲛⲉⲙⲙⲟⲛ	ⲛⲉ|ⲙⲙⲟⲛ
ⲉⲟⲩⲱⲓⲕ	ⲉ|ⲟⲩ|ⲱⲓⲕ
ⲛⲁϥϩⲟⲛϩⲉⲛ	ⲛⲁ|ϥ|ϩⲟⲛϩⲉⲛ
ϫⲉⲁⲛⲁⲩ	ϫⲉ|ⲁⲛⲁⲩ
ϩⲁⲡϣⲉⲙⲏⲣ	ϩⲁ|ⲡ|ϣⲉⲙⲏⲣ
ⲛⲧⲉⲛⲓⲫⲁⲣⲓⲥⲉⲟⲥ	ⲛⲧⲉ|ⲛⲓ|ⲫⲁⲣⲓⲥⲉⲟⲥ
ⲛⲉⲙⲡϣⲉⲙⲏⲣ	ⲛⲉⲙ|ⲡ|ϣⲉⲙⲏⲣ
ⲛⲁⲩⲙⲟⲕⲙⲉⲕ	ⲛⲁ|ⲩ|ⲙⲟⲕⲙⲉⲕ
ⲉⲧⲁϥⲉⲙⲓ	ⲉⲧ|ⲁ|ϥ|ⲉⲙⲓ
ϫⲉⲁϧⲱⲧⲉⲛ	ϫⲉ|ⲁϧⲱ|ⲧⲉⲛ
ⲧⲉⲧⲉⲛⲙⲟⲕⲙⲉⲕ	ⲧⲉⲧⲉⲛ|ⲙⲟⲕⲙⲉⲕ
ⲛⲧⲉⲛ	ⲛⲧⲉⲛ
ⲙⲡⲁⲧⲉⲧⲉⲛⲉⲙⲓ	ⲙⲡⲁⲧⲉ|ⲧⲉⲛ|ⲉⲙⲓ
ⲧⲉⲧⲉⲛⲕⲁϯ	ⲧⲉⲧⲉⲛ|ⲕⲁϯ
ϥⲑⲏⲙ	ϥ|ⲑⲏⲙ
ⲛϫⲉⲡⲉⲧⲉⲛϩⲏⲧ	ⲛϫⲉ|ⲡⲉⲧⲉⲛ|ϩⲏⲧ
ϩⲁⲛⲃⲁⲗ	ϩⲁⲛ|ⲃⲁⲗ
ⲛⲧⲉⲧⲉⲛⲛⲁⲩ	ⲛ|ⲧⲉⲧⲉⲛ|ⲛⲁⲩ
ⲙⲃⲟⲗ	ⲙ|ⲃⲟⲗ
ϩⲁⲛⲙⲁϣϫ	ϩⲁⲛ|ⲙⲁϣϫ
ⲛⲧⲉⲧⲉⲛⲥⲱⲧⲉⲙ	ⲛ|ⲧⲉⲧⲉⲛ|ⲥⲱⲧⲉⲙ
ⲉⲧⲁⲓⲫⲁϣⲟⲩ	ⲉⲧ|ⲁ|ⲓ|ⲫⲁϣ|ⲟⲩ
ⲉϩⲣⲉⲛⲡⲓⲉ	ⲉϩⲣⲉⲛ|ⲡⲓ|ⲉ
ϫⲉⲁⲧⲉⲧⲉⲛⲉⲗⲟⲩⲏⲣ	ϫⲉ|ⲁ|ⲧⲉⲧⲉⲛ|ⲉⲗ|ⲟⲩⲏⲣ
ϫⲉⲓⲃ	ϫⲉ|ⲓⲃ
ⲡⲓⲍ	ⲡⲓ|ⲍ
ⲉϩⲣⲉⲛⲡⲓⲇ	ⲉϩⲣⲉⲛ|ⲡⲓ|ⲇ
ⲛⲟⲩⲃⲉⲗⲗⲉ	ⲛ|ⲟⲩ|ⲃⲉⲗⲗⲉ
ⲛⲧϫⲓϫ	ⲛ|ⲧ|ϫⲓϫ
ⲙⲡⲓⲃⲉⲗⲗⲉ	ⲙ|ⲡⲓ|ⲃⲉⲗⲗⲉ
ⲁϥⲉⲛϥ	ⲁ|ϥ|ⲉⲛ|ϥ
ⲙⲡⲓϯⲙⲓ	ⲙ|ⲡⲓ|ϯⲙⲓ
ϧⲉⲛⲛⲉϥⲃⲁⲗ	ϧⲉⲛ|ⲛⲉϥ|ⲃⲁⲗ
ⲁϥⲭⲁⲛⲉϥϫⲓϫ	ⲁ|ϥ|ⲭⲁ|ⲛⲉϥ|ϫⲓϫ
ⲡⲉⲧⲉⲕⲛⲁⲩ	ⲡ|ⲉⲧⲉ|ⲕ|ⲛⲁⲩ
ϫⲉϯⲛⲁⲩ	ϫⲉ|ϯ|ⲛⲁⲩ
ⲉⲛⲓⲣⲱⲙⲓ	ⲉ|ⲛⲓ|ⲣⲱⲙⲓ
ⲉϫⲉⲛⲛⲉϥⲃⲁⲗ	ⲉϫⲉⲛ|ⲛⲉϥ|ⲃⲁⲗ
ⲁϥⲟⲩϫⲁⲓ	ⲁ|ϥ|ⲟⲩϫⲁⲓ
ϧⲉⲛⲟⲩⲱⲛϩ	ϧⲉⲛ|ⲟⲩⲱⲛϩ
ϫⲉⲙⲡⲣϣⲉ	ϫⲉ|ⲙⲡⲣ|ϣⲉ
ⲉⲡⲓϯⲙⲓ	ⲉ|ⲡⲓ|ϯⲙⲓ
ⲛⲉⲙⲛⲉϥⲙⲁⲑⲏⲧⲏⲥ	ⲛⲉⲙ|ⲛⲉϥ|ⲙⲁⲑⲏⲧⲏⲥ
ⲛⲧⲉⲕⲉⲥⲁⲣⲓⲁ	ⲛⲧⲉ|ⲕⲉⲥⲁⲣⲓⲁ
ⲛⲧⲉⲫⲓⲗⲓⲡⲡⲉ	ⲛⲧⲉ|ⲫⲓⲗⲓⲡⲡⲉ
ϧⲉⲛⲡⲓⲙⲱⲓⲧ	ϧⲉⲛ|ⲡⲓ|ⲙⲱⲓⲧ
ϫⲉⲁⲣⲉⲛⲓⲣⲱⲙⲓ	ϫⲉ|ⲁⲣⲉ|ⲛⲓ|ⲣⲱⲙⲓ
ⲛⲧⲉⲛⲓⲡⲣⲟⲫⲏⲧⲏⲥ	ⲛⲧⲉ|ⲛⲓ|ⲡⲣⲟⲫⲏⲧⲏⲥ
ⲛⲥⲉϣⲧⲉⲙϫⲟⲥ	ⲛ|ⲥⲉ|ϣⲧⲉⲙ|ϫⲟ|ⲥ
ϭⲓⲟⲩⲙⲏϣ	ϭⲓ|ⲟⲩ|ⲙⲏϣ
ⲛⲛⲓⲡⲣⲉⲥⲃⲩⲧⲉⲣⲟⲥ	ⲛ|ⲛⲓ|ⲡⲣⲉⲥⲃⲩⲧⲉⲣⲟⲥ
ⲛⲉⲙⲛⲓⲁⲣⲭⲓⲉⲣⲉⲩⲥ	ⲛⲉⲙ|ⲛⲓ|ⲁⲣⲭⲓⲉⲣⲉⲩⲥ
ⲛⲧⲉϥⲧⲱⲛϥ	ⲛⲧⲉ|ϥ|ⲧⲱⲛ|ϥ
ϧⲉⲛⲟⲩⲡⲁⲣⲣⲏⲥⲓⲁ	ϧⲉⲛ|ⲟⲩ|ⲡⲁⲣⲣⲏⲥⲓⲁ
ⲛⲉⲣⲉⲡⲓⲧⲓⲙⲁⲛ	ⲛ|ⲉⲣⲉⲡⲓⲧⲓⲙⲁⲛ
ⲉⲧⲁϥⲫⲟⲛϩϥ	ⲉⲧ|ⲁ|ϥ|ⲫⲟⲛϩ|ϥ
ⲉⲛⲉϥⲙⲁⲑⲏⲧⲏⲥ	ⲉ|ⲛⲉϥ|ⲙⲁⲑⲏⲧⲏⲥ
ⲥⲁⲫⲁϩⲟⲩ	ⲥⲁ|ⲫⲁϩⲟⲩ
ⲡⲥⲁⲧⲁⲛⲁⲥ	ⲡ|ⲥⲁⲧⲁⲛⲁⲥ
ϫⲉⲭⲙⲉⲩⲓ	ϫⲉ|ⲭ|ⲙⲉⲩⲓ
ⲉⲛⲁⲫⲛⲟⲩϯ	ⲉ|ⲛⲁ|ⲫ|ⲛⲟⲩϯ
ⲉⲛⲁⲛⲓⲣⲱⲙⲓ	ⲉ|ⲛⲁ|ⲛⲓ|ⲣⲱⲙⲓ
ⲉⲑⲟⲩⲱϣ	ⲉⲑ|ⲟⲩⲱϣ
ⲉⲓ	ⲉ|ⲓ
ⲥⲁⲙⲉⲛϩⲏⲓ	ⲥⲁⲙⲉⲛϩⲏ|ⲓ
ⲙⲁⲣⲉϥϫⲟⲗϥ	ⲙⲁⲣⲉ|ϥ|ϫⲟⲗ|ϥ
ⲛⲧⲉϥⲱⲗⲓ	ⲛⲧⲉ|ϥ|ⲱⲗⲓ
ⲙⲡⲉϥⲥⲧⲁⲩⲣⲟⲥ	ⲙ|ⲡⲉϥ|ⲥⲧⲁⲩⲣⲟⲥ
ⲛⲧⲉϥⲟⲩⲁϩϥ	ⲛⲧⲉ|ϥ|ⲟⲩⲁϩ|ϥ
ⲉⲑⲛⲁⲟⲩⲱϣ	ⲉⲑ|ⲛⲁ|ⲟⲩⲱϣ
ⲉϥⲉⲧⲁⲕⲟⲥ	ⲉϥⲉ|ⲧⲁⲕⲟ|ⲥ
ⲉⲑⲃⲏⲧ	ⲉⲑⲃⲏ|ⲧ
ⲛⲉⲙⲉⲑⲃⲉⲡⲓⲉⲩⲁⲅⲅⲉⲗⲓⲟⲛ	ⲛⲉⲙ|ⲉⲑⲃⲉ|ⲡⲓ|ⲉⲩⲁⲅⲅⲉⲗⲓⲟⲛ
ⲉϥⲉⲛⲁϩⲙⲉⲥ	ⲉϥⲉ|ⲛⲁϩⲙⲉ|ⲥ
ⲉⲧⲉⲡⲓⲣⲱⲙⲓ	ⲉⲧⲉ|ⲡⲓ|ⲣⲱⲙⲓ
ⲛⲁϫⲉⲙϩⲏⲟⲩ	ⲛⲁ|ϫⲉⲙϩⲏⲟⲩ
ⲁϥϣⲁⲛϫⲉⲙϩⲏⲟⲩ	ⲁϥϣⲁⲛ|ϫⲉⲙϩⲏⲟⲩ
ⲛⲧⲉϥϯⲟⲥⲓ	ⲛⲧⲉ|ϥ|ϯⲟⲥⲓ
ⲛⲁⲧⲏⲓϥ	ⲛⲁ|ⲧⲏⲓ|ϥ
ⲉⲑⲛⲁϣⲓⲡⲓ	ⲉⲑ|ⲛⲁ|ϣⲓⲡⲓ
ⲉⲟⲩⲟⲛϩⲧ	ⲉ|ⲟⲩⲟⲛϩ|ⲧ
ⲛⲉⲙⲛⲁⲥⲁϫⲓ	ⲛⲉⲙ|ⲛⲁ|ⲥⲁϫⲓ
ϧⲉⲛⲡⲁⲓϫⲱⲟⲩ	ϧⲉⲛ|ⲡⲁⲓ|ϫⲱⲟⲩ
ⲛⲛⲱⲓⲕ	ⲛ|ⲛⲱⲓⲕ
ⲛⲣⲉϥⲉⲣⲛⲟⲃⲓ	ⲛ|ⲣⲉϥⲉⲣⲛⲟⲃⲓ
ⲛⲁϯϣⲓⲡⲓ	ⲛⲁ|ϯϣⲓⲡⲓ
ϧⲉⲛⲡⲱⲟⲩ	ϧⲉⲛ|ⲡ|ⲱⲟⲩ
ⲛⲧⲉⲡⲉϥⲉⲓⲱⲧ	ⲛⲧⲉ|ⲡⲉϥ|ⲉⲓⲱⲧ
ⲛⲉⲙⲛⲉϥⲁⲅⲅⲉⲗⲟⲥ	ⲛⲉⲙ|ⲛⲉϥ|ⲁⲅⲅⲉⲗⲟⲥ
ⲁⲩⲥⲟϭⲛⲓ	ⲁ|ⲩ|ⲥⲟϭⲛⲓ
ⲛⲟⲩⲥⲟϭⲛⲓ	ⲛ|ⲟⲩ|ⲥⲟϭⲛⲓ
ⲛϣⲱⲣⲡ	ⲛ|ϣⲱⲣⲡ
ⲁⲩⲥⲱⲛϩ	ⲁ|ⲩ|ⲥⲱⲛϩ
ⲙⲡⲓⲗⲁⲧⲟⲥ	ⲙ|ⲡⲓⲗⲁⲧⲟⲥ
ⲛϫⲉⲡⲓⲗⲁⲧⲟⲥ	ⲛϫⲉ|ⲡⲓⲗⲁⲧⲟⲥ
ⲡⲟⲩⲣⲟ	ⲡ|ⲟⲩⲣⲟ
ⲛⲧⲉⲛⲓⲓⲟⲩⲇⲁⲓ	ⲛⲧⲉ|ⲛⲓ|ⲓⲟⲩⲇⲁⲓ
ⲡⲉⲧϫⲱ	ⲡ|ⲉⲧ|ϫⲱ
ⲛⲁⲩⲉⲣⲕⲁⲧⲏⲅⲟⲣⲓⲛ	ⲛⲁ|ⲩ|ⲉⲣⲕⲁⲧⲏⲅⲟⲣⲓⲛ
ⲡⲓⲗⲁⲧⲟⲥ	ⲡⲓⲗⲁⲧⲟⲥ
ⲛⲁϥϣⲉⲛϥ	ⲛⲁ|ϥ|ϣⲉⲛ|ϥ
ⲛⲕⲉⲣⲟⲩⲱ	ⲛ|ⲕ|ⲉⲣⲟⲩⲱ
ϫⲉⲥⲉⲉⲣⲕⲁⲧⲏⲅⲟⲣⲓⲛ	ϫⲉ|ⲥⲉ|ⲉⲣⲕⲁⲧⲏⲅⲟⲣⲓⲛ
ⲛⲟⲩⲏⲣ	ⲛ|ⲟⲩⲏⲣ
ⲙⲡⲉϥϫⲉⲉⲣⲟⲩⲱ	ⲙⲡⲉ|ϥ|ϫⲉ|ⲉⲣⲟⲩⲱ
ⲛⲧⲉϥⲉⲣϣⲫⲏⲣⲓ	ⲛⲧⲉ|ϥ|ⲉⲣϣⲫⲏⲣⲓ
ⲕⲁⲧⲁⲡϣⲁⲓ	ⲕⲁⲧⲁ|ⲡ|ϣⲁⲓ
ⲉϥⲥⲟⲛϩ	ⲉ|ϥ|ⲥⲟⲛϩ
ⲉϣⲁⲩⲉⲣⲉⲧⲓⲛ	ⲉ|ϣⲁ|ⲩ|ⲉⲣⲉⲧⲓⲛ
ⲉⲧⲟⲩⲙⲟⲩϯ	ⲉⲧ|ⲟⲩ|ⲙⲟⲩϯ
ϫⲉⲃⲁⲣⲁⲃⲃⲁⲥ	ϫⲉ|ⲃⲁⲣⲁⲃⲃⲁⲥ
ⲛⲁϥⲥⲟⲛϩ	ⲛⲁ|ϥ|ⲥⲟⲛϩ
ⲉⲧⲁⲩⲓⲣⲓ	ⲉⲧ|ⲁ|ⲩ|ⲓⲣⲓ
ⲛⲟⲩϣⲑⲟⲣⲧⲉⲣ	ⲛ|ⲟⲩ|ϣⲑⲟⲣⲧⲉⲣ
ⲉⲛⲁⲩⲓⲣⲓ	ⲉ|ⲛⲁ|ⲩ|ⲓⲣⲓ
ⲛⲟⲩϧⲱⲧⲉⲃ	ⲛ|ⲟⲩ|ϧⲱⲧⲉⲃ
ϧⲉⲛⲡϣⲑⲟⲣⲧⲉⲣ	ϧⲉⲛ|ⲡ|ϣⲑⲟⲣⲧⲉⲣ
ⲛϫⲉⲡⲓⲙⲏϣ	ⲛϫⲉ|ⲡⲓ|ⲙⲏϣ
ⲛⲉⲣⲉⲧⲓⲛ	ⲛ|ⲉⲣⲉⲧⲓⲛ
ⲉⲛⲁϥⲓⲣⲓ	ⲉ|ⲛⲁ|ϥ|ⲓⲣⲓ
ϫⲉⲧⲉⲧⲉⲛⲟⲩⲱϣ	ϫⲉ|ⲧⲉⲧⲉⲛ|ⲟⲩⲱϣ
ⲛⲧⲁⲭⲱ	ⲛ|ⲧⲁ|ⲭⲱ
ϫⲉⲉⲧⲁⲩⲧⲏⲓϥ	ϫⲉ|ⲉⲧ|ⲁ|ⲩ|ⲧⲏⲓ|ϥ
ⲉⲑⲃⲉⲟⲩⲫⲑⲟⲛⲟⲥ	ⲉⲑⲃⲉ|ⲟⲩ|ⲫⲑⲟⲛⲟⲥ
ⲛⲓⲁⲣⲭⲓⲉⲣⲉⲩⲥ	ⲛⲓ|ⲁⲣⲭⲓⲉⲣⲉⲩⲥ
ⲁⲩⲕⲓⲙ	ⲁ|ⲩ|ⲕⲓⲙ
ⲛⲧⲉϥⲭⲁⲃⲁⲣⲃⲃⲁⲥ	ⲛⲧⲉ|ϥ|ⲭⲁ|ⲃⲁⲣⲃⲃⲁⲥ
ⲡⲉϯⲛⲁⲁⲓϥ	ⲡ|ⲉ|ϯ|ⲛⲁ|ⲁⲓ|ϥ
ϫⲉⲡⲟⲩⲣⲟ	ϫⲉ|ⲡ|ⲟⲩⲣⲟ
ϫⲉⲁϣϥ	ϫⲉ|ⲁϣ|ϥ
ⲡⲉⲧⲁϥⲁⲓϥ	ⲡ|ⲉⲧ|ⲁ|ϥ|ⲁⲓ|ϥ
ⲛⲁⲩⲱϣ	ⲛⲁ|ⲩ|ⲱϣ
ⲉⲉⲣⲡⲉⲧⲉϩⲛⲉⲡⲓⲙⲏϣ	ⲉ|ⲉⲣ|ⲡ|ⲉⲧⲉ|ϩⲛⲉ|ⲡⲓ|ⲙⲏϣ
ⲁϥⲭⲁⲃⲁⲣⲁⲃⲃⲁⲥ	ⲁ|ϥ|ⲭⲁ|ⲃⲁⲣⲁⲃⲃⲁⲥ
ⲉⲉⲣⲫⲣⲁⲅⲉⲗⲗⲓⲛ	ⲉ|ⲉⲣⲫⲣⲁⲅⲉⲗⲗⲓⲛ
ⲛⲧⲟⲩⲁϣϥ	ⲛⲧ|ⲟⲩ|ⲁϣ|ϥ
ⲛⲓⲙⲁⲧⲟⲓ	ⲛⲓ|ⲙⲁⲧⲟⲓ
ⲛⲧⲉⲡⲓⲡⲣⲉⲧⲱⲣⲓⲟⲛ	ⲛⲧⲉ|ⲡⲓ|ⲡⲣⲉⲧⲱⲣⲓⲟⲛ
ⲉϯⲥⲡⲓⲣⲁ	ⲉ|ϯ|ⲥⲡⲓⲣⲁ
ϩⲓⲱⲧϥ	ϩⲓⲱⲧ|ϥ
ⲛⲟⲩϩⲃⲟⲥ	ⲛ|ⲟⲩ|ϩⲃⲟⲥ
ⲛϭⲏϫⲓ	ⲛ|ϭⲏϫⲓ
ⲁⲩϣⲱⲛⲧ	ⲁ|ⲩ|ϣⲱⲛⲧ
ⲛⲟⲩⲭⲗⲟⲙ	ⲛ|ⲟⲩ|ⲭⲗⲟⲙ
ϧⲉⲛϩⲁⲛⲥⲟⲩⲣⲓ	ϧⲉⲛ|ϩⲁⲛ|ⲥⲟⲩⲣⲓ
ⲛⲉⲣⲁⲥⲡⲁⲍⲉⲥⲑⲉ	ⲛ|ⲉⲣⲁⲥⲡⲁⲍⲉⲥⲑⲉ
ϫⲉⲭⲉⲣⲉ	ϫⲉ|ⲭⲉⲣⲉ
ⲁⲩϩⲓⲟⲩⲓ	ⲁ|ⲩ|ϩⲓⲟⲩⲓ
ϧⲉⲛⲧⲉϥⲁⲫⲉ	ϧⲉⲛ|ⲧⲉϥ|ⲁⲫⲉ
ⲛⲟⲩⲕⲁϣ	ⲛ|ⲟⲩ|ⲕⲁϣ
ⲛⲁⲩϩⲓⲑⲁϥ	ⲛⲁ|ⲩ|ϩⲓⲑⲁϥ
ϧⲉⲛⲡⲉϥϩⲟ	ϧⲉⲛ|ⲡⲉϥ|ϩⲟ
ⲉⲩϩⲓⲟⲩⲓ	ⲉ|ⲩ|ϩⲓⲟⲩⲓ
ⲉϫⲉⲛⲛⲟⲩⲕⲉⲗⲓ	ⲉϫⲉⲛ|ⲛⲟⲩ|ⲕⲉⲗⲓ
ⲉⲟⲩⲱϣⲧ	ⲉ|ⲟⲩⲱϣⲧ
ⲉⲧⲁⲩⲥⲱⲃⲓ	ⲉⲧ|ⲁ|ⲩ|ⲥⲱⲃⲓ
ⲁⲩⲃⲁϣϥ	ⲁ|ⲩ|ⲃⲁϣ|ϥ
ⲙⲡⲓϩⲃⲟⲥ	ⲙ|ⲡⲓ|ϩⲃⲟⲥ
ⲁⲩⲉⲛϥ	ⲁ|ⲩ|ⲉⲛ|ϥ
ⲛⲥⲉⲁϣϥ	ⲛ|ⲥⲉ|ⲁϣ|ϥ
ⲛⲭⲃⲁ	ⲛ|ⲭⲃⲁ
ⲉϥⲥⲓⲛⲓⲱⲟⲩ	ⲉ|ϥ|ⲥⲓⲛⲓⲱⲟⲩ
ⲥⲓⲙⲱⲛ	ⲥⲓⲙⲱⲛ
ⲡⲓⲕⲩⲣⲓⲛⲛⲉⲟⲥ	ⲡⲓ|ⲕⲩⲣⲓⲛⲛⲉⲟⲥ
ⲛⲁⲗⲉⲝⲁⲛⲇⲣⲟⲥ	ⲛ|ⲁⲗⲉⲝⲁⲛⲇⲣⲟⲥ
ⲛⲉⲙⲣⲟⲩⲫⲟⲥ	ⲛⲉⲙ|ⲣⲟⲩⲫⲟⲥ
ⲛⲧⲉⲅⲟⲗⲅⲟⲑⲁ	ⲛⲧⲉ|ⲅⲟⲗⲅⲟⲑⲁ
ⲉϣⲁⲩⲟⲩⲁϩⲙⲉϥ	ⲉ|ϣⲁ|ⲩ|ⲟⲩⲁϩⲙⲉ|ϥ
ⲛⲧⲉⲡⲓⲕⲣⲁⲛⲓⲟⲛ	ⲛⲧⲉ|ⲡⲓ|ⲕⲣⲁⲛⲓⲟⲛ
ⲛⲟⲩⲏⲣⲡ	ⲛ|ⲟⲩ|ⲏⲣⲡ
ⲉϥⲙⲟϫⲧ	ⲉ|ϥ|ⲙⲟϫⲧ
ⲛⲉⲙⲟⲩϣⲁϣⲓ	ⲛⲉⲙ|ⲟⲩ|ϣⲁϣⲓ
ⲙⲡⲉϥϭⲓⲧϥ	ⲙⲡⲉ|ϥ|ϭⲓⲧ|ϥ
ⲉⲁⲩϩⲓⲱⲡ	ⲉ|ⲁ|ⲩ|ϩⲓⲱⲡ
ⲉⲧⲛⲁⲟⲗⲟⲩ	ⲉⲧ|ⲛⲁ|ⲟⲗ|ⲟⲩ
ⲫⲛⲁⲩ	ⲫ|ⲛⲁⲩ
ⲛⲁϫⲡⲅ	ⲛ|ⲁϫⲡⲅ
ϯⲉⲡⲓⲅⲣⲁⲫⲏ	ϯ|ⲉⲡⲓⲅⲣⲁⲫⲏ
ⲛⲧⲉⲧⲉϥⲉⲧⲓⲁ	ⲛⲧⲉ|ⲧⲉϥ|ⲉⲧⲓⲁ
ⲛⲁⲥⲥϧⲏⲟⲩⲧ	ⲛⲁ|ⲥ|ⲥϧⲏⲟⲩⲧ
ⲁⲩⲉϣⲕⲉⲥⲟⲛⲓ	ⲁ|ⲩ|ⲉϣ|ⲕⲉ|ⲥⲟⲛⲓ
ⲥⲁϫⲁϭⲏ	ⲥⲁ|ϫⲁϭⲏ
ϯⲅⲣⲁⲫⲏ	ϯ|ⲅⲣⲁⲫⲏ
ϫⲱⲕ	ϫⲱⲕ
ϫⲉⲁⲩⲟⲡϥ	ϫⲉ|ⲁ|ⲩ|ⲟⲡ|ϥ
ⲛⲉⲙⲛⲓⲁⲛⲟⲙⲟⲥ	ⲛⲉⲙ|ⲛⲓ|ⲁⲛⲟⲙⲟⲥ
ⲉⲛⲁⲩⲥⲓⲛⲓ	ⲉ|ⲛⲁ|ⲩ|ⲥⲓⲛⲓ
ⲛⲁⲩϫⲉⲟⲩⲁ	ⲛⲁ|ⲩ|ϫⲉⲟⲩⲁ
ⲉⲩⲕⲓⲙ	ⲉ|ⲩ|ⲕⲓⲙ
ⲛⲛⲟⲩⲁⲫⲏⲟⲩⲓ	ⲛ|ⲛⲟⲩ|ⲁⲫⲏⲟⲩⲓ
ⲉⲧⲛⲁⲃⲉⲗⲡⲓⲉⲣⲫⲉⲓ	ⲉⲧ|ⲛⲁ|ⲃⲉⲗ|ⲡⲓ|ⲉⲣⲫⲉⲓ
ⲉⲧⲛⲁⲕⲟⲧϥ	ⲉⲧ|ⲛⲁ|ⲕⲟⲧ|ϥ
ⲛⲁϩⲙⲉⲕ	ⲛⲁϩⲙⲉ|ⲕ
ⲉⲁⲕⲓ	ⲉ|ⲁ|ⲕ|ⲓ
ϩⲓⲡⲓⲥⲧⲁⲩⲣⲟⲥ	ϩⲓ|ⲡⲓ|ⲥⲧⲁⲩⲣⲟⲥ
ⲛⲓⲕⲉⲁⲣⲭⲓⲉⲣⲉⲩⲥ	ⲛⲓ|ⲕⲉ|ⲁⲣⲭⲓⲉⲣⲉⲩⲥ
ⲉⲩⲥⲱⲃⲓ	ⲉ|ⲩ|ⲥⲱⲃⲓ
ϫⲉϥⲛⲟϩⲉⲙ	ϫⲉ|ϥ|ⲛⲟϩⲉⲙ
ⲛϩⲁⲛⲕⲉⲭⲱⲟⲩⲛⲓ	ⲛ|ϩⲁⲛ|ⲕⲉ|ⲭⲱⲟⲩⲛⲓ
ⲉⲛⲁϩⲙⲉϥ	ⲉ|ⲛⲁϩⲙⲉ|ϥ
ⲙⲡⲓⲥⲗ	ⲙ|ⲡ|ⲓⲥⲗ
ⲙⲁⲣⲉϥⲓ	ⲙⲁⲣⲉ|ϥ|ⲓ
ⲛⲧⲉⲛⲛⲁⲩ	ⲛⲧⲉ|ⲛ|ⲛⲁⲩ
ⲛⲧⲉⲛⲛⲁϩϯ	ⲛ|ⲧⲉⲛ|ⲛⲁϩϯ
ⲉⲧⲁⲩⲁϣⲟⲩ	ⲉⲧ|ⲁ|ⲩ|ⲁϣ|ⲟⲩ
ⲛⲁⲩϯϣⲱϣ	ⲛⲁ|ⲩ|ϯϣⲱϣ
ⲉⲧⲁⲫⲛⲁⲩ	ⲉⲧ|ⲁ|ⲫ|ⲛⲁⲩ
ⲛⲁϫⲡⲋ	ⲛ|ⲁϫⲡⲋ
ⲁ	ⲁ
ⲟⲩⲭⲁⲕⲓ	ⲟⲩ|ⲭⲁⲕⲓ
ϣⲁⲫⲛⲁⲩ	ϣⲁ|ⲫ|ⲛⲁⲩ
ⲛⲁϫⲡⲑ	ⲛ|ⲁϫⲡⲑ
ϧⲉⲛⲫⲛⲁⲩ	ϧⲉⲛ|ⲫ|ⲛⲁⲩ
ⲛⲥⲙⲏ	ⲛ|ⲥⲙⲏ
ϫⲉⲉⲗⲱⲓ	ϫⲉ|ⲉⲗⲱⲓ
ⲉⲗⲱⲓ	ⲉⲗⲱⲓ
ⲗⲉⲙⲁ	ⲗⲉⲙⲁ
ⲥⲁⲃⲁⲭⲑⲁⲛⲓ	ⲥⲁⲃⲁⲭⲑⲁⲛⲓ
ⲉⲧⲉⲙⲡⲉϥⲟⲩⲱϩⲉⲙ	ⲉⲧⲉ|ⲙ|ⲡⲉϥ|ⲟⲩⲱϩⲉⲙ
ϫⲉⲡⲁⲛⲟⲩϯ	ϫⲉ|ⲡⲁ|ⲛⲟⲩϯ
ⲡⲁⲛⲟⲩϯ	ⲡⲁ|ⲛⲟⲩϯ
ⲁⲕⲭⲁⲧ	ⲁ|ⲕ|ⲭⲁ|ⲧ
ϥⲙⲟⲩϯ	ϥ|ⲙⲟⲩϯ
ⲉⲏⲗⲓⲁⲥ	ⲉ|ⲏⲗⲓⲁⲥ
ⲉⲧⲁϥϭⲟϫⲓ	ⲉⲧ|ⲁ|ϥ|ϭⲟϫⲓ
ⲁϥⲙⲁϩⲟⲩⲥⲫⲟⲅⲅⲟⲥ	ⲁ|ϥ|ⲙⲁϩ|ⲟⲩ|ⲥⲫⲟⲅⲅⲟⲥ
ⲛϩⲉⲙϫ	ⲛ|ϩⲉⲙϫ
ⲉϫⲉⲛⲟⲩⲕⲁϣ	ⲉϫⲉⲛ|ⲟⲩ|ⲕⲁϣ
ⲁϥⲧⲥⲟϥ	ⲁ|ϥ|ⲧⲥⲟ|ϥ
ϫⲉⲭⲁϥ	ϫⲉ|ⲭⲁ|ϥ
ⲛⲏⲟⲩ	ⲛⲏⲟⲩ
ⲛⲧⲉϥⲉⲛϥ	ⲛⲧⲉ|ϥ|ⲉⲛ|ϥ
ⲡⲓⲕⲁⲧⲁⲡⲉⲧⲁⲥⲙⲁ	ⲡⲓ|ⲕⲁⲧⲁⲡⲉⲧⲁⲥⲙⲁ
ⲛⲧⲉⲡⲓⲉⲣⲫⲉⲓ	ⲛⲧⲉ|ⲡⲓ|ⲉⲣⲫⲉⲓ
ⲁϥⲫⲱϧ	ⲁ|ϥ|ⲫⲱϧ
ϧⲉⲛⲃ	ϧⲉⲛ|ⲃ
ⲓⲥϫⲉⲛⲡϣⲱⲓ	ⲓⲥϫⲉⲛ|ⲡ|ϣⲱⲓ
ⲛϫⲉⲡⲓⲉⲕⲁⲧⲟⲛⲧⲁⲣⲭⲟⲥ	ⲛϫⲉ|ⲡⲓ|ⲉⲕⲁⲧⲟⲛⲧⲁⲣⲭⲟⲥ
ⲙⲡⲉϥⲙⲑⲟ	ⲙ|ⲡⲉϥ|ⲙⲑⲟ
ⲡⲁⲓⲣⲱⲙⲓ	ⲡⲁⲓ|ⲣⲱⲙⲓ
ⲛⲉⲡϣⲏⲣⲓ	ⲛⲉ|ⲡ|ϣⲏⲣⲓ
ϩⲁⲛⲕⲉϩⲓⲟⲙⲓ	ϩⲁⲛ|ⲕⲉ|ϩⲓⲟⲙⲓ
ⲉⲛⲁⲣⲉⲙⲁⲣⲓⲁ	ⲉ|ⲛⲁⲣⲉ|ⲙⲁⲣⲓⲁ
ϯⲙⲁⲅⲇⲁⲗⲓⲛⲏ	ϯ|ⲙⲁⲅⲇⲁⲗⲓⲛⲏ
ⲛⲉⲙⲙⲁⲣⲓⲁ	ⲛⲉⲙ|ⲙⲁⲣⲓⲁ
ⲛⲧⲉⲓⲁⲕⲱⲃⲟⲥ	ⲛⲧⲉ|ⲓⲁⲕⲱⲃⲟⲥ
ⲡⲓⲕⲟⲩϫⲓ	ⲡⲓ|ⲕⲟⲩϫⲓ
ⲛⲉⲙⲧⲙⲁⲩ	ⲛⲉⲙ|ⲧ|ⲙⲁⲩ
ⲛⲓⲱⲥⲏⲧⲟⲥ	ⲛ|ⲓⲱⲥⲏⲧⲟⲥ
ⲛⲉⲙⲥⲁⲗⲱⲙⲏ	ⲛⲉⲙ|ⲥⲁⲗⲱⲙⲏ
ⲉⲛⲁⲩⲟⲩⲉϩ	ⲉ|ⲛⲁ|ⲩ|ⲟⲩⲉϩ
ϧⲉⲛϯⲅⲁⲗⲓⲗⲉⲁ	ϧⲉⲛ|ϯ|ⲅⲁⲗⲓⲗⲉⲁ
ⲛⲁⲩϣⲉⲙϣⲓ	ⲛⲁ|ⲩ|ϣⲉⲙϣⲓ
ⲛⲉⲙⲕⲉⲙⲏϣ	ⲛⲉⲙ|ⲕⲉ|ⲙⲏϣ
ⲉϩⲓⲉⲣⲟⲩⲥⲁⲗⲏⲙ	ⲉ|ϩⲓⲉⲣⲟⲩⲥⲁⲗⲏⲙ
ⲛⲉϯⲡⲁⲣⲁⲥⲕⲉⲩⲏ	ⲛⲉ|ϯ|ⲡⲁⲣⲁⲥⲕⲉⲩⲏ
ⲉⲧϧⲁϫⲱϥ	ⲉⲧ|ϧⲁϫⲱ|ϥ
ⲙⲡⲥⲁⲃⲃⲁⲧⲟⲛ	ⲙ|ⲡ|ⲥⲁⲃⲃⲁⲧⲟⲛ
ⲛϫⲉⲓⲱⲥⲏⲫ	ⲛϫⲉ|ⲓⲱⲥⲏⲫ
ⲡⲓⲉⲃⲟⲗ	ⲡⲓ|ⲉⲃⲟⲗ
ϧⲉⲛⲁⲣⲓⲙⲁⲑⲉⲁⲥ	ϧⲉⲛ|ⲁⲣⲓⲙⲁⲑⲉⲁⲥ
ⲉⲟⲩⲉⲩⲥⲭⲏⲙⲱⲛ	ⲉ|ⲟⲩ|ⲉⲩⲥⲭⲏⲙⲱⲛ
ⲙⲃⲟⲩⲗⲉⲩⲧⲏⲥ	ⲙ|ⲃⲟⲩⲗⲉⲩⲧⲏⲥ
ⲉⲧⲉⲛⲑⲟϥ	ⲉⲧⲉ|ⲛⲑⲟϥ
ⲛⲁϥϫⲟⲩϣⲧ	ⲛⲁ|ϥ|ϫⲟⲩϣⲧ
ⲛϯⲙⲉⲧⲟⲩⲣⲟ	ⲛ|ϯ|ⲙⲉⲧⲟⲩⲣⲟ
ⲁϥⲉⲣⲧⲟⲗⲙⲁⲛ	ⲁ|ϥ|ⲉⲣⲧⲟⲗⲙⲁⲛ
ϩⲁⲡⲓⲗⲁⲧⲟⲥ	ϩⲁ|ⲡⲓⲗⲁⲧⲟⲥ
ⲁϥⲉⲣⲉⲧⲓⲛ	ⲁ|ϥ|ⲉⲣⲉⲧⲓⲛ
ⲙⲡⲥⲱⲙⲁ	ⲙ|ⲡ|ⲥⲱⲙⲁ
ϫⲉϩⲏⲇⲏ	ϫⲉ|ϩⲏⲇⲏ
ⲁϥⲙⲟⲩ	ⲁ|ϥ|ⲙⲟⲩ
ⲉⲡⲓⲉⲕⲁⲧⲟⲛⲧⲁⲣⲭⲟⲥ	ⲉ|ⲡⲓ|ⲉⲕⲁⲧⲟⲛⲧⲁⲣⲭⲟⲥ
ⲁϥⲟⲩⲱ	ⲁ|ϥ|ⲟⲩⲱ
ⲙⲡⲓⲉⲕⲁⲧⲟⲛⲧⲁⲣⲭⲟⲥ	ⲙ|ⲡⲓ|ⲉⲕⲁⲧⲟⲛⲧⲁⲣⲭⲟⲥ
ⲛⲓⲱⲥⲏⲫ	ⲛ|ⲓⲱⲥⲏⲫ
ⲉⲧⲁϥϣⲉⲡⲟⲩϣⲉⲛⲧⲱ	ⲉⲧ|ⲁ|ϥ|ϣⲉⲡ|ⲟⲩ|ϣⲉⲛⲧⲱ
ⲁϥⲕⲟⲩⲗⲱⲗϥ	ⲁ|ϥ|ⲕⲟⲩⲗⲱⲗ|ϥ
ϧⲉⲛⲟⲩϣⲉⲛⲧⲱ	ϧⲉⲛ|ⲟⲩ|ϣⲉⲛⲧⲱ
ⲁϥⲭⲁϥ	ⲁ|ϥ|ⲭⲁ|ϥ
ⲉⲧϣⲏⲕ	ⲉⲧ|ϣⲏⲕ
ϧⲉⲛⲟⲩⲡⲉⲧⲣⲁ	ϧⲉⲛ|ⲟⲩ|ⲡⲉⲧⲣⲁ
ⲁϥⲥⲕⲉⲣⲕⲉⲣ	ⲁ|ϥ|ⲥⲕⲉⲣⲕⲉⲣ
ⲙⲡⲓⲱⲛⲓ	ⲙ|ⲡⲓ|ⲱⲛⲓ
ⲙⲡⲓⲙϩⲁⲩ	ⲙ|ⲡⲓ|ⲙϩⲁⲩ
ⲙⲁⲣⲓⲁ	ⲙⲁⲣⲓⲁ
ⲛⲧⲉⲓⲱⲥⲏⲧⲟⲥ	ⲛⲧⲉ|ⲓⲱⲥⲏⲧⲟⲥ
ⲛⲁⲩⲛⲁⲩ	ⲛⲁ|ⲩ|ⲛⲁⲩ
ϫⲉⲉⲧⲁⲩⲭⲁϥ	ϫⲉ|ⲉⲧ|ⲁ|ⲩ|ⲭⲁ|ϥ
ⲁⲑⲁⲛⲁⲥⲓⲟⲥ	ⲁⲑⲁⲛⲁⲥⲓⲟⲥ
ⲡⲓⲭⲁⲣⲧⲟⲗⲁⲣⲓⲟⲥ	ⲡⲓ|ⲭⲁⲣⲧⲟⲗⲁⲣⲓⲟⲥ
ⲉⲧⲁⲛⲉⲣϣⲟⲣⲡ	ⲉⲧ|ⲁ|ⲛ|ⲉⲣϣⲟⲣⲡ
ⲛⲁϥϯⲙⲕⲁϩ	ⲛⲁ|ϥ|ϯⲙⲕⲁϩ
ⲛⲁⲣⲉϯⲉⲝⲟⲩⲥⲓⲁ	ⲛⲁⲣⲉ|ϯ|ⲉⲝⲟⲩⲥⲓⲁ
ⲛⲁⲣⲉⲡⲓϧⲉⲗⲗⲟ	ⲛⲁⲣⲉ|ⲡⲓ|ϧⲉⲗⲗⲟ
ⲙⲡⲉϥⲣⲱⲟⲩϣ	ⲙ|ⲡⲉϥ|ⲣⲱⲟⲩϣ
ⲛⲟⲩⲥⲟϩⲓ	ⲛ|ⲟⲩ|ⲥⲟϩⲓ
ⲛⲧⲉⲧⲉϥⲙⲉⲧⲁⲑⲛⲁϩϯ	ⲛⲧⲉ|ⲧⲉϥ|ⲙⲉⲧⲁⲑⲛⲁϩϯ
ϩⲓⲧⲉⲛⲡϭⲟⲉⲓⲥ	ϩⲓⲧⲉⲛ|ⲡ|ϭⲟⲉⲓⲥ
ⲡⲉϥⲛⲓϣϯ	ⲡⲉϥ|ⲛⲓϣϯ
ⲉⲛⲟⲩϣⲱⲛⲓ	ⲉⲛ|ⲟⲩ|ϣⲱⲛⲓ
ⲛⲧⲉϥϧⲱⲛⲧ	ⲛⲧⲉ|ϥ|ϧⲱⲛⲧ
ⲁϥⲓⲛⲓ	ⲁ|ϥ|ⲓⲛⲓ
ⲛⲥⲏⲓⲛⲓ	ⲛ|ⲥⲏⲓⲛⲓ
ⲙⲡⲉⲧⲁⲗϭⲟ	ⲙⲡⲉ|ⲧⲁⲗϭⲟ
ⲛⲁϥⲛⲏⲟⲩ	ⲛⲁ|ϥ|ⲛⲏⲟⲩ
ⲉⲧⲁⲕⲟ	ⲉ|ⲧⲁⲕⲟ
ⲁϥⲉⲣⲕⲟⲩϫⲓ	ⲁ|ϥ|ⲉⲣⲕⲟⲩϫⲓ
ⲛϫⲉⲁⲑⲁⲛⲁⲥⲓⲟⲥ	ⲛϫⲉ|ⲁⲑⲁⲛⲁⲥⲓⲟⲥ
ⲉϥⲕⲱϯ	ⲉ|ϥ|ⲕⲱϯ
ⲛⲥⲁⲟⲩⲙⲧⲟⲛ	ⲛⲥⲁ|ⲟⲩ|ⲙⲧⲟⲛ
ⲙⲡⲉϥϣⲏⲣⲓ	ⲙ|ⲡⲉϥ|ϣⲏⲣⲓ
ⲉϥϫⲓⲙⲓ	ⲉ|ϥ|ϫⲓⲙⲓ
ⲙⲡⲉϥⲉⲣⲛⲩⲙⲫⲉⲓⲛ	ⲙⲡⲉ|ϥ|ⲉⲣⲛⲩⲙⲫⲉⲓⲛ
ⲛⲁⲩϩⲉⲙⲥⲓ	ⲛⲁ|ⲩ|ϩⲉⲙⲥⲓ
ⲙⲡⲉϥⲕⲱϯ	ⲙ|ⲡⲉϥ|ⲕⲱϯ
ⲛϫⲉⲛⲓⲁⲣⲭⲱⲛ	ⲛϫⲉ|ⲛⲓ|ⲁⲣⲭⲱⲛ
ϭⲱⲣⲡ	ϭⲱⲣⲡ
ϫⲉⲟⲩⲱⲣⲡ	ϫⲉ|ⲟⲩⲱⲣⲡ
ⲛⲣⲁⲥϯ	ⲛ|ⲣⲁⲥϯ
ⲛⲁⲑⲁⲛⲁⲥⲓⲟⲥ	ⲛ|ⲁⲑⲁⲛⲁⲥⲓⲟⲥ
ⲉⲕϫⲱ	ⲉ|ⲕ|ϫⲱ
ⲉⲕⲛⲁϩϯ	ⲉ|ⲕ|ⲛⲁϩϯ
ⲉⲡⲭⲣⲓⲥⲧⲟⲥ	ⲉ|ⲡ|ⲭⲣⲓⲥⲧⲟⲥ
ⲉⲧⲁϥⲧϩⲉⲙⲥⲟⲓ	ⲉⲧ|ⲁ|ϥ|ⲧϩⲉⲙⲥⲟ|ⲓ
ⲉϫⲉⲛⲧⲉϥⲉⲕⲕⲗⲏⲥⲓⲁ	ⲉϫⲉⲛ|ⲧⲉϥ|ⲉⲕⲕⲗⲏⲥⲓⲁ
ⲛⲁⲉⲣϩⲙⲟⲧ	ⲛⲁ|ⲉⲣϩⲙⲟⲧ
ⲙⲡⲉⲕϣⲏⲣⲓ	ⲙ|ⲡⲉⲕ|ϣⲏⲣⲓ
ⲙⲡⲓⲧⲁⲗϭⲟ	ⲙ|ⲡⲓ|ⲧⲁⲗϭⲟ
ⲉⲧⲁϥⲉⲣⲛⲩⲙⲫⲉⲓⲛ	ⲉⲧ|ⲁ|ϥ|ⲉⲣⲛⲩⲙⲫⲉⲓⲛ
ⲉⲡⲓϭⲱⲣⲡ	ⲉ|ⲡⲓ|ϭⲱⲣⲡ
ⲉⲡⲉϥⲙⲁⲑⲏⲧⲏⲥ	ⲉ|ⲡⲉϥ|ⲙⲁⲑⲏⲧⲏⲥ
ϫⲉⲟⲩⲟⲛⲉⲡⲓⲥⲕⲟⲡⲟⲥ	ϫⲉ|ⲟⲩⲟⲛ|ⲉⲡⲓⲥⲕⲟⲡⲟⲥ
ⲛϫⲉⲁⲃⲃⲁ	ⲛϫⲉ|ⲁⲃⲃⲁ
ⲅⲉⲱⲣⲅⲓⲟⲥ	ⲅⲉⲱⲣⲅⲓⲟⲥ
ⲛⲉⲙⲁⲃⲃⲁ	ⲛⲉⲙ|ⲁⲃⲃⲁ
ⲅⲣⲏⲅⲟⲣⲓⲟⲥ	ⲅⲣⲏⲅⲟⲣⲓⲟⲥ
ⲡⲓⲁⲙⲟⲧ	ⲡⲓⲁⲙⲟⲧ
ⲡⲓⲉⲡⲓⲥⲕⲟⲡⲟⲥ	ⲡⲓ|ⲉⲡⲓⲥⲕⲟⲡⲟⲥ
ⲛⲧⲉⲧⲁⲙⲓⲁⲧ	ⲛⲧⲉ|ⲧⲁⲙⲓⲁⲧ
ⲉⲧⲁⲡⲓⲡⲁⲧⲣⲓⲁⲣⲭⲏⲥ	ⲉⲧ|ⲁ|ⲡⲓ|ⲡⲁⲧⲣⲓⲁⲣⲭⲏⲥ
ⲉⲡⲓⲉⲡⲓⲥⲕⲟⲡⲟⲥ	ⲉ|ⲡⲓ|ⲉⲡⲓⲥⲕⲟⲡⲟⲥ
ⲁϥⲧⲁⲙⲱⲟⲩ	ⲁ|ϥ|ⲧⲁⲙⲱ|ⲟⲩ
ϧⲉⲛⲛⲓϭⲱⲣⲡ	ϧⲉⲛ|ⲛⲓ|ϭⲱⲣⲡ
ⲁϥⲉⲣⲟⲩⲱⲛ	ⲁ|ϥ|ⲉⲣⲟⲩⲱⲛ
ϫⲉⲉⲕⲥⲱⲟⲩⲛ	ϫⲉ|ⲉ|ⲕ|ⲥⲱⲟⲩⲛ
ϫⲉⲡⲁⲓⲣⲱⲙⲓ	ϫⲉ|ⲡⲁⲓ|ⲣⲱⲙⲓ
ϫⲟⲛⲧ	ϫⲟⲛⲧ
ⲉⲧⲉⲕⲙⲉⲧⲁⲅⲓⲟⲥ	ⲉ|ⲧⲉⲕ|ⲙⲉⲧⲁⲅⲓⲟⲥ
ⲟⲩⲫⲁⲛⲧⲁⲥⲓⲁ	ⲟⲩ|ⲫⲁⲛⲧⲁⲥⲓⲁ
ⲡⲁⲓⲟⲩⲱⲛϩ	ⲡⲁⲓ|ⲟⲩⲱⲛϩ
ⲙⲙⲉⲑⲙⲏⲓ	ⲙ|ⲙⲉⲑⲙⲏⲓ
ⲛϫⲉⲡⲓⲥⲁϫⲓ	ⲛϫⲉ|ⲡⲓ|ⲥⲁϫⲓ
ⲛⲧⲉϥⲉⲣⲡⲉⲧϩⲱⲟⲩ	ⲛⲧⲉ|ϥ|ⲉⲣⲡⲉⲧϩⲱⲟⲩ
ⲉⲧⲟⲩⲧⲱϥ	ⲉⲧ|ⲟⲩⲧⲱ|ϥ
ⲛⲉⲙⲫⲛⲟⲩϯ	ⲛⲉⲙ|ⲫ|ⲛⲟⲩϯ
ⲉⲧⲁⲓϫⲟϥ	ⲉⲧ|ⲁ|ⲓ|ϫⲟ|ϥ
ⲁⲓϫⲟϥ	ⲁ|ⲓ|ϫⲟ|ϥ
ⲙⲁⲣⲕⲟⲥ	ⲙⲁⲣⲕⲟⲥ
ⲡⲓⲉⲩⲁⲅⲅⲉⲗⲓⲥⲧⲏⲥ	ⲡⲓ|ⲉⲩⲁⲅⲅⲉⲗⲓⲥⲧⲏⲥ
ⲉⲧⲟⲩⲁϩⲥⲁϩⲛⲓ	ⲉⲧ|ⲟⲩⲁϩⲥⲁϩⲛⲓ
ⲁⲩϫⲉⲙϥ	ⲁ|ⲩ|ϫⲉⲙ|ϥ
ⲉϥⲣⲓⲙⲓ	ⲉ|ϥ|ⲣⲓⲙⲓ
ⲉⲡⲉϥϣⲏⲣⲓ	ⲉ|ⲡⲉϥ|ϣⲏⲣⲓ
ⲁⲩϫⲱ	ⲁ|ⲩ|ϫⲱ
ⲉⲧⲁⲡⲓⲁⲣⲭⲓⲉⲡⲓⲥⲕⲟⲡⲟⲥ	ⲉⲧ|ⲁ|ⲡⲓ|ⲁⲣⲭⲓⲉⲡⲓⲥⲕⲟⲡⲟⲥ
ϫⲟⲧⲟⲩ	ϫⲟⲧ|ⲟⲩ
ⲁⲣⲉϣⲁⲛⲡⲓⲧⲁⲗϭⲟ	ⲁⲣⲉϣⲁⲛ|ⲡⲓ|ⲧⲁⲗϭⲟ
ⲙⲡⲁϣⲏⲣⲓ	ⲙ|ⲡⲁ|ϣⲏⲣⲓ
ϩⲓⲧⲉⲛⲡⲓⲁⲣⲭⲓⲉⲡⲓⲥⲕⲟⲡⲟⲥ	ϩⲓⲧⲉⲛ|ⲡⲓ|ⲁⲣⲭⲓⲉⲡⲓⲥⲕⲟⲡⲟⲥ
ϯⲛⲁⲛⲁϩϯ	ϯ|ⲛⲁ|ⲛⲁϩϯ
ⲛⲉⲙⲕⲩⲣⲓⲗⲗⲟⲥ	ⲛⲉⲙ|ⲕⲩⲣⲓⲗⲗⲟⲥ
ⲛⲉⲙⲓⲅⲛⲁⲧⲓⲟⲥ	ⲛⲉⲙ|ⲓⲅⲛⲁⲧⲓⲟⲥ
ⲛⲉⲙⲥⲉⲩⲏⲣⲟⲥ	ⲛⲉⲙ|ⲥⲉⲩⲏⲣⲟⲥ
ⲛⲉⲙⲧⲉϥⲥϩⲓⲙⲓ	ⲛⲉⲙ|ⲧⲉϥ|ⲥϩⲓⲙⲓ
ϧⲁⲛⲉⲛϭⲁⲗⲁⲩϫ	ϧⲁ|ⲛⲉⲛ|ϭⲁⲗⲁⲩϫ
ϫⲉⲧⲉⲛϯϩⲟ	ϫⲉ|ⲧⲉⲛ|ϯϩⲟ
ⲛⲧⲉⲧⲉⲛϧⲱⲛϫ	ⲛⲧⲉⲧⲉⲛ|ϧⲱⲛϫ
ⲉⲡⲓⲁⲣⲭⲓⲉⲡⲓⲥⲕⲟⲡⲟⲥ	ⲉ|ⲡⲓ|ⲁⲣⲭⲓⲉⲡⲓⲥⲕⲟⲡⲟⲥ
ⲛⲧⲉϥⲧⲱⲃϩ	ⲛⲧⲉ|ϥ|ⲧⲱⲃϩ
ⲛⲧⲉϥⲟⲩϫⲁⲓ	ⲛⲧⲉ|ϥ|ⲟⲩϫⲁⲓ
ⲧⲉⲛⲛⲁϣϫⲉⲙϫⲟⲙ	ⲧⲉⲛ|ⲛⲁ|ϣϫⲉⲙϫⲟⲙ
ⲛϫⲟⲩϣⲧ	ⲛ|ϫⲟⲩϣⲧ
ⲉⲑⲃⲉⲛⲓⲡⲉⲧϩⲱⲟⲩ	ⲉⲑⲃⲉ|ⲛⲓ|ⲡⲉⲧϩⲱⲟⲩ
ⲉⲧⲁⲛⲁⲓⲧⲟⲩ	ⲉⲧ|ⲁ|ⲛ|ⲁⲓⲧ|ⲟⲩ
ⲛϫⲉⲛⲓⲉⲡⲓⲥⲕⲟⲡⲟⲥ	ⲛϫⲉ|ⲛⲓ|ⲉⲡⲓⲥⲕⲟⲡⲟⲥ
ⲁⲩⲧⲁⲙⲉ	ⲁ|ⲩ|ⲧⲁⲙⲉ
ⲉⲡⲓⲡⲁⲧⲣⲓⲁⲣⲭⲏⲥ	ⲉ|ⲡⲓ|ⲡⲁⲧⲣⲓⲁⲣⲭⲏⲥ
ⲉⲧⲁⲁⲑⲁⲛⲁⲥⲓⲟⲥ	ⲉⲧ|ⲁ|ⲁⲑⲁⲛⲁⲥⲓⲟⲥ
ⲙⲫⲙⲁ	ⲙ|ⲫ|ⲙⲁ
ⲛⲟⲩⲉⲩⲭⲏ	ⲛ|ⲟⲩ|ⲉⲩⲭⲏ
ⲁϥⲉⲣⲥⲫⲣⲁⲅⲓⲍⲉⲓⲛ	ⲁ|ϥ|ⲉⲣⲥⲫⲣⲁⲅⲓⲍⲉⲓⲛ
ϧⲉⲛⲧⲉϥϫⲓϫ	ϧⲉⲛ|ⲧⲉϥ|ϫⲓϫ
ϥⲟϫϥ	ϥⲟϫ|ϥ
ϧⲉⲛⲡⲓⲙⲁⲛⲕⲟⲧ	ϧⲉⲛ|ⲡⲓ|ⲙⲁⲛⲕⲟⲧ
ⲓⲥϫⲉⲕ	ⲓⲥϫⲉⲕ
ⲙⲡⲉϥϣⲱⲛⲓ	ⲙⲡⲉ|ϥ|ϣⲱⲛⲓ
ⲉϥⲑⲣⲟⲩⲓⲛⲓ	ⲉ|ϥ|ⲑⲣ|ⲟⲩ|ⲓⲛⲓ
ⲛⲧⲉϥⲟⲩⲱⲙ	ⲛⲧⲉ|ϥ|ⲟⲩⲱⲙ
ⲙⲡⲉϥϫⲉⲙϯⲡⲓ	ⲙⲡⲉ|ϥ|ϫⲉⲙϯⲡⲓ
ⲉⲡⲓⲧⲁⲗϭⲟ	ⲉ|ⲡⲓ|ⲧⲁⲗϭⲟ
ⲙⲡⲟⲩϣⲏⲣⲓ	ⲙ|ⲡⲟⲩ|ϣⲏⲣⲓ
ⲉϫⲉⲛⲛⲟⲩϩⲟ	ⲉϫⲉⲛ|ⲛ|ⲟⲩϩⲟ
ⲉⲩⲉⲣⲁⲓⲧⲉⲓⲛ	ⲉ|ⲩ|ⲉⲣⲁⲓⲧⲉⲓⲛ
ⲛⲟⲩⲥⲩⲛⲅⲛⲱⲙⲏ	ⲛ|ⲟⲩ|ⲥⲩⲛⲅⲛⲱⲙⲏ
ⲡⲉϫⲉⲡⲓⲁⲣⲭⲓⲉⲡⲓⲥⲕⲟⲡⲟⲥ	ⲡⲉϫⲉ|ⲡⲓ|ⲁⲣⲭⲓⲉⲡⲓⲥⲕⲟⲡⲟⲥ
ⲁⲣⲉϩ	ⲁⲣⲉϩ
ⲓⲥϫⲉⲛⲫⲟⲟⲩ	ⲓⲥϫⲉⲛ|ⲫⲟⲟⲩ
ⲙⲡⲣϯⲙⲕⲁϩ	ⲙⲡⲣ|ϯⲙⲕⲁϩ
ⲛϯⲉⲕⲕⲗⲏⲕⲓⲁ	ⲛ|ϯ|ⲉⲕⲕⲗⲏⲕⲓⲁ
ⲉϩⲣⲉⲛϯⲉⲕⲕⲗⲏⲥⲓⲁ	ⲉϩⲣⲉⲛ|ϯ|ⲉⲕⲕⲗⲏⲥⲓⲁ
ⲉϩⲣⲉⲛⲡⲭⲣⲓⲥⲧⲟⲥ	ⲉϩⲣⲉⲛ|ⲡ|ⲭⲣⲓⲥⲧⲟⲥ
ⲁⲡⲓⲁⲣⲭⲓⲉⲡⲓⲥⲕⲟⲡⲟⲥ	ⲁ|ⲡⲓ|ⲁⲣⲭⲓⲉⲡⲓⲥⲕⲟⲡⲟⲥ
ⲉⲧⲧⲁⲓⲏⲟⲩⲧ	ⲉⲧ|ⲧⲁⲓⲏⲟⲩⲧ
ⲉϥϯⲧⲁⲓⲟ	ⲉ|ϥ|ϯⲧⲁⲓⲟ
ⲛⲟⲩⲁⲅⲅⲉⲗⲟⲥ	ⲛ|ⲟⲩ|ⲁⲅⲅⲉⲗⲟⲥ
ⲛⲉⲙⲁⲑⲁⲛⲁⲥⲓⲟⲥ	ⲛⲉⲙ|ⲁⲑⲁⲛⲁⲥⲓⲟⲥ
ϧⲉⲛⲡϫⲓⲛⲑⲣⲉⲟⲩⲡⲁⲣⲟⲩⲥⲓⲁ	ϧⲉⲛⲡϫⲓⲛⲑⲣⲉ|ⲟⲩ|ⲡⲁⲣⲟⲩⲥⲓⲁ
ⲟⲩⲧⲱⲟⲩ	ⲟⲩⲧⲱ|ⲟⲩ
ⲉⲑⲃⲉⲡⲓⲉⲩⲁⲅⲅⲉⲗⲓⲟⲛ	ⲉⲑⲃⲉ|ⲡⲓ|ⲉⲩⲁⲅⲅⲉⲗⲓⲟⲛ
ⲛⲧⲉⲣⲁⲕⲟϯ	ⲛⲧⲉ|ⲣⲁⲕⲟϯ
ϫⲉⲛⲧⲉϥⲉⲣⲫⲓⲗⲟⲕⲁⲗⲉⲓⲛ	ϫⲉ|ⲛⲧⲉ|ϥ|ⲉⲣⲫⲓⲗⲟⲕⲁⲗⲉⲓⲛ
ⲉⲑⲃⲉϫⲉⲁϥⲣⲓⲕⲓ	ⲉⲑⲃⲉ|ϫⲉ|ⲁ|ϥ|ⲣⲓⲕⲓ
ⲛϩⲉⲓ	ⲛ|ϩⲉⲓ
ⲉⲑⲃⲉⲡⲁϣⲁⲓ	ⲉⲑⲃⲉ|ⲡ|ⲁϣⲁⲓ
ⲙⲡⲓⲭⲣⲟⲛⲟⲥ	ⲙ|ⲡⲓ|ⲭⲣⲟⲛⲟⲥ
ϩⲓⲧⲉⲛⲡⲓϩⲙⲟⲧ	ϩⲓⲧⲉⲛ|ⲡⲓ|ϩⲙⲟⲧ
ⲁϥⲥⲉⲗⲥⲱⲗϥ	ⲁ|ϥ|ⲥⲉⲗⲥⲱⲗ|ϥ
ⲙⲙⲉⲧⲥⲁⲓⲉ	ⲙ|ⲙⲉⲧⲥⲁⲓⲉ
ϧⲉⲛⲛⲉϥⲉϩⲟⲟⲩ	ϧⲉⲛ|ⲛⲉϥ|ⲉϩⲟⲟⲩ
ⲙⲡⲓϣⲉ	ⲙ|ⲡⲓ|ϣⲉ
ϧⲉⲛⲣⲁⲕⲟϯ	ϧⲉⲛ|ⲣⲁⲕⲟϯ
ⲉⲑⲃⲉϫⲉⲙⲡⲟⲩϣϫⲉⲙϫⲟⲙ	ⲉⲑⲃⲉ|ϫⲉ|ⲙⲡ|ⲟⲩ|ϣϫⲉⲙϫⲟⲙ
ⲛⲉⲣⲫⲁⲓ	ⲛ|ⲉⲣ|ⲫⲁⲓ
ⲛϫⲉⲛⲓⲁⲣⲭⲓⲉⲡⲓⲥⲕⲟⲡⲟⲥ	ⲛϫⲉ|ⲛⲓ|ⲁⲣⲭⲓⲉⲡⲓⲥⲕⲟⲡⲟⲥ
ⲉⲑⲃⲉⲛⲉⲛϫⲁϫⲓ	ⲉⲑⲃⲉ|ⲛⲉⲛ|ϫⲁϫⲓ
ⲙⲡⲉⲛⲛⲁϩϯ	ⲙ|ⲡⲉⲛ|ⲛⲁϩϯ
ϯ	ϯ
ⲛⲟⲩⲛⲟϩⲉⲙ	ⲛ|ⲟⲩ|ⲛⲟϩⲉⲙ
ⲛⲛⲓⲥⲁⲣⲁⲕⲏⲛⲟⲥ	ⲛ|ⲛⲓ|ⲥⲁⲣⲁⲕⲏⲛⲟⲥ
ⲛⲁϥⲧⲁⲓⲏⲟⲩⲧ	ⲛⲁ|ϥ|ⲧⲁⲓⲏⲟⲩⲧ
ϣⲁϥⲙⲟⲩϯ	ϣⲁ|ϥ|ⲙⲟⲩϯ
ⲛⲧⲟⲩϩⲉⲙⲥⲓ	ⲛⲧ|ⲟⲩ|ϩⲉⲙⲥⲓ
ⲛⲧⲟⲩⲉⲣⲥⲩⲛⲧⲩⲭⲓⲁ	ⲛⲧ|ⲟⲩ|ⲉⲣⲥⲩⲛⲧⲩⲭⲓⲁ
ⲉⲑⲃⲉϫⲉⲁⲡⲓⲟⲩⲣⲟ	ⲉⲑⲃⲉ|ϫⲉ|ⲁ|ⲡⲓ|ⲟⲩⲣⲟ
ⲉⲣⲉⲡⲉⲛⲓⲱⲧ	ⲉⲣⲉ|ⲡⲉⲛ|ⲓⲱⲧ
ⲉⲣⲥⲩⲛⲁⲝⲓⲥ	ⲉⲣⲥⲩⲛⲁⲝⲓⲥ
ⲉϥⲥⲓⲛⲓ	ⲉ|ϥ|ⲥⲓⲛⲓ
ⲛⲉⲙⲡⲉϥⲙⲏϣ	ⲛⲉⲙ|ⲡⲉϥ|ⲙⲏϣ
ⲙⲫⲣⲟ	ⲙ|ⲫ|ⲣⲟ
ⲉϥⲟϩⲓ	ⲉ|ϥ|ⲟϩⲓ
ⲉϫⲉⲛⲡⲓⲙⲁ	ⲉϫⲉⲛ|ⲡⲓ|ⲙⲁ
ⲛⲉⲣϣⲱⲟⲩϣⲓ	ⲛ|ⲉⲣϣⲱⲟⲩϣⲓ
ⲉⲣⲉⲟⲩⲭⲣⲱⲙ	ⲉⲣⲉ|ⲟⲩ|ⲭⲣⲱⲙ
ⲉⲣⲉⲟⲩⲇⲩⲛⲁⲙⲓⲥ	ⲉⲣⲉ|ⲟⲩ|ⲇⲩⲛⲁⲙⲓⲥ
ⲉⲥϯⲛⲟⲙϯ	ⲉ|ⲥ|ϯⲛⲟⲙϯ
ⲉⲡⲁⲓⲛⲓϣϯ	ⲉ|ⲡⲁⲓ|ⲛⲓϣϯ
ⲛϭⲱⲣⲡ	ⲛ|ϭⲱⲣⲡ
ⲉⲑⲃⲉϫⲉϯⲇⲩⲛⲁⲙⲓⲥ	ⲉⲑⲃⲉ|ϫⲉ|ϯ|ⲇⲩⲛⲁⲙⲓⲥ
ⲉⲧⲥⲁϫⲓ	ⲉⲧ|ⲥⲁϫⲓ
ⲉⲟⲩⲱⲣⲡ	ⲉ|ⲟⲩⲱⲣⲡ
ⲁⲡⲟⲩⲣⲟ	ⲁ|ⲡ|ⲟⲩⲣⲟ
ⲉϯⲇⲩⲛⲁⲙⲓⲥ	ⲉ|ϯ|ⲇⲩⲛⲁⲙⲓⲥ
ⲁⲟⲩϩⲟϯ	ⲁ|ⲟⲩ|ϩⲟϯ
ϧⲉⲛⲟⲩⲧⲁⲭⲏ	ϧⲉⲛ|ⲟⲩ|ⲧⲁⲭⲏ
ⲉⲑⲛⲉⲙⲁϥ	ⲉⲑ|ⲛⲉⲙⲁ|ϥ
ⲉⲡⲟⲩⲣⲟ	ⲉ|ⲡ|ⲟⲩⲣⲟ
ⲉϩⲟⲩⲛ	ⲉϩⲟⲩⲛ
ⲁϥⲉⲣ	ⲁ|ϥ|ⲉⲣ
ⲙⲡⲉϥϣϫⲉⲙϫⲱⲙ	ⲙⲡⲉ|ϥ|ϣ|ϫⲉⲙϫⲱⲙ
ϧⲉⲛⲡⲓⲉϩⲟⲟⲩ	ϧⲉⲛ|ⲡⲓ|ⲉϩⲟⲟⲩ
ⲛϫⲉⲛⲓⲭⲁⲣⲧⲟⲗⲁⲣⲓⲟⲥ	ⲛϫⲉ|ⲛⲓ|ⲭⲁⲣⲧⲟⲗⲁⲣⲓⲟⲥ
ⲁⲩϩⲱⲗ	ⲁ|ⲩ|ϩⲱⲗ
ϫⲉⲛⲧⲟⲩϫⲉⲙⲡⲉϥϣⲓⲛⲓ	ϫⲉ|ⲛⲧ|ⲟⲩ|ϫⲉⲙ|ⲡⲉϥ|ϣⲓⲛⲓ
ⲉϥϣⲱⲛⲓ	ⲉ|ϥ|ϣⲱⲛⲓ
ϯϩⲟϯ	ϯ|ϩⲟϯ
ⲉⲧⲁⲩϣⲉⲛϥ	ⲉⲧ|ⲁ|ⲩ|ϣⲉⲛ|ϥ
ⲉⲑⲃⲉⲧⲁⲓⲧⲓⲁ	ⲉⲑⲃⲉ|ⲧ|ⲁⲓⲧⲓⲁ
ⲙⲡⲓϣⲱⲛⲓ	ⲙ|ⲡⲓ|ϣⲱⲛⲓ
ⲁϥϭⲱⲣⲡ	ⲁ|ϥ|ϭⲱⲣⲡ
ⲉⲧⲁⲛⲉϥⲃⲁⲗ	ⲉⲧ|ⲁ|ⲛⲉϥ|ⲃⲁⲗ
ϫⲉⲙⲡⲓⲛⲁⲩ	ϫⲉ|ⲙ|ⲡⲓ|ⲛⲁⲩ
ⲉⲧⲉⲕⲟϩⲓ	ⲉⲧⲉ|ⲕ|ⲟϩⲓ
ⲉⲣⲁⲧⲕ	ⲉⲣⲁⲧ|ⲕ
ϩⲓϫⲉⲛⲡⲓⲙⲁ	ϩⲓϫⲉⲛ|ⲡⲓ|ⲙⲁ
ⲁⲕⲥⲁϫⲓ	ⲁ|ⲕ|ⲥⲁϫⲓ
ⲛⲉⲙⲛⲓⲙ	ⲛⲉⲙ|ⲛⲓⲙ
ⲉⲧⲁⲓⲛⲁⲩ	ⲉⲧ|ⲁ|ⲓ|ⲛⲁⲩ
ⲉⲥⲕⲏⲧⲕ	ⲉⲥⲕⲏⲧ|ⲕ
ⲛⲭⲣⲱⲙ	ⲛ|ⲭⲣⲱⲙ
ϫⲉⲉⲓⲥⲁϫⲓ	ϫⲉ|ⲉ|ⲓ|ⲥⲁϫⲓ
ⲛⲉⲙⲡⲁⲛⲟⲩϯ	ⲛⲉⲙ|ⲡⲁ|ⲛⲟⲩϯ
ⲛⲁⲣⲉⲡⲓⲁⲣⲭⲓⲉⲡⲓⲥⲕⲟⲡⲟⲥ	ⲛⲁⲣⲉ|ⲡⲓ|ⲁⲣⲭⲓⲉⲡⲓⲥⲕⲟⲡⲟⲥ
ⲉϯϫⲟⲙ	ⲉ|ϯ|ϫⲟⲙ
ⲉⲣⲁⲧⲥ	ⲉⲣⲁⲧ|ⲥ
ⲉϣⲁϥⲁⲗⲏⲓ	ⲉ|ϣⲁ|ϥ|ⲁⲗⲏⲓ
ⲙⲡⲁⲓⲕⲉⲥⲟⲡ	ⲙ|ⲡⲁⲓ|ⲕⲉ|ⲥⲟⲡ
ϫⲉⲥⲟⲡ	ϫⲉ|ⲥⲟⲡ
ⲉⲧⲉⲭⲛⲁϩⲱⲗ	ⲉⲧⲉ|ⲭ|ⲛⲁ|ϩⲱⲗ
ⲭⲛⲁⲩ	ⲭ|ⲛⲁⲩ
ⲉⲡⲉⲕⲛⲟⲩϯ	ⲉ|ⲡⲉⲕ|ⲛⲟⲩϯ
ϫⲉⲡⲉⲧⲉⲛⲛⲁϩϯ	ϫⲉ|ⲡⲉⲧⲉⲛ|ⲛⲁϩϯ
ⲛⲧⲱⲧⲉⲛ	ⲛⲧⲱ|ⲧⲉⲛ
ⲛⲓⲭⲣⲏⲥⲧⲓⲁⲛⲟⲥ	ⲛⲓ|ⲭⲣⲏⲥⲧⲓⲁⲛⲟⲥ
ⲉⲧϧⲁϫⲱⲕ	ⲉⲧ|ϧⲁϫⲱ|ⲕ
ϫⲉⲁⲓⲉⲙⲓ	ϫⲉ|ⲁ|ⲓ|ⲉⲙⲓ
ⲉⲕϭⲟⲥⲓ	ⲉ|ⲕ|ϭⲟⲥⲓ
ⲛⲟⲩⲣⲱⲙⲓ	ⲛ|ⲟⲩ|ⲣⲱⲙⲓ
ⲙⲡⲣⲟⲫⲏⲧⲏⲥ	ⲙ|ⲡⲣⲟⲫⲏⲧⲏⲥ
ϧⲁⲧⲉⲛⲡⲟⲩⲣⲟ	ϧⲁⲧⲉⲛ|ⲡ|ⲟⲩⲣⲟ
ⲉϥⲙⲟⲩϯ	ⲉ|ϥ|ⲙⲟⲩϯ
ϫⲉⲡⲁⲧⲣⲓⲁⲣⲭⲏⲥ	ϫⲉ|ⲡⲁⲧⲣⲓⲁⲣⲭⲏⲥ
ⲛⲁϥⲱⲗⲓ	ⲛⲁ|ϥ|ⲱⲗⲓ
ⲉⲙⲱⲓⲧ	ⲉ|ⲙⲱⲓⲧ
ⲛⲁⲣⲉⲫⲏ	ⲛⲁⲣⲉ|ⲫⲏ
ⲛⲉⲙⲕⲁϩ	ⲛ|ⲉⲙⲕⲁϩ
ϩⲏⲧ	ϩⲏⲧ
ⲉⲑⲃⲉϫⲉⲛⲁϥⲭⲱ	ⲉⲑⲃⲉ|ϫⲉ|ⲛⲁ|ϥ|ⲭⲱ
ⲉⲥⲉⲙⲛⲓ	ⲉ|ⲥⲉⲙⲛⲓ
ϧⲉⲛⲡⲉϥⲉⲡⲓⲥⲕⲟⲡⲉⲓⲟⲛ	ϧⲉⲛ|ⲡⲉϥ|ⲉⲡⲓⲥⲕⲟⲡⲉⲓⲟⲛ
ϫⲉⲛⲁϥⲙⲉ	ϫⲉ|ⲛⲁ|ϥ|ⲙⲉ
ⲛⲟⲩⲉϩⲟⲟⲩ	ⲛ|ⲟⲩ|ⲉϩⲟⲟⲩ
ⲉⲣⲉⲡⲟⲩⲣⲟ	ⲉⲣⲉ|ⲡ|ⲟⲩⲣⲟ
ϧⲉⲛⲁⲗⲃⲁⲛ	ϧⲉⲛ|ⲁⲗⲃⲁⲛ
ϯⲃⲁⲕⲓ	ϯ|ⲃⲁⲕⲓ
ⲉⲧⲁϥⲕⲟⲧⲥ	ⲉⲧ|ⲁ|ϥ|ⲕⲟⲧ|ⲥ
ⲛⲧⲉⲧⲉϥⲙⲉⲧⲟⲩⲣⲟ	ⲛⲧⲉ|ⲧⲉϥ|ⲙⲉⲧⲟⲩⲣⲟ
ⲙⲡⲉϥⲭⲁⲣⲱⲙⲓ	ⲙⲡⲉ|ϥ|ⲭⲁ|ⲣⲱⲙⲓ
ⲉⲑⲙⲏⲛ	ⲉⲑ|ⲙⲏⲛ
ⲛⲛⲉϥⲕⲟⲓⲧⲱⲛ	ⲛ|ⲛⲉϥ|ⲕⲟⲓⲧⲱⲛ
ϣⲉ	ϣⲉ
ⲉⲡⲉϥⲙⲱⲓⲧ	ⲉ|ⲡⲉϥ|ⲙⲱⲓⲧ
ⲁⲧⲥϩⲓⲙⲓ	ⲁ|ⲧ|ⲥϩⲓⲙⲓ
ⲉϩⲁⲛⲛⲓϣϯ	ⲉ|ϩⲁⲛ|ⲛⲓϣϯ
ⲛⲑⲱⲟⲩⲧⲥ	ⲛ|ⲑⲱⲟⲩⲧⲥ
ⲉⲩⲭⲏ	ⲉ|ⲩ|ⲭⲏ
ϧⲉⲛⲡⲓⲕⲟⲓⲧⲱⲛ	ϧⲉⲛ|ⲡⲓ|ⲕⲟⲓⲧⲱⲛ
ⲛⲁⲣⲭⲓⲉⲡⲓⲥⲕⲟⲡⲟⲥ	ⲛ|ⲁⲣⲭⲓⲉⲡⲓⲥⲕⲟⲡⲟⲥ
ⲁⲥⲛⲁⲩ	ⲁ|ⲥ|ⲛⲁⲩ
ⲛϩⲁⲛⲗⲁⲙⲡⲁⲥ	ⲛ|ϩⲁⲛ|ⲗⲁⲙⲡⲁⲥ
ⲉⲩⲙⲟϩ	ⲉ|ⲩ|ⲙⲟϩ
ⲉⲣⲉϩⲁⲛϩⲉⲃⲥⲱ	ⲉⲣⲉ|ϩⲁⲛ|ϩⲉⲃⲥⲱ
ϩⲓⲱⲧⲟⲩ	ϩⲓⲱⲧ|ⲟⲩ
ⲉⲩϩⲱⲥ	ⲉ|ⲩ|ϩⲱⲥ
ⲕⲁⲧⲁⲡⲓⲉⲑⲟⲥ	ⲕⲁⲧⲁ|ⲡⲓ|ⲉⲑⲟⲥ
ⲛⲛⲓⲭⲣⲓⲥⲧⲓⲁⲛⲟⲥ	ⲛ|ⲛⲓ|ⲭⲣⲓⲥⲧⲓⲁⲛⲟⲥ
ⲁⲥⲧⲁⲙⲉⲡⲟⲩⲣⲟ	ⲁ|ⲥ|ⲧⲁⲙⲉ|ⲡ|ⲟⲩⲣⲟ
ϫⲉϣⲁⲧⲉⲛⲕⲉⲕⲟⲩϫⲓ	ϫⲉ|ϣⲁⲧⲉ|ⲛ|ⲕⲉ|ⲕⲟⲩϫⲓ
ⲉⲣⲉⲡⲁⲡⲛⲉⲩⲙⲁ	ⲉⲣⲉ|ⲡⲁ|ⲡⲛⲉⲩⲙⲁ
ϩⲓⲧⲉⲙϯϩⲟϯ	ϩⲓⲧⲉⲙ|ϯ|ϩⲟϯ
ⲉⲧⲁⲓⲥⲟⲑⲙⲟⲩ	ⲉⲧ|ⲁ|ⲓ|ⲥⲟⲑⲙ|ⲟⲩ
ⲛⲧⲱⲙⲧ	ⲛ|ⲧⲱⲙⲧ
ⲁⲓⲟⲗϥ	ⲁ|ⲓ|ⲟⲗ|ϥ
ⲉⲡⲓⲕⲟⲓⲧⲱⲛ	ⲉ|ⲡⲓ|ⲕⲟⲓⲧⲱⲛ
ϫⲉⲛⲧⲉϥⲧⲱⲃϩ	ϫⲉ|ⲛⲧⲉ|ϥ|ⲧⲱⲃϩ
ⲛⲉⲙⲛⲉⲛϣⲏⲣⲓ	ⲛⲉⲙ|ⲛⲉⲛ|ϣⲏⲣⲓ
ⲁⲥⲉⲣⲁⲛⲁϣ	ⲁ|ⲥ|ⲉⲣⲁⲛⲁϣ
ϫⲉⲁⲓⲛⲁⲩ	ϫⲉ|ⲁ|ⲓ|ⲛⲁⲩ
ⲙⲙⲏϣ	ⲙ|ⲙⲏϣ
ⲉϥⲑⲟⲩⲏⲧ	ⲉ|ϥ|ⲑⲟⲩⲏⲧ
ⲉⲡⲁⲓϧⲉⲗⲗⲟ	ⲉ|ⲡⲁⲓ|ϧⲉⲗⲗⲟ
ⲉⲩⲥⲁϫⲓ	ⲉ|ⲩ|ⲥⲁϫⲓ
ϧⲉⲛⲧⲟⲩϫⲓⲛϣⲗⲏⲗ	ϧⲉⲛ|ⲧⲟⲩ|ϫⲓⲛϣⲗⲏⲗ
ⲉⲡⲟⲩⲛⲟⲩϯ	ⲉ|ⲡⲟⲩ|ⲛⲟⲩϯ
ⲉⲡⲉϥⲣⲁⲥϯ	ⲉ|ⲡⲉϥ|ⲣⲁⲥϯ
ⲉϥϯⲱⲟⲩ	ⲉ|ϥ|ϯⲱⲟⲩ
ⲕⲱⲧ	ⲕⲱⲧ
ⲛϩⲁⲛⲉⲕⲕⲗⲏⲥⲓⲁ	ⲛ|ϩⲁⲛ|ⲉⲕⲕⲗⲏⲥⲓⲁ
ⲛⲉⲙϩⲁⲛⲙⲟⲛⲁⲥⲧⲏⲣⲓⲟⲛ	ⲛⲉⲙ|ϩⲁⲛ|ⲙⲟⲛⲁⲥⲧⲏⲣⲓⲟⲛ
ⲙⲡⲓⲕⲱϯ	ⲙ|ⲡⲓ|ⲕⲱϯ
ⲛⲧⲉϥⲡⲟⲗⲓⲥ	ⲛ|ⲧⲉϥ|ⲡⲟⲗⲓⲥ
ⲉϥⲉⲣⲁⲅⲁⲡⲁⲛ	ⲉ|ϥ|ⲉⲣⲁⲅⲁⲡⲁⲛ
ⲉϥⲧⲁⲓⲏⲟⲩⲧ	ⲉ|ϥ|ⲧⲁⲓⲏⲟⲩⲧ
ϧⲉⲛⲧⲭⲱⲣⲁ	ϧⲉⲛ|ⲧ|ⲭⲱⲣⲁ
ⲛⲉⲟⲩⲭⲣⲓⲥⲧⲓⲁⲛⲟⲥ	ⲛⲉ|ⲟⲩ|ⲭⲣⲓⲥⲧⲓⲁⲛⲟⲥ
ϧⲉⲛⲡⲉϥϣⲉⲙϣⲓ	ϧⲉⲛ|ⲡⲉϥ|ϣⲉⲙϣⲓ
ⲛⲉⲟⲩⲛⲧⲁϥ	ⲛⲉ|ⲟⲩⲛⲧⲁ|ϥ
ⲡⲓⲭⲉⲧ	ⲡⲓ|ⲭⲉⲧ
ⲁϥⲡⲱⲧ	ⲁ|ϥ|ⲡⲱⲧ
ⲉⲭⲏⲙⲓ	ⲉ|ⲭⲏⲙⲓ
ⲉϫⲱⲗ	ⲉ|ϫⲱⲗ
ϧⲉⲛⲧⲉϥⲭⲱⲣⲁ	ϧⲉⲛ|ⲧⲉϥ|ⲭⲱⲣⲁ
ⲉⲑⲃⲉⲧϩⲟϯ	ⲉⲑⲃⲉ|ⲧ|ϩⲟϯ
ϫⲉⲟⲩⲭⲣⲓⲥⲧⲓⲁⲛⲟⲥ	ϫⲉ|ⲟⲩ|ⲭⲣⲓⲥⲧⲓⲁⲛⲟⲥ
ⲉϥϫⲏⲕ	ⲉ|ϥ|ϫⲏⲕ
ⲉⲧⲁⲡⲉϥⲓⲱⲧ	ⲉⲧ|ⲁ|ⲡⲉϥ|ⲓⲱⲧ
ⲛⲧⲉϥⲧⲁϩⲟϥ	ⲛⲧⲉ|ϥ|ⲧⲁϩⲟ|ϥ
ⲁϥϫⲉⲙϥ	ⲁ|ϥ|ϫⲉⲙ|ϥ
ⲉⲧⲁϥϫⲱⲗ	ⲉⲧ|ⲁ|ϥ|ϫⲱⲗ
ⲙⲡⲉϥⲛⲁϩϯ	ⲙ|ⲡⲉϥ|ⲛⲁϩϯ
ⲁϥⲥⲱⲧⲡ	ⲁ|ϥ|ⲥⲱⲧⲡ
ⲛϯⲧⲟⲓ	ⲛ|ϯ|ⲧⲟⲓ
ⲛⲧⲉⲓⲟⲩⲇⲁⲥ	ⲛⲧⲉ|ⲓⲟⲩⲇⲁⲥ
ⲉϩⲟⲧⲉⲡⲭⲣⲓⲥⲧⲟⲥ	ⲉϩⲟⲧⲉ|ⲡ|ⲭⲣⲓⲥⲧⲟⲥ
ⲁⲡⲓⲣⲱⲙⲓ	ⲁ|ⲡⲓ|ⲣⲱⲙⲓ
ⲓⲛⲓ	ⲓⲛⲓ
ⲙⲡⲓⲕⲟⲩϫⲓ	ⲙ|ⲡⲓ|ⲕⲟⲩϫⲓ
ⲉⲧⲉⲟⲩⲡⲛⲉⲩⲙⲁ	ⲉⲧⲉ|ⲟⲩ|ⲡⲛⲉⲩⲙⲁ
ⲛⲧⲉⲛⲓⲉⲡⲓⲥⲕⲟⲡⲟⲥ	ⲛⲧⲉ|ⲛⲓ|ⲉⲡⲓⲥⲕⲟⲡⲟⲥ
ϣⲗⲏⲗ	ϣⲗⲏⲗ
ⲉⲑⲃⲉϫⲉⲁϥⲥⲱⲧⲉⲙ	ⲉⲑⲃⲉ|ϫⲉ|ⲁ|ϥ|ⲥⲱⲧⲉⲙ
ϫⲉϩⲁⲛϩⲁⲅⲓⲟⲥ	ϫⲉ|ϩⲁⲛ|ϩⲁⲅⲓⲟⲥ
ⲁϥϣⲟⲡϥ	ⲁ|ϥ|ϣⲟⲡ|ϥ
ⲛϫⲉⲁⲃⲇⲉⲗⲁⲍⲓⲍ	ⲛϫⲉ|ⲁⲃⲇⲉⲗⲁⲍⲓⲍ
ⲉⲑⲃⲉϫⲉⲛⲉⲟⲩⲥⲩⲅⲅⲉⲛⲏⲥ	ⲉⲑⲃⲉ|ϫⲉ|ⲛⲉ|ⲟⲩ|ⲥⲩⲅⲅⲉⲛⲏⲥ
ⲉⲧⲁϥϣⲉⲛϥ	ⲉⲧ|ⲁ|ϥ|ϣⲉⲛ|ϥ
ⲉⲑⲃⲉⲡⲓϫⲓⲛⲓ	ⲉⲑⲃⲉ|ⲡⲓ|ϫⲓⲛⲓ
ⲉⲑⲃⲉϩⲱⲃ	ⲉⲑⲃⲉ|ϩⲱⲃ
ⲉⲑⲃⲏⲧⲟⲩ	ⲉⲑⲃⲏⲧ|ⲟⲩ
ⲛⲉⲣⲟⲩⲟⲧ	ⲛ|ⲉⲣⲟⲩⲟⲧ
ⲛⲉⲙⲟⲩⲛⲓϣϯ	ⲛⲉⲙ|ⲟⲩ|ⲛⲓϣϯ
ⲛⲧⲓⲙⲏ	ⲛ|ⲧⲓⲙⲏ
ⲛϫⲉⲡⲓⲣⲱⲙⲓ	ⲛϫⲉ|ⲡⲓ|ⲣⲱⲙⲓ
ϫⲉⲙⲡⲉⲡⲉϥϣⲏⲣⲓ	ϫⲉ|ⲙⲡⲉ|ⲡⲉϥ|ϣⲏⲣⲓ
ⲛⲧⲉϥⲧⲁⲥⲑⲟϥ	ⲛⲧⲉ|ϥ|ⲧⲁⲥⲑⲟ|ϥ
ϧⲉⲛⲟⲩⲙⲕⲁϩ	ϧⲉⲛ|ⲟⲩ|ⲙⲕⲁϩ
ϫⲉⲡⲉⲕⲥⲛⲟϥ	ϫⲉ|ⲡⲉⲕ|ⲥⲛⲟϥ
ⲉϫⲱⲕ	ⲉϫⲱ|ⲕ
ⲓⲥϫⲉⲛϯⲛⲟⲩ	ⲓⲥϫⲉⲛ|ϯⲛⲟⲩ
ⲕⲟⲓ	ⲕ|ⲟⲓ
ⲛϣⲉⲙⲙⲟ	ⲛ|ϣⲉⲙⲙⲟ
ϧⲉⲛⲡⲁⲓⲁⲓⲱⲛ	ϧⲉⲛ|ⲡⲁⲓ|ⲁⲓⲱⲛ
ⲉⲧⲁϥϣⲓⲛⲓ	ⲉⲧ|ⲁ|ϥ|ϣⲓⲛⲓ
ⲛⲥⲁⲟⲩⲉⲡⲓⲥⲕⲟⲡⲟⲥ	ⲛⲥⲁ|ⲟⲩ|ⲉⲡⲓⲥⲕⲟⲡⲟⲥ
ⲉⲑⲣⲉϥϣⲗⲏⲗ	ⲉ|ⲑⲣⲉ|ϥ|ϣⲗⲏⲗ
ⲁϥⲣⲁⲃⲏⲟⲩⲧ	ⲁ|ϥ|ⲣⲁⲃⲏⲟⲩⲧ
ⲛϫⲉⲟⲩⲯⲉⲩⲇⲟⲉⲡⲓⲥⲏⲟⲡⲟⲥ	ⲛϫⲉ|ⲟⲩ|ⲯⲉⲩⲇⲟⲉⲡⲓⲥⲏⲟⲡⲟⲥ
ⲉⲧⲉⲟⲩⲉⲃⲟⲗ	ⲉⲧⲉ|ⲟⲩ|ⲉⲃⲟⲗ
ϧⲉⲛⲛⲓϩⲁⲓⲣⲉⲥⲓⲥ	ϧⲉⲛ|ⲛⲓ|ϩⲁⲓⲣⲉⲥⲓⲥ
ⲛⲧⲉⲛⲓⲁⲧⲁⲫⲉ	ⲛⲧⲉ|ⲛⲓ|ⲁⲧⲁⲫⲉ
ⲉⲧⲁⲩⲧⲁⲙⲟϥ	ⲉⲧ|ⲁ|ⲩ|ⲧⲁⲙⲟ|ϥ
ϫⲉⲟⲩⲉⲡⲓⲥⲕⲟⲡⲟⲥ	ϫⲉ|ⲟⲩ|ⲉⲡⲓⲥⲕⲟⲡⲟⲥ
ⲙⲡⲉϥⲉⲙⲓ	ⲙⲡⲉ|ϥ|ⲉⲙⲓ
ϫⲉⲟⲩϩⲁⲓⲣⲉⲧⲓⲕⲟⲥ	ϫⲉ|ⲟⲩ|ϩⲁⲓⲣⲉⲧⲓⲕⲟⲥ
ⲁϥⲉⲛⲡⲉϥϣⲏⲣⲓ	ⲁ|ϥ|ⲉⲛ|ⲡⲉϥ|ϣⲏⲣⲓ
ϫⲉⲛⲧⲉϥϣⲗⲏⲗ	ϫⲉ|ⲛⲧⲉ|ϥ|ϣⲗⲏⲗ
ⲉⲧⲁϥⲉⲣⲫⲁⲓ	ⲉⲧ|ⲁ|ϥ|ⲉⲣ|ⲫⲁⲓ
ⲛϫⲉⲡⲓⲁⲥⲉⲃⲏⲥ	ⲛϫⲉ|ⲡⲓ|ⲁⲥⲉⲃⲏⲥ
ⲙⲡⲉϥϫⲉⲙϫⲟⲙ	ⲙⲡⲉ|ϥ|ϫⲉⲙϫⲟⲙ
ⲛⲧⲁⲗϭⲟϥ	ⲛ|ⲧⲁⲗϭⲟ|ϥ
ⲛⲁⲣⲉⲡⲓⲡⲛⲉⲩⲙⲁ	ⲛⲁⲣⲉ|ⲡⲓ|ⲡⲛⲉⲩⲙⲁ
ϯϧⲓⲥⲓ	ϯϧⲓⲥⲓ
ⲉϥⲭⲱ	ⲉ|ϥ|ⲭⲱ
ⲉⲉⲙⲧⲟⲛ	ⲉ|ⲉⲙⲧⲟⲛ
ⲛⲁϥⲟⲓ	ⲛⲁ|ϥ|ⲟⲓ
ⲧⲁⲙⲟϥ	ⲧⲁⲙⲟ|ϥ
ϫⲉⲫⲁⲛⲓⲟⲩⲃⲉⲣϣⲉⲛⲟⲩϥⲓ	ϫⲉ|ⲫⲁ|ⲛⲓⲟⲩⲃⲉⲣϣⲉⲛⲟⲩϥⲓ
ⲟⲩⲱⲣⲡ	ⲟⲩⲱⲣⲡ
ⲉⲓⲛⲓ	ⲉ|ⲓⲛⲓ
ⲉⲑⲃⲉⲡⲓⲁⲗⲟⲩ	ⲉⲑⲃⲉ|ⲡⲓ|ⲁⲗⲟⲩ
ⲛⲉⲙⲡⲓⲣⲏϯ	ⲛⲉⲙ|ⲡⲓ|ⲣⲏϯ
ⲉⲧⲉⲡⲉϥⲓⲱⲧ	ⲉⲧⲉ|ⲡⲉϥ|ⲓⲱⲧ
ⲁϥϣⲗⲏⲗ	ⲁ|ϥ|ϣⲗⲏⲗ
ⲁϥⲑⲁϩⲥⲡⲓⲁⲗⲟⲩ	ⲁ|ϥ|ⲑⲁϩⲥ|ⲡⲓ|ⲁⲗⲟⲩ
ϫⲉϧⲉⲛⲫⲣⲁⲛ	ϫⲉ|ϧⲉⲛ|ⲫ|ⲣⲁⲛ
ⲉⲕⲉⲉⲣϩⲙⲟⲧ	ⲉⲕⲉ|ⲉⲣϩⲙⲟⲧ
ⲙⲡⲉⲕⲃⲱⲕ	ⲙ|ⲡⲉⲕ|ⲃⲱⲕ
ⲙⲡⲥⲙⲟⲧ	ⲙ|ⲡ|ⲥⲙⲟⲧ
ⲛⲟⲩϣⲁϩ	ⲛ|ⲟⲩ|ϣⲁϩ
ⲁϥϩⲓⲧϥ	ⲁ|ϥ|ϩⲓⲧ|ϥ
ⲛϩⲁⲛⲥⲑⲟⲓⲛⲟⲩϥⲓ	ⲛ|ϩⲁⲛ|ⲥⲑⲟⲓⲛⲟⲩϥⲓ
ⲉⲩⲥⲱⲧⲡ	ⲉ|ⲩ|ⲥⲱⲧⲡ
ⲉⲧⲁϥⲉⲛⲟⲩ	ⲉⲧ|ⲁ|ϥ|ⲉⲛ|ⲟⲩ
ⲡⲓⲡⲁⲧⲣⲓⲁⲣⲭⲏⲥ	ⲡⲓ|ⲡⲁⲧⲣⲓⲁⲣⲭⲏⲥ
ⲁϥϫⲱ	ⲁ|ϥ|ϫⲱ
ⲛϩⲁⲛⲛⲓϣϯ	ⲛ|ϩⲁⲛ|ⲛⲓϣϯ
ⲉⲡⲧⲁϫⲣⲟ	ⲉ|ⲡ|ⲧⲁϫⲣⲟ
ⲛⲉⲙⲡⲟⲩϫⲁⲓ	ⲛⲉⲙ|ⲡ|ⲟⲩϫⲁⲓ
ϯϩⲟ	ϯϩⲟ
ⲉⲑⲣⲉϥⲥϧⲏⲧⲡⲓⲉⲩⲁⲅⲅⲉⲗⲓⲟⲛ	ⲉ|ⲑⲣⲉ|ϥ|ⲥϧⲏⲧ|ⲡⲓ|ⲉⲩⲁⲅⲅⲉⲗⲓⲟⲛ
ⲕⲁⲧⲁⲓⲱⲁⲛⲛⲏⲥ	ⲕⲁⲧⲁ|ⲓⲱⲁⲛⲛⲏⲥ
ⲉϫⲉⲛϩⲁⲛⲱⲓⲕ	ⲉϫⲉⲛ|ϩⲁⲛ|ⲱⲓⲕ
ⲛⲉⲩⲗⲟⲅⲓⲁ	ⲛ|ⲉⲩⲗⲟⲅⲓⲁ
ⲉϥⲉⲣⲁⲓⲧⲉⲓⲛ	ⲉ|ϥ|ⲉⲣⲁⲓⲧⲉⲓⲛ
ⲛⲟⲩⲥⲙⲟⲩ	ⲛ|ⲟⲩ|ⲥⲙⲟⲩ
ⲛⲛⲁϣϯ	ⲛ|ⲛⲁϣϯ
ⲛⲛⲉϥⲉϩⲟⲟⲩ	ⲛ|ⲛⲉϥ|ⲉϩⲟⲟⲩ
ⲛϫⲉⲡⲉⲛⲥⲱⲧⲏⲣ	ⲛϫⲉ|ⲡⲉⲛ|ⲥⲱⲧⲏⲣ
ⲛⲁⲅⲁⲑⲟⲥ	ⲛ|ⲁⲅⲁⲑⲟⲥ
ⲉⲑⲙⲉⲓ	ⲉⲑ|ⲙⲉⲓ
ⲉϥⲉⲙⲉⲛⲣⲓⲧϥ	ⲉϥⲉ|ⲙⲉⲛⲣⲓⲧ|ϥ
ⲛϫⲉⲡⲁⲓⲱⲧ	ⲛϫⲉ|ⲡⲁ|ⲓⲱⲧ
ⲉⲁϩⲁⲛⲟⲩⲟⲛ	ⲉ|ⲁ|ϩⲁⲛ|ⲟⲩⲟⲛ
ϧⲉⲛⲛⲓⲥⲁⲣⲁⲕⲏⲛⲟⲥ	ϧⲉⲛ|ⲛⲓ|ⲥⲁⲣⲁⲕⲏⲛⲟⲥ
ⲉⲑⲙⲟⲥϯ	ⲉⲑ|ⲙⲟⲥϯ
ϣⲁⲡⲟⲩⲣⲟ	ϣⲁ|ⲡ|ⲟⲩⲣⲟ
ⲁⲩϯϣⲑⲟⲩⲓⲧ	ⲁ|ⲩ|ϯϣⲑⲟⲩⲓⲧ
ϧⲁⲡⲓⲁⲣⲭⲓⲉⲡⲓⲥⲕⲟⲡⲟⲥ	ϧⲁ|ⲡⲓ|ⲁⲣⲭⲓⲉⲡⲓⲥⲕⲟⲡⲟⲥ
ⲕϯⲧⲁⲓⲟ	ⲕ|ϯⲧⲁⲓⲟ
ⲕϣⲱⲡ	ⲕ|ϣⲱⲡ
ϥϭⲓⲃⲟϯ	ϥ|ϭⲓⲃⲟϯ
ⲛⲉⲙⲡⲉⲛⲛⲁϩϯ	ⲛⲉⲙ|ⲡⲉⲛ|ⲛⲁϩϯ
ⲉⲓⲉⲣⲁⲅⲁⲡⲁⲛ	ⲉ|ⲓ|ⲉⲣⲁⲅⲁⲡⲁⲛ
ⲉⲡⲉϥϩⲱⲃ	ⲉ|ⲡⲉϥ|ϩⲱⲃ
ϥϭⲛⲟⲛ	ϥ|ϭⲛⲟⲛ
ϩⲁⲛⲙⲉⲑⲛⲟⲩϫ	ϩⲁⲛ|ⲙⲉⲑⲛⲟⲩϫ
ⲭⲟⲩⲱϣ	ⲭ|ⲟⲩⲱϣ
ϫⲉϥⲙⲟⲥϯ	ϫⲉ|ϥ|ⲙⲟⲥϯ
ⲉⲧⲉⲛϫⲱ	ⲉⲧⲉ|ⲛ|ϫⲱ
ϩⲁⲛⲙⲉⲑⲙⲏⲓ	ϩⲁⲛ|ⲙⲉⲑⲙⲏⲓ
ⲭⲛⲁⲑⲣⲉϥⲟⲩⲱⲙ	ⲭ|ⲛⲁ|ⲑⲣⲉ|ϥ|ⲟⲩⲱⲙ
ⲛⲉⲙⲡⲓⲟⲩⲱⲙ	ⲛⲉⲙ|ⲡⲓ|ⲟⲩⲱⲙ
ⲁϥϣⲧⲉⲙⲉⲣⲫⲁⲓ	ⲁ|ϥ|ϣⲧⲉⲙ|ⲉⲣ|ⲫⲁⲓ
ⲁⲣⲓⲉⲙⲓ	ⲁⲣⲓ|ⲉⲙⲓ
ⲉⲧⲁⲛϫⲟⲧⲟⲩ	ⲉⲧ|ⲁ|ⲛ|ϫⲟⲧ|ⲟⲩ
ϯⲛⲁⲑⲉⲧⲡⲉⲧⲉⲛϩⲏⲧ	ϯ|ⲛⲁ|ⲑⲉⲧ|ⲡⲉⲧⲉⲛ|ϩⲏⲧ
ϧⲉⲛⲡⲁⲓϩⲱⲃ	ϧⲉⲛ|ⲡⲁⲓ|ϩⲱⲃ
ⲉⲛⲓⲭⲁⲣⲧⲟⲗⲁⲣⲓⲥ	ⲉ|ⲛⲓ|ⲭⲁⲣⲧⲟⲗⲁⲣⲓⲥ
ϫⲉⲉⲓⲟⲩⲱϣ	ϫⲉ|ⲉ|ⲓ|ⲟⲩⲱϣ
ⲛⲧⲉⲡⲓⲡⲁⲧⲣⲓⲁⲣⲭⲏⲥ	ⲛⲧⲉ|ⲡⲓ|ⲡⲁⲧⲣⲓⲁⲣⲭⲏⲥ
ⲑⲉⲧⲡⲁϩⲏⲧ	ⲑⲉⲧ|ⲡⲁ|ϩⲏⲧ
ⲛⲧⲉϥϣⲧⲉⲙϩⲓⲥⲧⲁⲩⲣⲟⲥ	ⲛⲧⲉ|ϥ|ϣⲧⲉⲙ|ϩⲓⲥⲧⲁⲩⲣⲟⲥ
ⲛϫⲉⲡⲓⲃ	ⲛϫⲉ|ⲡⲓ|ⲃ
ϧⲁⲛⲓⲭⲣⲓⲥⲧⲓⲁⲛⲟⲥ	ϧⲁ|ⲛⲓ|ⲭⲣⲓⲥⲧⲓⲁⲛⲟⲥ
ϣⲁⲧⲉⲛϩⲓⲡⲓⲥⲧⲁⲩⲣⲟⲥ	ϣⲁⲧⲉ|ⲛ|ϩⲓⲡⲓⲥⲧⲁⲩⲣⲟⲥ
ⲭⲛⲁⲭⲁⲡⲓⲁⲣⲭⲓⲉⲡⲓⲥⲕⲟⲡⲟⲥ	ⲭ|ⲛⲁ|ⲭⲁ|ⲡⲓ|ⲁⲣⲭⲓⲉⲡⲓⲥⲕⲟⲡⲟⲥ
ⲛⲧⲉϥϩⲓⲥⲧⲁⲩⲣⲟⲥ	ⲛⲧⲉ|ϥ|ϩⲓⲥⲧⲁⲩⲣⲟⲥ
ⲉⲡⲓⲟⲩⲱⲙ	ⲉ|ⲡⲓ|ⲟⲩⲱⲙ
ϥⲛⲁⲟⲩⲱⲙ	ϥ|ⲛⲁ|ⲟⲩⲱⲙ
ϥⲛⲁⲑⲉⲧⲡⲉⲕϩⲏⲧ	ϥ|ⲛⲁ|ⲑⲉⲧ|ⲡⲉⲕ|ϩⲏⲧ
ⲭⲛⲁⲭⲁϥ	ⲭ|ⲛⲁ|ⲭⲁ|ϥ
ϫⲉⲓⲉ	ϫⲉ|ⲓⲉ
ⲧⲉⲛⲙⲉⲩⲓ	ⲧⲉⲛ|ⲙⲉⲩⲓ
ϧⲉⲛⲟⲩϫⲱⲛⲧ	ϧⲉⲛ|ⲟⲩ|ϫⲱⲛⲧ
ϯⲛⲁⲑⲣⲉϥⲟⲩⲱⲙ	ϯ|ⲛⲁ|ⲑⲣⲉ|ϥ|ⲟⲩⲱⲙ
ϯⲛⲁⲭⲁϥ	ϯ|ⲛⲁ|ⲭⲁ|ϥ
ⲉϩⲓⲥⲧⲁⲩⲣⲟⲥ	ⲉ|ϩⲓⲥⲧⲁⲩⲣⲟⲥ
ⲁϥϣⲁⲛⲉⲣⲫⲁⲓ	ⲁϥϣⲁⲛ|ⲉⲣ|ⲫⲁⲓ
ϯⲛⲁϧⲱⲧⲉⲃ	ϯ|ⲛⲁ|ϧⲱⲧⲉⲃ
ⲛⲉⲣⲟⲩⲱ	ⲛ|ⲉⲣⲟⲩⲱ
ⲉⲑⲃⲉⲡⲓϫⲱⲛⲧ	ⲉⲑⲃⲉ|ⲡⲓ|ϫⲱⲛⲧ
ⲁⲩⲭⲁⲣⲱⲟⲩ	ⲁ|ⲩ|ⲭⲁ|ⲣⲱ|ⲟⲩ
ϫⲉⲉϥⲛⲁϫⲉⲙⲡϣⲓⲛⲓ	ϫⲉ|ⲉ|ϥ|ⲛⲁ|ϫⲉⲙ|ⲡ|ϣⲓⲛⲓ
ⲕⲁⲧⲁⲧⲉϥⲥⲩⲛⲏⲑⲉⲓⲁ	ⲕⲁⲧⲁ|ⲧⲉϥ|ⲥⲩⲛⲏⲑⲉⲓⲁ
ⲛⲉⲙⲡⲟⲩⲣⲟ	ⲛⲉⲙ|ⲡ|ⲟⲩⲣⲟ
ⲛⲉⲙⲡⲓⲙⲡϣ	ⲛⲉⲙ|ⲡⲓ|ⲙⲡϣ
ⲛⲉⲙⲛⲓⲛⲓϣϯ	ⲛⲉⲙ|ⲛⲓ|ⲛⲓϣϯ
ⲛⲁⲣⲭⲱⲛ	ⲛ|ⲁⲣⲭⲱⲛ
ϩⲉⲙⲥⲓ	ϩⲉⲙⲥⲓ
ⲛⲟⲩⲕⲁⲛⲓⲥⲕⲓⲟⲛ	ⲛ|ⲟⲩ|ⲕⲁⲛⲓⲥⲕⲓⲟⲛ
ⲙⲃⲉⲛⲓ	ⲙ|ⲃⲉⲛⲓ
ⲉⲩⲧⲁⲓⲏⲟⲩⲧ	ⲉ|ⲩ|ⲧⲁⲓⲏⲟⲩⲧ
ⲉⲑⲣⲉϥⲟⲩⲱⲙ	ⲉ|ⲑⲣⲉ|ϥ|ⲟⲩⲱⲙ
ⲛⲥⲟⲫⲟⲥ	ⲛ|ⲥⲟⲫⲟⲥ
ϧⲉⲛⲛⲁⲫⲛⲟⲩϯ	ϧⲉⲛ|ⲛⲁ|ⲫ|ⲛⲟⲩϯ
ⲛⲉⲙⲛⲓⲣⲱⲙⲓ	ⲛⲉⲙ|ⲛⲓ|ⲣⲱⲙⲓ
ⲉⲧⲁⲡⲓⲡⲛⲉⲩⲙⲁ	ⲉⲧ|ⲁ|ⲡⲓ|ⲡⲛⲉⲩⲙⲁ
ⲙⲡⲓⲡⲣⲟⲫⲏⲧⲏⲥ	ⲙ|ⲡⲓ|ⲡⲣⲟⲫⲏⲧⲏⲥ
ⲇⲁⲛⲓⲏⲗ	ⲇⲁⲛⲓⲏⲗ
ⲁϥⲥⲟⲩⲧⲉⲛⲧⲉϥϫⲓϫ	ⲁ|ϥ|ⲥⲟⲩⲧⲉⲛ|ⲧⲉϥ|ϫⲓϫ
ⲛⲟⲩⲓⲛⲁⲙ	ⲛ|ⲟⲩⲓⲛⲁⲙ
ⲁϥⲁⲙⲟⲛⲓⲡⲓⲕⲁⲛⲓⲥⲕⲓⲟⲛ	ⲁ|ϥ|ⲁⲙⲟⲛⲓ|ⲡⲓ|ⲕⲁⲛⲓⲥⲕⲓⲟⲛ
ϧⲉⲛⲟⲩⲡⲁⲛⲟⲩⲣⲅⲓⲁ	ϧⲉⲛ|ⲟⲩ|ⲡⲁⲛⲟⲩⲣⲅⲓⲁ
ⲉⲣⲉⲛⲓⲃⲉⲛⲓ	ⲉⲣⲉ|ⲛⲓ|ⲃⲉⲛⲓ
ⲛⲧⲁⲟⲩⲱⲙ	ⲛ|ⲧⲁ|ⲟⲩⲱⲙ
ⲛⲁϣ	ⲛ|ⲁϣ
ⲙⲙⲱⲓⲧ	ⲙ|ⲙⲱⲓⲧ
ⲡⲁⲓⲙⲱⲓⲧ	ⲡⲁⲓ|ⲙⲱⲓⲧ
ⲡⲁⲓⲙⲁ	ⲡⲁⲓ|ⲙⲁ
ⲉⲧⲁϥⲁⲓϥ	ⲉⲧ|ⲁ|ϥ|ⲁⲓ|ϥ
ⲛⲓⲭⲁⲣⲧⲟⲗⲁⲣⲓⲟⲥ	ⲛⲓ|ⲭⲁⲣⲧⲟⲗⲁⲣⲓⲟⲥ
ⲛⲉⲙⲛⲓⲁⲣⲭⲱⲛ	ⲛⲉⲙ|ⲛⲓ|ⲁⲣⲭⲱⲛ
ⲁⲩⲉⲣⲛⲟⲉⲓⲛ	ⲁ|ⲩ|ⲉⲣⲛⲟⲉⲓⲛ
ⲉϫⲉⲛⲡⲉϥⲛⲓϣϯ	ⲉϫⲉⲛ|ⲡⲉϥ|ⲛⲓϣϯ
ⲛⲕⲁϯ	ⲛ|ⲕⲁϯ
ⲛⲉⲙⲛⲓϩⲙⲟⲧ	ⲛⲉⲙ|ⲛⲓ|ϩⲙⲟⲧ
ⲁⲓⲧⲟⲩ	ⲁⲓⲧ|ⲟⲩ
ϫⲉⲡⲓⲙⲱⲓⲧ	ϫⲉ|ⲡⲓ|ⲙⲱⲓⲧ
ⲉⲧⲉⲕⲟⲩⲁϣϥ	ⲉⲧⲉ|ⲕ|ⲟⲩⲁϣ|ϥ
ⲉⲧⲁⲩⲕⲏⲛ	ⲉⲧ|ⲁ|ⲩ|ⲕⲏⲛ
ⲛⲛⲓⲃⲉⲛⲓ	ⲛ|ⲛⲓ|ⲃⲉⲛⲓ
ⲭⲁⲡⲓⲁⲣⲭⲓⲉⲡⲓⲥⲕⲟⲡⲟⲥ	ⲭⲁ|ⲡⲓ|ⲁⲣⲭⲓⲉⲡⲓⲥⲕⲟⲡⲟⲥ
ⲛⲛⲓⲭⲁⲣⲧⲟⲗⲁⲣⲓⲟⲥ	ⲛ|ⲛⲓ|ⲭⲁⲣⲧⲟⲗⲁⲣⲓⲟⲥ
ⲉϥϣⲟⲩϣⲟⲩ	ⲉ|ϥ|ϣⲟⲩϣⲟⲩ
ϫⲉⲁⲓⲑⲣⲉϥⲟⲩⲱⲙ	ϫⲉ|ⲁ|ⲓ|ⲑⲣⲉ|ϥ|ⲟⲩⲱⲙ
ⲁϭⲛⲉⲡⲓⲥⲧⲁⲩⲣⲟⲥ	ⲁϭⲛⲉ|ⲡⲓ|ⲥⲧⲁⲩⲣⲟⲥ
ϧⲉⲛⲟⲩⲉⲣⲟⲩⲟⲧ	ϧⲉⲛ|ⲟⲩ|ⲉⲣⲟⲩⲟⲧ
ϫⲉⲙⲡⲉϥⲟⲩⲱⲙ	ϫⲉ|ⲙⲡⲉ|ϥ|ⲟⲩⲱⲙ
ϣⲁⲧⲉϥϩⲓⲡⲓⲥⲧⲁⲩⲣⲟⲥ	ϣⲁⲧⲉ|ϥ|ϩⲓⲡⲓⲥⲧⲁⲩⲣⲟⲥ
ϫⲉⲛⲁϣ	ϫⲉ|ⲛ|ⲁϣ
ⲁϥϩⲓⲡⲓⲥⲧⲁⲩⲣⲟⲥ	ⲁ|ϥ|ϩⲓⲡⲓⲥⲧⲁⲩⲣⲟⲥ
ⲉⲧⲁϥϩⲓⲡⲉϥⲧⲏⲃ	ⲉⲧ|ⲁ|ϥ|ϩⲓ|ⲡⲉϥ|ⲧⲏⲃ
ⲉⲡⲓⲇ	ⲉⲡⲓ|ⲇ
ⲛⲥⲁ	ⲛ|ⲥⲁ
ⲛⲥⲁⲛⲧⲉⲡⲓⲕⲁⲛⲓⲥⲕⲓⲟⲛ	ⲛⲥⲁ|ⲛⲧⲉ|ⲡⲓ|ⲕⲁⲛⲓⲥⲕⲓⲟⲛ
ϫⲉⲁⲕⲟⲩⲱϣ	ϫⲉ|ⲁ|ⲕ|ⲟⲩⲱϣ
ⲙⲡⲁⲓⲙⲱⲓⲧ	ⲙ|ⲡⲁⲓ|ⲙⲱⲓⲧ
ϣⲁⲛⲡⲁⲓⲙⲁ	ϣⲁⲛ|ⲡⲁⲓ|ⲙⲁ
ⲉⲧⲁϥϩⲓⲡⲓⲥⲧⲁⲩⲣⲟⲥ	ⲉⲧ|ⲁ|ϥ|ϩⲓⲡⲓⲥⲧⲁⲩⲣⲟⲥ
ⲉⲛⲓⲃⲉⲛⲓ	ⲉ|ⲛⲓ|ⲃⲉⲛⲓ
ⲉⲣϣⲫⲏⲣⲓ	ⲉⲣϣⲫⲏⲣⲓ
ⲉⲧⲁϥϯⲱⲟⲩ	ⲉⲧ|ⲁ|ϥ|ϯⲱⲟⲩ
ⲛⲉⲙϩⲙⲟⲧ	ⲛⲉⲙ|ϩⲙⲟⲧ
ⲛⲇⲁⲛⲓⲏⲗ	ⲛ|ⲇⲁⲛⲓⲏⲗ
ⲛⲛⲓⲟⲩⲣⲱⲟⲩ	ⲛ|ⲛⲓ|ⲟⲩⲣⲱⲟⲩ
ⲛⲧⲉⲛⲓⲭⲁⲗⲇⲁⲓⲟⲥ	ⲛⲧⲉ|ⲛⲓ|ⲭⲁⲗⲇⲁⲓⲟⲥ
ⲛⲉⲙⲛⲓⲡⲉⲣⲥⲏⲥ	ⲛⲉⲙ|ⲛⲓ|ⲡⲉⲣⲥⲏⲥ
ⲁϥϯⲱⲟⲩ	ⲁ|ϥ|ϯⲱⲟⲩ
ⲛⲧⲉⲛⲓⲥⲁⲣⲁⲕⲏⲛⲟⲥ	ⲛⲧⲉ|ⲛⲓ|ⲥⲁⲣⲁⲕⲏⲛⲟⲥ
ⲛⲁϥϯⲱⲟⲩ	ⲛⲁ|ϥ|ϯⲱⲟⲩ
ⲉⲑⲃⲉⲡⲓϩⲙⲟⲧ	ⲉⲑⲃⲉ|ⲡⲓ|ϩⲙⲟⲧ
ⲛⲧⲁϫⲱ	ⲛ|ⲧⲁ|ϫⲱ
ⲙⲡⲁⲓⲕⲉϩⲱⲃ	ⲙ|ⲡⲁⲓ|ⲕⲉ|ϩⲱⲃ
ⲙⲡⲓⲥⲏⲟⲩ	ⲙ|ⲡⲓ|ⲥⲏⲟⲩ
ⲛϯⲙⲁⲕⲟⲩⲣⲓⲁ	ⲛ|ϯ|ⲙⲁⲕⲟⲩⲣⲓⲁ
ⲛϩⲁⲛⲣⲉⲙⲛϩⲱⲃ	ⲛ|ϩⲁⲛ|ⲣⲉⲙⲛϩⲱⲃ
ⲛⲉⲙϩⲁⲛⲥϧⲁⲓ	ⲛⲉⲙ|ϩⲁⲛ|ⲥϧⲁⲓ
ⲉϥⲧⲁⲙⲟ	ⲉ|ϥ|ⲧⲁⲙⲟ
ⲉⲧⲁⲩⲉⲣⲕⲟⲩϫⲓ	ⲉⲧ|ⲁ|ⲩ|ⲉⲣⲕⲟⲩϫⲓ
ⲛⲧⲉϯⲭⲱⲣⲁ	ⲛⲧⲉ|ϯ|ⲭⲱⲣⲁ
ⲉⲑⲃⲉⲡⲱⲥⲕ	ⲉⲑⲃⲉ|ⲡ|ⲱⲥⲕ
ⲙⲡⲓⲙⲱⲓⲧ	ⲙ|ⲡⲓ|ⲙⲱⲓⲧ
ⲛⲉⲙⲡⲓⲭⲣⲟⲛⲟⲥ	ⲛⲉⲙ|ⲡⲓ|ⲭⲣⲟⲛⲟⲥ
ⲉⲑⲃⲉϫⲉⲛⲁⲩϣϫⲉⲙϫⲟⲙ	ⲉⲑⲃⲉ|ϫⲉ|ⲛⲁ|ⲩ|ϣ|ϫⲉⲙϫⲟⲙ
ⲉⲥⲓⲛⲓ	ⲉ|ⲥⲓⲛⲓ
ϩⲓⲧⲉⲛⲡⲟⲩⲣⲟ	ϩⲓⲧⲉⲛ|ⲡ|ⲟⲩⲣⲟ
ⲛϯⲙⲁⲩⲣⲱⲧⲁⲛⲓⲁ	ⲛ|ϯ|ⲙⲁⲩⲣⲱⲧⲁⲛⲓⲁ
ϣⲁⲧⲉϥⲉⲣϩⲉⲓⲣⲏⲛⲏ	ϣⲁⲧⲉ|ϥ|ⲉⲣϩⲉⲓⲣⲏⲛⲏ
ⲛⲟⲩⲣⲟ	ⲛ|ⲟⲩⲣⲟ
ⲑⲏϣ	ⲑⲏϣ
ⲉⲛⲓⲭⲱⲣⲁ	ⲉ|ⲛⲓ|ⲭⲱⲣⲁ
ⲡⲓⲃ	ⲡⲓ|ⲃ
ϩⲁⲛⲭⲣⲓⲥⲧⲓⲁⲛⲟⲥ	ϩⲁⲛ|ⲭⲣⲓⲥⲧⲓⲁⲛⲟⲥ
ⲥⲉⲟⲓ	ⲥⲉ|ⲟⲓ
ⲛϩⲉⲓⲣⲏⲛⲏ	ⲛ|ϩⲉⲓⲣⲏⲛⲏ
ⲛⲁⲣⲉⲟⲩϩⲉⲓⲣⲏⲛⲏ	ⲛⲁⲣⲉ|ⲟⲩ|ϩⲉⲓⲣⲏⲛⲏ
ⲛⲛⲓⲥⲁⲣⲣⲁⲕⲏⲛⲟⲥ	ⲛ|ⲛⲓ|ⲥⲁⲣⲣⲁⲕⲏⲛⲟⲥ
ⲉⲧⲉⲡⲟⲩⲣⲟ	ⲉⲧⲉ|ⲡ|ⲟⲩⲣⲟ
ⲉⲧⲉⲫⲁⲛⲓϣϯ	ⲉⲧⲉ|ⲫⲁ|ⲛⲓϣϯ
ⲛⲭⲱⲣⲁ	ⲛ|ⲭⲱⲣⲁ
ⲉⲧⲉϯⲙⲁⲕⲟⲩⲣⲓⲁ	ⲉⲧⲉ|ϯ|ⲙⲁⲕⲟⲩⲣⲓⲁ
ⲛⲧⲉⲡⲟⲩⲣⲟ	ⲛⲧⲉ|ⲡ|ⲟⲩⲣⲟ
ⲉⲧⲉⲛϧⲏⲧⲟⲩ	ⲉⲧⲉ|ⲛϧⲏⲧ|ⲟⲩ
ⲉⲑⲃⲉⲛⲓⲉⲕⲕⲗⲏⲥⲓⲁ	ⲉⲑⲃⲉ|ⲛⲓ|ⲉⲕⲕⲗⲏⲥⲓⲁ
ⲁϥⲥϧⲁⲓ	ⲁ|ϥ|ⲥϧⲁⲓ
ⲛϩⲁⲛⲥϧⲁⲓ	ⲛ|ϩⲁⲛ|ⲥϧⲁⲓ
ⲉϥϯⲥⲟϭⲛⲓ	ⲉ|ϥ|ϯⲥⲟϭⲛⲓ
ⲛⲉⲙⲥⲃⲱ	ⲛⲉⲙ|ⲥⲃⲱ
ϧⲉⲛⲛⲉⲛⲥⲁϫⲓ	ϧⲉⲛ|ⲛⲉⲛ|ⲥⲁϫⲓ
ⲛϯⲅⲣⲁⲫⲏ	ⲛ|ϯ|ⲅⲣⲁⲫⲏ
ⲉⲧⲁϥⲥϧⲏⲧ	ⲉⲧ|ⲁ|ϥ|ⲥϧⲏⲧ
ⲉⲡⲧⲁϩⲟ	ⲉ|ⲡ|ⲧⲁϩⲟ
ⲛⲧⲉⲧⲉϥⲯⲩⲭⲏ	ⲛⲧⲉ|ⲧⲉϥ|ⲯⲩⲭⲏ
ⲛⲉⲙⲡⲓⲛⲁϩϯ	ⲛⲉⲙ|ⲡⲓ|ⲛⲁϩϯ
ⲛⲟⲣⲑⲟⲇⲟⲝⲟⲥ	ⲛ|ⲟⲣⲑⲟⲇⲟⲝⲟⲥ
ⲉϣⲧⲉⲙⲉⲣⲕⲱⲗⲩⲉⲓⲛ	ⲉ|ϣⲧⲉⲙ|ⲉⲣⲕⲱⲗⲩⲉⲓⲛ
ⲛⲧⲉⲡⲓⲟⲩⲣⲟ	ⲛⲧⲉ|ⲡⲓ|ⲟⲩⲣⲟ
ⲉⲧⲥⲁⲡϣⲱⲓ	ⲉ|ⲧ|ⲥⲁⲡϣⲱⲓ
ⲉⲑⲣⲟⲩⲥⲓⲛⲓ	ⲉ|ⲑⲣ|ⲟⲩ|ⲥⲓⲛⲓ
ϩⲓⲧⲉⲙⲧⲉϥⲭⲱⲣⲁ	ϩⲓⲧⲉⲙ|ⲧⲉϥ|ⲭⲱⲣⲁ
ⲉⲑⲃⲉⲛⲟⲩⲉⲡⲓⲥⲕⲟⲡⲟⲥ	ⲉⲑⲃⲉ|ⲛⲟⲩ|ⲉⲡⲓⲥⲕⲟⲡⲟⲥ
ϫⲉⲛⲛⲉⲛⲓⲉⲕⲕⲗⲏⲥⲓⲁ	ϫⲉ|ⲛⲛⲉ|ⲛⲓ|ⲉⲕⲕⲗⲏⲥⲓⲁ
ⲉⲣϣⲁϥⲉ	ⲉⲣϣⲁϥⲉ
ⲛⲧⲉⲕϫⲉⲙⲟⲩⲛⲓϣϯ	ⲛⲧⲉ|ⲕ|ϫⲉⲙ|ⲟⲩ|ⲛⲓϣϯ
ⲛϫⲫⲓⲟ	ⲛ|ϫⲫⲓⲟ
ⲛϫⲉⲛⲉⲛϫⲁϫⲓ	ⲛϫⲉ|ⲛⲉⲛ|ϫⲁϫⲓ
ⲁⲩⲉⲣⲇⲓⲁⲃⲁⲗⲗⲉⲓⲛ	ⲁ|ⲩ|ⲉⲣⲇⲓⲁⲃⲁⲗⲗⲉⲓⲛ
ϫⲉⲧⲉⲛⲧⲁⲙⲟ	ϫⲉ|ⲧⲉⲛ|ⲧⲁⲙⲟ
ϫⲉⲁⲡⲟⲩⲣⲟ	ϫⲉ|ⲁ|ⲡ|ⲟⲩⲣⲟ
ⲛⲁⲃⲃⲁ	ⲛ|ⲁⲃⲃⲁ
ⲛⲟⲩⲉⲡⲓⲥⲕⲟⲡⲟⲥ	ⲛ|ⲟⲩ|ⲉⲡⲓⲥⲕⲟⲡⲟⲥ
ⲛⲧⲟⲩⲟⲗϥ	ⲛⲧ|ⲟⲩ|ⲟⲗ|ϥ
ⲉⲧⲟⲩⲭⲱⲣⲁ	ⲉⲧ|ⲟⲩ|ⲭⲱⲣⲁ
ⲁϥⲉⲣⲡⲕⲉⲟⲩⲱⲣⲡ	ⲁ|ϥ|ⲉⲣ|ⲡ|ⲕⲉ|ⲟⲩⲱⲣⲡ
ⲉⲑⲣⲉϥⲉⲣϩⲉⲓⲣⲏⲛⲏ	ⲉ|ⲑⲣⲉ|ϥ|ⲉⲣϩⲉⲓⲣⲏⲛⲏ
ⲡⲉⲛϫⲁϫⲓ	ⲡⲉⲛ|ϫⲁϫⲓ
ⲁⲣⲉϣⲁⲛⲫⲁⲓ	ⲁⲣⲉϣⲁⲛ|ⲫⲁⲓ
ⲥⲉⲛⲁⲉⲣⲟⲩϩⲏⲧ	ⲥⲉ|ⲛⲁ|ⲉⲣ|ⲟⲩ|ϩⲏⲧ
ⲛⲥⲉⲧⲱⲟⲩⲛⲟⲩ	ⲛ|ⲥⲉ|ⲧⲱⲟⲩⲛⲟⲩ
ⲛⲧⲟⲩⲉⲣⲡⲟⲗⲉⲙⲉⲓⲛ	ⲛⲧ|ⲟⲩ|ⲉⲣⲡⲟⲗⲉⲙⲉⲓⲛ
ⲛⲉⲙⲁⲛ	ⲛⲉⲙⲁ|ⲛ
ⲉⲧⲁⲡⲟⲩⲣⲟ	ⲉⲧ|ⲁ|ⲡ|ⲟⲩⲣⲟ
ⲁϥϫⲱⲛⲧ	ⲁ|ϥ|ϫⲱⲛⲧ
ϣⲁⲡⲓⲁⲩⲅⲟⲩⲥⲧⲁⲗⲓⲟⲥ	ϣⲁ|ⲡⲓ|ⲁⲩⲅⲟⲩⲥⲧⲁⲗⲓⲟⲥ
ⲉⲁϥⲥϧⲁⲓ	ⲉ|ⲁ|ϥ|ⲥϧⲁⲓ
ϫⲉϧⲉⲛϯⲟⲩⲛⲟⲩ	ϫⲉ|ϧⲉⲛ|ϯ|ⲟⲩⲛⲟⲩ
ⲉⲧⲟⲩⲛⲁⲫⲟϩ	ⲉⲧ|ⲟⲩ|ⲛⲁ|ⲫⲟϩ
ⲛϫⲉⲛⲁⲓϥⲁⲓ	ⲛϫⲉ|ⲛⲁⲓ|ϥⲁⲓ
ϣⲓⲛⲓ	ϣⲓⲛⲓ
ⲛⲉⲙⲛⲁⲓⲥϧⲁⲓ	ⲛⲉⲙ|ⲛⲁⲓ|ⲥϧⲁⲓ
ⲧⲁϩⲉⲡⲓⲁⲣⲭⲓⲉⲡⲓⲥⲕⲟⲡⲟⲥ	ⲧⲁϩⲉ|ⲡⲓ|ⲁⲣⲭⲓⲉⲡⲓⲥⲕⲟⲡⲟⲥ
ⲟⲩⲟⲣⲡϥ	ⲟⲩⲟⲣⲡ|ϥ
ⲛⲉⲁⲡⲟⲩⲣⲟ	ⲛⲉ|ⲁ|ⲡ|ⲟⲩⲣⲟ
ⲥⲉⲙⲛⲏⲧⲥ	ⲥⲉⲙⲛⲏⲧ|ⲥ
ⲉⲧⲉϥⲛⲁⲫⲟϩ	ⲉⲧⲉ|ϥ|ⲛⲁ|ⲫⲟϩ
ϧⲉⲛⲧⲥⲏϥⲓ	ϧⲉⲛ|ⲧ|ⲥⲏϥⲓ
ⲉⲧⲁⲩⲫⲟϩ	ⲉⲧ|ⲁ|ⲩ|ⲫⲟϩ
ⲛϫⲉⲛⲓⲥϧⲁⲓ	ⲛϫⲉ|ⲛⲓ|ⲥϧⲁⲓ
ϧⲉⲛϯⲉⲕⲕⲗⲏⲥⲓⲁ	ϧⲉⲛ|ϯ|ⲉⲕⲕⲗⲏⲥⲓⲁ
ϯϩⲉⲃⲇⲟⲙⲁⲥ	ϯ|ϩⲉⲃⲇⲟⲙⲁⲥ
ⲛⲧⲉⲡⲓⲡⲁⲥⲭⲁ	ⲛⲧⲉ|ⲡⲓ|ⲡⲁⲥⲭⲁ
ⲛⲟⲩϫⲁⲓ	ⲛ|ⲟⲩϫⲁⲓ
ϫⲉⲟⲩⲏⲣ	ϫⲉ|ⲟⲩⲏⲣ
ⲡⲓϩⲏⲃⲓ	ⲡⲓ|ϩⲏⲃⲓ
ⲛⲉⲙⲡⲓⲙⲕⲁϩ	ⲛⲉⲙ|ⲡⲓ|ⲙⲕⲁϩ
ⲙⲡⲓⲉϩⲟⲟⲩ	ⲙ|ⲡⲓ|ⲉϩⲟⲟⲩ
ϧⲉⲛⲛⲁⲡⲉⲛⲛⲁϩϯ	ϧⲉⲛ|ⲛⲁ|ⲡⲉⲛ|ⲛⲁϩϯ
ⲉⲧⲉϥⲛⲓϣϯ	ⲉ|ⲧⲉϥ|ⲛⲓϣϯ
ⲙⲡⲁⲣⲟⲩⲥⲓⲁ	ⲙ|ⲡⲁⲣⲟⲩⲥⲓⲁ
ⲉⲩⲉⲣϩⲏⲃⲓ	ⲉ|ⲩ|ⲉⲣϩⲏⲃⲓ
ⲉϫⲉⲛⲡⲟⲩⲙⲁⲛⲉⲥⲱⲟⲩ	ⲉϫⲉⲛ|ⲡⲟⲩ|ⲙⲁⲛⲉⲥⲱⲟⲩ
ⲉⲩⲉⲙⲓ	ⲉ|ⲩ|ⲉⲙⲓ
ϫⲉⲟⲩⲧⲉⲧⲉϥⲁⲓⲧⲓⲁ	ϫⲉ|ⲟⲩⲧⲉ|ⲧⲉϥ|ⲁⲓⲧⲓⲁ
ⲉⲧⲁⲩⲧⲁⲗⲟϥ	ⲉⲧ|ⲁ|ⲩ|ⲧⲁⲗⲟ|ϥ
ϧⲉⲛⲟⲩⲓⲱⲥ	ϧⲉⲛ|ⲟⲩ|ⲓⲱⲥ
ⲁⲩⲟⲗϥ	ⲁ|ⲩ|ⲟⲗ|ϥ
ⲉⲃⲁⲃⲩⲗⲱⲛ	ⲉ|ⲃⲁⲃⲩⲗⲱⲛ
ⲉⲣⲉⲡⲓⲁⲣⲭⲓⲉⲡⲓⲥⲕⲟⲡⲟⲥ	ⲉⲣⲉ|ⲡⲓ|ⲁⲣⲭⲓⲉⲡⲓⲥⲕⲟⲡⲟⲥ
ⲧⲁⲗⲏⲟⲩⲧ	ⲧⲁⲗⲏⲟⲩⲧ
ⲉⲡⲓⲓⲱ	ⲉ|ⲡⲓ|ⲓⲱ
ϧⲉⲛⲛⲓⲡⲗⲁⲧⲉⲓⲁ	ϧⲉⲛ|ⲛⲓ|ⲡⲗⲁⲧⲉⲓⲁ
ⲛⲧⲉⲃⲁⲃⲩⲗⲱⲛ	ⲛⲧⲉ|ⲃⲁⲃⲩⲗⲱⲛ
ⲉⲣⲉⲡⲓⲙⲏϣ	ⲉⲣⲉ|ⲡⲓ|ⲙⲏϣ
ϣⲓⲛⲉ	ϣⲓⲛⲉ
ⲕⲁⲧⲁϯⲥⲩⲛⲏⲑⲉⲓⲁ	ⲕⲁⲧⲁ|ϯ|ⲥⲩⲛⲏⲑⲉⲓⲁ
ϣⲁⲧⲟⲩⲉⲙⲓ	ϣⲁⲧ|ⲟⲩ|ⲉⲙⲓ
ⲙⲡⲟⲩⲙⲁⲛⲉⲥⲱⲟⲩ	ⲙ|ⲡⲟⲩ|ⲙⲁⲛⲉⲥⲱⲟⲩ
ⲉϥϩⲏⲗ	ⲉ|ϥ|ϩⲏⲗ
ⲉⲣⲱⲙⲓ	ⲉ|ⲣⲱⲙⲓ
ⲉⲩϭⲟⲥⲓ	ⲉ|ⲩ|ϭⲟⲥⲓ
ⲉⲩⲉⲣⲫⲟⲣⲉⲓⲛ	ⲉ|ⲩ|ⲉⲣⲫⲟⲣⲉⲓⲛ
ⲛϩⲁⲛϩⲉⲃⲥⲱ	ⲛ|ϩⲁⲛ|ϩⲉⲃⲥⲱ
ⲛⲟⲩⲱⲃϣ	ⲛ|ⲟⲩⲱⲃϣ
ⲛⲥⲁⲣⲝ	ⲛ|ⲥⲁⲣⲝ
ⲛⲁϣⲥⲁϫⲓ	ⲛⲁ|ϣ|ⲥⲁϫⲓ
ⲙⲡⲟⲩⲱⲟⲩ	ⲙ|ⲡⲟⲩ|ⲱⲟⲩ
ⲛⲉⲙⲡⲟⲩⲧⲁⲓⲟ	ⲛⲉⲙ|ⲡⲟⲩ|ⲧⲁⲓⲟ
ⲛⲁϥⲛⲁⲩ	ⲛⲁ|ϥ|ⲛⲁⲩ
ⲉⲣⲟⲟⲩ	ⲉⲣⲟ|ⲟⲩ
ⲥⲁⲧⲉϥⲟⲩⲓⲛⲁⲙ	ⲥⲁ|ⲧⲉϥ|ⲟⲩⲓⲛⲁⲙ
ⲥⲁⲧⲉϥϫⲁϭⲏ	ⲥⲁ|ⲧⲉϥ|ϫⲁϭⲏ
ⲉⲧⲉⲛⲙⲟϣⲓ	ⲉ|ⲧⲉⲛ|ⲙⲟϣⲓ
ⲛⲁⲧⲁϩⲟⲕ	ⲛⲁ|ⲧⲁϩⲟ|ⲕ
ⲉⲣⲉⲧⲉⲛϣⲟⲡ	ⲉⲣⲉ|ⲧⲉⲛ|ϣⲟⲡ
ⲉⲧⲥⲁⲟⲩⲓⲛⲁⲙ	ⲉⲧ|ⲥⲁ|ⲟⲩⲓⲛⲁⲙ
ϧⲉⲛⲡⲉϥⲥⲙⲟⲧ	ϧⲉⲛ|ⲡⲉϥ|ⲥⲙⲟⲧ
ⲕⲏⲫⲁ	ⲕⲏⲫⲁ
ⲉⲧⲁⲩϯⲣⲉⲛⲉϥ	ⲉⲧ|ⲁ|ⲩ|ϯⲣⲉⲛⲉ|ϥ
ϫⲉⲡⲉⲧⲣⲟⲥ	ϫⲉ|ⲡⲉⲧⲣⲟⲥ
ⲡⲁⲓⲕⲉⲟⲩⲁⲓ	ⲡⲁⲓ|ⲕⲉ|ⲟⲩⲁⲓ
ⲛⲅⲛⲏⲥⲓⲟⲥ	ⲛ|ⲅⲛⲏⲥⲓⲟⲥ
ⲉⲧⲁⲩⲧϩⲉⲙⲥⲟⲕ	ⲉⲧ|ⲁ|ⲩ|ⲧϩⲉⲙⲥⲟ|ⲕ
ⲉϫⲉⲛⲡⲑⲣⲟⲛⲟⲥ	ⲉϫⲉⲛ|ⲡ|ⲑⲣⲟⲛⲟⲥ
ⲛϯⲙⲉⲧⲁⲣⲭⲓⲉⲣⲉⲩⲥ	ⲛ|ϯ|ⲙⲉⲧⲁⲣⲭⲓⲉⲣⲉⲩⲥ
ⲧⲉⲛϣⲟⲡ	ⲧⲉⲛ|ϣⲟⲡ
ϧⲉⲛⲙⲱⲓⲧ	ϧⲉⲛ|ⲙⲱⲓⲧ
ⲭⲛⲁϫⲱⲕ	ⲭ|ⲛⲁ|ϫⲱⲕ
ϫⲉⲛⲧⲁⲓⲣⲟⲙⲡⲓ	ϫⲉ|ⲛ|ⲧⲁⲓ|ⲣⲟⲙⲡⲓ
ⲥⲉⲛⲁⲭⲁⲕ	ⲥⲉ|ⲛⲁ|ⲭⲁ|ⲕ
ϧⲁⲧⲉⲛⲛⲉⲕⲓⲟϯ	ϧⲁⲧⲉⲛ|ⲛⲉⲕ|ⲓⲟϯ
ⲉⲁⲕϫⲱⲕ	ⲉ|ⲁ|ⲕ|ϫⲱⲕ
ⲙⲡϩⲱⲃ	ⲙ|ⲡ|ϩⲱⲃ
ⲛⲉⲙϯⲙⲉⲧⲙⲁⲛⲉⲥⲱⲟⲩ	ⲛⲉⲙ|ϯ|ⲙⲉⲧⲙⲁⲛⲉⲥⲱⲟⲩ
ⲉⲣⲉⲡϭⲟⲉⲓⲥ	ⲉⲣⲉ|ⲡ|ϭⲟⲉⲓⲥ
ⲟⲩⲱϣ	ⲟⲩⲱϣ
ⲉⲑⲣⲉⲕⲉⲣⲫⲟⲣⲉⲓⲛ	ⲉ|ⲑⲣⲉ|ⲕ|ⲉⲣⲫⲟⲣⲉⲓⲛ
ⲙⲫⲁϯⲙⲉⲧϩⲟⲙⲟⲗⲟⲅⲏⲧⲏⲥ	ⲙ|ⲫⲁ|ϯ|ⲙⲉⲧϩⲟⲙⲟⲗⲟⲅⲏⲧⲏⲥ
ⲡⲓⲙⲁⲛⲉⲥⲱⲟⲩ	ⲡⲓ|ⲙⲁⲛⲉⲥⲱⲟⲩ
ϧⲉⲛⲛⲓⲥⲛⲏⲟⲩ	ϧⲉⲛ|ⲛⲓ|ⲥⲛⲏⲟⲩ
ϫⲉⲉϥⲥⲁϫⲓ	ϫⲉ|ⲉ|ϥ|ⲥⲁϫⲓ
ⲉⲧⲁϥⲫⲟϩ	ⲉⲧ|ⲁ|ϥ|ⲫⲟϩ
ⲉⲡⲓⲡⲣⲁⲓⲧⲱⲣⲓⲟⲛ	ⲉ|ⲡⲓ|ⲡⲣⲁⲓⲧⲱⲣⲓⲟⲛ
ⲁⲩⲧⲁⲙⲉⲡⲟⲩⲣⲟ	ⲁ|ⲩ|ⲧⲁⲙⲉ|ⲡ|ⲟⲩⲣⲟ
ϫⲉⲁϥⲓ	ϫⲉ|ⲁ|ϥ|ⲓ
ⲉⲑⲣⲟⲩⲉⲛϥ	ⲉ|ⲑⲣ|ⲟⲩ|ⲉⲛ|ϥ
ⲛⲉⲣⲡⲉⲧϩⲱⲟⲩ	ⲛ|ⲉⲣⲡⲉⲧϩⲱⲟⲩ
ⲉⲡⲓϩⲁⲅⲓⲟⲥ	ⲉ|ⲡⲓ|ϩⲁⲅⲓⲟⲥ
ⲁⲛⲉϥⲃⲁⲗ	ⲁ|ⲛⲉϥ|ⲃⲁⲗ
ⲉⲡⲓⲃ	ⲉ|ⲡⲓ|ⲃ
ⲛⲁⲡⲟⲥⲧⲟⲗⲟⲥ	ⲛ|ⲁⲡⲟⲥⲧⲟⲗⲟⲥ
ⲟⲩϩⲟϯ	ⲟⲩ|ϩⲟϯ
ⲁⲥϭⲓⲧϥ	ⲁ|ⲥ|ϭⲓⲧ|ϥ
ⲉⲧⲁⲡⲉϥϩⲏⲧ	ⲉⲧ|ⲁ|ⲡⲉϥ|ϩⲏⲧ
ⲥⲉⲙⲛⲓ	ⲥⲉⲙⲛⲓ
ϧⲉⲛⲟⲩⲙⲉⲧⲣⲉⲙⲣⲁⲩϣ	ϧⲉⲛ|ⲟⲩ|ⲙⲉⲧⲣⲉⲙⲣⲁⲩϣ
ϫⲉϩⲁⲛ	ϫⲉ|ϩⲁⲛ
ⲛⲉⲙⲉⲑⲙⲏⲓ	ⲛⲉ|ⲙⲉⲑⲙⲏⲓ
ⲉⲧⲁⲩϫⲟⲧⲟⲩ	ⲉⲧ|ⲁ|ⲩ|ϫⲟⲧ|ⲟⲩ
ⲉⲑⲃⲏⲧⲕ	ⲉⲑⲃⲏⲧ|ⲕ
ⲙⲡⲁⲣⲣⲏⲥⲓⲁ	ⲙ|ⲡⲁⲣⲣⲏⲥⲓⲁ
ⲉⲧⲁϥⲑⲉⲧⲡϩⲏⲧ	ⲉⲧ|ⲁ|ϥ|ⲑⲉⲧ|ⲡ|ϩⲏⲧ
ϫⲉϯⲛⲁϯ	ϫⲉ|ϯ|ⲛⲁ|ϯ
ⲉⲧⲉⲛⲥⲉⲛⲁϣϫⲉⲙϫⲟⲙ	ⲉⲧⲉ|ⲛ|ⲥⲉ|ⲛⲁ|ϣ|ϫⲉⲙϫⲟⲙ
ⲟⲩⲃⲏⲥ	ⲟⲩⲃⲏ|ⲥ
ⲛⲧⲟⲩⲉⲛⲑⲏⲛⲟⲩ	ⲛⲧ|ⲟⲩ|ⲉⲛ|ⲑⲏⲛⲟⲩ
ⲛⲉⲙⲛⲓϩⲏⲅⲉⲙⲱⲛ	ⲛⲉⲙ|ⲛⲓ|ϩⲏⲅⲉⲙⲱⲛ
ⲙⲡⲉⲣϥⲓⲣⲱⲟⲩϣ	ⲙⲡⲉⲣ|ϥⲓⲣⲱⲟⲩϣ
ⲉⲧⲉⲧⲉⲛⲛⲁϫⲟϥ	ⲉⲧⲉ|ⲧⲉⲛ|ⲛⲁ|ϫⲟ|ϥ
ⲛⲁⲧⲥⲁⲃⲉⲑⲏⲛⲟⲩ	ⲛⲁ|ⲧⲥⲁⲃⲉ|ⲑⲏⲛⲟⲩ
ⲉⲧⲉⲧⲉⲛⲛⲁϫⲟⲧⲟⲩ	ⲉⲧⲉ|ⲧⲉⲛ|ⲛⲁ|ϫⲟⲧ|ⲟⲩ
ⲉⲓⲧⲁ	ⲉⲓⲧⲁ
ϣⲉⲛⲡⲓⲁⲣⲭⲓⲉⲡⲓⲥⲕⲟⲡⲟⲥ	ϣⲉⲛ|ⲡⲓ|ⲁⲣⲭⲓⲉⲡⲓⲥⲕⲟⲡⲟⲥ
ϫⲉϯⲧⲁⲣⲕⲟ	ϫⲉ|ϯ|ⲧⲁⲣⲕⲟ
ⲛⲉⲙⲡⲓⲱⲟⲩ	ⲛⲉⲙ|ⲡⲓ|ⲱⲟⲩ
ⲛⲧⲉⲕϣⲧⲉⲙⲭⲱⲡ	ⲛⲧ|ⲉⲕ|ϣⲧⲉⲙ|ⲭⲱⲡ
ⲉϯⲛⲁϣⲉⲛⲕ	ⲉ|ϯ|ⲛⲁ|ϣⲉⲛ|ⲕ
ϫⲉϯⲛⲁϩⲉⲡϩⲗⲓ	ϫⲉ|ϯ|ⲛⲁ|ϩⲉⲡ|ϩⲗⲓ
ⲉϯⲥⲱⲟⲩⲛ	ⲉ|ϯ|ⲥⲱⲟⲩⲛ
ⲉⲧⲁⲕⲓ	ⲉⲧ|ⲁ|ⲕ|ⲓ
ⲁⲓⲛⲁⲩ	ⲁ|ⲓ|ⲛⲁⲩ
ⲙⲡⲉϥⲣⲏϯ	ⲙ|ⲡⲉϥ|ⲣⲏϯ
ϫⲉⲁⲩⲉⲣⲁⲑⲟⲩⲟⲱⲛϩ	ϫⲉ|ⲁ|ⲩ|ⲉⲣⲁⲑⲟⲩⲟⲱⲛϩ
ⲛⲁⲓⲛⲁⲙⲟⲩ	ⲛⲁ|ⲓ|ⲛⲁ|ⲙⲟⲩ
ⲥⲁⲧⲟⲧ	ⲥⲁⲧⲟⲧ
ⲛⲧⲉⲛϯϩⲟϯ	ⲛⲧⲉⲛ|ϯ|ϩⲟϯ
ⲡⲉϫⲉⲫⲏ	ⲡⲉϫⲉ|ⲫⲏ
ⲉⲧⲁⲕⲛⲁⲩ	ⲉⲧ|ⲁ|ⲕ|ⲛⲁⲩ
ϩⲁⲛⲙⲁⲑⲏⲧⲏⲥ	ϩⲁⲛ|ⲙⲁⲑⲏⲧⲏⲥ
ⲛⲧⲉⲛⲓⲟⲩⲣⲱⲟⲩ	ⲛⲧⲉ|ⲛⲓ|ⲟⲩⲣⲱⲟⲩ
ⲉⲧⲉⲛⲓⲟⲩⲣⲱⲟⲩ	ⲉⲧⲉ|ⲛⲓ|ⲟⲩⲣⲱⲟⲩ
ⲉⲧϯⲙⲕⲁϩ	ⲉⲧ|ϯⲙⲕⲁϩ
ⲁϥϯⲙⲕⲁϩ	ⲁ|ϥ|ϯⲙⲕⲁϩ
ⲉⲑⲣⲉϥⲕⲱⲧ	ⲉ|ⲑⲣⲉ|ϥ|ⲕⲱⲧ
ⲛⲟⲩⲉⲕⲕⲗⲏⲥⲓⲁ	ⲛ|ⲟⲩ|ⲉⲕⲕⲗⲏⲥⲓⲁ
ϧⲉⲛϩⲁⲗⲃⲁⲛ	ϧⲉⲛ|ϩⲁⲗⲃⲁⲛ
ⲉⲧⲁϥϫⲱⲕ	ⲉⲧ|ⲁ|ϥ|ϫⲱⲕ
ϧⲉⲛⲙⲉⲧⲥⲁⲓⲉ	ϧⲉⲛ|ⲙⲉⲧⲥⲁⲓⲉ
ⲁϥϣⲱⲛⲓ	ⲁ|ϥ|ϣⲱⲛⲓ
ⲁϥϧⲓⲥⲓ	ⲁ|ϥ|ϧⲓⲥⲓ
ⲁⲩⲧⲁⲗⲟϥ	ⲁ|ⲩ|ⲧⲁⲗⲟ|ϥ
ϧⲉⲛⲡⲧⲟⲡⲟⲥ	ϧⲉⲛ|ⲡ|ⲧⲟⲡⲟⲥ
ⲙⲡⲓϩⲁⲅⲓⲟⲥ	ⲙ|ⲡⲓ|ϩⲁⲅⲓⲟⲥ
ⲛⲁϥϣⲱⲛⲓ	ⲛⲁ|ϥ|ϣⲱⲛⲓ
ⲉϥϧⲟⲥⲓ	ⲉ|ϥ|ϧⲟⲥⲓ
ⲁⲩⲉⲣⲡⲉϥϣⲉⲙϣⲓ	ⲁ|ⲩ|ⲉⲣ|ⲡⲉϥ|ϣⲉⲙϣⲓ
ϫⲉⲙⲡⲉϥϣⲓⲛⲓ	ϫⲉⲙ|ⲡⲉϥ|ϣⲓⲛⲓ
ⲉϥⲛⲁⲙⲧⲟⲛ	ⲉ|ϥ|ⲛⲁ|ⲙⲧⲟⲛ
ⲛϫⲉϩⲁⲛⲙⲏϣ	ⲛϫⲉ|ϩⲁⲛ|ⲙⲏϣ
ⲛϩⲁⲅⲓⲟⲥ	ⲛ|ϩⲁⲅⲓⲟⲥ
ⲉⲧⲉϩⲁⲛⲉⲡⲓⲥⲕⲟⲡⲟⲥ	ⲉⲧⲉ|ϩⲁⲛ|ⲉⲡⲓⲥⲕⲟⲡⲟⲥ
ⲛⲉⲙϩⲁⲛⲕⲗⲏⲣⲓⲕⲟⲥ	ⲛⲉⲙ|ϩⲁⲛ|ⲕⲗⲏⲣⲓⲕⲟⲥ
ⲛⲉⲙϩⲁⲛⲙⲟⲛⲁⲭⲟⲥ	ⲛⲉⲙ|ϩⲁⲛ|ⲙⲟⲛⲁⲭⲟⲥ
ⲙⲡⲉϥⲡⲛⲉⲩⲙⲁ	ⲙ|ⲡⲉϥ|ⲡⲛⲉⲩⲙⲁ
ⲛϫⲉⲡⲓⲁⲣⲕⲓⲉⲡⲓⲥⲕⲟⲡⲟⲥ	ⲛϫⲉ|ⲡⲓ|ⲁⲣⲕⲓⲉⲡⲓⲥⲕⲟⲡⲟⲥ
ⲛⲥⲟⲩⲑ	ⲛ|ⲥⲟⲩ|ⲑ
ⲛⲁⲑⲱⲣ	ⲛ|ⲁⲑⲱⲣ
ⲁϥⲉⲣⲛⲉⲙⲡϣⲁ	ⲁ|ϥ|ⲉⲣⲛⲉⲙⲡϣⲁ
ⲛⲭⲱ	ⲛ|ⲭⲱ
ⲛⲛⲉϥϫⲓϫ	ⲛ|ⲛⲉϥ|ϫⲓϫ
ⲛⲧⲉⲣⲉⲛⲟⲩϯ	ⲛⲧⲉ|ⲣⲉⲛⲟⲩϯ
ⲉⲧⲁϥⲭⲱ	ⲉⲧ|ⲁ|ϥ|ⲭⲱ
ⲉϫⲉⲛⲛⲉⲛⲃⲁⲗ	ⲉϫⲉⲛ|ⲛⲉⲛ|ⲃⲁⲗ
ⲁⲩⲕⲟⲥϥ	ⲁ|ⲩ|ⲕⲟⲥ|ϥ
ϧⲉⲛⲟⲩⲱⲟⲩ	ϧⲉⲛ|ⲟⲩ|ⲱⲟⲩ
ⲛⲉⲙⲟⲩⲧⲁⲓⲟ	ⲛⲉⲙ|ⲟⲩ|ⲧⲁⲓⲟ
ⲁⲩⲉⲣⲡⲓⲉϫⲱⲣϩ	ⲁ|ⲩ|ⲉⲣ|ⲡⲓ|ⲉϫⲱⲣϩ
ⲉⲩⲉⲣⲯⲁⲗⲗⲉⲓⲛ	ⲉ|ⲩ|ⲉⲣⲯⲁⲗⲗⲉⲓⲛ
ⲛⲉⲙⲛⲓⲕⲗⲏⲣⲓⲕⲟⲥ	ⲛⲉⲙ|ⲛⲓ|ⲕⲗⲏⲣⲓⲕⲟⲥ
ⲉⲧⲁϣⲱⲣⲡ	ⲉⲧ|ⲁ|ϣⲱⲣⲡ
ⲁⲟⲩⲛⲓϣϯ	ⲁ|ⲟⲩ|ⲛⲓϣϯ
ⲛⲗⲁⲟⲥ	ⲛ|ⲗⲁⲟⲥ
ⲑⲱⲟⲩϯ	ⲑⲱⲟⲩϯ
ⲙⲡⲓϣⲉⲙϣⲓ	ⲙ|ⲡⲓ|ϣⲉⲙϣⲓ
ⲁⲡⲓⲗⲁⲟⲥ	ⲁ|ⲡⲓ|ⲗⲁⲟⲥ
ⲛⲉⲙⲡⲓⲥⲛⲟϥ	ⲛⲉⲙ|ⲡⲓ|ⲥⲛⲟϥ
ϧⲁⲧⲉⲛⲡⲉϥϣⲫⲏⲣ	ϧⲁⲧⲉⲛ|ⲡⲉϥ|ϣⲫⲏⲣ
ⲡⲉϥⲥⲱⲙⲁ	ⲡⲉϥ|ⲥⲱⲙⲁ
ϧⲁⲧⲟⲧⲉⲛ	ϧⲁⲧⲟⲧ|ⲉⲛ
ⲡⲉϥⲡⲛⲉⲩⲙⲁ	ⲡⲉϥ|ⲡⲛⲉⲩⲙⲁ
ϧⲉⲛⲛⲓⲫⲏⲟⲩⲓ	ϧⲉⲛ|ⲛⲓ|ⲫⲏⲟⲩⲓ
ⲉϥⲉⲣⲡⲣⲉⲥⲃⲉⲩⲓⲛ	ⲉ|ϥ|ⲉⲣⲡⲣⲉⲥⲃⲉⲩⲓⲛ
ⲧⲉⲛⲛⲁϩϯ	ⲧⲉⲛ|ⲛⲁϩϯ
ϫⲉⲛⲏ	ϫⲉ|ⲛⲏ
ⲛⲓⲡⲁⲧⲣⲓⲁⲣⲭⲏⲥ	ⲛⲓ|ⲡⲁⲧⲣⲓⲁⲣⲭⲏⲥ
ⲛⲉⲙⲛⲓⲁⲡⲟⲥⲧⲟⲗⲟⲥ	ⲛⲉⲙ|ⲛⲓ|ⲁⲡⲟⲥⲧⲟⲗⲟⲥ
ⲉⲥⲉϣⲱⲡⲓ	ⲉⲥⲉ|ϣⲱⲡⲓ
ⲧⲉⲛϣⲁϣⲛⲓ	ⲧⲉⲛ|ϣⲁϣⲛⲓ
ⲉⲟⲩⲛⲁⲓ	ⲉ|ⲟⲩ|ⲛⲁⲓ
ϩⲓⲧⲉⲛⲛⲉϥⲉⲩⲭⲏ	ϩⲓⲧⲉⲛ|ⲛⲉϥ|ⲉⲩⲭⲏ
ⲡⲉⲛϭⲟⲉⲓⲥ	ⲡⲉⲛ|ϭⲟⲉⲓⲥ
ⲉⲣⲉⲡⲓⲱⲟⲩ	ⲉⲣⲉ|ⲡⲓ|ⲱⲟⲩ
ⲉⲣⲡⲣⲉⲡⲓⲛ	ⲉⲣⲡⲣⲉⲡⲓⲛ
ⲛⲉⲙⲡⲉϥⲓⲱⲧ	ⲛⲉⲙ|ⲡⲉϥ|ⲓⲱⲧ
ⲛⲧⲉⲛⲓⲉⲛⲉϩ	ⲛⲧⲉ|ⲛⲓ|ⲉⲛⲉϩ
ⲛⲁⲉⲣⲧⲟⲗⲙⲁⲛ	ⲛⲁ|ⲉⲣⲧⲟⲗⲙⲁⲛ
ⲟⲩⲧⲱϥ	ⲟⲩⲧⲱ|ϥ
ⲛⲉⲙⲡⲉϥϣⲫⲏⲣ	ⲛⲉⲙ|ⲡⲉϥ|ϣⲫⲏⲣ
ⲉϭⲓϩⲁⲡ	ⲉ|ϭⲓϩⲁⲡ
ϩⲓⲛⲓⲣⲉϥϭⲓⲛϫⲟⲛⲥ	ϩⲓ|ⲛⲓ|ⲣⲉϥϭⲓⲛϫⲟⲛⲥ
ϩⲓⲛⲓⲁⲅⲓⲟⲥ	ϩⲓ|ⲛⲓ|ⲁⲅⲓⲟⲥ
ϫⲉⲛⲓⲁⲅⲓⲟⲥ	ϫⲉ|ⲛⲓ|ⲁⲅⲓⲟⲥ
ⲉⲑⲛⲁϯϩⲁⲡ	ⲉⲑ|ⲛⲁ|ϯϩⲁⲡ
ⲉⲡⲓⲕⲟⲥⲙⲟⲥ	ⲉ|ⲡⲓ|ⲕⲟⲥⲙⲟⲥ
ⲉⲩⲛⲁϯϩⲁⲡ	ⲉ|ⲩ|ⲛⲁ|ϯϩⲁⲡ
ⲛⲁⲣⲉⲧⲉⲛⲙⲡϣⲁ	ⲛⲁⲣⲉ|ⲧⲉⲛ|ⲙⲡϣⲁ
ϫⲉⲛϩⲁⲛⲕⲟⲩϫⲓ	ϫⲉ|ⲛ|ϩⲁⲛ|ⲕⲟⲩϫⲓ
ⲛⲧⲉⲧⲉⲛⲉⲙⲓ	ⲛ|ⲧⲉⲧⲉⲛ|ⲉⲙⲓ
ϫⲉⲉⲛⲛⲁϯϩⲁⲡ	ϫⲉ|ⲉ|ⲛ|ⲛⲁ|ϯϩⲁⲡ
ⲉϩⲁⲛⲁⲅⲅⲉⲗⲟⲥ	ⲉ|ϩⲁⲛ|ⲁⲅⲅⲉⲗⲟⲥ
ⲙⲏⲧⲓ	ⲙⲏⲧⲓ
ⲅⲉ	ⲅⲉ
ϩⲁⲛϩⲃⲏⲟⲩⲓ	ϩⲁⲛ|ϩⲃⲏⲟⲩⲓ
ⲛⲧⲉⲡⲁⲓⲃⲓⲟⲥ	ⲛⲧⲉ|ⲡⲁⲓ|ⲃⲓⲟⲥ
ⲉⲟⲩⲟⲛⲧⲱⲧⲉⲛ	ⲉ|ⲟⲩⲟⲛⲧⲱ|ⲧⲉⲛ
ⲛϩⲁⲛⲙⲁ	ⲛ|ϩⲁⲛ|ⲙⲁ
ⲉⲧϣⲏϣ	ⲉⲧ|ϣⲏϣ
ⲙⲁⲧϩⲉⲙⲥⲱⲟⲩ	ⲙⲁ|ⲧϩⲉⲙⲥⲱ|ⲟⲩ
ⲉⲓϫⲱ	ⲉ|ⲓ|ϫⲱ
ⲉⲩϫⲫⲓⲟ	ⲉ|ⲩ|ϫⲫⲓⲟ
ⲉⲟⲩⲟⲛϣϫⲟⲙ	ⲉ|ⲟⲩⲟⲛ|ϣϫⲟⲙ
ⲉⲉⲣⲇⲓⲁⲕⲣⲓⲛⲓⲛ	ⲉ|ⲉⲣⲇⲓⲁⲕⲣⲓⲛⲓⲛ
ⲟⲩⲧⲉⲡⲉϥⲥⲟⲛ	ⲟⲩⲧⲉ|ⲡⲉϥ|ⲥⲟⲛ
ⲛⲉⲙⲟⲩⲥⲟⲛ	ⲛⲉⲙ|ⲟⲩ|ⲥⲟⲛ
ⲉϥϭⲓϩⲁⲡ	ⲉ|ϥ|ϭⲓϩⲁⲡ
ϩⲓⲛⲓⲁⲑⲛⲁϩϯ	ϩⲓ|ⲛⲓ|ⲁⲑⲛⲁϩϯ
ϩⲟⲗⲱⲥ	ϩⲟⲗⲱⲥ
ⲟⲩⲑⲉⲃⲓⲟ	ⲟⲩ|ⲑⲉⲃⲓⲟ
ϫⲉⲟⲩⲟⲛⲧⲉⲧⲉⲛ	ϫⲉ|ⲟⲩⲟⲛⲧⲉ|ⲧⲉⲛ
ϩⲁⲡ	ϩⲁⲡ
ⲟⲩⲧⲱⲧⲉⲛ	ⲟⲩⲧⲱ|ⲧⲉⲛ
ⲛⲉⲙⲛⲉⲧⲉⲛⲉⲣⲏⲟⲩ	ⲛⲉⲙ|ⲛⲉⲧⲉⲛ|ⲉⲣⲏⲟⲩ
ⲥⲉϭⲓ	ⲥⲉ|ϭⲓ
ⲥⲉϥⲱϫⲓ	ⲥⲉ|ϥⲱϫⲓ
ⲉⲧϭⲓ	ⲉⲧ|ϭⲓ
ⲉⲧϥⲱϫⲓ	ⲉⲧ|ϥⲱϫⲓ
ⲛⲛⲉⲧⲉⲛⲥⲛⲏⲟⲩ	ⲛ|ⲛⲉⲧⲉⲛ|ⲥⲛⲏⲟⲩ
ϫⲉⲛⲓⲣⲉϥϭⲓ	ϫⲉ|ⲛⲓ|ⲣⲉϥϭⲓ
ϯⲙⲉⲧⲟⲩⲣⲟ	ϯ|ⲙⲉⲧⲟⲩⲣⲟ
ⲥⲉⲛⲁⲉⲣⲕⲗⲏⲣⲟⲛⲟⲙⲓⲛ	ⲥⲉ|ⲛⲁ|ⲉⲣⲕⲗⲏⲣⲟⲛⲟⲙⲓⲛ
ⲙⲡⲉⲣⲥⲱⲣⲉⲙ	ⲙⲡⲉⲣ|ⲥⲱⲣⲉⲙ
ⲡⲟⲣⲛⲟⲥ	ⲡⲟⲣⲛⲟⲥ
ⲣⲉϥϣⲁⲙϣⲉⲓⲇⲱⲗⲟⲛ	ⲣⲉϥϣⲁⲙϣⲉⲓⲇⲱⲗⲟⲛ
ⲙⲁⲗⲁⲕⲟⲥ	ⲙⲁⲗⲁⲕⲟⲥ
ⲣⲉϥⲉⲛⲕⲟⲧ	ⲣⲉϥⲉⲛⲕⲟⲧ
ⲛⲉⲙϩⲱⲟⲩⲧ	ⲛⲉⲙ|ϩⲱⲟⲩⲧ
ⲣⲉϥϭⲓⲟⲩⲓ	ⲣⲉϥϭⲓⲟⲩⲓ
ⲣⲉϥϭⲓ	ⲣⲉϥϭⲓ
ⲣⲉϥⲑⲓϧⲓ	ⲣⲉϥⲑⲓϧⲓ
ⲣⲉϥϯϣⲱϣ	ⲣⲉϥϯϣⲱϣ
ⲣⲉϥϩⲱⲗⲉⲙ	ⲣⲉϥϩⲱⲗⲉⲙ
ⲧⲁⲩⲧⲁ	ⲧⲁⲩⲧⲁ
ⲛⲉⲛⲑⲱⲧⲉⲛϩⲁⲛⲟⲩⲟⲛ	ⲛⲉ|ⲛⲑⲱⲧⲉⲛ|ϩⲁⲛ|ⲟⲩⲟⲛ
ⲁⲩϫⲉⲕⲉⲙⲑⲏⲛⲟⲩ	ⲁ|ⲩ|ϫⲉⲕⲉⲙ|ⲑⲏⲛⲟⲩ
ⲁⲩⲧⲟⲩⲃⲉⲑⲏⲛⲟⲩ	ⲁ|ⲩ|ⲧⲟⲩⲃⲉ|ⲑⲏⲛⲟⲩ
ⲁⲩⲑⲙⲁⲓⲉⲑⲏⲛⲟⲩ	ⲁ|ⲩ|ⲑⲙⲁⲓⲉ|ⲑⲏⲛⲟⲩ
ⲛⲉⲙϧⲉⲛⲡⲓⲡⲛⲉⲩⲙⲁ	ⲛⲉⲙ|ϧⲉⲛ|ⲡⲓ|ⲡⲛⲉⲩⲙⲁ
ⲛⲧⲉⲡⲉⲧⲉⲛⲛⲟⲩϯ	ⲛⲧⲉ|ⲡⲉⲧⲉⲛ|ⲛⲟⲩϯ
ⲥⲉⲉⲣⲛⲟϥⲣⲓ	ⲥⲉ|ⲉⲣⲛⲟϥⲣⲓ
ⲛⲛⲉϣ	ⲛ|ⲛⲉϣ
ⲓⲣⲓ	ⲓⲣⲓ
ⲙⲡⲁⲉⲣϣⲓϣⲓ	ⲙ|ⲡⲁ|ⲉⲣϣⲓϣⲓ
ⲛⲓϧⲣⲏⲟⲩⲓ	ⲛⲓ|ϧⲣⲏⲟⲩⲓ
ⲁⲩⲭⲏ	ⲁ|ⲩ|ⲭⲏ
ⲛϯⲛⲉϫⲓ	ⲛ|ϯ|ⲛⲉϫⲓ
ϯⲛⲉϫⲓ	ϯ|ⲛⲉϫⲓ
ⲛⲁⲕⲟⲣϥⲟⲩ	ⲛⲁ|ⲕⲟⲣϥ|ⲟⲩ
ⲛϯⲡⲟⲣⲛⲓⲁ	ⲛ|ϯ|ⲡⲟⲣⲛⲓⲁ
ⲁϥⲧⲟⲩⲛⲟⲥⲡⲉⲛϭⲟⲓⲥ	ⲁ|ϥ|ⲧⲟⲩⲛⲟⲥ|ⲡⲉⲛ|ϭⲟⲓⲥ
ϩⲱⲛ	ϩⲱ|ⲛ
ⲉϥⲉⲧⲟⲩⲛⲟⲥⲧⲉⲛ	ⲉϥⲉ|ⲧⲟⲩⲛⲟⲥ|ⲧⲉⲛ
ϩⲓⲧⲉⲛⲧⲉϥϫⲟⲙ	ϩⲓⲧⲉⲛ|ⲧⲉϥ|ϫⲟⲙ
ϫⲉⲛⲉⲧⲉⲛⲥⲱⲙⲁ	ϫⲉ|ⲛⲉⲧⲉⲛ|ⲥⲱⲙⲁ
ϩⲁⲛⲙⲉⲗⲟⲥ	ϩⲁⲛ|ⲙⲉⲗⲟⲥ
ⲛⲧⲁⲱⲗⲓ	ⲛ|ⲧⲁ|ⲱⲗⲓ
ⲛⲧⲁⲁⲓⲧⲟⲩ	ⲛ|ⲧⲁ|ⲁⲓⲧ|ⲟⲩ
ⲙⲡⲟⲣⲛⲏ	ⲙ|ⲡⲟⲣⲛⲏ
ⲛⲛⲉⲥϣⲱⲡⲓ	ⲛⲛⲉ|ⲥ|ϣⲱⲡⲓ
ⲉⲧⲧⲱⲙⲓ	ⲉⲧ|ⲧⲱⲙⲓ
ⲉϯⲡⲟⲣⲛⲏ	ⲉ|ϯ|ⲡⲟⲣⲛⲏ
ⲟⲩⲥⲱⲙⲁ	ⲟⲩ|ⲥⲱⲙⲁ
ⲉⲩⲉϣⲱⲡⲓ	ⲉⲩⲉ|ϣⲱⲡⲓ
ⲉⲩⲥⲁⲣⲝ	ⲉ|ⲩ|ⲥⲁⲣⲝ
ⲛⲟⲃⲓ	ⲛⲟⲃⲓ
ϥⲥⲁⲃⲟⲗ	ϥ|ⲥⲁⲃⲟⲗ
ⲉⲧⲉⲣⲡⲟⲣⲛⲉⲩⲓⲛ	ⲉⲧ|ⲉⲣⲡⲟⲣⲛⲉⲩⲓⲛ
ⲁϥⲉⲣⲛⲟⲃⲓ	ⲁ|ϥ|ⲉⲣⲛⲟⲃⲓ
ⲉⲡⲉϥⲥⲱⲙⲁ	ⲉ|ⲡⲉϥ|ⲥⲱⲙⲁ
ⲟⲩⲉⲣⲫⲉⲓ	ⲟⲩ|ⲉⲣⲫⲉⲓ
ⲉⲧⲁⲣⲉⲧⲉⲛϭⲓⲧϥ	ⲉⲧ|ⲁⲣⲉ|ⲧⲉⲛ|ϭⲓⲧ|ϥ
ⲛⲧⲉⲛⲫⲛⲟⲩϯ	ⲛⲧⲉⲛ|ⲫ|ⲛⲟⲩϯ
ⲫⲱⲧⲉⲧⲉⲛ	ⲫⲱⲧⲉⲧⲉⲛ
ⲙⲁⲱⲟⲩ	ⲙⲁⲱⲟⲩ
ϧⲉⲛⲛⲉⲧⲉⲛⲥⲱⲙⲁ	ϧⲉⲛ|ⲛⲉⲧⲉⲛ|ⲥⲱⲙⲁ
ⲉⲡⲓⲉⲩⲁⲅⲅⲉⲗⲓⲟⲛ	ⲉ|ⲡⲓ|ⲉⲩⲁⲅⲅⲉⲗⲓⲟⲛ
ⲉⲧⲁⲓϩⲓϣⲉⲛⲛⲟⲩϥⲓ	ⲉⲧ|ⲁ|ⲓ|ϩⲓϣⲉⲛⲛⲟⲩϥⲓ
ⲉⲧⲉⲫⲏ	ⲉⲧⲉ|ⲫⲏ
ⲉⲧⲉⲧⲉⲛⲟϩⲓ	ⲉ|ⲧⲉⲧⲉⲛ|ⲟϩⲓ
ⲉⲧⲉⲧⲉⲛⲛⲁⲛⲟϩⲉⲙ	ⲉ|ⲧⲉⲧⲉⲛ|ⲛⲁ|ⲛⲟϩⲉⲙ
ϫⲉϧⲉⲛⲟⲩⲥⲁϫⲓ	ϫⲉ|ϧⲉⲛ|ⲟⲩ|ⲥⲁϫⲓ
ⲁⲓϩⲓϣⲉⲛⲛⲟⲩϥⲓ	ⲁ|ⲓ|ϩⲓϣⲉⲛⲛⲟⲩϥⲓ
ⲓⲥϫⲉⲧⲉⲧⲉⲛⲁⲙⲟⲛⲓ	ⲓⲥϫⲉ|ⲧⲉⲧⲉⲛ|ⲁⲙⲟⲛⲓ
ⲓⲙⲏⲧⲓ	ⲓⲙⲏⲧⲓ
ϩⲓⲕⲏ	ϩⲓ|ⲕⲏ
ⲁⲣⲉⲧⲉⲛⲛⲁϩϯ	ⲁⲣⲉ|ⲧⲉⲛ|ⲛⲁϩϯ
ⲉⲧⲁⲓϭⲓⲧϥ	ⲉⲧ|ⲁ|ⲓ|ϭⲓⲧ|ϥ
ϫⲉⲡⲭⲣⲓⲥⲧⲟⲥ	ϫⲉ|ⲡ|ⲭⲣⲓⲥⲧⲟⲥ
ⲉϫⲉⲛⲛⲉⲛⲛⲟⲃⲓ	ⲉϫⲉⲛ|ⲛⲉⲛ|ⲛⲟⲃⲓ
ⲕⲁⲧⲁⲛⲓⲅⲣⲁⲫⲏ	ⲕⲁⲧⲁ|ⲛⲓ|ⲅⲣⲁⲫⲏ
ϫⲉⲁⲩⲕⲟⲥϥ	ϫⲉ|ⲁ|ⲩ|ⲕⲟⲥ|ϥ
ϫⲉⲁϥⲧⲱⲛϥ	ϫⲉ|ⲁ|ϥ|ⲧⲱⲛ|ϥ
ⲙⲙⲁϩⲅ	ⲙ|ⲙⲁϩⲅ
ⲉⲕⲏⲫⲁ	ⲉ|ⲕⲏⲫⲁ
ⲛⲫ	ⲛ|ⲫ
ⲉⲩⲥⲟⲡ	ⲉ|ⲩ|ⲥⲟⲡ
ⲉⲧⲉⲡⲟⲩϩⲟⲩⲟ	ⲉⲧⲉ|ⲡⲟⲩ|ϩⲟⲩⲟ
ⲉϯⲛⲟⲩ	ⲉ|ϯⲛⲟⲩ
ⲁⲩⲉⲛⲕⲟⲧ	ⲁ|ⲩ|ⲉⲛⲕⲟⲧ
ⲉⲓⲁⲕⲱⲃⲟⲥ	ⲉ|ⲓⲁⲕⲱⲃⲟⲥ
ⲉⲡϧⲁⲉ	ⲉ|ⲡ|ϧⲁⲉ
ⲙⲡⲓⲟⲩϧⲉ	ⲙ|ⲡⲓ|ⲟⲩϧⲉ
ⲛⲓⲁⲡⲟⲥⲧⲟⲗⲟⲥ	ⲛⲓ|ⲁⲡⲟⲥⲧⲟⲗⲟⲥ
ⲛϯⲉⲙⲡϣⲁ	ⲛ|ϯ|ⲉⲙⲡϣⲁ
ⲉⲑⲣⲟⲩⲙⲟⲩϯ	ⲉ|ⲑⲣⲟ|ⲩ|ⲙⲟⲩϯ
ϫⲉⲁⲡⲟⲥⲧⲟⲗⲟⲥ	ϫⲉ|ⲁⲡⲟⲥⲧⲟⲗⲟⲥ
ⲉⲑⲃⲉϫⲉⲁⲓϭⲟϫⲓ	ⲉⲑⲃⲉ|ϫⲉ|ⲁ|ⲓ|ϭⲟϫⲓ
ⲛⲥⲁϯⲉⲕⲕⲗⲏⲥⲓⲁ	ⲛⲥⲁ|ϯ|ⲉⲕⲕⲗⲏⲥⲓⲁ
ϧⲉⲛⲟⲩϩⲙⲟⲧ	ϧⲉⲛ|ⲟⲩ|ϩⲙⲟⲧ
ϯⲟⲓ	ϯ|ⲟⲓ
ⲙⲡⲉϯⲟⲓ	ⲙⲡⲉ|ϯ|ⲟⲓ
ⲡⲉϥϩⲙⲟⲧ	ⲡⲉϥ|ϩⲙⲟⲧ
ⲉⲧⲉⲛϧⲏⲧ	ⲉⲧⲉ|ⲛϧⲏⲧ
ⲙⲡⲉϥϣⲱⲡⲓ	ⲙⲡⲉ|ϥ|ϣⲱⲡⲓ
ⲁⲓϭⲓϧⲓⲥⲓ	ⲁ|ⲓ|ϭⲓϧⲓⲥⲓ
ⲡⲓϩⲙⲟⲧ	ⲡⲓ|ϩⲙⲟⲧ
ⲁⲧⲉⲧⲉⲛⲛⲁϩϯ	ⲁ|ⲧⲉⲧⲉⲛ|ⲛⲁϩϯ
ⲥⲉϩⲓⲱⲓϣ	ⲥⲉ|ϩⲓⲱⲓϣ
ⲉⲧⲙⲱⲟⲩⲧ	ⲉⲧ|ⲙⲱⲟⲩⲧ
ϫⲉⲙⲙⲟⲛⲁⲛⲁⲥⲧⲁⲥⲓⲥ	ϫⲉ|ⲙⲙⲟⲛ|ⲁⲛⲁⲥⲧⲁⲥⲓⲥ
ⲛⲧⲉⲛⲓⲣⲉϥⲙⲱⲟⲩⲧ	ⲛⲧⲉ|ⲛⲓ|ⲣⲉϥⲙⲱⲟⲩⲧ
ⲙⲙⲟⲛⲁⲛⲁⲥⲧⲁⲥⲓⲥ	ⲙⲙⲟⲛ|ⲁⲛⲁⲥⲧⲁⲥⲓⲥ
ⲙⲡⲉⲡⲭⲣⲓⲥⲧⲟⲥ	ⲙⲡⲉ|ⲡ|ⲭⲣⲓⲥⲧⲟⲥ
ϥϣⲟⲩⲓⲧ	ϥ|ϣⲟⲩⲓⲧ
ⲛϫⲉⲡⲉⲛϩⲓⲱⲓϣ	ⲛϫⲉ|ⲡⲉⲛ|ϩⲓⲱⲓϣ
ⲛϫⲉⲡⲉⲧⲉⲛⲕⲉⲛⲁϩϯ	ⲛϫⲉ|ⲡⲉⲧⲉⲛ|ⲕⲉ|ⲛⲁϩϯ
ⲥⲉⲛⲁϫⲉⲙⲉⲛ	ⲥⲉ|ⲛⲁ|ϫⲉⲙ|ⲉⲛ
ϧⲁⲫⲛⲟⲩϯ	ϧⲁ|ⲫ|ⲛⲟⲩϯ
ϫⲉⲁⲛⲉⲣⲙⲉⲑⲣⲉ	ϫⲉ|ⲁ|ⲛ|ⲉⲣⲙⲉⲑⲣⲉ
ϫⲉⲁϥⲧⲟⲩⲛⲟⲥ	ϫⲉ|ⲁ|ϥ|ⲧⲟⲩⲛⲟⲥ
ⲉⲧⲉⲙⲡⲉϥⲧⲟⲩⲛⲟⲥϥ	ⲉⲧⲉ|ⲙⲡⲉ|ϥ|ⲧⲟⲩⲛⲟⲥ|ϥ
ⲛⲓⲣⲉϥⲙⲱⲟⲩⲧ	ⲛⲓ|ⲣⲉϥⲙⲱⲟⲩⲧ
ⲟⲩⲉⲫⲗⲏⲟⲩ	ⲟⲩ|ⲉⲫⲗⲏⲟⲩ
ⲡⲉⲧⲉⲛⲛⲁϩϯ	ⲡⲉⲧⲉⲛ|ⲛⲁϩϯ
ⲧⲉⲧⲉⲛⲭⲏ	ⲧⲉⲧⲉⲛ|ⲭⲏ
ϧⲉⲛⲛⲉⲧⲉⲛⲛⲟⲃⲓ	ϧⲉⲛ|ⲛⲉⲧⲉⲛ|ⲛⲟⲃⲓ
ⲉⲧⲁⲩⲉⲛⲕⲟⲧ	ⲉⲧ|ⲁ|ⲩ|ⲉⲛⲕⲟⲧ
ϧⲉⲛⲡⲁⲓⲱⲛϧ	ϧⲉⲛ|ⲡⲁⲓ|ⲱⲛϧ
ⲁⲛⲉⲣϩⲉⲗⲡⲓⲥ	ⲁ|ⲛ|ⲉⲣϩⲉⲗⲡⲓⲥ
ⲛⲟⲩⲛⲁⲓ	ⲛ|ⲟⲩ|ⲛⲁⲓ
ⲣⲱⲙⲓ	ⲣⲱⲙⲓ
ⲁⲡⲭⲣⲓⲥⲧⲟⲥ	ⲁ|ⲡ|ⲭⲣⲓⲥⲧⲟⲥ
ⲧⲁⲡⲁⲣⲭⲏ	ⲧ|ⲁⲡⲁⲣⲭⲏ
ϩⲓⲧⲉⲛⲟⲩⲣⲱⲙⲓ	ϩⲓⲧⲉⲛ|ⲟⲩ|ⲣⲱⲙⲓ
ⲁⲫⲙⲟⲩ	ⲁ|ⲫ|ⲙⲟⲩ
ϩⲓⲧⲉⲛⲕⲉⲣⲱⲙⲓ	ϩⲓⲧⲉⲛ|ⲕⲉ|ⲣⲱⲙⲓ
ⲧⲁⲛⲁⲥⲧⲁⲥⲓⲥ	ⲧ|ⲁⲛⲁⲥⲧⲁⲥⲓⲥ
ⲉⲧⲉϧⲉⲛⲁⲇⲁⲙ	ⲉⲧⲉ|ϧⲉⲛ|ⲁⲇⲁⲙ
ⲥⲉⲛⲁⲙⲟⲩ	ⲥⲉ|ⲛⲁ|ⲙⲟⲩ
ⲥⲉⲛⲁⲱⲛϧ	ⲥⲉ|ⲛⲁ|ⲱⲛϧ
ϧⲉⲛⲡⲉϥⲧⲁⲅⲙⲁ	ϧⲉⲛ|ⲡⲉϥ|ⲧⲁⲅⲙⲁ
ⲁⲡⲁⲣⲭⲏ	ⲁ|ⲡ|ⲁⲣⲭⲏ
ϧⲉⲛⲡⲉϥϫⲓⲛⲓ	ϧⲉⲛ|ⲡⲉϥ|ϫⲓⲛⲓ
ⲛⲁⲡⲓϫⲱⲕ	ⲛⲁ|ⲡⲓ|ϫⲱⲕ
ⲁϥϣⲁⲛϯ	ⲁϥϣⲁⲛ|ϯ
ⲁϥϣⲁⲛⲕⲱⲣϥ	ⲁϥϣⲁⲛ|ⲕⲱⲣϥ
ⲛⲁⲣⲭⲏ	ⲛ|ⲁⲣⲭⲏ
ⲛⲉⲙⲉⲝⲟⲩⲥⲓⲁ	ⲛⲉⲙ|ⲉⲝⲟⲩⲥⲓⲁ
ⲛⲉⲙϫⲟⲙ	ⲛⲉⲙ|ϫⲟⲙ
ϩⲱϯ	ϩⲱϯ
ⲛⲧⲉϥⲉⲣⲟⲩⲣⲟ	ⲛⲧⲉ|ϥ|ⲉⲣⲟⲩⲣⲟ
ϣⲁⲧⲉϥⲭⲁⲛⲉϥϫⲁϫⲓ	ϣⲁⲧⲉ|ϥ|ⲭⲁ|ⲛⲉϥ|ϫⲁϫⲓ
ⲛⲛⲉϥϭⲁⲗⲁⲩϫ	ⲛ|ⲛⲉϥ|ϭⲁⲗⲁⲩϫ
ⲡⲓϧⲁⲉ	ⲡⲓ|ϧⲁⲉ
ⲛϫⲁϫⲓ	ⲛ|ϫⲁϫⲓ
ϥⲛⲁⲕⲱⲣϥϥ	ϥ|ⲛⲁ|ⲕⲱⲣϥ|ϥ
ⲉⲧⲉⲫⲙⲟⲩ	ⲉⲧⲉ|ⲫ|ⲙⲟⲩ
ⲁϥⲉⲑⲣⲉⲉⲛⲭⲁⲓ	ⲁ|ϥ|ⲉⲑⲣⲉ|ⲉⲛⲭⲁⲓ
ϭⲛⲉϫⲱⲟⲩ	ϭⲛⲉϫⲱ|ⲟⲩ
ⲁϥϣⲁⲛϫⲟⲥ	ⲁϥϣⲁⲛ|ϫⲟⲥ
ϫⲉⲁⲉⲛⲭⲁⲓ	ϫⲉ|ⲁ|ⲉⲛⲭⲁⲓ
ϥⲟⲩⲟⲛϩ	ϥ|ⲟⲩⲟⲛϩ
ϫⲉϣⲁⲧⲉⲛⲫⲏ	ϫⲉ|ϣⲁⲧⲉⲛ|ⲫⲏ
ⲉⲧⲁϥⲑⲣⲉⲉⲛⲭⲁⲓ	ⲉⲧ|ⲁ|ϥ|ⲑⲣⲉ|ⲉⲛⲭⲁⲓ
ⲁⲣⲉϣⲁⲛⲉⲛⲭⲁⲓ	ⲁⲣⲉϣⲁⲛ|ⲉⲛⲭⲁⲓ
ⲡⲓϣⲏⲣⲓ	ⲡⲓ|ϣⲏⲣⲓ
ⲉϥⲉϭⲛⲉϫⲱϥ	ⲉϥⲉ|ϭⲛⲉϫⲱ|ϥ
ⲉⲙⲙⲟⲛ	ⲉ|ⲙⲙⲟⲛ
ⲡⲉⲧⲟⲩⲛⲁⲁⲓϥ	ⲡ|ⲉⲧ|ⲟⲩ|ⲛⲁ|ⲁⲓ|ϥ
ⲉⲧϭⲓⲱⲙⲥ	ⲉⲧ|ϭⲓⲱⲙⲥ
ⲉϫⲉⲛⲛⲓⲣⲉϥⲙⲱⲟⲩⲧ	ⲉϫⲉⲛ|ⲛⲓ|ⲣⲉϥⲙⲱⲟⲩⲧ
ⲥⲉⲉⲣⲡⲕⲉϭⲓⲱⲙⲥ	ⲥⲉ|ⲉⲣⲡⲕⲉ|ϭⲓⲱⲙⲥ
ⲧⲉⲛⲉⲣⲕⲩⲛⲇⲓⲛⲉⲩⲓⲛ	ⲧⲉⲛ|ⲉⲣⲕⲩⲛⲇⲓⲛⲉⲩⲓⲛ
ϯⲙⲱⲟⲩⲧ	ϯ|ⲙⲱⲟⲩⲧ
ϣⲁⲡⲉⲧⲉⲛϣⲟⲩϣⲟⲩ	ϣⲁ|ⲡⲉⲧⲉⲛ|ϣⲟⲩϣⲟⲩ
ⲉⲧⲉⲛⲧⲏⲓ	ⲉⲧⲉ|ⲛⲧⲏ|ⲓ
ⲓⲥϫⲉϧⲉⲛⲟⲩⲙⲉⲧⲣⲱⲙⲓ	ⲓⲥϫⲉ|ϧⲉⲛ|ⲟⲩ|ⲙⲉⲧⲣⲱⲙⲓ
ⲟⲩⲃⲉⲡⲓⲑⲏⲣⲓⲟⲛ	ⲟⲩⲃⲉ|ⲡⲓ|ⲑⲏⲣⲓⲟⲛ
ⲡⲁϩⲏⲟⲩ	ⲡⲁ|ϩⲏⲟⲩ
ⲓⲥϫⲉⲛⲓⲣⲉϥⲙⲱⲟⲩⲧ	ⲓⲥϫⲉ|ⲛⲓ|ⲣⲉϥⲙⲱⲟⲩⲧ
ⲙⲁⲣⲉⲛⲟⲩⲱⲙ	ⲙⲁⲣⲉ|ⲛ|ⲟⲩⲱⲙ
ⲛⲧⲉⲛⲥⲱ	ⲛⲧⲉ|ⲛ|ⲥⲱ
ⲣⲁⲥϯ	ⲣⲁⲥϯ
ⲧⲉⲛⲛⲁⲙⲟⲩ	ⲧⲉⲛ|ⲛⲁ|ⲙⲟⲩ
ⲙⲡⲣⲥⲱⲣⲉⲙ	ⲙⲡⲣ|ⲥⲱⲣⲉⲙ
ϣⲁⲣⲉⲛⲓⲥⲁϫⲓ	ϣⲁⲣⲉ|ⲛⲓ|ⲥⲁϫⲓ
ϣⲁⲩⲧⲁⲕⲉ	ϣⲁ|ⲩ|ⲧⲁⲕⲉ
ⲛⲓϩⲏⲧ	ⲛⲓ|ϩⲏⲧ
ⲉⲧⲛⲁⲛⲉⲩ	ⲉⲧ|ⲛⲁⲛⲉ|ⲩ
ⲉⲣⲉⲧⲉⲛⲣⲏⲥ	ⲉⲣⲉ|ⲧⲉⲛ|ⲣⲏⲥ
ϧⲉⲛⲟⲩⲙⲉⲑⲙⲏⲓ	ϧⲉⲛ|ⲟⲩ|ⲙⲉⲑⲙⲏⲓ
ⲙⲡⲣⲉⲣⲛⲟⲃⲓ	ⲙⲡⲣ|ⲉⲣⲛⲟⲃⲓ
ⲟⲩⲙⲉⲧⲁⲧⲥⲟⲩⲉⲛ	ⲟⲩ|ⲙⲉⲧⲁⲧⲥⲟⲩⲉⲛ
ϧⲉⲛϩⲁⲛⲟⲩⲟⲛ	ϧⲉⲛ|ϩⲁⲛ|ⲟⲩⲟⲛ
ⲁⲓⲥⲁϫⲓ	ⲁ|ⲓ|ⲥⲁϫⲓ
ϧⲉⲛⲟⲩϫⲫⲓⲟ	ϧⲉⲛ|ⲟⲩ|ϫⲫⲓⲟ
ⲛⲁϫⲟⲥ	ⲛⲁ|ϫⲟⲥ
ⲁⲩⲛⲏⲟⲩ	ⲁ|ⲩ|ⲛⲏⲟⲩ
ϧⲉⲛⲁϣ	ϧⲉⲛ|ⲁϣ
ⲡⲓⲁⲧϩⲏⲧ	ⲡⲓ|ⲁⲧϩⲏⲧ
ⲡⲉⲧⲉⲕⲥⲓϯ	ⲡ|ⲉⲧⲉ|ⲕ|ⲥⲓϯ
ⲙⲡⲁϥⲱⲛϧ	ⲙⲡⲁ|ϥ|ⲱⲛϧ
ⲁϥϣⲧⲉⲙⲙⲟⲩ	ⲁ|ϥ|ϣⲧⲉⲙ|ⲙⲟⲩ
ⲉⲧⲛⲁϣⲱⲡⲓ	ⲉⲧ|ⲛⲁ|ϣⲱⲡⲓ
ⲟⲩⲛⲁⲫⲣⲓ	ⲟⲩ|ⲛⲁⲫⲣⲓ
ⲉⲥⲃⲏϣ	ⲉ|ⲥ|ⲃⲏϣ
ⲟⲩⲥⲟⲩⲟ	ⲟⲩ|ⲥⲟⲩⲟ
ⲙⲡⲥⲉⲡⲓ	ⲙⲡ|ⲥ|ⲉⲡⲓ
ⲛⲛⲓϫⲱⲣϫ	ⲛ|ⲛⲓ|ϫⲱⲣϫ
ϣⲁϥϯ	ϣⲁ|ϥ|ϯ
ⲥⲱⲙⲁ	ⲥⲱⲙⲁ
ϥϯ	ϥ|ϯ
ⲙⲡⲟⲩⲥⲱⲙⲁ	ⲙ|ⲡⲟⲩ|ⲥⲱⲙⲁ
ⲙⲙⲓⲛ	ⲙⲙⲓⲛ
ⲥⲁⲣⲝ	ⲥⲁⲣⲝ
ⲧⲁⲓⲥⲁⲣⲝ	ⲧⲁⲓ|ⲥⲁⲣⲝ
ⲟⲩⲉⲧⲥⲁⲣⲝ	ⲟⲩⲉⲧ|ⲥⲁⲣⲝ
ⲛⲧⲉⲛⲓⲧⲉⲃⲛⲱⲟⲩⲓ	ⲛⲧⲉ|ⲛⲓ|ⲧⲉⲃⲛⲱⲟⲩⲓ
ⲛⲧⲉⲛⲓϩⲁⲗⲁϯ	ⲛⲧⲉ|ⲛⲓ|ϩⲁⲗⲁϯ
ⲟⲩⲉⲧⲑⲁⲛⲓⲧⲉⲃⲧ	ⲟⲩⲉⲧ|ⲑⲁ|ⲛⲓ|ⲧⲉⲃⲧ
ⲟⲩⲟⲛⲟⲩⲥⲱⲙⲁ	ⲟⲩⲟⲛ|ⲟⲩ|ⲥⲱⲙⲁ
ⲟⲩⲉⲧⲡⲱⲟⲩ	ⲟⲩⲉⲧ|ⲡ|ⲱⲟⲩ
ⲛⲧⲉⲛⲁⲧⲫⲉ	ⲛⲧⲉ|ⲛⲁ|ⲧ|ⲫⲉ
ⲛⲧⲉⲛⲁⲡⲕⲁϩⲓ	ⲛⲧⲉ|ⲛⲁ|ⲡ|ⲕⲁϩⲓ
ⲙⲫⲣⲏ	ⲙ|ⲫ|ⲣⲏ
ⲙⲡⲓⲓⲟϩ	ⲙ|ⲡⲓ|ⲓⲟϩ
ⲛⲛⲓⲥⲓⲟⲩ	ⲛ|ⲛⲓ|ⲥⲓⲟⲩ
ⲟⲩⲟⲛⲟⲩⲥⲓⲟⲩ	ⲟⲩⲟⲛ|ⲟⲩ|ⲥⲓⲟⲩ
ⲉϥⲟⲩⲟⲧ	ⲉ|ϥ|ⲟⲩⲟⲧ
ⲉⲥⲓⲟⲩ	ⲉ|ⲥⲓⲟⲩ
ϧⲉⲛⲡⲉϥⲱⲟⲩ	ϧⲉⲛ|ⲡⲉϥ|ⲱⲟⲩ
ϯⲕⲉⲁⲛⲁⲥⲧⲁⲥⲓⲥ	ϯ|ⲕⲉ|ⲁⲛⲁⲥⲧⲁⲥⲓⲥ
ⲥⲉⲥⲓϯ	ⲥⲉ|ⲥⲓϯ
ϧⲉⲛⲟⲩⲧⲁⲕⲟ	ϧⲉⲛ|ⲟⲩ|ⲧⲁⲕⲟ
ⲥⲛⲁⲧⲱⲛⲥ	ⲥ|ⲛⲁ|ⲧⲱⲛ|ⲥ
ϧⲉⲛⲟⲩⲙⲉⲧⲁⲧⲧⲁⲕⲟ	ϧⲉⲛ|ⲟⲩ|ⲙⲉⲧⲁⲧⲧⲁⲕⲟ
ϧⲉⲛⲟⲩϣⲱϣ	ϧⲉⲛ|ⲟⲩ|ϣⲱϣ
ϧⲉⲛⲟⲩϫⲱⲃ	ϧⲉⲛ|ⲟⲩ|ϫⲱⲃ
ⲛⲟⲩⲥⲱⲙⲁ	ⲛ|ⲟⲩ|ⲥⲱⲙⲁ
ⲙⲯⲩⲭⲓⲕⲟⲛ	ⲙ|ⲯⲩⲭⲓⲕⲟⲛ
ⲛϫⲉⲟⲩⲥⲱⲙⲁ	ⲛϫⲉ|ⲟⲩ|ⲥⲱⲙⲁ
ⲓⲥϫⲉⲟⲩⲟⲛⲟⲩⲥⲱⲙⲁ	ⲓⲥϫⲉ|ⲟⲩⲟⲛ|ⲟⲩ|ⲥⲱⲙⲁ
ⲁⲥⲥϧⲏⲟⲩⲧ	ⲁ|ⲥ|ⲥϧⲏⲟⲩⲧ
ⲛϫⲉⲁⲇⲁⲙ	ⲛϫⲉ|ⲁⲇⲁⲙ
ⲛϩⲟⲩⲓⲧ	ⲛ|ϩⲟⲩⲓⲧ
ⲉⲩⲯⲩⲭⲏ	ⲉ|ⲩ|ⲯⲩⲭⲏ
ⲉⲥⲱⲛϧ	ⲉ|ⲥ|ⲱⲛϧ
ⲁⲇⲁⲙ	ⲁⲇⲁⲙ
ⲉϥⲧⲁⲛϧⲟ	ⲉ|ϥ|ⲧⲁⲛϧⲟ
ⲡⲓⲡⲛⲉⲩⲙⲁⲧⲓⲕⲟⲛ	ⲡⲓ|ⲡⲛⲉⲩⲙⲁⲧⲓⲕⲟⲛ
ⲡⲓϣⲟⲣⲡ	ⲡⲓ|ϣⲟⲣⲡ
ⲡⲓⲯⲩⲭⲓⲕⲟⲛ	ⲡⲓ|ⲯⲩⲭⲓⲕⲟⲛ
ⲙⲉⲛⲉⲛⲥⲱϥ	ⲙⲉⲛⲉⲛⲥⲱ|ϥ
ϧⲉⲛⲡⲕⲁϩⲓ	ϧⲉⲛ|ⲡ|ⲕⲁϩⲓ
ⲛⲣⲉⲙⲛⲕⲁϩⲓ	ⲛ|ⲣⲉⲙⲛⲕⲁϩⲓ
ⲡⲓⲙⲁϩⲃ	ⲡⲓ|ⲙⲁϩⲃ
ⲙⲡⲓⲣⲉⲙⲛⲕⲁϩⲓ	ⲙ|ⲡⲓ|ⲣⲉⲙⲛⲕⲁϩⲓ
ⲛⲓⲕⲉⲣⲉⲙⲛⲕⲁϩⲓ	ⲛⲓ|ⲕⲉ|ⲣⲉⲙⲛⲕⲁϩⲓ
ⲙⲡⲓⲣⲉⲙⲙⲫⲉ	ⲙ|ⲡⲓ|ⲣⲉⲙⲙⲫⲉ
ⲛⲓⲕⲉⲣⲉⲙⲙⲫⲉ	ⲛⲓ|ⲕⲉ|ⲣⲉⲙⲙⲫⲉ
ⲉⲧⲁⲛⲉⲣⲫⲟⲣⲓⲛ	ⲉⲧ|ⲁ|ⲛ|ⲉⲣⲫⲟⲣⲓⲛ
ⲛⲧϩⲓⲕⲱⲛ	ⲛ|ⲧ|ϩⲓⲕⲱⲛ
ⲙⲁⲣⲉⲛⲉⲣⲫⲟⲣⲓⲛ	ⲙⲁⲣⲉ|ⲛ|ⲉⲣⲫⲟⲣⲓⲛ
ⲛϯϩⲓⲕⲱⲛ	ⲛ|ϯ|ϩⲓⲕⲱⲛ
ⲛⲧⲉⲡⲓⲣⲉⲙⲙⲫⲉ	ⲛⲧⲉ|ⲡⲓ|ⲣⲉⲙⲙⲫⲉ
ϫⲉⲥⲁⲣⲝ	ϫⲉ|ⲥⲁⲣⲝ
ϩⲓⲥⲛⲟϥ	ϩⲓ|ⲥⲛⲟϥ
ⲡⲧⲁⲕⲟ	ⲡ|ⲧⲁⲕⲟ
ϥⲛⲁⲉⲣⲕⲗⲏⲣⲟⲛⲟⲙⲓⲛ	ϥ|ⲛⲁ|ⲉⲣⲕⲗⲏⲣⲟⲛⲟⲙⲓⲛ
ⲛϯⲙⲉⲧⲁⲧⲧⲁⲕⲟ	ⲛ|ϯ|ⲙⲉⲧⲁⲧⲧⲁⲕⲟ
ⲟⲩⲙⲩⲥⲧⲏⲣⲓⲟⲛ	ⲟⲩ|ⲙⲩⲥⲧⲏⲣⲓⲟⲛ
ⲧⲉⲛⲛⲁⲉⲛⲕⲟⲧ	ⲧⲉⲛ|ⲛⲁ|ⲉⲛⲕⲟⲧ
ⲥⲉⲛⲁϣⲟⲃⲧⲉⲛ	ⲥⲉ|ⲛⲁ|ϣⲟⲃⲧ|ⲉⲛ
ϧⲉⲛⲟⲩⲥⲟⲩⲥⲟⲩ	ϧⲉⲛ|ⲟⲩ|ⲥⲟⲩⲥⲟⲩ
ϧⲉⲛⲟⲩⲣⲓⲕⲓ	ϧⲉⲛ|ⲟⲩ|ⲣⲓⲕⲓ
ⲙⲃⲁⲗ	ⲙ|ⲃⲁⲗ
ϧⲉⲛϯϧⲁⲉ	ϧⲉⲛ|ϯ|ϧⲁⲉ
ⲛⲥⲁⲗⲡⲓⲅⲅⲟⲥ	ⲛ|ⲥⲁⲗⲡⲓⲅⲅⲟⲥ
ⲉⲥⲉⲙⲟⲩϯ	ⲉⲥⲉ|ⲙⲟⲩϯ
ⲛϫⲉϯⲥⲁⲗⲡⲓⲅⲝ	ⲛϫⲉ|ϯ|ⲥⲁⲗⲡⲓⲅⲝ
ⲉⲩⲉⲧⲱⲟⲩⲛⲟⲩ	ⲉⲩⲉ|ⲧⲱⲟⲩⲛⲟⲩ
ⲛⲁⲧⲁⲕⲟ	ⲛ|ⲁⲧⲁⲕⲟ
ⲛⲧⲉⲫⲁⲓ	ⲛⲧⲉ|ⲫⲁⲓ
ⲉⲧⲛⲁⲧⲁⲕⲟ	ⲉⲧ|ⲛⲁ|ⲧⲁⲕⲟ
ⲛⲧⲉϥϯ	ⲛⲧⲉ|ϥ|ϯ
ⲉⲧⲛⲁⲙⲟⲩ	ⲉⲧ|ⲛⲁ|ⲙⲟⲩ
ⲛϯⲙⲉⲧⲁⲧⲙⲟⲩ	ⲛ|ϯ|ⲙⲉⲧⲁⲧⲙⲟⲩ
ⲛϯⲙⲉⲧⲁⲑⲙⲟⲩ	ⲛ|ϯ|ⲙⲉⲧⲁⲑⲙⲟⲩ
ⲉϥⲉϣⲱⲡⲓ	ⲉϥⲉ|ϣⲱⲡⲓ
ϫⲉⲁⲩⲱⲙⲕ	ϫⲉ|ⲁ|ⲩ|ⲱⲙⲕ
ⲉⲩϭⲣⲟ	ⲉ|ⲩ|ϭⲣⲟ
ⲡⲉⲕϭⲣⲟ	ⲡⲉⲕ|ϭⲣⲟ
ⲫⲙⲟⲩ	ⲫ|ⲙⲟⲩ
ⲁⲥⲑⲱⲛ	ⲁ|ⲥ|ⲑⲱⲛ
ⲧⲉⲕⲥⲟⲩⲣⲓ	ⲧⲉⲕ|ⲥⲟⲩⲣⲓ
ⲧⲥⲟⲩⲣⲓ	ⲧ|ⲥⲟⲩⲣⲓ
ⲫⲛⲟⲃⲓ	ⲫ|ⲛⲟⲃⲓ
ⲧϫⲟⲙ	ⲧ|ϫⲟⲙ
ⲙⲫⲛⲟⲃⲓ	ⲙ|ⲫ|ⲛⲟⲃⲓ
ⲫⲛⲟⲙⲟⲥ	ⲫ|ⲛⲟⲙⲟⲥ
ϣⲏⲡ	ϣⲏⲡ
ⲙⲡⲓϭⲣⲟ	ⲙ|ⲡⲓ|ϭⲣⲟ
ϩⲓⲧⲉⲛⲡⲉⲛϭⲟⲓⲥ	ϩⲓⲧⲉⲛ|ⲡⲉⲛ|ϭⲟⲓⲥ
ⲙⲙⲉⲛⲣⲁϯ	ⲙ|ⲙⲉⲛⲣⲁϯ
ⲉⲣⲉⲧⲉⲛⲧⲁϫⲣⲏⲟⲩⲧ	ⲉⲣⲉ|ⲧⲉⲛ|ⲧⲁϫⲣⲏⲟⲩⲧ
ⲛⲁⲧⲕⲓⲙ	ⲛ|ⲁⲧⲕⲓⲙ
ϧⲉⲛⲡⲓϩⲱⲃ	ϧⲉⲛ|ⲡⲓ|ϩⲱⲃ
ⲉⲣⲉⲧⲉⲛⲉⲙⲓ	ⲉⲣⲉ|ⲧⲉⲛ|ⲉⲙⲓ
ϫⲉⲡⲉⲧⲉⲛϧⲓⲥⲓ	ϫⲉ|ⲡⲉⲧⲉⲛ|ϧⲓⲥⲓ
ⲉⲧⲁⲓⲓ	ⲉⲧ|ⲁ|ⲓ|ⲓ
ⲛⲉⲧⲁⲓⲓ	ⲛ|ⲉⲧ|ⲁ|ⲓ|ⲓ
ⲕⲁⲧⲁⲟⲩϭⲓⲥⲓ	ⲕⲁⲧⲁ|ⲟⲩ|ϭⲓⲥⲓ
ⲛⲧⲉⲟⲩⲥⲁϫⲓ	ⲛⲧⲉ|ⲟⲩ|ⲥⲁϫⲓ
ⲟⲩⲥⲟⲫⲓⲁ	ⲟⲩ|ⲥⲟⲫⲓⲁ
ⲁⲓⲧⲁⲙⲟ	ⲁ|ⲓ|ⲧⲁⲙⲟ
ⲉⲡⲓⲙⲩⲥⲧⲏⲣⲓⲟⲛ	ⲉ|ⲡⲓ|ⲙⲩⲥⲧⲏⲣⲓⲟⲛ
ⲙⲡⲓϯϩⲁⲡ	ⲙⲡ|ⲓ|ϯϩⲁⲡ
ϧⲉⲛⲟⲩⲙⲉⲧⲁⲥⲑⲉⲛⲏⲥ	ϧⲉⲛ|ⲟⲩ|ⲙⲉⲧⲁⲥⲑⲉⲛⲏⲥ
ⲛⲉⲙⲟⲩϩⲟϯ	ⲛⲉⲙ|ⲟⲩ|ϩⲟϯ
ⲛⲉⲙⲟⲩⲥⲑⲉⲣⲧⲉⲣ	ⲛⲉⲙ|ⲟⲩ|ⲥⲑⲉⲣⲧⲉⲣ
ⲁⲓⲓ	ⲁ|ⲓ|ⲓ
ⲡⲁⲥⲁϫⲓ	ⲡⲁ|ⲥⲁϫⲓ
ⲛⲉⲙ	ⲛⲉⲙ
ⲡⲁϩⲓⲱⲓϣ	ⲡⲁ|ϩⲓⲱⲓϣ
ⲛⲁϥϧⲉⲛϩⲁⲛⲑⲱⲧ	ⲛⲁ|ϥ|ϧⲉⲛ|ϩⲁⲛ|ⲑⲱⲧ
ⲛⲧⲉϩⲁⲛⲥⲁϫⲓ	ⲛⲧⲉ|ϩⲁⲛ|ⲥⲁϫⲓ
ⲛⲧⲉⲟⲩⲡⲛⲉⲩⲙⲁ	ⲛⲧⲉ|ⲟⲩ|ⲡⲛⲉⲩⲙⲁ
ⲛⲉⲙⲟⲩϫⲟⲙ	ⲛⲉⲙ|ⲟⲩ|ϫⲟⲙ
ϧⲉⲛⲟⲩⲥⲟⲫⲓⲁ	ϧⲉⲛ|ⲟⲩ|ⲥⲟⲫⲓⲁ
ⲡⲉⲧⲉⲛⲥⲁϫⲓ	ⲡ|ⲉⲧⲉ|ⲛ|ⲥⲁϫⲓ
ⲉⲧϫⲏⲕ	ⲉⲧ|ϫⲏⲕ
ⲛⲑⲁⲡⲁⲓⲉⲛⲉϩ	ⲛ|ⲑⲁ|ⲡⲁⲓ|ⲉⲛⲉϩ
ⲛⲑⲁⲛⲓⲁⲣⲭⲱⲛ	ⲛ|ⲑⲁ|ⲛⲓ|ⲁⲣⲭⲱⲛ
ⲉⲑⲛⲁⲕⲱⲣϥ	ⲉⲑ|ⲛⲁ|ⲕⲱⲣϥ
ⲉⲧⲉⲛⲥⲁϫⲓ	ⲉⲧⲉ|ⲛ|ⲥⲁϫⲓ
ϧⲉⲛⲟⲩⲙⲩⲥⲧⲏⲣⲓⲟⲛ	ϧⲉⲛ|ⲟⲩ|ⲙⲩⲥⲧⲏⲣⲓⲟⲛ
ⲉⲧϩⲏⲡ	ⲉⲧ|ϩⲏⲡ
ⲉⲧⲁϥⲉⲣϣⲟⲣⲡ	ⲉⲧ|ⲁ|ϥ|ⲉⲣϣⲟⲣⲡ
ⲛⲑⲁϣⲥ	ⲛ|ⲑⲁϣ|ⲥ
ⲉⲩⲱⲟⲩ	ⲉ|ⲩ|ⲱⲟⲩ
ⲉⲧⲉⲙⲡⲉϩⲗⲓ	ⲉⲧⲉ|ⲙⲡⲉ|ϩⲗⲓ
ⲛⲛⲓⲁⲣⲭⲱⲛ	ⲛ|ⲛⲓ|ⲁⲣⲭⲱⲛ
ⲥⲟⲩⲱⲛⲥ	ⲥⲟⲩⲱⲛ|ⲥ
ⲉⲛⲉⲁⲩⲥⲟⲩⲱⲛⲥ	ⲉⲛⲉ|ⲁ|ⲩ|ⲥⲟⲩⲱⲛ|ⲥ
ⲛⲁⲩⲛⲁⲉϣ	ⲛⲁ|ⲩ|ⲛⲁ|ⲉϣ
ⲛⲧⲉⲡⲱⲟⲩ	ⲛⲧⲉ|ⲡ|ⲱⲟⲩ
ⲉⲧⲉⲙⲡⲉⲃⲁⲗ	ⲉⲧⲉ|ⲙⲡⲉ|ⲃⲁⲗ
ⲙⲡⲉⲙⲁϣϫ	ⲙⲡⲉ|ⲙⲁϣϫ
ⲥⲟⲑⲙⲟⲩ	ⲥⲟⲑⲙ|ⲟⲩ
ⲙⲡⲟⲩϣⲉ	ⲙⲡ|ⲟⲩ|ϣⲉ
ⲉϫⲉⲛⲡϩⲏⲧ	ⲉϫⲉⲛ|ⲡ|ϩⲏⲧ
ⲥⲉⲃⲧⲱⲧⲟⲩ	ⲥⲉⲃⲧⲱⲧ|ⲟⲩ
ⲉⲑⲛⲁⲙⲉⲛⲣⲓⲧϥ	ⲉⲑ|ⲛⲁ|ⲙⲉⲛⲣⲓⲧ|ϥ
ⲁϥϭⲟⲣⲡⲟⲩ	ⲁ|ϥ|ϭⲟⲣⲡ|ⲟⲩ
ϥϧⲟⲧϧⲉⲧ	ϥ|ϧⲟⲧϧⲉⲧ
ϧⲉⲛⲛⲓⲣⲱⲙⲓ	ϧⲉⲛ|ⲛⲓ|ⲣⲱⲙⲓ
ⲉⲧⲥⲱⲟⲩⲛ	ⲉⲧ|ⲥⲱⲟⲩⲛ
ⲛⲛⲁⲡⲓⲣⲱⲙⲓ	ⲛ|ⲛⲁ|ⲡⲓ|ⲣⲱⲙⲓ
ⲉⲡⲓⲡⲛⲉⲩⲙⲁ	ⲉ|ⲡⲓ|ⲡⲛⲉⲩⲙⲁ
ⲛⲁⲫⲛⲟⲩϯ	ⲛⲁ|ⲫ|ⲛⲟⲩϯ
ⲡⲉⲧⲁⲛϭⲓⲧϥ	ⲡ|ⲉⲧ|ⲁ|ⲛ|ϭⲓⲧ|ϥ
ϧⲉⲛⲫⲛⲟⲩϯ	ϧⲉⲛ|ⲫ|ⲛⲟⲩϯ
ⲛⲧⲉⲛⲉⲙⲓ	ⲛⲧⲉ|ⲛ|ⲉⲙⲓ
ⲧⲏⲓⲧⲟⲩ	ⲧⲏⲓⲧ|ⲟⲩ
ⲛⲉⲉⲧⲉⲛⲥⲁϫⲓ	ⲛⲉ|ⲉⲧⲉ|ⲛ|ⲥⲁϫⲓ
ϧⲉⲛϩⲁⲛⲙⲉⲧⲣⲉϥϯⲥⲃⲱ	ϧⲉⲛ|ϩⲁⲛ|ⲙⲉⲧⲣⲉϥϯⲥⲃⲱ
ⲉⲛⲉⲣⲥⲩⲛⲕⲣⲓⲛⲓⲛ	ⲉ|ⲛ|ⲉⲣⲥⲩⲛⲕⲣⲓⲛⲓⲛ
ⲛϩⲁⲛⲡⲛⲉⲩⲙⲁⲧⲓⲕⲟⲛ	ⲛ|ϩⲁⲛ|ⲡⲛⲉⲩⲙⲁⲧⲓⲕⲟⲛ
ⲛⲛⲓⲡⲛⲉⲩⲙⲁⲧⲓⲕⲟⲥ	ⲛ|ⲛⲓ|ⲡⲛⲉⲩⲙⲁⲧⲓⲕⲟⲥ
ⲡⲓⲯⲩⲭⲓⲕⲟⲥ	ⲡⲓ|ⲯⲩⲭⲓⲕⲟⲥ
ⲙⲡⲁϥϣⲉⲡ	ⲙⲡⲁ|ϥ|ϣⲉⲡ
ⲛⲁⲡⲓⲡⲛⲉⲩⲙⲁ	ⲛⲁ|ⲡⲓ|ⲡⲛⲉⲩⲙⲁ
ϫⲉⲁⲩϧⲟⲧϧⲉⲧ	ϫⲉ|ⲁ|ⲩ|ϧⲟⲧϧⲉⲧ
ⲡⲛⲁⲧⲓⲕⲟⲥ	ⲡⲛⲁⲧⲓⲕⲟⲥ
ⲡⲓⲡⲛⲁⲧⲓⲕⲱⲥ	ⲡⲓ|ⲡⲛⲁⲧⲓⲕⲱⲥ
ϣⲁϥϧⲉⲧϧⲉⲧ	ϣⲁ|ϥ|ϧⲉⲧϧⲉⲧ
ⲙⲡⲁⲣⲉϩⲗⲓ	ⲙⲡⲁⲣⲉ|ϩⲗⲓ
ϣϧⲉⲧϧⲱⲧϥ	ϣ|ϧⲉⲧϧⲱⲧ|ϥ
ⲡⲉⲧⲁϥⲉⲙⲓ	ⲡ|ⲉⲧ|ⲁ|ϥ|ⲉⲙⲓ
ⲉⲡϩⲏⲧ	ⲉ|ⲡ|ϩⲏⲧ
ⲉⲑⲛⲁϣⲧⲥⲁⲃⲟϥ	ⲉⲑ|ⲛⲁ|ϣ|ⲧⲥⲁⲃⲟ|ϥ
ⲡϩⲏⲧ	ⲡ|ϩⲏⲧ
ⲡⲉⲧⲉⲙⲙⲟⲛ	ⲡ|ⲉⲧⲉ|ⲙⲙⲟ|ⲛ
ⲉⲧⲭⲱⲣⲁ	ⲉ|ⲧ|ⲭⲱⲣⲁ
ⲛⲧⲉⲛⲓⲅⲉⲣⲅⲉⲥⲏⲛⲟⲥ	ⲛⲧⲉ|ⲛⲓ|ⲅⲉⲣⲅⲉⲥⲏⲛⲟⲥ
ϧⲉⲛⲡⲓϫⲟⲓ	ϧⲉⲛ|ⲡⲓ|ϫⲟⲓ
ⲉϩⲣⲁϥ	ⲉϩⲣⲁ|ϥ
ϧⲉⲛⲛⲓⲙϩⲁⲩ	ϧⲉⲛ|ⲛⲓ|ⲙϩⲁⲩ
ⲉϥϧⲉⲛⲟⲩⲡⲛⲉⲩⲙⲁ	ⲉ|ϥ|ϧⲉⲛ|ⲟⲩ|ⲡⲛⲉⲩⲙⲁ
ⲉⲛⲁⲣⲉⲡⲉϥⲙⲁ	ⲉ|ⲛⲁⲣⲉ|ⲡⲉϥ|ⲙⲁ
ϧⲉⲛⲛⲓⲕⲉϩⲁⲗⲩⲥⲓⲥ	ϧⲉⲛ|ⲛⲓ|ⲕⲉ|ϩⲁⲗⲩⲥⲓⲥ
ⲉⲥⲟⲛϩϥ	ⲉ|ⲥⲟⲛϩ|ϥ
ⲉⲑⲃⲉϫⲉ	ⲉⲑⲃⲉ|ϫⲉ
ⲛⲉⲁⲩⲥⲟⲛϩϥ	ⲛⲉ|ⲁ|ⲩ|ⲥⲟⲛϩ|ϥ
ⲛϩⲁⲛⲡⲉⲇⲏⲥ	ⲛ|ϩⲁⲛ|ⲡⲉⲇⲏⲥ
ⲛⲉⲙϩⲁⲛϩⲁⲗⲩⲥⲓⲥ	ⲛⲉⲙ|ϩⲁⲛ|ϩⲁⲗⲩⲥⲓⲥ
ⲛⲧⲉϥⲥⲱⲗⲡ	ⲛⲧⲉ|ϥ|ⲥⲱⲗⲡ
ⲛⲛⲓϩⲁⲗⲩⲥⲓⲥ	ⲛ|ⲛⲓ|ϩⲁⲗⲩⲥⲓⲥ
ⲛⲥⲉϧⲟⲙϧⲉⲙ	ⲛ|ⲥⲉ|ϧⲟⲙϧⲉⲙ
ⲛϫⲉⲛⲓⲡⲉⲇⲏⲥ	ⲛϫⲉ|ⲛⲓ|ⲡⲉⲇⲏⲥ
ⲉⲣⲇⲁⲙⲁⲍⲓⲛ	ⲉⲣⲇⲁⲙⲁⲍⲓⲛ
ⲛⲉⲙⲡⲓⲉϩⲟⲟⲩ	ⲛⲉⲙ|ⲡⲓ|ⲉϩⲟⲟⲩ
ϧⲉⲛⲛⲓⲧⲱⲟⲩ	ϧⲉⲛ|ⲛⲓ|ⲧⲱⲟⲩ
ⲉϥϣⲱⲧ	ⲉ|ϥ|ϣⲱⲧ
ⲛϩⲁⲛⲱⲛⲓ	ⲛ|ϩⲁⲛ|ⲱⲛⲓ
ⲓⲥϫⲉⲛϩⲓⲫⲟⲩⲉⲓ	ⲓⲥϫⲉⲛ|ϩⲓ|ⲫ|ⲟⲩⲉⲓ
ϫⲉⲁϧⲟⲕ	ϫⲉ|ⲁϧⲟ|ⲕ
ϯⲧⲁⲣⲕⲟ	ϯ|ⲧⲁⲣⲕⲟ
ⲙⲡⲉⲣϯϭⲗⲁⲕ	ⲙⲡⲉⲣ|ϯϭⲗⲁⲕ
ϫⲉⲁⲙⲟⲩ	ϫⲉ|ⲁⲙⲟⲩ
ϧⲉⲛⲡⲓⲣⲱⲙⲓ	ϧⲉⲛ|ⲡⲓ|ⲣⲱⲙⲓ
ⲡⲉⲕⲣⲁⲛ	ⲡⲉⲕ|ⲣⲁⲛ
ϫⲉⲗⲉⲅⲓⲱⲛ	ϫⲉ|ⲗⲉⲅⲓⲱⲛ
ⲡⲁⲣⲁⲛ	ⲡⲁ|ⲣⲁⲛ
ϫⲉⲧⲉⲛⲉⲣⲟⲩⲙⲏϣ	ϫⲉ|ⲧⲉⲛ|ⲉⲣ|ⲟⲩ|ⲙⲏϣ
ⲛⲁϥϯϩⲟ	ⲛⲁ|ϥ|ϯϩⲟ
ⲛϯⲭⲱⲣⲁ	ⲛ|ϯ|ⲭⲱⲣⲁ
ⲟⲩⲁⲅⲉⲗⲏ	ⲟⲩ|ⲁⲅⲉⲗⲏ
ⲛⲣⲓⲣ	ⲛ|ⲣⲓⲣ
ⲉⲥⲟϣ	ⲉ|ⲥ|ⲟϣ
ⲉⲥⲙⲟⲛⲓ	ⲉ|ⲥ|ⲙⲟⲛⲓ
ϧⲁⲧⲉⲛⲡⲓⲧⲱⲟⲩ	ϧⲁⲧⲉⲛ|ⲡⲓ|ⲧⲱⲟⲩ
ϫⲉⲟⲩⲟⲣⲡⲧⲉⲛ	ϫⲉ|ⲟⲩⲟⲣⲡ|ⲧⲉⲛ
ⲉⲛⲓⲣⲓⲣ	ⲉ|ⲛⲓ|ⲣⲓⲣ
ⲛϫⲉⲛⲓⲡⲛⲉⲩⲙⲁ	ⲛϫⲉ|ⲛⲓ|ⲡⲛⲉⲩⲙⲁ
ⲛⲁⲕⲁⲑⲣⲧⲟⲛ	ⲛ|ⲁⲕⲁⲑⲣⲧⲟⲛ
ⲉⲛⲓⲉϣⲁⲩ	ⲉ|ⲛⲓ|ⲉϣⲁⲩ
ⲁⲥϩⲉⲓ	ⲁ|ⲥ|ϩⲉⲓ
ⲛϫⲉϯⲁⲅⲉⲗⲏ	ⲛϫⲉ|ϯ|ⲁⲅⲉⲗⲏ
ϧⲁⲧⲉⲛⲡⲓϫⲁϫⲣⲓⲙ	ϧⲁⲧⲉⲛ|ⲡⲓ|ϫⲁϫⲣⲓⲙ
ⲉⲩⲉⲣϣⲟ	ⲉ|ⲩ|ⲉⲣ|ϣⲟ
ⲥⲛⲁⲩ	ⲥⲛⲁⲩ
ⲛⲁⲩⲱϫϩ	ⲛⲁ|ⲩ|ⲱϫϩ
ⲉⲛⲁⲩⲙⲟⲛⲓ	ⲉ|ⲛⲁ|ⲩ|ⲙⲟⲛⲓ
ϧⲉⲛϯⲃⲁⲕⲓ	ϧⲉⲛ|ϯ|ⲃⲁⲕⲓ
ⲛⲉⲙϧⲉⲛⲧⲕⲟⲓ	ⲛⲉⲙ|ϧⲉⲛ|ⲧ|ⲕⲟⲓ
ⲉⲛⲁⲣⲉⲛⲓⲇⲁⲓⲙⲱⲛ	ⲉ|ⲛⲁⲣⲉ|ⲛⲓ|ⲇⲁⲓⲙⲱⲛ
ⲉⲣⲉⲛⲉϥϩⲃⲱⲥ	ⲉⲣⲉ|ⲛⲉϥ|ϩⲃⲱⲥ
ⲉⲣⲉⲡⲉϥϩⲏⲧ	ⲉⲣⲉ|ⲡⲉϥ|ϩⲏⲧ
ⲁⲩⲥⲁϫⲓ	ⲁ|ⲩ|ⲥⲁϫⲓ
ϫⲉⲉⲧⲁⲥϣⲱⲡⲓ	ϫⲉ|ⲉⲧ|ⲁ|ⲥ|ϣⲱⲡⲓ
ⲛⲣⲏϯ	ⲛ|ⲣⲏϯ
ⲛⲉⲙⲉⲑⲃⲉⲛⲓⲣⲓⲣ	ⲛⲉⲙ|ⲉⲑⲃⲉ|ⲛⲓ|ⲣⲓⲣ
ⲛϯϩⲟ	ⲛ|ϯϩⲟ
ϫⲉⲛⲧⲉϥϣⲉ	ϫⲉ|ⲛⲧⲉ|ϥ|ϣⲉ
ϧⲉⲛⲛⲟⲩⲑⲟϣ	ϧⲉⲛ|ⲛⲟⲩ|ⲑⲟϣ
ⲉⲡⲓϫⲟⲓ	ⲉ|ⲡⲓ|ϫⲟⲓ
ⲛⲧⲉϥⲟϩⲓ	ⲛⲧⲉ|ϥ|ⲟϩⲓ
ⲙⲡⲉϥⲭⲁϥ	ⲙⲡⲉ|ϥ|ⲭⲁ|ϥ
ⲉⲡⲉⲕⲏⲓ	ⲉ|ⲡⲉⲕ|ⲏⲓ
ϩⲁⲛⲏ	ϩⲁ|ⲛⲏ
ⲉⲧⲉⲛⲟⲩⲕ	ⲉⲧⲉ|ⲛⲟⲩⲕ
ⲙⲁⲧⲁⲙⲱⲟⲩ	ⲙⲁ|ⲧⲁⲙⲱ|ⲟⲩ
ⲉⲁϥⲛⲁⲓ	ⲉ|ⲁ|ϥ|ⲛⲁⲓ
ⲛϩⲓⲱⲓϣ	ⲛ|ϩⲓⲱⲓϣ
ⲛϯⲃⲁⲕⲓ	ⲛ|ϯ|ⲃⲁⲕⲓ
ⲙⲡⲉⲧⲁϥⲁⲓϥ	ⲙ|ⲡ|ⲉⲧ|ⲁ|ϥ|ⲁⲓ|ϥ
ϧⲁⲧⲉⲛⲫⲓⲟⲙ	ϧⲁⲧⲉⲛ|ⲫ|ⲓⲟⲙ
ⲛⲧⲉⲛⲓⲁⲣⲭⲏⲥⲩⲛⲁⲅⲱⲅⲟⲥ	ⲛⲧⲉ|ⲛⲓ|ⲁⲣⲭⲏⲥⲩⲛⲁⲅⲱⲅⲟⲥ
ⲓⲁⲓⲣⲟⲥ	ⲓⲁⲓⲣⲟⲥ
ϧⲁⲣⲁⲧⲟⲩ	ϧⲁⲣⲁⲧ|ⲟⲩ
ϫⲉⲁⲧⲁϣⲉⲣⲓ	ϫⲉ|ⲁ|ⲧⲁ|ϣⲉⲣⲓ
ⲁⲥϧⲱⲛⲧ	ⲁ|ⲥ|ϧⲱⲛⲧ
ⲛⲧⲉⲕⲭⲁⲧⲉⲕϫⲓϫ	ⲛⲧⲉ|ⲕ|ⲭⲁ|ⲧⲉⲕ|ϫⲓϫ
ⲛⲧⲉⲥⲛⲟϩⲉⲙ	ⲛⲧⲉ|ⲥ|ⲛⲟϩⲉⲙ
ⲛⲧⲉⲥⲱⲛϧ	ⲛⲧⲉ|ⲥ|ⲱⲛϧ
ⲛⲁⲩϩⲟϫϩⲉϫ	ⲛⲁ|ⲩ|ϩⲟϫϩⲉϫ
ⲓⲥ	ⲓⲥ
ⲁⲥⲉⲣⲓⲃ	ⲁ|ⲥ|ⲉⲣ|ⲓⲃ
ⲛⲣⲟⲙⲡⲓ	ⲛ|ⲣⲟⲙⲡⲓ
ⲟⲩⲥⲛⲟϥ	ⲟⲩ|ⲥⲛⲟϥ
ϧⲁⲣⲟⲥ	ϧⲁⲣⲟ|ⲥ
ⲁⲥϭⲓ	ⲁ|ⲥ|ϭⲓ
ⲛⲛⲓⲙⲏϣ	ⲛ|ⲛⲓ|ⲙⲏϣ
ⲁⲥϭⲉ	ⲁ|ⲥ|ϭⲉ
ⲛⲉⲧⲉⲛⲧⲁⲥ	ⲛ|ⲉⲧⲉ|ⲛⲧⲁ|ⲥ
ⲙⲡⲉⲥϫⲉⲙϩⲏⲟⲩ	ⲙⲡⲉ|ⲥ|ϫⲉⲙϩⲏⲟⲩ
ⲁⲥⲧϩⲟ	ⲁ|ⲥ|ⲧϩⲟ
ⲉⲧⲁⲥⲥⲱⲧⲉⲙ	ⲉⲧ|ⲁ|ⲥ|ⲥⲱⲧⲉⲙ
ⲉⲑⲃⲉⲓⲏⲥⲟⲩⲥ	ⲉⲑⲃⲉ|ⲓⲏⲥⲟⲩⲥ
ϩⲓⲫⲁϩⲟⲩ	ϩⲓ|ⲫⲁϩⲟⲩ
ⲛⲉⲙⲡⲉϥϩⲃⲟⲥ	ⲛⲉⲙ|ⲡⲉϥ|ϩⲃⲟⲥ
ⲛⲁⲥϫⲱ	ⲛⲁ|ⲥ|ϫⲱ
ⲁⲓϣⲁⲛϭⲓ	ⲁⲓϣⲁⲛ|ϭⲓ
ⲛⲉⲙⲛⲉϥϩⲃⲱⲥ	ⲛⲉⲙ|ⲛⲉϥ|ϩⲃⲱⲥ
ϯⲛⲁⲛⲟϩⲉⲙ	ϯ|ⲛⲁ|ⲛⲟϩⲉⲙ
ⲁⲥϣⲱⲟⲩⲓ	ⲁ|ⲥ|ϣⲱⲟⲩⲓ
ⲛϫⲉϯⲙⲟⲩⲙⲓ	ⲛϫⲉ|ϯ|ⲙⲟⲩⲙⲓ
ⲛⲧⲉⲡⲉⲥⲥⲛⲟϥ	ⲛⲧⲉ|ⲡⲉⲥ|ⲥⲛⲟϥ
ⲁⲥⲉⲙⲓ	ⲁ|ⲥ|ⲉⲙⲓ
ϫⲉⲁⲥⲟⲩϫⲁⲓ	ϫⲉ|ⲁ|ⲥ|ⲟⲩϫⲁⲓ
ϩⲁϯⲙⲁⲥⲧⲓⲅⲝ	ϩⲁ|ϯ|ⲙⲁⲥⲧⲓⲅⲝ
ⲡⲉⲧⲁϥϭⲓ	ⲡ|ⲉⲧ|ⲁ|ϥ|ϭⲓ
ⲛⲉⲙⲛⲁϩⲃⲱⲥ	ⲛⲉⲙ|ⲛⲁ|ϩⲃⲱⲥ
ϫⲉⲭⲛⲁⲩ	ϫⲉ|ⲭ|ⲛⲁⲩ
ⲉϥϩⲟϫϩⲉϫ	ⲉ|ϥ|ϩⲟϫϩⲉϫ
ⲕϫⲱ	ⲕ|ϫⲱ
ⲉⲑⲏ	ⲉ|ⲑⲏ
ⲉⲧⲁⲥⲉⲣⲫⲁⲓ	ⲉⲧ|ⲁ|ⲥ|ⲉⲣ|ⲫⲁⲓ
ⲉⲧⲁⲥⲉⲣϩⲟϯ	ⲉⲧ|ⲁ|ⲥ|ⲉⲣϩⲟϯ
ⲁⲥⲥⲑⲉⲣⲧⲉⲣ	ⲁ|ⲥ|ⲥⲑⲉⲣⲧⲉⲣ
ⲉⲥⲉⲙⲓ	ⲉ|ⲥ|ⲉⲙⲓ
ⲁⲥϫⲉϯⲙⲉⲑⲙⲏⲓ	ⲁ|ⲥ|ϫⲉ|ϯ|ⲙⲉⲑⲙⲏⲓ
ϫⲉⲧⲁϣⲉⲣⲓ	ϫⲉ|ⲧⲁ|ϣⲉⲣⲓ
ⲡⲉⲛⲁϩϯ	ⲡⲉ|ⲛⲁϩϯ
ⲡⲉⲧⲁϥⲛⲁϩⲙⲓ	ⲡ|ⲉⲧ|ⲁ|ϥ|ⲛⲁϩⲙ|ⲓ
ⲉⲟⲩⲟⲩϫⲁⲓ	ⲉ|ⲟⲩ|ⲟⲩϫⲁⲓ
ϩⲁⲧⲉⲙⲁⲥⲧⲓⲅⲝ	ϩⲁ|ⲧⲉ|ⲙⲁⲥⲧⲓⲅⲝ
ϩⲁⲡⲓⲁⲣⲭⲏⲥⲩⲛⲁⲅⲱⲅⲟⲥ	ϩⲁ|ⲡⲓ|ⲁⲣⲭⲏⲥⲩⲛⲁⲅⲱⲅⲟⲥ
ϫⲉⲁⲧⲉⲕϣⲉⲣⲓ	ϫⲉ|ⲁ|ⲧⲉⲕ|ϣⲉⲣⲓ
ⲉⲕϯϧⲓⲥⲓ	ⲉ|ⲕ|ϯϧⲓⲥⲓ
ⲙⲡⲓⲣⲉϥϯⲥⲃⲱ	ⲙ|ⲡⲓ|ⲣⲉϥϯⲥⲃⲱ
ⲉⲧⲟⲩϫⲱ	ⲉⲧ|ⲟⲩ|ϫⲱ
ⲙⲡⲓⲁⲣⲭⲏⲥⲩⲛⲁⲅⲱⲅⲟⲥ	ⲙ|ⲡⲓ|ⲁⲣⲭⲏⲥⲩⲛⲁⲅⲱⲅⲟⲥ
ϫⲉⲙⲡⲉⲣⲉⲣϩⲟϯ	ϫⲉ|ⲙⲡⲉⲣ|ⲉⲣϩⲟϯ
ⲛⲁϩϯ	ⲛⲁϩϯ
ⲉⲩϣⲑⲉⲣⲑⲱⲣ	ⲉ|ⲩ|ϣⲑⲉⲣⲑⲱⲣ
ⲉⲩⲣⲓⲙⲓ	ⲉ|ⲩ|ⲣⲓⲙⲓ
ⲉⲩϣⲗⲏⲗⲟⲩⲓ	ⲉ|ⲩ|ϣⲗⲏⲗⲟⲩⲓ
ⲧⲉⲧⲉⲛϣⲧⲉⲣⲑⲱⲣ	ⲧⲉⲧⲉⲛ|ϣⲧⲉⲣⲑⲱⲣ
ⲧⲉⲧⲉⲛⲣⲓⲙⲓ	ⲧⲉⲧⲉⲛ|ⲣⲓⲙⲓ
ⲙⲡⲉⲥⲙⲟⲩ	ⲙⲡⲉ|ⲥ|ⲙⲟⲩ
ⲛϫⲉϯⲁⲗⲟⲩ	ⲛϫⲉ|ϯ|ⲁⲗⲟⲩ
ⲁⲥⲛⲕⲟⲧ	ⲁ|ⲥ|ⲛⲕⲟⲧ
ⲛⲁⲩⲥⲱⲃⲓ	ⲛⲁ|ⲩ|ⲥⲱⲃⲓ
ⲉⲧⲁϥϩⲓ	ⲉⲧ|ⲁ|ϥ|ϩⲓ
ⲡⲧⲏⲣϥ	ⲡ|ⲧⲏⲣϥ
ⲛⲉⲙⲧⲉⲥⲙⲁⲩ	ⲛⲉⲙ|ⲧⲉⲥ|ⲙⲁⲩ
ⲉⲛⲁⲣⲉϯⲁⲗⲟⲩ	ⲉ|ⲛⲁⲣⲉ|ϯ|ⲁⲗⲟⲩ
ϫⲉⲧⲁⲗⲓⲑⲁ	ϫⲉ|ⲧⲁⲗⲓⲑⲁ
ⲕⲟⲩⲙ	ⲕⲟⲩⲙ
ϫⲉϯⲁⲗⲟⲩ	ϫⲉ|ϯ|ⲁⲗⲟⲩ
ⲁⲓϫⲉ	ⲁ|ⲓ|ϫⲉ
ⲉⲣⲟ	ⲉⲣⲟ
ⲧⲱⲛⲓ	ⲧⲱⲛ|ⲓ
ⲁⲥⲧⲱⲛⲥ	ⲁ|ⲥ|ⲧⲱⲛ|ⲥ
ⲁⲥⲙⲟϣⲓ	ⲁ|ⲥ|ⲙⲟϣⲓ
ϧⲉⲛⲓⲃ	ϧⲉⲛ|ⲓⲃ
ⲛⲧⲉϣⲧⲉⲙϩⲗⲓ	ⲛⲧⲉ|ϣⲧⲉⲙ|ϩⲗⲓ
ⲉⲫⲁⲓ	ⲉ|ⲫⲁⲓ
ⲛⲧⲟⲩϯⲟⲩⲱⲙ	ⲛⲧ|ⲟⲩ|ϯⲟⲩⲱⲙ
ⲛⲥⲁⲟⲩⲣⲱⲙⲓ	ⲛⲥⲁ|ⲟⲩ|ⲣⲱⲙⲓ
ϫⲉⲛⲧⲉϥⲁⲓϥ	ϫⲉ|ⲛⲧⲉ|ϥ|ⲁⲓ|ϥ
ⲛⲥⲩⲅⲅⲉⲗⲗⲟⲥ	ⲛ|ⲥⲩⲅⲅⲉⲗⲗⲟⲥ
ⲛⲉⲙⲛⲟⲧⲁⲣⲓⲟⲥ	ⲛⲉⲙ|ⲛⲟⲧⲁⲣⲓⲟⲥ
ⲉⲑⲃⲉϫⲉⲙⲙⲟⲛ	ⲉⲑⲃⲉ|ϫⲉ|ⲙⲙⲟⲛ
ⲉⲉⲣⲁⲧⲥⲱⲧⲉⲙ	ⲉ|ⲉⲣⲁⲧⲥⲱⲧⲉⲙ
ⲛⲟⲩϩⲉⲃⲥⲱ	ⲛ|ⲟⲩ|ϩⲉⲃⲥⲱ
ⲉⲥⲑⲉⲃⲓⲏⲟⲩⲧ	ⲉ|ⲥ|ⲑⲉⲃⲓⲏⲟⲩⲧ
ⲁϥϫⲉⲛϥ	ⲁ|ϥ|ϫⲉⲛ|ϥ
ϧⲉⲛⲟⲩⲑⲉⲃⲓⲟ	ϧⲉⲛ|ⲟⲩ|ⲑⲉⲃⲓⲟ
ϫⲉⲛⲧⲉϥⲥϧⲏⲧⲟⲩⲉⲡⲓⲥⲧⲟⲗⲏ	ϫⲉ|ⲛⲧⲉ|ϥ|ⲥϧⲏⲧ|ⲟⲩ|ⲉⲡⲓⲥⲧⲟⲗⲏ
ⲛⲧⲉϥⲛⲁⲩ	ⲛⲧⲉ|ϥ|ⲛⲁⲩ
ⲁϥⲥϧⲏⲧϯⲉⲡⲓⲥⲧⲟⲗⲏ	ⲁ|ϥ|ⲥϧⲏⲧ|ϯ|ⲉⲡⲓⲥⲧⲟⲗⲏ
ⲁϥⲧⲁⲕⲟⲥ	ⲁ|ϥ|ⲧⲁⲕⲟ|ⲥ
ϧⲉⲛⲡⲉϥⲟⲩⲱϣ	ϧⲉⲛ|ⲡⲉϥ|ⲟⲩⲱϣ
ϫⲉϩⲓⲧⲉⲛⲧⲁⲓⲁⲓⲧⲓⲁ	ϫⲉ|ϩⲓⲧⲉⲛ|ⲧⲁⲓ|ⲁⲓⲧⲓⲁ
ⲛⲁⲭⲁϥ	ⲛⲁ|ⲭⲁ|ϥ
ⲉϣⲧⲉⲙⲁⲙⲟⲛⲓ	ⲉ|ϣⲧⲉⲙ|ⲁⲙⲟⲛⲓ
ⲉⲑⲃⲉϫⲉⲉⲣⲁⲅⲁⲡⲁⲛ	ⲉⲑⲃⲉ|ϫⲉ|ⲉⲣⲁⲅⲁⲡⲁⲛ
ⲙⲡⲓⲱⲣϥ	ⲙ|ⲡⲓ|ⲱⲣϥ
ⲉⲁϥⲧⲉⲛⲑⲱⲛϥ	ⲉ|ⲁ|ϥ|ⲧⲉⲛⲑⲱⲛ|ϥ
ⲉⲡⲓⲡⲣⲟⲫⲏⲧⲏⲥ	ⲉ|ⲡⲓ|ⲡⲣⲟⲫⲏⲧⲏⲥ
ⲛⲁⲭⲟⲩⲥ	ⲛ|ⲁⲭⲟⲩⲥ
ⲛⲅⲉⲑ	ⲛ|ⲅⲉⲑ
ϧⲉⲛⲡϫⲓⲛⲑⲣⲟⲩⲧⲁⲙⲟϥ	ϧⲉⲛ|ⲡ|ϫⲓⲛⲑⲣⲟⲩⲧⲁⲙⲟϥ
ⲛϫⲉⲛⲉϥⲁⲗⲱⲟⲩⲓ	ⲛϫⲉ|ⲛⲉϥ|ⲁⲗⲱⲟⲩⲓ
ⲉⲧⲁⲩⲉⲣⲭⲟⲣⲉⲩⲉⲓⲛ	ⲉⲧ|ⲁ|ⲩ|ⲉⲣⲭⲟⲣⲉⲩⲉⲓⲛ
ⲛϫⲉⲛⲓϧⲉⲗϣⲁⲓⲣⲓ	ⲛϫⲉ|ⲛⲓ|ϧⲉⲗϣⲁⲓⲣⲓ
ⲛⲧⲉⲡⲓⲥⲗ	ⲛⲧⲉ|ⲡⲓ|ⲥⲗ
ϫⲉⲁⲥⲁⲟⲩⲗ	ϫⲉ|ⲁ|ⲥⲁⲟⲩⲗ
ϣⲁⲓⲣⲓ	ϣⲁⲓⲣⲓ
ϧⲉⲛϩⲁⲛⲁⲛϣⲟ	ϧⲉⲛ|ϩⲁⲛ|ⲁⲛϣⲟ
ϧⲉⲛϩⲁⲛⲁⲛⲑⲃⲁ	ϧⲉⲛ|ϩⲁⲛ|ⲁⲛⲑⲃⲁ
ⲉϥϣⲁϣⲛⲓ	ⲉ|ϥ|ϣⲁϣⲛⲓ
ⲉⲡⲉϥⲟⲩⲱϣ	ⲉ|ⲡⲉϥ|ⲟⲩⲱϣ
ϫⲉⲛⲉⲣⲭⲣⲉⲓⲁ	ϫⲉ|ⲛ|ⲉⲣⲭⲣⲉⲓⲁ
ϫⲉⲉⲧⲁϥⲥϧⲉ	ϫⲉ|ⲉⲧ|ⲁ|ϥ|ⲥϧⲉ
ϫⲉⲛⲁⲛⲉⲑⲁⲓ	ϫⲉ|ⲛⲁⲛⲉ|ⲑⲁⲓ
ⲥϧⲁⲓ	ⲥϧⲁⲓ
ϫⲉⲭⲛⲁⲥⲉⲛⲡⲁⲓⲙⲁ	ϫⲉ|ⲭ|ⲛⲁ|ⲥⲉⲛ|ⲡⲁⲓ|ⲙⲁ
ϫⲉⲙⲡⲉϥϣⲁϣⲛⲓ	ϫⲉ|ⲙⲡⲉ|ϥ|ϣⲁϣⲛⲓ
ⲁϥⲥϧⲏⲧ	ⲁ|ϥ|ⲥϧⲏⲧ
ϯⲙⲁϩⲥⲛⲟⲩϯ	ϯ|ⲙⲁϩⲥⲛⲟⲩϯ
ⲛⲉⲡⲓⲥⲧⲟⲗⲏ	ⲛ|ⲉⲡⲓⲥⲧⲟⲗⲏ
ⲉⲥⲟⲓ	ⲉ|ⲥ|ⲟⲓ
ⲉⲧⲁϥϫⲓⲙⲓ	ⲉⲧ|ⲁ|ϥ|ϫⲓⲙⲓ
ⲙⲡⲓⲁⲛⲁⲙⲏⲓ	ⲙ|ⲡⲓ|ⲁⲛⲁⲙⲏⲓ
ⲉⲧⲁⲛⲥⲱⲧⲉⲙ	ⲉⲧ|ⲁ|ⲛ|ⲥⲱⲧⲉⲙ
ⲛⲁϣⲏⲣⲓ	ⲛⲁ|ϣⲏⲣⲓ
ⲉⲧⲁⲛⲉⲣⲁⲓⲧⲉⲓⲛ	ⲉⲧ|ⲁ|ⲛ|ⲉⲣⲁⲓⲧⲉⲓⲛ
ⲁⲛϣⲁϣⲛⲓ	ⲁ|ⲛ|ϣⲁϣⲛⲓ
ϩⲓⲧⲉⲛϯϫⲟⲙ	ϩⲓⲧⲉⲛ|ϯ|ϫⲟⲙ
ⲉⲛⲉⲣⲭⲣⲉⲓⲁ	ⲉ|ⲛ|ⲉⲣⲭⲣⲉⲓⲁ
ⲛⲁϥϩⲉϫϩⲱϫ	ⲛⲁ|ϥ|ϩⲉϫϩⲱϫ
ⲉⲧⲁϥϯϩⲟ	ⲉⲧ|ⲁ|ϥ|ϯϩⲟ
ⲙⲟⲅⲓⲥ	ⲙⲟⲅⲓⲥ
ⲁϥⲑⲉⲧⲡⲉϥϩⲏⲧ	ⲁ|ϥ|ⲑⲉⲧ|ⲡⲉϥ|ϩⲏⲧ
ⲉⲭⲁϥ	ⲉ|ⲭⲁ|ϥ
ⲁϥⲥⲉⲙⲛⲏⲧⲥ	ⲁ|ϥ|ⲥⲉⲙⲛⲏⲧ|ⲥ
ⲉⲑⲣⲉϥⲉⲣⲟⲩⲁⲃⲟⲧ	ⲉ|ⲑⲣⲉ|ϥ|ⲉⲣ|ⲟⲩ|ⲁⲃⲟⲧ
ⲛⲧⲉⲛⲣⲟⲙⲡⲓ	ⲛⲧⲉⲛ|ⲣⲟⲙⲡⲓ
ⲉϥⲥϧⲁⲓ	ⲉ|ϥ|ⲥϧⲁⲓ
ⲛⲛⲓϩⲉⲟⲣⲧⲁⲥⲧⲓⲕⲏ	ⲛ|ⲛⲓ|ϩⲉⲟⲣⲧⲁⲥⲧⲓⲕⲏ
ⲁϥⲧⲁϩⲉⲡϣⲁϥⲉ	ⲁ|ϥ|ⲧⲁϩⲉ|ⲡ|ϣⲁϥⲉ
ⲉⲧⲉϥⲙⲉⲓ	ⲉⲧⲉ|ϥ|ⲙⲉⲓ
ⲁϥⲙⲧⲟⲛ	ⲁ|ϥ|ⲙⲧⲟⲛ
ⲡⲧⲉϯⲡⲟⲗⲓⲥ	ⲡⲧⲉ|ϯ|ⲡⲟⲗⲓⲥ
ⲁⲩⲧⲁϩⲟ	ⲁ|ⲩ|ⲧⲁϩⲟ
ⲁⲩⲁⲓϥ	ⲁ|ⲩ|ⲁⲓ|ϥ
ⲛⲉⲙⲛⲉϥⲥⲛⲏⲟⲩ	ⲛⲉⲙ|ⲛⲉϥ|ⲥⲛⲏⲟⲩ
ⲉϫⲉⲙⲡⲉϥϣⲓⲛⲓ	ⲉϫⲉⲙ|ⲡⲉϥ|ϣⲓⲛⲓ
ⲉⲧⲁⲩⲉⲣⲁⲡⲁⲛⲧⲁⲛ	ⲉⲧ|ⲁ|ⲩ|ⲉⲣⲁⲡⲁⲛⲧⲁⲛ
ⲉⲛⲟⲩⲉⲣⲏⲟⲩ	ⲉ|ⲛⲟⲩ|ⲉⲣⲏⲟⲩ
ⲟⲩⲟⲛⲟⲩⲣⲱⲙⲓ	ⲟⲩⲟⲛ|ⲟⲩ|ⲣⲱⲙⲓ
ⲛⲉⲟⲩⲙⲁⲓⲛⲟⲩϯ	ⲛⲉ|ⲟⲩ|ⲙⲁⲓⲛⲟⲩϯ
ϧⲉⲛⲟⲩⲧⲓⲙⲓ	ϧⲉⲛ|ⲟⲩ|ⲧⲓⲙⲓ
ϫⲉϫⲉⲃⲣⲟⲛⲁⲑⲏⲛⲓ	ϫⲉ|ϫⲉⲃⲣⲟⲛⲁⲑⲏⲛⲓ
ⲛⲛⲁϩϯ	ⲛ|ⲛⲁϩϯ
ⲉϥϯϩⲟ	ⲉ|ϥ|ϯϩⲟ
ϫⲉⲉⲡⲉⲓⲇⲏ	ϫⲉ|ⲉⲡⲉⲓⲇⲏ
ⲡⲗⲟⲅⲟⲥ	ⲡ|ⲗⲟⲅⲟⲥ
ⲛⲛⲓⲇⲏⲙⲟⲥⲓⲟⲛ	ⲛ|ⲛⲓ|ⲇⲏⲙⲟⲥⲓⲟⲛ
ⲉⲑⲣⲉⲕⲧⲱⲃϩ	ⲉ|ⲑⲣⲉ|ⲕ|ⲧⲱⲃϩ
ⲛⲧⲉϥϭⲱⲣⲡ	ⲛⲧⲉ|ϥ|ϭⲱⲣⲡ
ⲡⲑⲱϣ	ⲡ|ⲑⲱϣ
ⲙⲡⲁⲏⲓ	ⲙ|ⲡⲁ|ⲏⲓ
ⲛϩⲓⲕⲁⲛⲟⲥ	ⲛ|ϩⲓⲕⲁⲛⲟⲥ
ⲡⲁⲓϩⲱⲃ	ⲡⲁⲓ|ϩⲱⲃ
ⲉⲧⲉⲕⲙⲉⲩⲓ	ⲉⲧⲉ|ⲕ|ⲙⲉⲩⲓ
ⲉⲡϭⲟⲉⲓⲥ	ⲉ|ⲡ|ϭⲟⲉⲓⲥ
ⲉⲧⲉⲕⲛⲁⲉⲣⲁⲓⲧⲉⲓⲛ	ⲉⲧⲉ|ⲕ|ⲛⲁ|ⲉⲣⲁⲓⲧⲉⲓⲛ
ⲡⲉϫⲉⲡⲓⲉⲡⲓⲥⲕⲟⲡⲟⲥ	ⲡⲉϫⲉ|ⲡⲓ|ⲉⲡⲓⲥⲕⲟⲡⲟⲥ
ⲡⲉϥⲙⲁⲑⲏⲧⲏⲥ	ⲡⲉϥ|ⲙⲁⲑⲏⲧⲏⲥ
ϫⲉⲙⲁⲣⲉⲛⲧⲱⲃϩ	ϫⲉ|ⲙⲁⲣⲉ|ⲛ|ⲧⲱⲃϩ
ⲙⲡⲁⲓⲉϫⲱⲣϩ	ⲙ|ⲡⲁⲓ|ⲉϫⲱⲣϩ
ⲡⲉⲛⲛⲟⲩϯ	ⲡⲉⲛ|ⲛⲟⲩϯ
ⲉⲣⲉⲡⲓⲃ	ⲉⲣⲉ|ⲡⲓ|ⲃ
ⲉⲩⲧⲱⲃϩ	ⲉ|ⲩ|ⲧⲱⲃϩ
ⲁⲡⲓⲙⲁ	ⲁ|ⲡⲓ|ⲙⲁ
ⲉⲣⲟⲩⲱⲓⲛⲓ	ⲉⲣⲟⲩⲱⲓⲛⲓ
ⲙⲡⲉ	ⲙⲡⲉ
ϣϫⲉⲙϫⲟⲙ	ϣ|ϫⲉⲙϫⲟⲙ
ϧⲁⲡⲓⲟⲩⲱⲓⲛⲓ	ϧⲁ|ⲡⲓ|ⲟⲩⲱⲓⲛⲓ
ⲁϥϩⲉⲓ	ⲁ|ϥ|ϩⲉⲓ
ϣⲁⲧⲉϥⲉⲣⲑⲉⲱⲣⲉⲓⲛ	ϣⲁⲧⲉ|ϥ|ⲉⲣⲑⲉⲱⲣⲉⲓⲛ
ϩⲉⲛⲟⲩⲙⲉⲧϫⲱⲣⲓ	ϩⲉⲛ|ⲟⲩ|ⲙⲉⲧϫⲱⲣⲓ
ⲛϫⲉⲡⲓⲁⲅⲅⲉⲗⲟⲥ	ⲛϫⲉ|ⲡⲓ|ⲁⲅⲅⲉⲗⲟⲥ
ϫⲉⲁⲛⲉⲕϩⲃⲏⲟⲩⲓ	ϫⲉ|ⲁ|ⲛⲉⲕ|ϩⲃⲏⲟⲩⲓ
ⲉⲑⲛⲁⲛⲉⲩ	ⲉⲑ|ⲛⲁⲛⲉ|ⲩ
ⲉⲣⲛⲓϣϯ	ⲉⲣⲛⲓϣϯ
ⲛⲉⲙⲛⲉⲕϣⲗⲏⲗ	ⲛⲉⲙ|ⲛⲉⲕ|ϣⲗⲏⲗ
ⲁϥϯϫⲟⲙ	ⲁ|ϥ|ϯ|ϫⲟⲙ
ϫⲉⲉⲑⲃⲉⲡⲉϥⲧⲟⲩⲃⲟ	ϫⲉ|ⲉⲑⲃⲉ|ⲡⲉϥ|ⲧⲟⲩⲃⲟ
ⲁϥϥⲁⲓ	ⲁ|ϥ|ϥⲁⲓ
ϧⲁⲡⲓϭⲱⲣⲡ	ϧⲁ|ⲡⲓ|ϭⲱⲣⲡ
ϫⲉⲱⲟⲩⲛⲓⲁⲧⲟⲩ	ϫⲉ|ⲱⲟⲩ|ⲛⲓⲁⲧ|ⲟⲩ
ϧⲉⲛⲡⲟⲩϩⲏⲧ	ϧⲉⲛ|ⲡⲟⲩ|ϩⲏⲧ
ϫⲉⲛⲑⲱⲟⲩ	ϫⲉ|ⲛⲑⲱⲟⲩ
ⲉⲑⲛⲁⲛⲁⲩ	ⲉⲑ|ⲛⲁ|ⲛⲁⲩ
ⲁⲡⲥⲁϫⲓ	ⲁ|ⲡ|ⲥⲁϫⲓ
ⲉϫⲉⲛⲛⲁⲓϩⲁⲅⲓⲟⲥ	ⲉϫⲉⲛ|ⲛⲁⲓ|ϩⲁⲅⲓⲟⲥ
ⲁⲣⲉϣⲁⲛ	ⲁⲣⲉϣⲁⲛ
ⲉⲧⲟⲩⲛⲁⲉⲣⲁⲓⲧⲉⲓⲛ	ⲉⲧ|ⲟⲩ|ⲛⲁ|ⲉⲣⲁⲓⲧⲉⲓⲛ
ϩⲓⲧⲉⲛⲡⲁⲓⲱⲧ	ϩⲓⲧⲉⲛ|ⲡⲁ|ⲓⲱⲧ
ⲉⲧϧⲉⲛⲛⲓⲫⲏⲟⲩⲓ	ⲉⲧ|ϧⲉⲛ|ⲛⲓ|ⲫⲏⲟⲩⲓ
ⲁϥⲧⲁϩ	ⲁ|ϥ|ⲧⲁϩ
ⲉⲡⲓϣⲁϥⲉ	ⲉ|ⲡⲓ|ϣⲁϥⲉ
ⲛⲉⲙⲛⲓⲥⲛⲏⲟⲩ	ⲛⲉⲙ|ⲛⲓ|ⲥⲛⲏⲟⲩ
ⲉⲩϫⲟⲩϣⲧ	ⲉ|ⲩ|ϫⲟⲩϣⲧ
ⲉϥⲑⲱϩⲉⲙ	ⲉ|ϥ|ⲑⲱϩⲉⲙ
ⲉⲡⲓⲁⲅⲱⲛ	ⲉ|ⲡⲓ|ⲁⲅⲱⲛ
ⲛⲉⲧⲉϥⲥⲩⲛⲏⲑⲉⲓⲁ	ⲛⲉ|ⲧⲉϥ|ⲥⲩⲛⲏⲑⲉⲓⲁ
ⲉⲛⲓⲉϩⲟⲟⲩ	ⲉ|ⲛⲓ|ⲉϩⲟⲟⲩ
ⲛⲧⲉⲡⲓϩⲙⲉ	ⲛⲧⲉ|ⲡⲓ|ϩⲙⲉ
ϣⲁϥⲉⲣⲁⲛⲁⲭⲱⲣⲉⲓⲛ	ϣⲁ|ϥ|ⲉⲣⲁⲛⲁⲭⲱⲣⲉⲓⲛ
ϧⲉⲛⲟⲩⲕⲟⲩϫⲓ	ϧⲉⲛ|ⲟⲩ|ⲕⲟⲩϫⲓ
ⲙⲡⲓⲙⲟⲛⲁⲥⲧⲏⲣⲓⲟⲛ	ⲙ|ⲡⲓ|ⲙⲟⲛⲁⲥⲧⲏⲣⲓⲟⲛ
ⲉϥⲉⲣⲁⲡⲁⲛⲧⲁⲛ	ⲉ|ϥ|ⲉⲣⲁⲡⲁⲛⲧⲁⲛ
ⲉⲧⲁⲩϩⲓⲕⲟⲧ	ⲉⲧ|ⲁ|ⲩ|ϩⲓⲕⲟⲧ
ⲛⲓⲛⲓϣϯ	ⲛⲓ|ⲛⲓϣϯ
ⲛⲛⲟⲩⲙⲉⲩⲓ	ⲛ|ⲛⲟⲩ|ⲙⲉⲩⲓ
ⲁⲩϫⲉⲙϩⲏⲟⲩ	ⲁ|ⲩ|ϫⲉⲙϩⲏⲟⲩ
ⲉⲡⲉϥⲙⲁ	ⲉ|ⲡⲉϥ|ⲙⲁ
ⲉϩⲁⲛⲕⲟⲩϫⲓ	ⲉ|ϩⲁⲛ|ⲕⲟⲩϫⲓ
ⲛⲉⲙⲟⲩⲕⲟⲩϫⲓ	ⲛⲉⲙ|ⲟⲩ|ⲕⲟⲩϫⲓ
ⲛϩⲙⲟⲩ	ⲛ|ϩⲙⲟⲩ
ⲙⲡⲉϥⲁⲙⲟⲛⲓ	ⲙ|ⲡⲉϥ|ⲁⲙⲟⲛⲓ
ϫⲉⲡⲉⲛⲓⲱⲧ	ϫⲉ|ⲡⲉⲛ|ⲓⲱⲧ
ⲁⲕⲟⲩⲉⲙ	ⲁ|ⲕ|ⲟⲩⲉⲙ
ⲛⲛⲁⲓⲉϩⲟⲟⲩ	ⲛ|ⲛⲁⲓ|ⲉϩⲟⲟⲩ
ⲉⲧⲉⲛⲓⲥⲛⲏⲟⲩ	ⲉⲧⲉ|ⲛⲓ|ⲥⲛⲏⲟⲩ
ϫⲉⲧⲉⲛⲛⲁⲩ	ϫⲉ|ⲧⲉⲛ|ⲛⲁⲩ
ⲉⲱⲓⲕ	ⲉ|ⲱⲓⲕ
ϩⲓϩⲙⲟⲩ	ϩⲓ|ϩⲙⲟⲩ
ϫⲉⲛⲧⲉⲛⲓⲛⲓ	ϫⲉ|ⲛⲧⲉ|ⲛ|ⲓⲛⲓ
ⲛϩⲁⲛ	ⲛ|ϩⲁⲛ
ⲕⲟⲩϫⲓ	ⲕⲟⲩϫⲓ
ⲙⲡⲉϥⲉⲣⲁⲛⲉⲭⲉⲥⲑⲁⲓ	ⲙⲡⲉ|ϥ|ⲉⲣⲁⲛⲉⲭⲉⲥⲑⲁⲓ
ϫⲉⲡⲉⲧⲥϣⲉ	ϫⲉ|ⲡ|ⲉⲧ|ⲥϣⲉ
ⲛⲧⲁϣⲉⲡϩⲁⲛⲕⲟⲩϫⲓ	ⲛ|ⲧⲁ|ϣⲉⲡ|ϩⲁⲛ|ⲕⲟⲩϫⲓ
ⲛⲓⲥⲛⲏⲟⲩ	ⲛⲓ|ⲥⲛⲏⲟⲩ
ⲉⲑⲃⲉⲛⲉϥⲁⲥⲕⲏⲥⲓⲥ	ⲉⲑⲃⲉ|ⲛⲉϥ|ⲁⲥⲕⲏⲥⲓⲥ
ⲛϣⲉⲛⲛⲟⲩϥⲓ	ⲛ|ϣⲉⲛⲛⲟⲩϥⲓ
ϧⲁⲧⲉⲛⲟⲩⲟⲛ	ϧⲁⲧⲉⲛ|ⲟⲩⲟⲛ
ⲛⲉⲙⲧⲭⲱⲣⲁ	ⲛⲉⲙ|ⲧ|ⲭⲱⲣⲁ
ⲛⲭⲏⲙⲓ	ⲛ|ⲭⲏⲙⲓ
ⲕⲁⲧⲁⲡⲥⲁϫⲓ	ⲕⲁⲧⲁ|ⲡ|ⲥⲁϫⲓ
ⲙⲡⲓⲉⲩⲁⲅⲅⲉⲗⲓⲟⲛ	ⲙ|ⲡⲓ|ⲉⲩⲁⲅⲅⲉⲗⲓⲟⲛ
ⲟⲩⲃⲁⲕⲓ	ⲟⲩ|ⲃⲁⲕⲓ
ⲛⲁⲭⲱⲡ	ⲛⲁ|ⲭⲱⲡ
ⲉⲥⲭⲏ	ⲉ|ⲥ|ⲭⲏ
ϩⲓϫⲉⲛⲟⲩⲧⲱⲟⲩ	ϩⲓϫⲉⲛ|ⲟⲩ|ⲧⲱⲟⲩ
ⲙⲡⲁⲩϭⲉⲣⲉⲟⲩϧⲏⲃⲥ	ⲙⲡⲁ|ⲩ|ϭⲉⲣⲉ|ⲟⲩ|ϧⲏⲃⲥ
ⲛⲥⲉⲭⲁϥ	ⲛ|ⲥⲉ|ⲭⲁ|ϥ
ϧⲁⲟⲩⲙⲉⲛⲧ	ϧⲁ|ⲟⲩ|ⲙⲉⲛⲧ
ϣⲁⲩⲭⲁⲓ	ϣⲁ|ⲩ|ⲭⲁ|ⲓ
ϩⲓϫⲉⲛϯⲗⲩⲭⲛⲓⲁ	ϩⲓϫⲉⲛ|ϯ|ⲗⲩⲭⲛⲓⲁ
ⲛⲧⲉϥⲉⲣⲟⲩⲱⲓⲛⲓ	ⲛⲧⲉ|ϥ|ⲉⲣⲟⲩⲱⲓⲛⲓ
ⲉⲧϧⲉⲛⲡⲓⲏⲓ	ⲉⲧ|ϧⲉⲛ|ⲡⲓ|ⲏⲓ
ⲕⲁⲓⲧⲟⲓ	ⲕⲁⲓⲧⲟⲓ
ⲁⲩϩⲓⲧⲟⲧⲟⲩ	ⲁ|ⲩ|ϩⲓ|ⲧⲟⲧ|ⲟⲩ
ⲉⲑⲣⲟⲩⲁⲓϥ	ⲉ|ⲑⲣ|ⲟⲩ|ⲁⲓ|ϥ
ϧⲉⲛⲟⲩⲙⲉⲧⲁⲧⲣⲱⲟⲩϣ	ϧⲉⲛ|ⲟⲩ|ⲙⲉⲧⲁⲧⲣⲱⲟⲩϣ
ϫⲉⲥⲣⲱϥⲧ	ϫⲉ|ⲥⲣⲱϥⲧ
ⲛⲧⲉⲡⲉⲛⲟⲩϫⲁⲓ	ⲛⲧⲉ|ⲡⲉⲛ|ⲟⲩϫⲁⲓ
ⲉⲡⲓⲕⲟⲩϫⲓ	ⲉ|ⲡⲓ|ⲕⲟⲩϫⲓ
ⲙⲡⲟⲩⲉⲗⲱⲓⲕ	ⲙⲡ|ⲟⲩ|ⲉⲗⲱⲓⲕ
ⲉⲧⲁϥⲉⲣⲡⲓⲉϩⲟⲟⲩ	ⲉⲧ|ⲁ|ϥ|ⲉⲣ|ⲡⲓ|ⲉϩⲟⲟⲩ
ⲛⲉⲙⲡⲓⲙⲁϩⲃ	ⲛⲉⲙ|ⲡⲓ|ⲙⲁϩⲃ
ⲛⲉⲙⲡⲓⲙⲁϩⲅ	ⲛⲉⲙ|ⲡⲓ|ⲙⲁϩⲅ
ϣⲁⲡⲓⲙⲁϩⲉ	ϣⲁ|ⲡⲓ|ⲙⲁϩⲉ
ⲛⲁⲑⲟⲩⲱⲙ	ⲛ|ⲁⲑⲟⲩⲱⲙ
ϧⲉⲛⲡⲓⲙⲁϩⲉ	ϧⲉⲛ|ⲡⲓ|ⲙⲁϩⲉ
ⲛⲧⲉⲧⲉϥⲙⲉⲧⲁⲧⲟⲩⲱⲙ	ⲛⲧⲉ|ⲧⲉϥ|ⲙⲉⲧⲁⲧⲟⲩⲱⲙ
ⲙⲡⲗⲁⲝ	ⲙ|ⲡⲗⲁⲝ
ⲉⲧⲁⲩⲉⲛⲥ	ⲉⲧ|ⲁ|ⲩ|ⲉⲛ|ⲥ
ϧⲉⲛⲡⲓϭⲣⲱⲡ	ϧⲉⲛ|ⲡⲓ|ϭⲣⲱⲡ
ⲛⲟⲩⲡⲣⲟⲥⲉⲩⲭⲏ	ⲛ|ⲟⲩ|ⲡⲣⲟⲥⲉⲩⲭⲏ
ⲉϥϣⲉⲡϩⲙⲟⲧ	ⲉ|ϥ|ϣⲉⲡϩⲙⲟⲧ
ⲁϥⲟⲩⲱⲙ	ⲁ|ϥ|ⲟⲩⲱⲙ
ⲡⲉϥⲣⲁⲥϯ	ⲡⲉϥ|ⲣⲁⲥϯ
ⲁϥⲉⲛⲡⲓⲕⲉⲥⲱϫⲡ	ⲁ|ϥ|ⲉⲛ|ⲡⲓ|ⲕⲉ|ⲥⲱϫⲡ
ⲉⲡⲓⲙⲟⲛⲁⲥⲧⲏⲣⲓⲟⲛ	ⲉ|ⲡⲓ|ⲙⲟⲛⲁⲥⲧⲏⲣⲓⲟⲛ
ϫⲉⲉⲧⲁⲕϫⲉⲙⲡⲁⲓⲱⲓⲕ	ϫⲉ|ⲉⲧ|ⲁ|ⲕ|ϫⲉⲙ|ⲡⲁⲓ|ⲱⲓⲕ
ⲉⲧϫⲏⲛ	ⲉⲧ|ϫⲏⲛ
ⲛⲑⲱⲛ	ⲛ|ⲑⲱⲛ
ⲁϥϩⲉⲡⲡⲓϩⲱⲃ	ⲁ|ϥ|ϩⲉⲡ|ⲡⲓ|ϩⲱⲃ
ϫⲉⲁⲩⲉⲛϥ	ϫⲉ|ⲁ|ⲩ|ⲉⲛ|ϥ
ϧⲉⲛⲭⲏⲙⲓ	ϧⲉⲛ|ⲭⲏⲙⲓ
ⲉⲧⲁⲩϣⲉⲛⲛⲟⲩⲉⲣⲏⲟⲩ	ⲉⲧ|ⲁ|ⲩ|ϣⲉⲛ|ⲛⲟⲩ|ⲉⲣⲏⲟⲩ
ϫⲉⲁⲛⲁⲟⲩⲟⲛϧⲉⲛⲑⲏⲛⲟⲩ	ϫⲉ|ⲁⲛ|ⲁ|ⲟⲩⲟⲛ|ϧⲉⲛ|ⲑⲏⲛⲟⲩ
ⲛⲧⲁⲓϩⲉⲃⲇⲟⲙⲁⲥ	ⲛ|ⲧⲁⲓ|ϩⲉⲃⲇⲟⲙⲁⲥ
ⲉⲗⲱⲓⲕ	ⲉⲗⲱⲓⲕ
ⲙⲡⲟⲩϫⲉⲙⲟⲩⲟⲛ	ⲙⲡ|ⲟⲩ|ϫⲉⲙ|ⲟⲩⲟⲛ
ⲉⲁⲩⲱⲗⲓ	ⲉ|ⲁ|ⲩ|ⲱⲗⲓ
ⲁⲩⲉⲙⲓ	ⲁ|ⲩ|ⲉⲙⲓ
ϫⲉⲟⲩⲉⲃⲟⲗ	ϫⲉ|ⲟⲩ|ⲉⲃⲟⲗ
ⲉⲩⲉⲥⲓ	ⲉⲩⲉ|ⲥⲓ
ⲉⲣⲉⲧⲉⲛⲉϩⲕⲟ	ⲉⲣⲉⲧⲉⲛⲉ|ϩⲕⲟ
ⲉⲩⲉⲥⲱ	ⲉⲩⲉ|ⲥⲱ
ⲉⲣⲉⲧⲉⲛⲉⲓⲃⲓ	ⲉⲣⲉⲧⲉⲛⲉ|ⲓⲃⲓ
ⲡⲓⲁⲅⲁⲑⲟⲛ	ⲡⲓ|ⲁⲅⲁⲑⲟⲛ
ⲛⲧⲉⲡⲓⲕⲁϩⲓ	ⲛⲧⲉ|ⲡⲓ|ⲕⲁϩⲓ
ⲉⲣⲉⲧⲉⲛⲉⲟⲩⲟⲙⲟⲩ	ⲉⲣⲉⲧⲉⲛⲉ|ⲟⲩⲟⲙ|ⲟⲩ
ⲧⲁⲓϣⲫⲏⲣⲓ	ⲧⲁⲓ|ϣⲫⲏⲣⲓ
ⲟⲩⲟⲧⲉⲃ	ⲟⲩⲟⲧⲉⲃ
ⲉⲑⲁⲡⲓⲡⲣⲟⲫⲏⲧⲏⲥ	ⲉ|ⲑⲁ|ⲡⲓ|ⲡⲣⲟⲫⲏⲧⲏⲥ
ⲉⲧⲟⲩⲁϧ	ⲉⲧ|ⲟⲩⲁϧ
ⲏⲗⲓⲁⲥ	ⲏⲗⲓⲁⲥ
ⲙⲉⲛⲉⲛⲥⲁⲉⲧⲟⲩⲉⲛⲱⲓⲕ	ⲙⲉⲛⲉⲛⲥⲁ|ⲉⲧ|ⲟⲩ|ⲉⲛⲱⲓⲕ
ⲉⲃⲟⲗϧⲉⲛ	ⲉⲃⲟⲗ|ϧⲉⲛ
ⲧⲫⲉ	ⲧ|ⲫⲉ
ϩⲓⲧⲉⲛⲡⲓⲁⲅⲅⲉⲗⲟⲥ	ϩⲓⲧⲉⲛ|ⲡⲓ|ⲁⲅⲅⲉⲗⲟⲥ
ϧⲉⲛⲡϫⲓⲛⲑⲣⲉϥϧⲱⲧⲉⲃ	ϧⲉⲛ|ⲡ|ϫⲓⲛⲑⲣⲉϥϧⲱⲧⲉⲃ
ⲛⲧⲉⲡϣⲓⲡⲓ	ⲛⲧⲉ|ⲡ|ϣⲓⲡⲓ
ⲛϫⲉⲱⲣⲓⲱⲛ	ⲛϫⲉ|ⲱⲣⲓⲱⲛ
ⲛⲧⲉⲥⲁⲓ	ⲛⲧⲉ|ⲥⲁⲓ
ⲛⲁⲛⲁⲅⲛⲱⲥⲧⲏⲥ	ⲛ|ⲁⲛⲁⲅⲛⲱⲥⲧⲏⲥ
ⲙⲡⲁⲧϥⲉⲣⲉⲡⲓⲥⲕⲟⲡⲟⲥ	ⲙⲡⲁⲧ|ϥ|ⲉⲣⲉⲡⲓⲥⲕⲟⲡⲟⲥ
ⲉⲑⲣⲉϥϭⲓⲥⲙⲟⲩ	ⲉ|ⲑⲣⲉ|ϥ|ϭⲓⲥⲙⲟⲩ
ⲡⲉⲧⲉϥⲥⲩⲛⲏⲑⲉⲓⲁ	ⲡ|ⲉⲧⲉ|ϥ|ⲥⲩⲛⲏⲑⲉⲓⲁ
ⲉϣⲧⲉⲙⲑⲣⲉϥϩⲉⲙⲥⲓ	ⲉ|ϣⲧⲉⲙ|ⲑⲣⲉ|ϥ|ϩⲉⲙⲥⲓ
ϧⲉⲛⲡⲓⲡⲁⲥⲭⲁ	ϧⲉⲛ|ⲡⲓ|ⲡⲁⲥⲭⲁ
ⲙⲡⲓϣⲛⲉ	ⲙ|ⲡⲓ|ϣⲛⲉ
ⲡⲉϫⲉⲡⲓⲁⲗⲟⲩ	ⲡⲉϫⲉ|ⲡⲓ|ⲁⲗⲟⲩ
ϫⲉⲡⲁⲓⲱⲧ	ϫⲉ|ⲡⲁ|ⲓⲱⲧ
ⲉⲓⲟⲩⲱϣ	ⲉ|ⲓ|ⲟⲩⲱϣ
ⲉⲉⲣⲙⲟⲛⲁⲭⲟⲥ	ⲉ|ⲉⲣⲙⲟⲛⲁⲭⲟⲥ
ⲛⲓⲉⲣⲙⲱⲟⲩⲓ	ⲛⲓ|ⲉⲣⲙⲱⲟⲩⲓ
ⲛⲧⲉⲡⲁⲓⲱⲧ	ⲛⲧⲉ|ⲡⲁ|ⲓⲱⲧ
ⲁⲡⲓϩⲁⲅⲓⲟⲥ	ⲁ|ⲡⲓ|ϩⲁⲅⲓⲟⲥ
ϭⲓⲟⲩⲥⲣⲟⲙ	ϭⲓ|ⲟⲩ|ⲥⲣⲟⲙ
ⲛϩⲓⲛⲓⲙ	ⲛ|ϩⲓⲛⲓⲙ
ϫⲉⲱⲣⲓⲱⲛ	ϫⲉ|ⲱⲣⲓⲱⲛ
ϫⲉⲙⲡⲣⲉⲣϩⲟϯ	ϫⲉ|ⲙⲡⲣ|ⲉⲣϩⲟϯ
ⲛⲥⲁⲡⲉⲕⲓⲱⲧ	ⲛⲥⲁ|ⲡⲉⲕ|ⲓⲱⲧ
ϣⲁⲧⲉϥⲙⲧⲟⲛ	ϣⲁⲧⲉ|ϥ|ⲙⲧⲟⲛ
ⲉⲧⲁϥⲥⲁϫⲓ	ⲉⲧ|ⲁ|ϥ|ⲥⲁϫⲓ
ⲁϥⲧⲁⲙⲟⲓ	ⲁ|ϥ|ⲧⲁⲙⲟ|ⲓ
ϫⲉⲙⲉⲛⲉⲛⲥⲁⲑⲣⲉϥⲙⲟⲩ	ϫⲉ|ⲙⲉⲛⲉⲛⲥⲁ|ⲑⲣⲉ|ϥ|ⲙⲟⲩ
ⲛϫⲉⲡⲉⲕⲓⲱⲧ	ⲛϫⲉ|ⲡⲉⲕ|ⲓⲱⲧ
ⲉⲟⲩⲧⲁⲝⲓⲥ	ⲉ|ⲟⲩ|ⲧⲁⲝⲓⲥ
ⲉⲥϭⲟⲥⲓ	ⲉ|ⲥ|ϭⲟⲥⲓ
ⲉϥϯⲙⲏⲓⲛⲓ	ⲉ|ϥ|ϯⲙⲏⲓⲛⲓ
ⲉϯⲙⲉⲧⲉⲡⲓⲥⲕⲟⲡⲟⲥ	ⲉ|ϯ|ⲙⲉⲧⲉⲡⲓⲥⲕⲟⲡⲟⲥ
ⲉⲧⲁϥⲉⲣⲡⲉⲙⲡϣⲁ	ⲉⲧ|ⲁ|ϥ|ⲉⲣ|ⲡⲉ|ⲙⲡϣⲁ
ⲁϥϩⲱⲗⲓ	ⲁ|ϥ|ϩⲱⲗⲓ
ϫⲉⲛⲓⲡⲛⲉⲩⲙⲁ	ϫⲉ|ⲛⲓ|ⲡⲛⲉⲩⲙⲁ
ϣⲁⲩϭⲛⲉϫⲱⲟⲩ	ϣⲁ|ⲩ|ϭⲛⲉ|ϫⲱ|ⲟⲩ
ϧⲉⲛⲡⲓϣⲱⲛⲓ	ϧⲉⲛ|ⲡⲓ|ϣⲱⲛⲓ
ⲉⲧⲉϥⲛⲁⲙⲟⲩ	ⲉⲧⲉ|ϥ|ⲛⲁ|ⲙⲟⲩ
ⲉⲁⲫⲛⲟⲩϯ	ⲉ|ⲁ|ⲫ|ⲛⲟⲩϯ
ⲉⲣϣⲟⲣⲡ	ⲉⲣϣⲟⲣⲡ
ⲛⲧⲁⲙⲟϥ	ⲛ|ⲧⲁⲙⲟ|ϥ
ⲉⲡⲉϥⲙⲟⲛⲁⲥⲧⲏⲣⲓⲟⲛ	ⲉ|ⲡⲉϥ|ⲙⲟⲛⲁⲥⲧⲏⲣⲓⲟⲛ
ⲛⲁϥϣⲉⲙϣⲓ	ⲛⲁ|ϥ|ϣⲉⲙϣⲓ
ⲉⲧⲁϥⲛⲟⲩⲓ	ⲉⲧ|ⲁ|ϥ|ⲛⲟⲩⲓ
ⲉⲛⲉϥϣⲏⲣⲓ	ⲉ|ⲛⲉϥ|ϣⲏⲣⲓ
ⲓⲁⲕⲱⲃ	ⲓⲁⲕⲱⲃ
ⲁⲕϣⲁⲛϭⲓⲥⲓ	ⲁⲕϣⲁⲛ|ϭⲓⲥⲓ
ⲁⲣⲓⲫⲙⲉⲩⲓ	ⲁⲣⲓ|ⲫ|ⲙⲉⲩⲓ
ⲛⲛⲉⲕⲥⲛⲏⲟⲩ	ⲛ|ⲛⲉⲕ|ⲥⲛⲏⲟⲩ
ⲉⲧⲁϥϫⲟϥ	ⲉⲧ|ⲁ|ϥ|ϫⲟ|ϥ
ⲉⲡⲓϩⲙⲟⲧ	ⲉ|ⲡⲓ|ϩⲙⲟⲧ
ⲉⲑⲛⲁⲧⲁϩⲣⲟϥ	ⲉⲑ|ⲛⲁ|ⲧⲁϩⲣⲟ|ϥ
ⲉⲧⲁϥⲕⲏⲛ	ⲉⲧ|ⲁ|ϥ|ⲕⲏⲛ
ⲉϥϩⲟⲛϩⲉⲛ	ⲉ|ϥ|ϩⲟⲛϩⲉⲛ
ⲛⲛⲉϥϣⲏⲣⲓ	ⲛ|ⲛⲉϥ|ϣⲏⲣⲓ
ⲉⲩϩⲉⲙⲥⲓ	ⲉ|ⲩ|ϩⲉⲙⲥⲓ
ⲛϫⲉϩⲁⲛⲛⲓϣϯ	ⲛϫⲉ|ϩⲁⲛ|ⲛⲓϣϯ
ⲉⲧⲁⲩⲕⲟⲥϥ	ⲉⲧ|ⲁ|ⲩ|ⲕⲟⲥ|ϥ
ⲛⲧⲁⲓⲟ	ⲛ|ⲧⲁⲓⲟ
ⲥⲉⲓⲣⲓ	ⲥⲉ|ⲓⲣⲓ
ⲙⲡⲉϥⲙⲉⲩⲓ	ⲙ|ⲡⲉϥ|ⲙⲉⲩⲓ
ⲛⲉⲙⲛⲓϣⲫⲏⲣⲓ	ⲛⲉⲙ|ⲛⲓ|ϣⲫⲏⲣⲓ
ⲉⲧⲁϥⲁⲓⲧⲟⲩ	ⲉⲧ|ⲁ|ϥ|ⲁⲓⲧ|ⲟⲩ
ϧⲉⲛⲡⲉϥⲱⲛϧ	ϧⲉⲛ|ⲡⲉϥ|ⲱⲛϧ
ϫⲉⲉⲣⲉⲟⲩⲟⲛ	ϫⲉ|ⲉⲣⲉ|ⲟⲩⲟⲛ
ⲟⲩⲙⲁⲑⲏⲧⲏⲥ	ⲟⲩ|ⲙⲁⲑⲏⲧⲏⲥ
ⲛⲧⲟϥ	ⲛⲧⲟϥ
ⲁϥⲉⲣϫⲱⲃ	ⲁ|ϥ|ⲉⲣ|ϫⲱⲃ
ϩⲁⲡⲓϧⲉⲗⲗⲟ	ϩⲁ|ⲡⲓ|ϧⲉⲗⲗⲟ
ϧⲁⲡϭⲛⲉϫⲱϥ	ϧⲁ|ⲡ|ϭⲛⲉϫⲱϥ
ⲛⲧⲉⲡⲉϥⲙⲟⲩ	ⲛⲧⲉ|ⲡⲉϥ|ⲙⲟⲩ
ⲕⲉⲥⲩⲅⲅⲉⲛⲏⲥ	ⲕⲉ|ⲥⲩⲅⲅⲉⲛⲏⲥ
ⲉⲑⲣⲉϥⲓ	ⲉ|ⲑⲣⲉ|ϥ|ⲓ
ⲉⲡⲁⲓϣⲱⲛⲓ	ⲉ|ⲡⲁⲓ|ϣⲱⲛⲓ
ⲉⲧⲉϯⲙⲉⲧⲃⲉⲗⲗⲉ	ⲉⲧⲉ|ϯ|ⲙⲉⲧⲃⲉⲗⲗⲉ
ϧⲁⲡⲓϧⲉⲗⲗⲟ	ϧⲁ|ⲡⲓ|ϧⲉⲗⲗⲟ
ⲁϥϯϩⲟ	ⲁ|ϥ|ϯϩⲟ
ϫⲉⲙⲡⲓⲣⲏϯ	ϫⲉ|ⲙ|ⲡⲓ|ⲣⲏϯ
ϧⲁⲡⲁⲥⲟⲛ	ϧⲁ|ⲡⲁ|ⲥⲟⲛ
ⲙⲡⲓⲃ	ⲙ|ⲡⲓ|ⲃ
ⲉⲃⲟⲗϧⲉⲛⲛⲓⲙⲩⲥⲧⲏⲣⲓⲟⲛ	ⲉⲃⲟⲗ|ϧⲉⲛ|ⲛⲓ|ⲙⲩⲥⲧⲏⲣⲓⲟⲛ
ⲛϯⲙⲁⲡⲡⲁ	ⲛ|ϯ|ⲙⲁⲡⲡⲁ
ⲉⲛⲁϥⲁⲙⲟⲛⲓ	ⲉ|ⲛⲁ|ϥ|ⲁⲙⲟⲛⲓ
ⲙⲡⲓⲡⲟⲧⲏⲣⲓⲟⲛ	ⲙ|ⲡⲓ|ⲡⲟⲧⲏⲣⲓⲟⲛ
ⲁϥϥⲱϯ	ⲁ|ϥ|ϥⲱϯ
ϧⲉⲛⲡϩⲟ	ϧⲉⲛ|ⲡ|ϩⲟ
ⲛⲛⲉϥⲫⲏⲣⲓ	ⲛ|ⲛⲉϥ|ⲫⲏⲣⲓ
ⲉϥϣⲟⲛ	ⲉ|ϥ|ϣⲟⲛ
ϧⲉⲛϯⲡⲟⲗⲓⲥ	ϧⲉⲛ|ϯ|ⲡⲟⲗⲓⲥ
ⲛⲉⲟⲩϧⲉⲗϣⲓⲣⲓ	ⲛⲉ|ⲟⲩ|ϧⲉⲗϣⲓⲣⲓ
ⲁⲡⲓⲇⲓⲁⲃⲟⲗⲟⲥ	ⲁ|ⲡⲓ|ⲇⲓⲁⲃⲟⲗⲟⲥ
ⲑⲣⲉϥϩⲉⲓ	ⲑⲣⲉ|ϥ|ϩⲉⲓ
ϧⲉⲛⲟⲩⲡⲁⲣⲁⲡⲧⲱⲙⲁ	ϧⲉⲛ|ⲟⲩ|ⲡⲁⲣⲁⲡⲧⲱⲙⲁ
ⲙⲡϣⲓϣ	ⲙ|ⲡ|ϣⲓϣ
ⲉⲧⲥⲏⲟⲩⲧ	ⲉⲧ|ⲥⲏⲟⲩⲧ
ϧⲉⲛⲇⲁⲩⲓⲇ	ϧⲉⲛ|ⲇⲁⲩⲓⲇ
ϫⲉⲁⲩⲧⲁϩⲉⲡⲓⲣⲉϥⲉⲣⲛⲟⲃⲓ	ϫⲉ|ⲁ|ⲩ|ⲧⲁϩⲉ|ⲡⲓ|ⲣⲉϥⲉⲣⲛⲟⲃⲓ
ϧⲉⲛⲛⲓϩⲃⲏⲟⲩⲓ	ϧⲉⲛ|ⲛⲓ|ϩⲃⲏⲟⲩⲓ
ⲛⲧⲉⲛⲉϥϫⲓϫ	ⲛⲧⲉ|ⲛⲉϥ|ϫⲓϫ
ⲛϩⲁⲛⲁⲧⲟⲟⲩⲓ	ⲛ|ϩⲁⲛⲁⲧⲟⲟⲩⲓ
ⲁⲩϫⲉⲙⲡⲓⲁⲗⲟⲩ	ⲁ|ⲩ|ϫⲉⲙ|ⲡⲓ|ⲁⲗⲟⲩ
ⲉϥⲥⲏⲧ	ⲉ|ϥ|ⲥⲏⲧ
ⲉⲧⲉⲕⲁⲅⲓⲟⲥⲩⲛⲏ	ⲉ|ⲧⲉⲕ|ⲁⲅⲓⲟⲥⲩⲛⲏ
ⲉⲑⲣⲉⲕϯϩⲟ	ⲉ|ⲑⲣⲉ|ⲕ|ϯϩⲟ
ⲉⲑⲃⲉⲡⲉⲛϣⲏⲣⲓ	ⲉⲑⲃⲉ|ⲡⲉⲛ|ϣⲏⲣⲓ
ⲉⲑⲣⲉϥⲟⲩϫⲁⲓ	ⲉ|ⲑⲣⲉ|ϥ|ⲟⲩϫⲁⲓ
ϫⲉⲧⲉⲛⲉⲙⲓ	ϫⲉ|ⲧⲉⲛ|ⲉⲙⲓ
ⲕⲏⲛ	ⲕⲏⲛ
ⲉⲧⲁⲙⲟϥ	ⲉ|ⲧⲁⲙⲟ|ϥ
ⲙⲡⲁⲧⲟⲩⲓ	ⲙⲡⲁⲧ|ⲟⲩ|ⲓ
ⲁϥⲧⲱⲃϩ	ⲁ|ϥ|ⲧⲱⲃϩ
ϫⲉⲙⲡⲉϥϣⲱⲛⲓ	ϫⲉ|ⲙⲡⲉ|ϥ|ϣⲱⲛⲓ
ⲙⲡⲓⲛⲟⲃⲓ	ⲙ|ⲡⲓ|ⲛⲟⲃⲓ
ⲉⲧⲁⲕⲁⲓϥ	ⲉⲧ|ⲁ|ⲕ|ⲁⲓ|ϥ
ⲙⲡⲣⲁⲓϥ	ⲙⲡⲣ|ⲁⲓ|ϥ
ϫⲉϫⲉⲛⲛⲉⲡⲉⲧϩⲱⲟⲩ	ϫⲉ|ϫⲉ|ⲛⲛⲉ|ⲡⲉⲧϩⲱⲟⲩ
ⲉⲧⲁⲡⲟⲩϣⲏⲣⲓ	ⲉⲧ|ⲁ|ⲡⲟⲩ|ϣⲏⲣⲓ
ⲉⲡⲓϩⲗⲗⲟ	ⲉ|ⲡⲓ|ϩⲗⲗⲟ
ϫⲉⲧⲉⲛⲛⲁⲁⲣⲉϩ	ϫⲉ|ⲧⲉⲛ|ⲛⲁ|ⲁⲣⲉϩ
ⲉⲧⲁⲕϫⲟⲧⲟⲩ	ⲉⲧ|ⲁ|ⲕ|ϫⲟⲧ|ⲟⲩ
ⲉⲩϯⲱⲟⲩ	ⲉ|ⲩ|ϯⲱⲟⲩ
ⲛⲛⲓⲁⲡⲟⲥⲧⲟⲗⲟⲥ	ⲛ|ⲛⲓ|ⲁⲡⲟⲥⲧⲟⲗⲟⲥ
ⲙⲡⲉⲭⲣⲓⲥⲧⲟⲥ	ⲙ|ⲡⲉ|ⲭⲣⲓⲥⲧⲟⲥ
ⲙⲉⲛⲉⲛⲥⲁⲟⲩⲁⲃⲟⲧ	ⲙⲉⲛⲉⲛⲥⲁ|ⲟⲩ|ⲁⲃⲟⲧ
ⲉⲑⲃⲉⲡⲉϥϫⲓⲛⲫⲱⲣϫ	ⲉⲑⲃⲉ|ⲡⲉϥ|ϫⲓⲛⲫⲱⲣϫ
ϧⲉⲛⲡⲁⲓⲕⲟⲥⲙⲟⲥ	ϧⲉⲛ|ⲡⲁⲓ|ⲕⲟⲥⲙⲟⲥ
ⲛⲉⲫⲗⲏⲟⲩ	ⲛ|ⲉⲫⲗⲏⲟⲩ
ⲧⲱⲃϩ	ⲧⲱⲃϩ
ⲉⲑⲣⲉϥϭⲱⲣⲡ	ⲉ|ⲑⲣⲉ|ϥ|ϭⲱⲣⲡ
ⲉⲑⲛⲁⲉⲣⲡⲉⲙⲡϣⲁ	ⲉⲑ|ⲛⲁ|ⲉⲣ|ⲡⲉ|ⲙⲡϣⲁ
ⲛⲓ	ⲛ|ⲓ
ⲛⲧⲉϥⲁⲙⲟⲛⲓ	ⲛⲧⲉ|ϥ|ⲁⲙⲟⲛⲓ
ⲁⲩⲧⲟⲩⲛⲓⲁⲧϥ	ⲁ|ⲩ|ⲧⲟⲩⲛ|ⲓⲁⲧ|ϥ
ϧⲉⲛⲟⲩϩⲟⲣⲁⲙⲁ	ϧⲉⲛ|ⲟⲩ|ϩⲟⲣⲁⲙⲁ
ⲛⲥⲁⲓⲥⲁⲁⲕ	ⲛⲥⲁ|ⲓⲥⲁⲁⲕ
ⲡⲓⲙⲟⲛⲁⲭⲟⲥ	ⲡⲓ|ⲙⲟⲛⲁⲭⲟⲥ
ⲛⲇⲓⲁⲇⲟⲭⲟⲥ	ⲛ|ⲇⲓⲁⲇⲟⲭⲟⲥ
ⲉⲥⲉⲛϥ	ⲉ|ⲥⲉⲛ|ϥ
ⲉⲧⲁϥⲙⲧⲟⲛ	ⲉⲧ|ⲁ|ϥ|ⲙⲧⲟⲛ
ⲛⲥⲁⲡⲓⲁⲣⲭⲓⲉⲡⲓⲥⲕⲟⲡⲟⲥ	ⲛⲥⲁ|ⲡⲓ|ⲁⲣⲭⲓⲉⲡⲓⲥⲕⲟⲡⲟⲥ
ⲉⲑⲣⲉϥⲉⲣⲁⲡⲁⲛⲧⲁⲛ	ⲉ|ⲑⲣⲉ|ϥ|ⲉⲣⲁⲡⲁⲛⲧⲁⲛ
ⲛⲉϣⲁϥⲉⲣⲫⲁⲓ	ⲛⲉ|ϣⲁ|ϥ|ⲉⲣ|ⲫⲁⲓ
ⲉϥⲓⲛⲓ	ⲉ|ϥ|ⲓⲛⲓ
ⲉⲑⲃⲉⲧⲉϥⲁⲅⲁⲡⲏ	ⲉⲑⲃⲉ|ⲧⲉϥ|ⲁⲅⲁⲡⲏ
ⲫⲣⲁⲛ	ⲫ|ⲣⲁⲛ
ⲙⲡⲓⲟⲩⲣⲟ	ⲙ|ⲡⲓ|ⲟⲩⲣⲟ
ⲁⲃⲇⲉⲗⲁⲍⲓⲍ	ⲁⲃⲇⲉⲗⲁⲍⲓⲍ
ϣⲁⲩⲙⲟⲩϯ	ϣⲁ|ⲩ|ⲙⲟⲩϯ
ϫⲉⲁⲗⲁⲙⲏⲣ	ϫⲉ|ⲁⲗⲁⲙⲏⲣ
ⲉⲛⲁⲩⲟⲓ	ⲉ|ⲛⲁ|ⲩ|ⲟⲓ
ⲛϫⲉⲣⲱⲙⲓ	ⲛϫⲉ|ⲣⲱⲙⲓ
ⲙⲙⲁⲓⲛⲟⲩϯ	ⲙ|ⲙⲁⲓⲛⲟⲩϯ
ⲉⲧⲉⲁⲑⲁⲛⲁⲥⲓⲟⲥ	ⲉⲧⲉ|ⲁⲑⲁⲛⲁⲥⲓⲟⲥ
ⲛⲉⲙⲓⲥⲁⲁⲕ	ⲛⲉⲙ|ⲓⲥⲁⲁⲕ
ⲛⲉⲙⲛⲟⲩϣⲏⲣⲓ	ⲛⲉⲙ|ⲛⲟⲩ|ϣⲏⲣⲓ
ⲛⲁⲣⲉⲡⲓⲡⲣⲁⲓⲧⲱⲣⲓⲟⲛ	ⲛⲁⲣⲉ|ⲡⲓ|ⲡⲣⲁⲓⲧⲱⲣⲓⲟⲛ
ⲙⲉϩ	ⲙⲉϩ
ϧⲉⲛⲧⲉϥⲁⲣⲭⲏ	ϧⲉⲛ|ⲧⲉϥ|ⲁⲣⲭⲏ
ⲁϥϩⲓⲧⲟⲧϥ	ⲁ|ϥ|ϩⲓ|ⲧⲟⲧ|ϥ
ⲉⲉⲣⲡⲉⲧϩⲱⲟⲩ	ⲉ|ⲉⲣ|ⲡ|ⲉⲧ|ϩⲱⲟⲩ
ⲛⲓⲥⲧⲁⲩⲣⲟⲥ	ⲛⲓ|ⲥⲧⲁⲩⲣⲟⲥ
ⲁϥⲕⲁϣⲁⲩ	ⲁ|ϥ|ⲕⲁϣⲁ|ⲩ
ⲁϥⲉⲣϩⲁⲛⲙⲏϣ	ⲁ|ϥ|ⲉⲣ|ϩⲁⲛ|ⲙⲏϣ
ⲉⲧⲁϥⲉⲣⲉⲡⲓⲧⲓⲙⲁⲛ	ⲉⲧ|ⲁ|ϥ|ⲉⲣⲉⲡⲓⲧⲓⲙⲁⲛ
ⲙⲫⲁⲣⲁⲱ	ⲙ|ⲫⲁⲣⲁⲱ
ⲁϥϩⲓϩⲟϯ	ⲁ|ϥ|ϩⲓϩⲟϯ
ⲉⲡⲁⲓⲭⲉⲧ	ⲉ|ⲡⲁⲓ|ⲭⲉⲧ
ϧⲉⲛⲟⲩⲣⲁⲥⲟⲩⲓ	ϧⲉⲛ|ⲟⲩ|ⲣⲁⲥⲟⲩⲓ
ϩⲁⲡⲓⲁⲣⲭⲓⲉⲡⲓⲥⲕⲟⲡⲟⲥ	ϩⲁ|ⲡⲓ|ⲁⲣⲭⲓⲉⲡⲓⲥⲕⲟⲡⲟⲥ
ⲙⲡⲉϥⲥⲙⲟⲩ	ⲙ|ⲡⲉϥ|ⲥⲙⲟⲩ
ⲉⲧⲁⲩⲧⲁⲙⲉ	ⲉⲧ|ⲁ|ⲩ|ⲧⲁⲙⲉ
ϧⲉⲛⲡⲓⲧⲟⲡⲟⲥ	ϧⲉⲛ|ⲡⲓ|ⲧⲟⲡⲟⲥ
ⲛⲧⲉⲡⲓϩⲁⲅⲓⲟⲥ	ⲛⲧⲉ|ⲡⲓ|ϩⲁⲅⲓⲟⲥ
ⲉⲧⲁϥⲕⲟⲧϥ	ⲉⲧ|ⲁ|ϥ|ⲕⲟⲧ|ϥ
ⲉⲑⲣⲟⲩⲓⲛⲓ	ⲉ|ⲑⲣ|ⲟⲩ|ⲓⲛⲓ
ϫⲉⲅⲉⲱⲣⲅⲓⲟⲥ	ϫⲉ|ⲅⲉⲱⲣⲅⲓⲟⲥ
ⲁϥⲉⲣⲉⲡⲓⲑⲩⲙⲉⲓⲛ	ⲁ|ϥ|ⲉⲣⲉⲡⲓⲑⲩⲙⲉⲓⲛ
ⲉϯⲙⲉⲧⲁⲣⲭⲓⲉⲣⲉⲩⲥ	ⲉ|ϯ|ⲙⲉⲧⲁⲣⲭⲓⲉⲣⲉⲩⲥ
ⲡⲁⲣⲁⲫⲟⲩⲱϣ	ⲡⲁⲣⲁ|ⲫ|ⲟⲩⲱϣ
ⲁϥⲑⲉⲧⲡϩⲏⲧ	ⲁ|ϥ|ⲑⲉⲧ|ⲡ|ϩⲏⲧ
ⲉⲧⲁⲩϯⲙⲁϯ	ⲉⲧ|ⲁ|ⲩ|ϯⲙⲁϯ
ⲉⲑⲣⲟⲩϯ	ⲉ|ⲑⲣ|ⲟⲩ|ϯ
ⲛϯⲙⲉⲧⲁⲣⲭⲓⲉⲡⲓⲥⲕⲟⲡⲟⲥ	ⲛ|ϯ|ⲙⲉⲧⲁⲣⲭⲓⲉⲡⲓⲥⲕⲟⲡⲟⲥ
ⲛⲧⲉⲧⲉϥⲙⲉⲧⲡⲁⲣⲁⲛⲟⲙⲟⲥ	ⲛⲧⲉ|ⲧⲉϥ|ⲙⲉⲧⲡⲁⲣⲁⲛⲟⲙⲟⲥ
ⲛϯⲥⲟⲗⲏ	ⲛ|ϯ|ⲥⲟⲗⲏ
ⲛⲁⲓϥ	ⲛ|ⲁⲓ|ϥ
ϧⲉⲛⲧⲙⲏϯ	ϧⲉⲛ|ⲧ|ⲙⲏϯ
ⲛϯϩⲉⲃⲇⲟⲙⲁⲥ	ⲛ|ϯ|ϩⲉⲃⲇⲟⲙⲁⲥ
ⲉⲩⲟⲩⲱϣ	ⲉ|ⲩ|ⲟⲩⲱϣ
ⲉⲑⲁⲙⲓⲟ	ⲉ|ⲑⲁⲙⲓⲟ
ⲡⲁⲣⲁⲛⲓⲕⲁⲛⲱⲛ	ⲡⲁⲣⲁ|ⲛⲓ|ⲕⲁⲛⲱⲛ
ⲛϫⲉⲡⲓⲁⲣⲭⲓⲇⲓⲁⲕⲱⲛ	ⲛϫⲉ|ⲡⲓ|ⲁⲣⲭⲓⲇⲓⲁⲕⲱⲛ
ϫⲉⲁⲩⲕⲓⲙ	ϫⲉ|ⲁ|ⲩ|ⲕⲓⲙ
ϫⲉⲛⲛⲉⲥϣⲱⲡⲓ	ϫⲉ|ⲛⲛⲉ|ⲥ|ϣⲱⲡⲓ
ⲉⲑⲣⲉⲛⲓⲣⲓ	ⲉ|ⲑⲣⲉ|ⲛ|ⲓⲣⲓ
ⲛⲟⲩϩⲱⲃ	ⲛ|ⲟⲩ|ϩⲱⲃ
ⲙⲁⲣⲉⲛⲟϩⲓ	ⲙⲁⲣⲉ|ⲛ|ⲟϩⲓ
ϣⲁϯⲕⲩⲣⲓⲁⲕⲏ	ϣⲁ|ϯ|ⲕⲩⲣⲓⲁⲕⲏ
ⲡⲓⲣⲏϯ	ⲡⲓ|ⲣⲏϯ
ϣⲁϣⲧϥ	ϣⲁϣⲧ|ϥ
ⲉϣⲧⲉⲙⲉⲣⲟⲩⲏⲃ	ⲉ|ϣⲧⲉⲙ|ⲉⲣⲟⲩⲏⲃ
ⲛⲥⲛⲟϥ	ⲛ|ⲥⲛⲟϥ
ϩⲓⲭⲣⲟϥ	ϩⲓ|ⲭⲣⲟϥ
ϭⲓⲃⲟϯ	ϭⲓⲃⲟϯ
ⲛϫⲉⲛⲓⲛⲓϣϯ	ⲛϫⲉ|ⲛⲓ|ⲛⲓϣϯ
ⲉⲫⲱϣⲉⲛ	ⲉ|ⲫⲱϣⲉⲛ
ⲥⲟⲧⲡϥ	ⲥⲟⲧⲡ|ϥ
ⲉⲧⲁⲩϫⲉⲙⲛⲓⲕⲉⲭⲱⲟⲩⲛⲓ	ⲉⲧ|ⲁ|ⲩ|ϫⲉⲙ|ⲛⲓ|ⲕⲉ|ⲭⲱⲟⲩⲛⲓ
ⲉⲧⲁⲩⲣⲁⲃⲏⲟⲩⲧ	ⲉⲧ|ⲁ|ⲩ|ⲣⲁⲃⲏⲟⲩⲧ
ⲉⲁⲩϯⲙⲁϯ	ⲉ|ⲁ|ⲩ|ϯⲙⲁϯ
ⲛⲉⲙⲅⲉⲱⲣⲅⲓⲟⲥ	ⲛⲉⲙ|ⲅⲉⲱⲣⲅⲓⲟⲥ
ⲛϫⲉⲟⲩⲫⲱⲣϫ	ⲛϫⲉ|ⲟⲩ|ⲫⲱⲣϫ
ϧⲉⲛⲧⲟⲩϩⲙⲏϯ	ϧⲉⲛ|ⲧⲟⲩ|ϩⲙⲏϯ
ⲛϫⲉϩⲁⲛⲣⲉⲙⲛϩⲱⲃ	ⲛϫⲉ|ϩⲁⲛ|ⲣⲉⲙⲛϩⲱⲃ
ⲉⲑⲣⲟⲩⲉⲛⲛⲓⲉⲡⲓⲥⲕⲟⲡⲟⲥ	ⲉ|ⲑⲣ|ⲟⲩ|ⲉⲛ|ⲛⲓ|ⲉⲡⲓⲥⲕⲟⲡⲟⲥ
ⲛⲧⲉϥⲉⲙⲓ	ⲛⲧⲉ|ϥ|ⲉⲙⲓ
ⲉⲧⲟⲩⲛⲁⲑⲁϣϥ	ⲉⲧ|ⲟⲩ|ⲛⲁ|ⲑⲁϣ|ϥ
ϣⲉⲙϣⲓ	ϣⲉⲙϣⲓ
ϧⲉⲛⲡϫⲓⲛⲑⲣⲟⲩϧⲟⲧϧⲉⲧ	ϧⲉⲛ|ⲡ|ϫⲓⲛⲑⲣⲟⲩϧⲟⲧϧⲉⲧ
ⲛⲥⲁⲫⲃⲓⲟⲥ	ⲛⲥⲁ|ⲫ|ⲃⲓⲟⲥ
ⲁⲩϫⲉⲙⲟⲩⲙⲏϣ	ⲁ|ⲩ|ϫⲉⲙ|ⲟⲩ|ⲙⲏϣ
ⲛⲁⲓⲧⲓⲁ	ⲛ|ⲁⲓⲧⲓⲁ
ϫⲉⲛⲉⲟⲩⲣⲱⲙⲓ	ϫⲉ|ⲛⲉ|ⲟⲩ|ⲣⲱⲙⲓ
ⲉⲧⲁϥϭⲓⲅⲁⲙⲟⲥ	ⲉⲧ|ⲁ|ϥ|ϭⲓ|ⲅⲁⲙⲟⲥ
ϩⲁⲛϣⲏⲣⲓ	ϩⲁⲛ|ϣⲏⲣⲓ
ⲉⲩϩⲱⲟⲩ	ⲉ|ⲩ|ϩⲱⲟⲩ
ⲛⲥⲣⲁϩ	ⲛ|ⲥⲣⲁϩ
ⲉⲑⲱϣ	ⲉ|ⲑⲱϣ
ⲛϯⲕⲩⲣⲓⲁⲕⲏ	ⲛ|ϯ|ⲕⲩⲣⲓⲁⲕⲏ
ⲉⲩⲑⲟⲩⲏⲧ	ⲉ|ⲩ|ⲑⲟⲩⲏⲧ
ⲛⲉⲙⲣⲁⲕⲟϯ	ⲛⲉⲙ|ⲣⲁⲕⲟϯ
ⲛⲉⲙⲭⲱⲣⲁ	ⲛⲉⲙ|ⲭⲱⲣⲁ
ⲥⲉⲣⲅⲓⲟⲥ	ⲥⲉⲣⲅⲓⲟⲥ
ⲉϥϣⲗⲏⲗ	ⲉ|ϥ|ϣⲗⲏⲗ
ϧⲉⲛⲟⲩⲉⲝⲁⲓⲡⲛⲁ	ϧⲉⲛ|ⲟⲩ|ⲉⲝⲁⲓⲡⲛⲁ
ⲁⲡⲓⲫⲁⲛⲟⲥ	ⲁ|ⲡⲓ|ⲫⲁⲛⲟⲥ
ⲕⲱϣ	ⲕⲱϣ
ⲁϥϫⲟⲕⲙⲉϥ	ⲁ|ϥ|ϫⲟⲕⲙⲉ|ϥ
ⲁⲡⲓⲙⲏϣ	ⲁ|ⲡⲓ|ⲙⲏϣ
ϫⲉⲁⲝⲓⲟⲥ	ϫⲉ|ⲁⲝⲓⲟⲥ
ⲁⲝⲓⲟⲥ	ⲁⲝⲓⲟⲥ
ⲡⲓⲙⲁϩⲓⲅ	ⲡⲓ|ⲙⲁϩⲓⲅ
ⲁϥⲉⲣⲟⲩⲛⲓϣϯ	ⲁ|ϥ|ⲉⲣ|ⲟⲩ|ⲛⲓϣϯ
ⲛϣⲁⲓ	ⲛ|ϣⲁⲓ
ⲉⲛⲓⲉⲡⲓⲥⲕⲟⲡⲟⲥ	ⲉ|ⲛⲓ|ⲉⲡⲓⲥⲕⲟⲡⲟⲥ
ⲛϫⲉⲡⲓⲙⲁⲓⲛⲟⲩϯ	ⲛϫⲉ|ⲡⲓ|ⲙⲁⲓⲛⲟⲩϯ
ⲕⲩⲣⲓⲟⲥ	ⲕⲩⲣⲓⲟⲥ
ⲛⲓⲉⲡⲓⲥⲕⲟⲡⲟⲥ	ⲛⲓ|ⲉⲡⲓⲥⲕⲟⲡⲟⲥ
ⲁⲩⲉⲣ	ⲁ|ⲩ|ⲉⲣ
ⲥⲁⲧϩⲏ	ⲥⲁ|ⲧ|ϩⲏ
ϫⲉⲡⲓⲡⲛⲉⲩⲙⲁ	ϫⲉ|ⲡⲓ|ⲡⲛⲉⲩⲙⲁ
ⲉⲧⲑⲱϩⲉⲙ	ⲉⲧ|ⲑⲱϩⲉⲙ
ⲉⲧⲉⲣⲭⲉⲓⲣⲟⲧⲟⲛⲓⲟⲛ	ⲉⲧ|ⲉⲣⲭⲉⲓⲣⲟⲧⲟⲛⲓⲟⲛ
ϫⲉⲁϥⲑⲁϩⲥⲕ	ϫⲉ|ⲁ|ϥ|ⲑⲁϩⲥ|ⲕ
ⲛⲟⲩⲛⲉϩ	ⲛ|ⲟⲩ|ⲛⲉϩ
ⲛⲑⲉⲗⲏⲗ	ⲛ|ⲑⲉⲗⲏⲗ
ⲟⲩⲧⲉⲛⲉⲕϣⲫⲏⲣ	ⲟⲩⲧⲉ|ⲛⲉⲕ|ϣⲫⲏⲣ
ϩⲓⲧϩⲏ	ϩⲓ|ⲧ|ϩⲏ
ⲉⲧⲁⲩⲧⲁϩⲱⲟⲩ	ⲉⲧ|ⲁ|ⲩ|ⲧⲁϩⲱ|ⲟⲩ
ⲉⲅⲉⲱⲣⲅⲓⲟⲥ	ⲉ|ⲅⲉⲱⲣⲅⲓⲟⲥ
ⲉⲣⲉϯϩⲉⲃⲥⲱ	ⲉⲣⲉ|ϯ|ϩⲉⲃⲥⲱ
ⲛⲧⲉϯⲙⲉⲧⲟⲩⲏⲃ	ⲛⲧⲉ|ϯ|ⲙⲉⲧⲟⲩⲏⲃ
ⲉⲧⲑⲉⲃⲓⲏⲟⲩⲧ	ⲉⲧ|ⲑⲉⲃⲓⲏⲟⲩⲧ
ⲛⲉⲙⲛⲓⲙⲏϣ	ⲛⲉⲙ|ⲛⲓ|ⲙⲏϣ
ϧⲉⲛⲡⲁⲓⲃ	ϧⲉⲛ|ⲡⲁⲓ|ⲃ
ⲉⲣⲉⲧⲉⲛⲟⲩⲁϣϥ	ⲉⲣⲉ|ⲧⲉⲛ|ⲟⲩⲁϣ|ϥ
ϫⲉⲡⲁⲓⲙⲟⲛⲁⲭⲟⲥ	ϫⲉ|ⲡⲁⲓ|ⲙⲟⲛⲁⲭⲟⲥ
ⲟⲩϫⲱⲃ	ⲟⲩ|ϫⲱⲃ
ⲟⲩⲡⲁⲣⲑⲉⲛⲟⲥ	ⲟⲩ|ⲡⲁⲣⲑⲉⲛⲟⲥ
ⲉϥⲧⲟⲩⲃⲏⲟⲩⲧ	ⲉ|ϥ|ⲧⲟⲩⲃⲏⲟⲩⲧ
ⲙⲡⲓⲑⲣⲟⲛⲟⲥ	ⲙ|ⲡⲓ|ⲑⲣⲟⲛⲟⲥ
ⲛϩⲁⲛⲭⲣⲏⲙⲁ	ⲛ|ϩⲁⲛ|ⲭⲣⲏⲙⲁ
ⲁⲩⲉⲣⲁⲛⲁⲑⲉⲙⲁⲧⲓⲍⲉⲓⲛ	ⲁ|ⲩ|ⲉⲣⲁⲛⲁⲑⲉⲙⲁⲧⲓⲍⲉⲓⲛ
ϫⲉⲡⲉⲕϩⲁⲧ	ϫⲉ|ⲡⲉⲕ|ϩⲁⲧ
ⲉⲡⲧⲁⲕⲟ	ⲉ|ⲡ|ⲧⲁⲕⲟ
ϫⲉⲉⲭⲟⲩⲱϣ	ϫⲉ|ⲉ|ⲭ|ⲟⲩⲱϣ
ⲉϫⲫⲟ	ⲉ|ϫⲫⲟ
ⲛϯⲇⲱⲣⲉⲁ	ⲛ|ϯ|ⲇⲱⲣⲉⲁ
ϩⲓⲧⲉⲛϩⲁⲛⲭⲣⲏⲙⲁ	ϩⲓⲧⲉⲛ|ϩⲁⲛ|ⲭⲣⲏⲙⲁ
ⲁⲛⲓⲉⲡⲓⲥⲕⲟⲡⲟⲥ	ⲁ|ⲛⲓ|ⲉⲡⲓⲥⲕⲟⲡⲟⲥ
ⲉϯⲙⲉⲧⲟⲩⲏⲃ	ⲉ|ϯ|ⲙⲉⲧⲟⲩⲏⲃ
ϧⲉⲛⲟⲩϫⲱⲕ	ϧⲉⲛ|ⲟⲩ|ϫⲱⲕ
ⲉⲁⲫⲏ	ⲉ|ⲁ|ⲫⲏ
ϫⲉⲟⲩⲗⲁⲕⲕⲟⲥ	ϫⲉ|ⲟⲩ|ⲗⲁⲕⲕⲟⲥ
ⲁϥϣⲟⲕϥ	ⲁ|ϥ|ϣⲟⲕ|ϥ
ⲁϥϭⲣⲏ	ⲁ|ϥ|ϭⲣⲏ
ⲉϥⲉϩⲉⲓ	ⲉϥⲉ|ϩⲉⲓ
ⲡⲓϣⲓⲕ	ⲡⲓ|ϣⲓⲕ
ⲉⲧⲁϥⲉⲣϩⲱⲃ	ⲉⲧ|ⲁ|ϥ|ⲉⲣϩⲱⲃ
ⲉⲑⲛⲁϭⲟⲥϥ	ⲉⲑ|ⲛⲁ|ϭⲟⲥ|ϥ
ⲥⲉⲛⲁⲑⲉⲃⲓⲟϥ	ⲥⲉ|ⲛⲁ|ⲑⲉⲃⲓⲟ|ϥ
ⲉⲑⲛⲁⲑⲉⲃⲓⲟϥ	ⲉⲑ|ⲛⲁ|ⲑⲉⲃⲓⲟ|ϥ
ⲥⲉⲛⲁϭⲁⲥϥ	ⲥⲉ|ⲛⲁ|ϭⲁⲥ|ϥ
ϧⲉⲛⲟⲩⲯⲏⲫⲟⲥ	ϧⲉⲛ|ⲟⲩ|ⲯⲏⲫⲟⲥ
ⲛⲉⲙⲟⲩⲟⲙⲟⲛⲟⲓⲁ	ⲛⲉⲙ|ⲟⲩ|ⲟⲙⲟⲛⲟⲓⲁ
ⲛⲧⲉⲡⲓⲗⲁⲟⲥ	ⲛⲧⲉ|ⲡⲓ|ⲗⲁⲟⲥ
ⲁⲩⲉⲣⲭⲉⲓⲣⲟⲧⲟⲛⲉⲓⲛ	ⲁ|ⲩ|ⲉⲣⲭⲉⲓⲣⲟⲧⲟⲛⲉⲓⲛ
ⲡⲓⲣⲁϣⲓ	ⲡⲓ|ⲣⲁϣⲓ
ⲛⲉⲙⲡⲓⲟⲩⲛⲟϥ	ⲛⲉⲙ|ⲡⲓ|ⲟⲩⲛⲟϥ
ⲛⲁⲩⲉⲣⲭⲟⲣⲉⲩⲓⲛ	ⲛⲁ|ⲩ|ⲉⲣⲭⲟⲣⲉⲩⲓⲛ
ⲛϫⲉⲛⲓⲙⲏϣ	ⲛϫⲉ|ⲛⲓ|ⲙⲏϣ
ⲉⲣⲉⲛⲓϯⲙⲓ	ⲉⲣⲉ|ⲛⲓ|ϯⲙⲓ
ϣⲓⲃϯ	ϣⲓⲃϯ
ⲛⲛⲟⲩⲉⲣⲏⲩ	ⲛ|ⲛⲟⲩ|ⲉⲣⲏⲩ
ⲥⲁⲡⲉⲓⲉⲃⲧ	ⲥⲁ|ⲡ|ⲉⲓⲉⲃⲧ
ⲛⲉⲙⲥⲁⲡⲉⲙⲉⲛⲧ	ⲛⲉⲙ|ⲥⲁ|ⲡ|ⲉⲙⲉⲛⲧ
ⲓⲥϫⲉⲛⲃⲁⲃⲩⲗⲱⲛ	ⲓⲥϫⲉⲛ|ⲃⲁⲃⲩⲗⲱⲛ
ϣⲁⲣⲁⲕⲟϯ	ϣⲁ|ⲣⲁⲕⲟϯ
ⲛⲁⲩⲙⲟϣⲓ	ⲛⲁ|ⲩ|ⲙⲟϣⲓ
ⲉⲧⲁⲩⲑⲱⲟⲩϯ	ⲉⲧ|ⲁ|ⲩ|ⲑⲱⲟⲩϯ
ⲉⲑⲃⲉⲡⲧⲁϩⲟ	ⲉⲑⲃⲉ|ⲡ|ⲧⲁϩⲟ
ⲛⲁⲣⲉⲓⲱⲁⲛⲛⲏⲥ	ⲛⲁⲣⲉ|ⲓⲱⲁⲛⲛⲏⲥ
ⲛⲧⲉⲡϣⲁϯ	ⲛⲧⲉ|ⲡϣⲁϯ
ⲉⲧⲉⲛⲁϥⲟⲓ	ⲉⲧⲉ|ⲛⲁ|ϥ|ⲟⲓ
ⲛⲁⲡⲟⲕⲣⲓⲧⲏⲥ	ⲛ|ⲁⲡⲟⲕⲣⲓⲧⲏⲥ
ⲉϯⲉⲡⲓⲥⲕⲟⲡⲏ	ⲉ|ϯ|ⲉⲡⲓⲥⲕⲟⲡⲏ
ⲛⲧⲉϯⲁⲛⲟⲩ	ⲛⲧⲉ|ϯ|ⲁⲛⲟⲩ
ⲛⲉⲙⲅⲣⲏⲅⲟⲣⲓⲟⲥ	ⲛⲉⲙ|ⲅⲣⲏⲅⲟⲣⲓⲟⲥ
ⲛⲕⲁⲓⲥ	ⲛ|ⲕⲁⲓⲥ
ⲛⲧⲉϯⲕⲁⲧⲱ	ⲛⲧⲉ|ϯ|ⲕⲁⲧⲱ
ⲛⲉⲙⲛⲓⲉⲡⲓⲥⲕⲟⲡⲟⲥ	ⲛⲉⲙ|ⲛⲓ|ⲉⲡⲓⲥⲕⲟⲡⲟⲥ
ⲉⲣⲉⲛⲓⲕⲗⲏⲣⲓⲕⲟⲥ	ⲉⲣⲉ|ⲛⲓ|ⲕⲗⲏⲣⲓⲕⲟⲥ
ϥⲁⲓ	ϥⲁⲓ
ⲛⲛⲓⲉⲩⲁⲅⲅⲉⲗⲓⲟⲛ	ⲛ|ⲛⲓ|ⲉⲩⲁⲅⲅⲉⲗⲓⲟⲛ
ⲛⲉⲙⲛⲓⲥⲧⲁⲩⲣⲟⲥ	ⲛⲉⲙ|ⲛⲓ|ⲥⲧⲁⲩⲣⲟⲥ
ⲛⲉⲙϩⲁⲛⲕⲩⲣⲱⲛ	ⲛⲉⲙ|ϩⲁⲛ|ⲕⲩⲣⲱⲛ
ⲛⲁⲩⲉⲣⲯⲁⲗⲗⲉⲓⲛ	ⲛⲁ|ⲩ|ⲉⲣⲯⲁⲗⲗⲉⲓⲛ
ϣⲁⲧⲟⲩⲟⲗϥ	ϣⲁⲧ|ⲟⲩ|ⲟⲗ|ϥ
ⲛⲥⲟⲩⲏ	ⲛ|ⲥⲟⲩⲏ
ⲛⲭⲟⲓⲁⲕ	ⲛ|ⲭⲟⲓⲁⲕ
ⲛⲕⲩⲣⲓⲁⲕⲏ	ⲛ|ⲕⲩⲣⲓⲁⲕⲏ
ⲁⲩⲧϩⲉⲙⲥⲟϥ	ⲁ|ⲩ|ⲧϩⲉⲙⲥⲟ|ϥ
ϩⲓϫⲉⲛⲡⲓⲑⲣⲟⲛⲟⲥ	ϩⲓϫⲉⲛ|ⲡⲓ|ⲑⲣⲟⲛⲟⲥ
ⲛⲁⲡⲟⲥⲧⲟⲗⲓⲕⲟⲛ	ⲛ|ⲁⲡⲟⲥⲧⲟⲗⲓⲕⲟⲛ
ⲛⲧⲉⲡⲓⲉⲩⲁⲅⲅⲉⲗⲓⲥⲧⲏⲥ	ⲛⲧⲉ|ⲡⲓ|ⲉⲩⲁⲅⲅⲉⲗⲓⲥⲧⲏⲥ
ⲡⲓϧⲏⲃⲥ	ⲡⲓ|ϧⲏⲃⲥ
ⲉⲧⲁϥⲉⲣⲟⲩⲱⲓⲛⲓ	ⲉⲧ|ⲁ|ϥ|ⲉⲣⲟⲩⲱⲓⲛⲓ
ⲁⲩϫⲱⲕ	ⲁ|ⲩ|ϫⲱⲕ
ⲛⲧⲉϯⲙⲉⲧⲁⲣⲭⲓⲉⲣⲉⲩⲥ	ⲛⲧⲉ|ϯ|ⲙⲉⲧⲁⲣⲭⲓⲉⲣⲉⲩⲥ
ⲕⲁⲧⲁⲛⲓⲕⲁⲛⲱⲛ	ⲕⲁⲧⲁ|ⲛⲓ|ⲕⲁⲛⲱⲛ
ⲙⲡⲓⲉⲣϣⲓϣ	ⲙ|ⲡⲓ|ⲉⲣϣⲓϣ
ⲉⲥⲱⲛϩ	ⲉ|ⲥⲱⲛϩ
ⲛⲉⲙⲉⲃⲱⲗ	ⲛⲉⲙ|ⲉ|ⲃⲱⲗ
ⲁϥⲉⲣⲟⲩⲱⲓⲛⲓ	ⲁ|ϥ|ⲉⲣⲟⲩⲱⲓⲛⲓ
ⲉⲧϧⲉⲛⲡⲓⲉⲡⲓⲥⲕⲟⲡⲓⲟⲛ	ⲉⲧ|ϧⲉⲛ|ⲡⲓ|ⲉⲡⲓⲥⲕⲟⲡⲓⲟⲛ
ⲛⲟⲩⲛⲟⲙⲟⲥ	ⲛ|ⲟⲩ|ⲛⲟⲙⲟⲥ
ⲉⲑⲣⲉⲛⲓⲥⲛⲏⲟⲩ	ⲉ|ⲑⲣⲉ|ⲛⲓ|ⲥⲛⲏⲟⲩ
ⲉⲣⲏⲥⲩⲭⲁⲍⲉⲓⲛ	ⲉⲣⲏⲥⲩⲭⲁⲍⲉⲓⲛ
ϧⲉⲛⲛⲟⲩⲙⲁ	ϧⲉⲛ|ⲛⲟⲩ|ⲙⲁ
ⲛⲥⲉⲉⲣⲙⲉⲗⲉⲧⲁⲛ	ⲛ|ⲥⲉ|ⲉⲣⲙⲉⲗⲉⲧⲁⲛ
ϧⲉⲛⲛⲓⲅⲣⲁⲫⲏ	ϧⲉⲛ|ⲛⲓ|ⲅⲣⲁⲫⲏ
ⲛⲧⲟⲩⲓⲣⲓ	ⲛⲧ|ⲟⲩ|ⲓⲣⲓ
ⲛⲧⲟⲩⲥⲩⲛⲁⲝⲓⲥ	ⲛ|ⲧⲟⲩ|ⲥⲩⲛⲁⲝⲓⲥ
ⲉϥϯⲭⲟϩ	ⲉ|ϥ|ϯ|ⲭⲟϩ
ⲉⲫⲃⲓⲟⲥ	ⲉ|ⲫ|ⲃⲓⲟⲥ
ⲛⲛⲓⲣⲉⲙϣⲓⲏⲧ	ⲛ|ⲛⲓ|ⲣⲉⲙϣⲓⲏⲧ
ⲛϫⲉⲡⲕⲉⲥⲉⲉⲡⲏ	ⲛϫⲉ|ⲡ|ⲕⲉ|ⲥⲉⲉⲡⲏ
ⲛⲉⲙⲛⲓⲙⲟⲛⲁⲭⲟⲥ	ⲛⲉⲙ|ⲛⲓ|ⲙⲟⲛⲁⲭⲟⲥ
ⲛⲧⲉⲛⲓⲙⲟⲛⲁⲥⲧⲏⲣⲓⲟⲛ	ⲛⲧⲉ|ⲛⲓ|ⲙⲟⲛⲁⲥⲧⲏⲣⲓⲟⲛ
ⲁⲩⲉⲣⲡⲣⲟⲥⲕⲩⲛⲉⲓⲛ	ⲁ|ⲩ|ⲉⲣⲡⲣⲟⲥⲕⲩⲛⲉⲓⲛ
ⲉⲩⲥⲱⲟⲩⲛ	ⲉ|ⲩ|ⲥⲱⲟⲩⲛ
ⲛⲧⲉϥⲛⲓϣϯ	ⲛ|ⲧⲉϥ|ⲛⲓϣϯ
ⲛⲉⲙⲛⲉϥⲁⲥⲕⲏⲥⲓⲥ	ⲛⲉⲙ|ⲛⲉϥ|ⲁⲥⲕⲏⲥⲓⲥ
ϧⲉⲛϩⲁⲛϩⲃⲏⲟⲩⲓ	ϧⲉⲛ|ϩⲁⲛ|ϩⲃⲏⲟⲩⲓ
ⲉⲛⲁⲛⲉⲩ	ⲉ|ⲛⲁⲛⲉ|ⲩ
ϩⲙⲟⲧ	ϩⲙⲟⲧ
ⲥⲟⲡ	ⲥⲟⲡ
ⲉⲧⲉϥⲛⲁϩⲱⲗ	ⲉⲧⲉ|ϥ|ⲛⲁ|ϩⲱⲗ
ⲉⲉⲣⲡⲣⲟⲥⲫⲉⲣⲉⲓⲛ	ⲉ|ⲉⲣⲡⲣⲟⲥⲫⲉⲣⲉⲓⲛ
ⲓⲥϫⲉⲛⲡⲓⲛⲁⲩ	ⲓⲥϫⲉⲛ|ⲡⲓ|ⲛⲁⲩ
ⲉⲧⲉϥⲛⲁⲉⲣϩⲏⲧⲥ	ⲉⲧⲉ|ϥ|ⲛⲁ|ⲉⲣ|ϩⲏⲧ|ⲥ
ⲉϯⲁⲛⲁⲫⲟⲣⲁ	ⲉ|ϯ|ⲁⲛⲁⲫⲟⲣⲁ
ϣⲁⲣⲉⲛⲉϥⲃⲁⲗ	ϣⲁⲣⲉ|ⲛⲉϥ|ⲃⲁⲗ
ⲛϩⲁⲛⲉⲣⲙⲱⲟⲩⲓ	ⲛ|ϩⲁⲛ|ⲉⲣⲙⲱⲟⲩⲓ
ϣⲁⲧⲉϥϫⲱⲕ	ϣⲁⲧⲉ|ϥ|ϫⲱⲕ
ⲁϥϣⲁⲛⲫⲟϩ	ⲁϥϣⲁⲛ|ⲫⲟϩ
ⲉⲡⲓⲛⲁⲩ	ⲉ|ⲡⲓ|ⲛⲁⲩ
ⲉⲣⲉⲡⲓⲡⲛⲉⲩⲙⲁ	ⲉⲣⲉ|ⲡⲓ|ⲡⲛⲉⲩⲙⲁ
ϣⲁϥⲉⲣⲑⲉⲱⲣⲉⲓⲛ	ϣⲁ|ϥ|ⲉⲣⲑⲉⲱⲣⲉⲓⲛ
ⲉϥⲛⲏⲩ	ⲉ|ϥ|ⲛⲏⲩ
ⲉϫⲉⲛϯⲑⲩⲥⲓⲁ	ⲉϫⲉⲛ|ϯ|ⲑⲩⲥⲓⲁ
ⲉϥⲟⲩⲱⲧⲉⲃ	ⲉ|ϥ|ⲟⲩⲱⲧⲉⲃ
ⲉⲡⲓⲥⲱⲙⲁ	ⲉ|ⲡⲓ|ⲥⲱⲙⲁ
ⲛⲛⲟⲩϯ	ⲛ|ⲛⲟⲩϯ
ϧⲉⲛⲡϫⲓⲛⲑⲣⲉⲡⲁⲓⲁⲅⲓⲟⲥ	ϧⲉⲛ|ⲡ|ϫⲓⲛⲑⲣⲉⲡⲁⲓⲁⲅⲓⲟⲥ
ϣⲁⲣⲉⲟⲩϩⲟϯ	ϣⲁⲣⲉ|ⲟⲩ|ϩⲟϯ
ⲛⲉⲙⲟⲩⲣⲁϣⲓ	ⲛⲉⲙ|ⲟⲩ|ⲣⲁϣⲓ
ϣⲁⲣⲉⲡⲉϥϩⲟ	ϣⲁⲣⲉ|ⲡⲉϥ|ϩⲟ
ϩⲓⲁⲕⲧⲓⲛ	ϩⲓ|ⲁⲕⲧⲓⲛ
ⲉⲃⲱⲗ	ⲉⲃⲱⲗ
ⲛⲧⲉⲟⲩⲟⲛ	ⲛⲧⲉ|ⲟⲩⲟⲛ
ϫⲉⲁⲫⲛⲟⲩϯ	ϫⲉ|ⲁ|ⲫ|ⲛⲟⲩϯ
ⲁⲓⲧⲉⲛ	ⲁⲓⲧ|ⲉⲛ
ⲛⲉⲙⲡϣⲁ	ⲛ|ⲉⲙⲡϣⲁ
ⲛⲁⲣⲉⲡⲉϥⲛⲟⲩⲥ	ⲛⲁⲣⲉ|ⲡⲉϥ|ⲛⲟⲩⲥ
ⲛⲛⲓⲇⲟⲅⲙⲁ	ⲛ|ⲛⲓ|ⲇⲟⲅⲙⲁ
ⲙⲡⲓⲛⲓϣϯ	ⲙ|ⲡⲓ|ⲛⲓϣϯ
ⲛⲉⲙⲡⲓⲥⲟⲫⲟⲥ	ⲛⲉⲙ|ⲡⲓ|ⲥⲟⲫⲟⲥ
ⲕⲩⲣⲓⲗⲗⲟⲥ	ⲕⲩⲣⲓⲗⲗⲟⲥ
ⲁϥⲧⲁⲥⲑⲟ	ⲁ|ϥ|ⲧⲁⲥⲑⲟ
ϧⲉⲛⲛⲟⲩϩⲁⲓⲣⲉⲥⲓⲥ	ϧⲉⲛ|ⲛⲟⲩ|ϩⲁⲓⲣⲉⲥⲓⲥ
ⲁϥⲉⲛⲟⲩ	ⲁ|ϥ|ⲉⲛ|ⲟⲩ
ⲉⲡⲓⲛⲁϩϯ	ⲉ|ⲡⲓ|ⲛⲁϩϯ
ⲉⲧⲥⲟⲩⲧⲱⲛ	ⲉⲧ|ⲥⲟⲩⲧⲱⲛ
ⲛⲧⲉⲡⲉⲛϭⲟⲉⲓⲥ	ⲛⲧⲉ|ⲡⲉⲛ|ϭⲟⲉⲓⲥ
ϧⲉⲛⲡϫⲓⲛⲑⲣⲟⲩⲉⲣⲁⲛⲁⲑⲉⲙⲁⲧⲓⲍⲉⲓⲛ	ϧⲉⲛ|ⲡ|ϫⲓⲛⲑⲣⲟⲩⲉⲣⲁⲛⲁⲑⲉⲙⲁⲧⲓⲍⲉⲓⲛ
ⲛⲛⲟⲩϩⲁⲓⲣⲉⲥⲓⲥ	ⲛ|ⲛⲟⲩ|ϩⲁⲓⲣⲉⲥⲓⲥ
ⲙⲓⲛⲙⲙⲱⲟⲩ	ⲙⲓⲛⲙⲙⲱ|ⲟⲩ
ϩⲓⲧⲉⲛⲛⲉϥⲥⲁϫⲓ	ϩⲓⲧⲉⲛ|ⲛⲉϥ|ⲥⲁϫⲓ
ⲛⲣⲉϥⲧⲟⲩϫⲉⲯⲩⲭⲏ	ⲛ|ⲣⲉϥⲧⲟⲩϫⲉⲯⲩⲭⲏ
ⲉⲛϥ	ⲉⲛ|ϥ
ⲉⲟⲩⲧⲓⲙⲓ	ⲉ|ⲟⲩ|ⲧⲓⲙⲓ
ϫⲉⲡⲥⲁⲛⲁϣⲟ	ϫⲉ|ⲡⲥⲁⲛⲁϣⲟ
ⲉⲓⲧⲉ	ⲉⲓⲧⲉ
ⲛⲓϣϯ	ⲛⲓϣϯ
ⲙⲫⲛⲁⲩ	ⲙ|ⲫ|ⲛⲁⲩ
ⲙⲡⲓⲁⲣⲓⲥⲧⲟⲛ	ⲙ|ⲡⲓ|ⲁⲣⲓⲥⲧⲟⲛ
ⲉϥⲣⲟⲧⲉⲃ	ⲉ|ϥ|ⲣⲟⲧⲉⲃ
ⲉϥⲧϩⲉⲙⲕⲏⲟⲩⲧ	ⲉ|ϥ|ⲧϩⲉⲙⲕⲏⲟⲩⲧ
ⲉⲣⲉⲛⲉϥⲥⲁϧⲟⲩⲛ	ⲉⲣⲉ|ⲛⲉϥ|ⲥⲁϧⲟⲩⲛ
ⲛϣⲁϩ	ⲛ|ϣⲁϩ
ⲁϥϣⲁⲛⲥⲟ	ⲁϥϣⲁⲛ|ⲥⲟ
ⲛⲟⲩⲗⲁⲕⲕⲟⲥ	ⲛ|ⲟⲩ|ⲗⲁⲕⲕⲟⲥ
ϣⲁϥⲉⲣⲙⲫⲣⲏϯ	ϣⲁ|ϥ|ⲉⲣ|ⲙ|ⲫ|ⲣⲏϯ
ⲙⲡⲉϥⲥⲱ	ⲙⲡⲉ|ϥ|ⲥⲱ
ϩⲓⲧⲉⲛⲡⲓⲛⲓϣϯ	ϩⲓⲧⲉⲛ|ⲡⲓ|ⲛⲓϣϯ
ⲉⲧⲥⲁϧⲟⲩⲛ	ⲉⲧ|ⲥⲁϧⲟⲩⲛ
ⲉⲧⲁⲩⲉⲛϥ	ⲉⲧ|ⲁ|ⲩ|ⲉⲛ|ϥ
ⲟⲩⲇⲓⲕⲁⲓⲟⲥ	ⲟⲩ|ⲇⲓⲕⲁⲓⲟⲥ
ⲛⲉⲕϩⲁⲡ	ⲛⲉⲕ|ϩⲁⲡ
ⲥⲟⲩⲧⲱⲛ	ⲥⲟⲩⲧⲱⲛ
ⲛⲏⲣⲡ	ⲛ|ⲏⲣⲡ
ⲁϥⲥⲟϥ	ⲁ|ϥ|ⲥⲟ|ϥ
ⲁϥⲱϣⲉⲙ	ⲁ|ϥ|ⲱϣⲉⲙ
ⲛϫⲉⲡⲓⲭⲣⲱⲙ	ⲛϫⲉ|ⲡⲓ|ⲭⲣⲱⲙ
ⲉⲧⲁϥϧⲱⲛⲧ	ⲉⲧ|ⲁ|ϥ|ϧⲱⲛⲧ
ⲉⲃⲏⲑⲫⲁⲅⲏ	ⲉ|ⲃⲏⲑⲫⲁⲅⲏ
ⲛⲉⲙⲃⲏⲑⲁⲛⲓⲁ	ⲛⲉⲙ|ⲃⲏⲑⲁⲛⲓⲁ
ϧⲉⲛⲛⲉϥⲙⲁⲑⲏⲧⲏⲥ	ϧⲉⲛ|ⲛⲉϥ|ⲙⲁⲑⲏⲧⲏⲥ
ⲉⲡⲁⲓϯⲙⲓ	ⲉ|ⲡⲁⲓ|ϯⲙⲓ
ⲙⲡⲉⲧⲉⲛⲙⲑⲟ	ⲙ|ⲡⲉⲧⲉⲛ|ⲙⲑⲟ
ⲥⲁⲧⲉⲛⲑⲏⲛⲟⲩ	ⲥⲁⲧⲉⲛ|ⲑⲏⲛⲟⲩ
ⲉⲣⲉⲧⲉⲛⲛⲁϣⲉ	ⲉⲣⲉ|ⲧⲉⲛ|ⲛⲁ|ϣⲉ
ⲉⲣⲉⲧⲉⲛⲉϫⲓⲙⲓ	ⲉⲣⲉ|ⲧⲉⲛⲉ|ϫⲓⲙⲓ
ⲛⲟⲩⲥⲏϫ	ⲛ|ⲟⲩ|ⲥⲏϫ
ⲉⲧⲉⲙⲡⲁⲧⲉϩⲗⲓ	ⲉⲧⲉ|ⲙⲡⲁⲧⲉ|ϩⲗⲓ
ⲁⲗⲏⲓ	ⲁⲗⲏⲓ
ⲙⲁϯⲟⲩⲱ	ⲙⲁ|ϯⲟⲩⲱ
ⲉⲧⲉⲧⲉⲛⲓⲣⲓ	ⲉⲧⲉ|ⲧⲉⲛ|ⲓⲣⲓ
ⲡⲉⲧⲉⲣⲭⲣⲓⲁ	ⲡ|ⲉⲧⲉ|ⲣⲭⲣⲓⲁ
ϥⲛⲁⲟⲩⲟⲣⲡϥ	ϥ|ⲛⲁ|ⲟⲩⲟⲣⲡ|ϥ
ⲙⲛⲁⲓ	ⲙ|ⲛⲁⲓ
ϧⲁⲧⲉⲛⲟⲩⲣⲟ	ϧⲁⲧⲉⲛ|ⲟⲩ|ⲣⲟ
ⲙⲡⲓϧⲓⲣ	ⲙ|ⲡⲓ|ϧⲓⲣ
ⲁⲩϯⲟⲩⲱ	ⲁ|ⲩ|ϯⲟⲩⲱ
ⲡⲉⲧⲉⲧⲉⲛⲓⲣⲓ	ⲡ|ⲉⲧⲉ|ⲧⲉⲛ|ⲓⲣⲓ
ⲉⲣⲉⲧⲉⲛϯⲟⲩⲱ	ⲉⲣⲉ|ⲧⲉⲛ|ϯⲟⲩⲱ
ⲙⲡⲓⲥⲏϫ	ⲙ|ⲡⲓ|ⲥⲏϫ
ⲁⲩⲭⲁⲩ	ⲁ|ⲩ|ⲭⲁ|ⲩ
ⲁⲩⲧⲁⲗⲉⲛⲟⲩϩⲃⲱⲥ	ⲁ|ⲩ|ⲧⲁⲗⲉ|ⲛⲟⲩ|ϩⲃⲱⲥ
ϩⲓϫⲱⲟⲩ	ϩⲓϫⲱ|ⲟⲩ
ⲁⲩⲫⲱⲣϣ	ⲁ|ⲩ|ⲫⲱⲣϣ
ⲛⲛⲟⲩϩⲃⲱⲥ	ⲛ|ⲛⲟⲩ|ϩⲃⲱⲥ
ⲁⲩⲕⲱⲣϫ	ⲁ|ⲩ|ⲕⲱⲣϫ
ⲛϩⲁⲛϫⲁⲗ	ⲛ|ϩⲁⲛ|ϫⲁⲗ
ϧⲉⲛⲛⲓⲓⲟϩⲓ	ϧⲉⲛ|ⲛⲓ|ⲓⲟϩⲓ
ⲛⲁⲩⲫⲱⲣϣ	ⲛⲁ|ⲩ|ⲫⲱⲣϣ
ⲉⲛⲁⲩⲙⲟϣⲓ	ⲉ|ⲛⲁ|ⲩ|ⲙⲟϣⲓ
ϫⲉⲱⲥⲁⲛⲛⲁ	ϫⲉ|ⲱⲥⲁⲛⲛⲁ
ϥⲥⲙⲁⲣⲱⲟⲩⲧ	ϥ|ⲥⲙⲁⲣⲱⲟⲩⲧ
ⲛϫⲉⲡⲉⲧⲛⲏⲟⲩ	ⲛϫⲉ|ⲡ|ⲉⲧ|ⲛⲏⲟⲩ
ⲥⲥⲙⲁⲣⲱⲟⲩⲧ	ⲥ|ⲥⲙⲁⲣⲱⲟⲩⲧ
ⲛϫⲉϯⲙⲉⲧⲟⲩⲣⲟ	ⲛϫⲉ|ϯ|ⲙⲉⲧⲟⲩⲣⲟ
ⲉⲧⲛⲏⲟⲩ	ⲉⲧ|ⲛⲏⲟⲩ
ⲛⲧⲉⲡⲉⲛⲉⲓⲱⲧ	ⲛⲧⲉ|ⲡⲉⲛ|ⲉⲓⲱⲧ
ⲱⲥⲁⲛⲛⲁ	ⲱⲥⲁⲛⲛⲁ
ⲉⲡⲓⲉⲣⲫⲉⲓ	ⲉ|ⲡⲓ|ⲉⲣⲫⲉⲓ
ⲉⲧⲁϥⲥⲟⲙⲥ	ⲉⲧ|ⲁ|ϥ|ⲥⲟⲙⲥ
ⲛⲧⲉⲟⲩⲟⲩⲛⲟⲩ	ⲛⲧⲉ|ⲟⲩ|ⲟⲩⲛⲟⲩ
ⲉⲃⲏⲑⲁⲛⲓⲁ	ⲉ|ⲃⲏⲑⲁⲛⲓⲁ
ⲁϥϩⲕⲟ	ⲁ|ϥ|ϩⲕⲟ
ⲉⲟⲩⲃⲱ	ⲉ|ⲟⲩ|ⲃⲱ
ϩⲁⲛϫⲱⲃⲓ	ϩⲁⲛ|ϫⲱⲃⲓ
ϫⲉϩⲁⲣⲁ	ϫⲉ|ϩⲁⲣⲁ
ϥⲛⲁϫⲉⲙϩⲗⲓ	ϥ|ⲛⲁ|ϫⲉⲙ|ϩⲗⲓ
ⲙⲡⲉϥϫⲉⲙϩⲗⲓ	ⲙⲡⲉ|ϥ|ϫⲉⲙ|ϩⲗⲓ
ⲉϩⲁⲛϫⲱⲃⲓ	ⲉ|ϩⲁⲛ|ϫⲱⲃⲓ
ⲛⲉⲡⲥⲏⲟⲩ	ⲛⲉ|ⲡ|ⲥⲏⲟⲩ
ϫⲉⲛⲛⲉϩⲗⲓ	ϫⲉ|ⲛⲛⲉ|ϩⲗⲓ
ϫⲉⲙⲟⲩⲧⲁϩ	ϫⲉⲙⲟⲩⲧⲁϩ
ϩⲓⲱϯ	ϩⲓⲱ|ϯ
ⲛⲁⲩⲥⲱⲧⲉⲙ	ⲛⲁ|ⲩ|ⲥⲱⲧⲉⲙ
ⲛϩⲓⲟⲩⲓ	ⲛ|ϩⲓⲟⲩⲓ
ⲛⲓⲧⲣⲁⲡⲉⲍⲁ	ⲛⲓ|ⲧⲣⲁⲡⲉⲍⲁ
ⲛⲧⲉⲛⲓⲕⲟⲗⲩⲃⲓⲥⲧⲏⲥ	ⲛⲧⲉ|ⲛⲓ|ⲕⲟⲗⲩⲃⲓⲥⲧⲏⲥ
ⲛⲉⲙⲛⲓⲕⲁⲑⲉⲇⲣⲁ	ⲛⲉⲙ|ⲛⲓ|ⲕⲁⲑⲉⲇⲣⲁ
ϭⲣⲟⲙⲡⲓ	ϭⲣⲟⲙⲡⲓ
ⲁϥⲥⲟⲥⲟⲩ	ⲁ|ϥ|ⲥⲟⲥⲟⲩ
ⲛⲧⲉϥⲉⲛⲟⲩⲥⲕⲉⲩⲟⲥ	ⲛⲧⲉ|ϥ|ⲉⲛ|ⲟⲩ|ⲥⲕⲉⲩⲟⲥ
ϩⲓⲧⲉⲛⲡⲓⲉⲣⲫⲉⲓ	ϩⲓⲧⲉⲛ|ⲡⲓ|ⲉⲣⲫⲉⲓ
ϫⲉⲥⲥϧⲏⲟⲩⲧ	ϫⲉ|ⲥ|ⲥϧⲏⲟⲩⲧ
ϫⲉⲡⲁⲏⲓ	ϫⲉ|ⲡⲁ|ⲏⲓ
ⲉⲩⲉⲙⲟⲩϯ	ⲉⲩⲉ|ⲙⲟⲩϯ
ⲙⲡⲣⲟⲥⲉⲩⲭⲏ	ⲙ|ⲡⲣⲟⲥⲉⲩⲭⲏ
ⲛⲛⲓⲉⲑⲛⲟⲥ	ⲛ|ⲛⲓ|ⲉⲑⲛⲟⲥ
ⲁⲣⲉⲧⲉⲛⲁⲓϥ	ⲁⲣⲉ|ⲧⲉⲛ|ⲁⲓ|ϥ
ⲙⲃⲏⲃ	ⲙ|ⲃⲏⲃ
ⲛⲥⲟⲛⲓ	ⲛ|ⲥⲟⲛⲓ
ϫⲉⲁⲩⲛⲁⲧⲁⲕⲟϥ	ϫⲉ|ⲁ|ⲩ|ⲛⲁ|ⲧⲁⲕⲟ|ϥ
ⲉϫⲉⲛⲧⲉϥⲥⲃⲱ	ⲉϫⲉⲛ|ⲧⲉϥ|ⲥⲃⲱ
ⲛⲧⲉⲣⲟⲩϩⲓ	ⲛⲧⲉ|ⲣⲟⲩϩⲓ
ⲛⲁϥϩⲏⲗ	ⲛⲁ|ϥ|ϩⲏⲗ
ⲉⲩⲥⲓⲛⲓⲱⲟⲩ	ⲉ|ⲩ|ⲥⲓⲛⲓⲱⲟⲩ
ⲉϯⲃⲱ	ⲉ|ϯ|ⲃⲱ
ϩⲓⲧⲉⲥⲛⲟⲩⲛⲓ	ϩⲓ|ⲧⲉⲥ|ⲛⲟⲩⲛⲓ
ⲉⲧⲁϥⲉⲣⲫⲙⲉⲩⲓ	ⲉⲧ|ⲁ|ϥ|ⲉⲣ|ⲫ|ⲙⲉⲩⲓ
ⲉⲧⲁⲕⲥⲁϩⲟⲩⲓ	ⲉⲧ|ⲁ|ⲕ|ⲥⲁϩⲟⲩⲓ
ϫⲉⲭⲁⲟⲩⲛⲁϩϯ	ϫⲉ|ⲭⲁ|ⲟⲩ|ⲛⲁϩϯ
ⲉⲧⲛⲁϫⲟⲥ	ⲉⲧ|ⲛⲁ|ϫⲟ|ⲥ
ⲙⲡⲁⲓⲧⲱⲟⲩ	ⲙ|ⲡⲁⲓ|ⲧⲱⲟⲩ
ϫⲉϥⲓⲧⲕ	ϫⲉ|ϥⲓⲧ|ⲕ
ϩⲓⲧⲕ	ϩⲓⲧ|ⲕ
ⲛⲧⲉϥϣⲧⲉⲙϭⲓⲥⲁⲛⲓⲥ	ⲛⲧⲉ|ϥ|ϣⲧⲉⲙ|ϭⲓⲥⲁⲛⲓⲥ
ⲛⲧⲉϥⲛⲁϩϯ	ⲛⲧⲉ|ϥ|ⲛⲁϩϯ
ⲉⲧⲉϥϫⲱ	ⲉⲧⲉ|ϥ|ϫⲱ
ⲉⲧⲉⲧⲉⲛⲛⲁⲉⲣⲉⲧⲓⲛ	ⲉⲧⲉ|ⲧⲉⲛ|ⲛⲁ|ⲉⲣⲉⲧⲓⲛ
ϫⲉⲁⲣⲉⲧⲉⲛϭⲓ	ϫⲉ|ⲁⲣⲉ|ⲧⲉⲛ|ϭⲓ
ⲁⲣⲉⲧⲉⲛϣⲁⲛⲟϩⲓ	ⲁⲣⲉⲧⲉⲛϣⲁⲛ|ⲟϩⲓ
ⲙⲡⲉⲧⲉⲟⲩⲟⲛ	ⲙⲡ|ⲉⲧⲉ|ⲟⲩⲟⲛ
ⲛⲧⲉϥⲭⲱ	ⲛⲧⲉ|ϥ|ⲭⲱ
ⲛⲛⲉⲧⲛⲡⲁⲣⲁⲡⲧⲱⲙⲁ	ⲛ|ⲛⲉⲧⲛ|ⲡⲁⲣⲁⲡⲧⲱⲙⲁ
ⲛⲧⲉⲧⲉⲛϣⲧⲉⲙⲭⲱ	ⲛⲧⲉ|ⲧⲉⲛ|ϣⲧⲉⲙ|ⲭⲱ
ⲛⲛⲉϥⲭⲱ	ⲛⲛⲉ|ϥ|ⲭⲱ
ⲙⲡⲉⲧⲉⲛⲡⲁⲣⲁⲡⲧⲱⲙⲁ	ⲙ|ⲡⲉⲧⲉⲛ|ⲡⲁⲣⲁⲡⲧⲱⲙⲁ
ϫⲉⲁⲕⲓⲣⲓ	ϫⲉ|ⲁ|ⲕ|ⲓⲣⲓ
ⲛⲉⲣϣⲓϣⲓ	ⲛ|ⲉⲣϣⲓϣⲓ
ⲡⲉⲧⲁϥϯ	ⲡ|ⲉⲧ|ⲁ|ϥ|ϯ
ⲙⲡⲁⲓⲉⲣϣⲓϣⲓ	ⲙ|ⲡⲁⲓ|ⲉⲣϣⲓϣⲓ
ⲛⲧⲉⲕⲓⲣⲓ	ⲛⲧⲉ|ⲕ|ⲓⲣⲓ
ϫⲉϯⲛⲁϣⲉⲛⲑⲏⲛⲟⲩ	ϫⲉ|ϯ|ⲛⲁ|ϣⲉⲛ|ⲑⲏⲛⲟⲩ
ⲉⲟⲩⲥⲁϫⲓ	ⲉ|ⲟⲩ|ⲥⲁϫⲓ
ⲁⲣⲓⲟⲩⲱ	ⲁⲣⲓⲟⲩⲱ
ϯⲛⲁϫⲟⲥ	ϯ|ⲛⲁ|ϫⲟ|ⲥ
ϫⲉⲁⲓⲓⲣⲓ	ϫⲉ|ⲁ|ⲓ|ⲓⲣⲓ
ⲡⲓⲱⲙⲥ	ⲡⲓ|ⲱⲙⲥ
ⲛⲧⲉⲓⲱⲁⲛⲛⲏⲥ	ⲛⲧⲉ|ⲓⲱⲁⲛⲛⲏⲥ
ϫⲉⲁⲛϣⲁⲛϫⲟⲥ	ϫⲉ|ⲁⲛϣⲁⲛ|ϫⲟ|ⲥ
ϥⲛⲁϫⲟⲥ	ϥ|ⲛⲁ|ϫⲟ|ⲥ
ⲙⲡⲉⲧⲉⲛⲛⲁϩϯ	ⲙⲡⲉ|ⲧⲉⲛ|ⲛⲁϩϯ
ⲛⲧⲉⲛϫⲟⲥ	ⲛⲧⲉ|ⲛ|ϫⲟ|ⲥ
ⲧⲉⲛⲉⲣϩⲟϯ	ⲧⲉⲛ|ⲉⲣϩⲟϯ
ϫⲉⲟⲛⲧⲱⲥ	ϫⲉ|ⲟⲛⲧⲱⲥ
ⲛⲉⲟⲩⲡⲣⲟⲫⲏⲧⲏⲥ	ⲛⲉ|ⲟⲩ|ⲡⲣⲟⲫⲏⲧⲏⲥ
ⲉⲧⲁⲩⲉⲣⲟⲩⲱ	ⲉⲧ|ⲁ|ⲩ|ⲉⲣⲟⲩⲱ
ϫⲉⲧⲉⲛⲓ	ϫⲉ|ⲧⲉⲛ|ⲓ
ⲉⲣⲉⲧⲉⲛⲟⲛⲓ	ⲉⲣⲉ|ⲧⲉⲛ|ⲟⲛⲓ
ⲉϯⲟⲛⲓ	ⲉ|ϯ|ⲟⲛⲓ
ϯⲧⲁⲓⲟ	ϯ|ⲧⲁⲓⲟ
ϫⲉⲧⲉⲧⲉⲛⲓⲣⲓ	ϫⲉ|ⲧⲉⲧⲉⲛ|ⲓⲣⲓ
ⲙⲡⲁⲙⲉⲩⲓ	ⲙ|ⲡⲁ|ⲙⲉⲩⲓ
ⲉⲧⲁⲓϯ	ⲉⲧ|ⲁ|ⲓ|ϯ
ⲛⲛⲓⲡⲁⲣⲁⲇⲟⲥⲓⲥ	ⲛ|ⲛⲓ|ⲡⲁⲣⲁⲇⲟⲥⲓⲥ
ⲧⲁⲫⲉ	ⲧ|ⲁⲫⲉ
ⲡⲉⲥϩⲁⲓ	ⲡⲉⲥ|ϩⲁⲓ
ⲉⲧⲧⲱⲃϩ	ⲉⲧ|ⲧⲱⲃϩ
ⲉϥⲉⲣⲡⲣⲟⲫⲏ	ⲉ|ϥ|ⲉⲣⲡⲣⲟⲫⲏ
ⲧⲉⲩⲓⲛ	ⲧⲉⲩⲓⲛ
ⲉⲣⲉϫⲱϥ	ⲉⲣⲉ|ϫⲱ|ϥ
ϩⲱⲃⲥ	ϩⲱⲃⲥ
ⲉϥϯϣⲓⲡⲓ	ⲉ|ϥ|ϯϣⲓⲡⲓ
ⲉⲥⲧⲱⲃϩ	ⲉ|ⲥ|ⲧⲱⲃϩ
ⲉⲥⲉⲣⲡⲣⲟⲫⲏⲧⲉⲩⲓⲛ	ⲉ|ⲥ|ⲉⲣⲡⲣⲟⲫⲏⲧⲉⲩⲓⲛ
ⲛϫⲱⲥ	ⲛ|ϫⲱ|ⲥ
ⲥϯϣⲓⲡⲓ	ⲥ|ϯ|ϣⲓⲡⲓ
ⲛⲧⲉⲥⲁⲫⲉ	ⲛ|ⲧⲉⲥ|ⲁⲫⲉ
ⲛⲑⲏⲉⲧⲉϫⲱⲥ	ⲛ|ⲑⲏ|ⲉⲧⲉ|ϫⲱ|ⲥ
ϧⲟⲕϩⲥ	ϧⲟⲕϩ|ⲥ
ⲓⲥϫⲉⲅⲁⲣ	ⲓⲥϫⲉ|ⲅⲁⲣ
ⲛⲁϩⲉⲃⲥϫⲱⲥ	ⲛⲁ|ϩⲉⲃⲥ|ϫⲱ|ⲥ
ⲙⲁⲣⲉⲥϧⲟⲕϩϥ	ⲙⲁⲣⲉ|ⲥ|ϧⲟⲕϩ|ϥ
ⲓⲥϫⲉⲟⲩϣⲱϣ	ⲓⲥϫⲉ|ⲟⲩ|ϣⲱϣ
ⲉⲟⲩⲥϩⲓⲙⲓ	ⲉ|ⲟⲩ|ⲥϩⲓⲙⲓ
ⲉϫⲉⲃⲥϫⲱⲥ	ⲉ|ϫⲉⲃⲥ|ϫⲱ|ⲥ
ⲉϧⲟⲕϩϥ	ⲉ|ϧⲟⲕϩ|ϥ
ⲙⲁⲣⲉⲥϩⲉⲃⲥϫⲱⲥ	ⲙⲁⲣⲉ|ⲥ|ϩⲉⲃⲥ|ϫⲱ|ⲥ
ⲥⲉⲙⲡϣⲁ	ⲥ|ⲉⲙⲡϣⲁ
ⲛⲧⲉϥϩⲉⲃⲥϫⲱϥ	ⲛⲧⲉ|ϥ|ϩⲉⲃⲥ|ϫⲱ|ϥ
ϫⲉⲟⲩϩⲓⲕⲱⲛ	ϫⲉ|ⲟⲩ|ϩⲓⲕⲱⲛ
ⲛⲉⲙⲟⲩⲱⲟⲩ	ⲛⲉⲙ|ⲟⲩ|ⲱⲟⲩ
ⲟⲩⲱⲟⲩ	ⲟⲩ|ⲱⲟⲩ
ⲛⲧⲉⲡⲉⲥϩⲁⲓ	ⲛⲧⲉ|ⲡⲉⲥ|ϩⲁⲓ
ⲛⲉⲧⲁⲩⲉⲛⲡⲓⲣⲱⲙⲓ	ⲛ|ⲉⲧ|ⲁ|ⲩ|ⲉⲛ|ⲡⲓ|ⲣⲱⲙⲓ
ⲕⲉⲅⲁⲣ	ⲕⲉ|ⲅⲁⲣ
ⲛⲉⲧⲁⲩⲥⲉⲛⲧⲡⲓⲣⲱⲙⲓ	ⲛ|ⲉⲧ|ⲁ|ⲩ|ⲥⲉⲛⲧ|ⲡⲓ|ⲣⲱⲙⲓ
ⲉⲑⲃⲉϯⲥϩⲓⲙⲓ	ⲉⲑⲃⲉ|ϯ|ⲥϩⲓⲙⲓ
ⲉⲑⲃⲉⲡⲓⲣⲱⲙⲓ	ⲉⲑⲃⲉ|ⲡⲓ|ⲣⲱⲙⲓ
ⲛⲧⲉϯⲥϩⲓⲙⲓ	ⲛⲧⲉ|ϯ|ⲥϩⲓⲙⲓ
ⲭⲁⲟⲩⲉⲣϣⲱⲛ	ⲭⲁ|ⲟⲩ|ⲉⲣϣⲱⲛ
ⲉϫⲉⲛⲧⲉⲥⲁⲫⲉ	ⲉϫⲉⲛ|ⲧⲉⲥ|ⲁⲫⲉ
ⲉⲑⲃⲉⲛⲓⲁⲅⲅⲉⲗⲟⲥ	ⲉⲑⲃⲉ|ⲛⲓ|ⲁⲅⲅⲉⲗⲟⲥ
ⲭⲱⲣⲓⲥ	ⲭⲱⲣⲓⲥ
ⲉⲧⲉϯⲥϩⲓⲙⲓ	ⲉⲧⲉ|ϯ|ⲥϩⲓⲙⲓ
ϫⲉⲁⲥⲥϣⲉ	ϫⲉ|ⲁ|ⲥ|ⲥϣⲉ
ⲛⲟⲩⲥϩⲓⲙⲓ	ⲛ|ⲟⲩ|ⲥϩⲓⲙⲓ
ⲉⲑⲣⲉⲥⲧⲱⲃϩ	ⲉ|ⲑⲣⲉ|ⲥ|ⲧⲱⲃϩ
ϩⲟⲃⲥ	ϩⲟⲃⲥ
ϯⲫⲩⲥⲓⲥ	ϯ|ⲫⲩⲥⲓⲥ
ϯⲥⲃⲱ	ϯⲥⲃⲱ
ϫⲉⲡⲓⲣⲱⲙⲓ	ϫⲉ|ⲡⲓ|ⲣⲱⲙⲓ
ϣⲏⲟⲩ	ϣⲏⲟⲩ
ⲟⲩϣⲱϣ	ⲟⲩ|ϣⲱϣ
ⲉⲣⲉϫⲱⲥ	ⲉⲣⲉ|ϫⲱ|ⲥ
ϫⲉⲉⲧⲁⲩϯ	ϫⲉ|ⲉⲧ|ⲁ|ⲩ|ϯ
ⲙⲡⲓϥⲱⲓ	ⲙ|ⲡⲓ|ϥⲱⲓ
ⲛⲟⲩⲉⲣϣⲱⲛ	ⲛ|ⲟⲩ|ⲉⲣϣⲱⲛ
ⲓⲥϫⲉⲇⲉⲟⲩⲟⲛⲟⲩⲁⲓ	ⲓⲥϫⲉ|ⲇⲉ|ⲟⲩⲟⲛ|ⲟⲩⲁⲓ
ⲉⲉⲣⲣⲉϥϣϭ	ⲉ|ⲉⲣⲣⲉϥϣϭ
ⲛⲏⲛ	ⲛⲏ|ⲛ
ⲙⲙⲟⲛⲧⲁⲛ	ⲙⲙⲟⲛⲧⲁ|ⲛ
ⲛⲟⲩⲕⲁϩⲥ	ⲛ|ⲟⲩ|ⲕⲁϩⲥ
ⲛⲓⲉⲕⲕⲗⲏⲥⲓⲁ	ⲛⲓ|ⲉⲕⲕⲗⲏⲥⲓⲁ
ⲉⲓϩⲟⲛϩⲉⲛ	ⲉ|ⲓ|ϩⲟⲛϩⲉⲛ
ⲛⲁⲓⲑⲙⲁⲓⲟ	ⲛ|ⲁ|ⲓ|ⲑⲙⲁⲓⲟ
ϫⲉⲉⲧⲁⲣⲉⲧⲉⲛⲑⲱⲟⲩϯ	ϫⲉ|ⲉⲧ|ⲁⲣⲉ|ⲧⲉⲛ|ⲑⲱⲟⲩϯ
ⲉⲡⲉⲧⲥⲱⲧⲡ	ⲉ|ⲡ|ⲉⲧ|ⲥⲱⲧⲡ
ⲉⲣⲉⲧⲉⲛⲛⲁⲑⲱⲟⲩϯ	ⲉⲣⲉ|ⲧⲉⲛ|ⲛⲁ|ⲑⲱⲟⲩϯ
ϩⲓⲟⲩⲙⲁ	ϩⲓ|ⲟⲩ|ⲙⲁ
ϯⲥⲱⲧⲉⲙ	ϯ|ⲥⲱⲧⲉⲙ
ⲉϩⲁⲛⲫⲱⲣϫ	ⲉ|ϩⲁⲛ|ⲫⲱⲣϫ
ⲛⲧⲉϩⲁⲛϩⲉⲣⲉⲥⲓⲥ	ⲛⲧⲉ|ϩⲁⲛ|ϩⲉⲣⲉⲥⲓⲥ
ⲛⲓⲥⲱⲧⲡ	ⲛⲓ|ⲥⲱⲧⲡ
ⲛⲥⲉⲟⲩⲱⲛϩ	ⲛ|ⲥⲉ|ⲟⲩⲱⲛϩ
ⲛⲟⲩⲕⲩⲣⲓⲁⲕⲟⲛ	ⲛ|ⲟⲩ|ⲕⲩⲣⲓⲁⲕⲟⲛ
ⲛⲇⲓⲡⲛⲟⲛ	ⲛ|ⲇⲓⲡⲛⲟⲛ
ⲉⲟⲩⲟⲙϥ	ⲉ|ⲟⲩⲟⲙ|ϥ
ϥⲉⲣϣⲟⲣⲡ	ϥ|ⲉⲣϣⲟⲣⲡ
ⲛϭⲓ	ⲛ|ϭⲓ
ϧⲉⲛⲡⲉϥⲇⲓⲡⲛⲟⲛ	ϧⲉⲛ|ⲡⲉϥ|ⲇⲓⲡⲛⲟⲛ
ⲟⲩⲟⲛⲡⲉⲧϩⲟⲕⲉⲣ	ⲟⲩⲟⲛ|ⲡ|ⲉⲧ|ϩⲟⲕⲉⲣ
ⲟⲩⲟⲛⲡⲉⲧⲑⲁϧⲓ	ⲟⲩⲟⲛ|ⲡ|ⲉⲧ|ⲑⲁϧⲓ
ⲙⲙⲟⲛⲧⲉⲧⲉⲛⲏⲓ	ⲙⲙⲟⲛⲧⲉ|ⲧⲉⲛ|ⲏⲓ
ⲁⲣⲉⲧⲉⲛⲉⲣⲕⲁⲧⲁⲫⲣⲟⲛⲓⲛ	ⲁⲣⲉ|ⲧⲉⲛ|ⲉⲣⲕⲁⲧⲁⲫⲣⲟⲛⲓⲛ
ⲛⲧⲉⲧⲉⲛϯϣⲓⲡⲓ	ⲛⲧⲉ|ⲧⲉⲛ|ϯϣⲓⲡⲓ
ⲉⲧⲉⲙⲙⲟⲛⲛⲧⲱⲟⲩ	ⲉⲧⲉ|ⲙⲙⲟⲛⲛⲧⲱ|ⲟⲩ
ϯⲛⲁϫⲟϥ	ϯ|ⲛⲁ|ϫⲟ|ϥ
ⲛⲧⲁⲑⲙⲁⲓⲉ	ⲛ|ⲧⲁ|ⲑⲙⲁⲓⲉ
ⲛϯⲛⲁⲑⲙⲁⲓⲉ	ⲛ|ϯ|ⲛⲁ|ⲑⲙⲁⲓⲉ
ⲁⲓϭⲓ	ⲁ|ⲓ|ϭⲓ
ⲉⲧⲁⲓⲧⲏⲓϥ	ⲉⲧ|ⲁ|ⲓ|ⲧⲏⲓ|ϥ
ⲉⲧⲉⲛⲑⲏⲛⲟⲩ	ⲉⲧⲉⲛ|ⲑⲏⲛⲟⲩ
ϧⲉⲛⲡⲓϫⲱⲣϩ	ϧⲉⲛ|ⲡⲓ|ϫⲱⲣϩ
ⲉⲛⲁⲩⲛⲁⲧⲏⲓϥ	ⲉ|ⲛⲁ|ⲩ|ⲛⲁ|ⲧⲏⲓ|ϥ
ⲉⲧⲟⲩⲛⲁⲧⲏⲓϥ	ⲉⲧ|ⲟⲩ|ⲛⲁ|ⲧⲏⲓ|ϥ
ⲉⲡϫⲓⲛⲉⲣⲡⲁⲙⲉⲩⲓ	ⲉ|ⲡ|ϫⲓⲛⲉⲣⲡⲁⲙⲉⲩⲓ
ⲡⲓⲕⲉⲁⲫⲟⲧ	ⲡⲓ|ⲕⲉ|ⲁⲫⲟⲧ
ⲙⲉⲛⲉⲛⲥⲁⲡⲓⲇⲓⲡⲛⲟⲛ	ⲙⲉⲛⲉⲛⲥⲁ|ⲡⲓ|ⲇⲓⲡⲛⲟⲛ
ϫⲉⲡⲁⲓⲁⲫⲟⲧ	ϫⲉ|ⲡⲁⲓ|ⲁⲫⲟⲧ
ϯⲇⲓⲁⲑⲏⲕⲏ	ϯ|ⲇⲓⲁⲑⲏⲕⲏ
ϧⲉⲛⲡⲁⲥⲛⲟϥ	ϧⲉⲛ|ⲡⲁ|ⲥⲛⲟϥ
ⲉⲧⲉⲧⲉⲛⲛⲁⲥⲱ	ⲉ|ⲧⲉⲧⲉⲛ|ⲛⲁ|ⲥⲱ
ⲉⲣⲉⲧⲉⲛⲓⲣⲓ	ⲉⲣⲉ|ⲧⲉⲛ|ⲓⲣⲓ
ⲉⲧⲉⲧⲉⲛⲛⲁⲟⲩⲱⲙ	ⲉ|ⲧⲉⲧⲉⲛ|ⲛⲁ|ⲟⲩⲱⲙ
ⲙⲡⲁⲓⲱⲓⲕ	ⲙ|ⲡⲁⲓ|ⲱⲓⲕ
ⲛⲧⲉⲧⲉⲛⲥⲱ	ⲛⲧⲉ|ⲧⲉⲛ|ⲥⲱ
ⲙⲡⲁⲓⲁⲫⲟⲧ	ⲙ|ⲡⲁⲓ|ⲁⲫⲟⲧ
ⲉⲣⲉⲧⲉⲛϩⲓⲱⲓϣ	ⲉⲣⲉ|ⲧⲉⲛ|ϩⲓⲱⲓϣ
ϣⲁⲧⲉϥⲓ	ϣⲁⲧⲉ|ϥ|ⲓ
ⲉⲧⲛⲁⲟⲩⲱⲙ	ⲉⲧ|ⲛⲁ|ⲟⲩⲱⲙ
ⲛⲧⲉϥⲥⲱ	ⲛⲧⲉ|ϥ|ⲥⲱ
ϧⲉⲛⲡⲁⲓⲁⲫⲟⲧ	ϧⲉⲛ|ⲡⲁⲓ|ⲁⲫⲟⲧ
ϧⲉⲛⲟⲩⲙⲉⲧⲁⲧⲙⲡϣⲁ	ϧⲉⲛ|ⲟⲩ|ⲙⲉⲧⲁⲧⲙⲡϣⲁ
ⲙⲁⲣⲉⲡⲓⲣⲱⲙⲓ	ⲙⲁⲣⲉ|ⲡⲓ|ⲣⲱⲙⲓ
ⲉⲣⲇⲟⲕⲓⲙⲁⲍⲓⲛ	ⲉⲣⲇⲟⲕⲓⲙⲁⲍⲓⲛ
ⲙⲁⲣⲉϥⲟⲩⲱⲙ	ⲙⲁⲣⲉ|ϥ|ⲟⲩⲱⲙ
ϧⲉⲛⲡⲓⲱⲓⲕ	ϧⲉⲛ|ⲡⲓ|ⲱⲓⲕ
ⲉⲧⲥⲱ	ⲉⲧ|ⲥⲱ
ⲁϥⲥⲱ	ⲁ|ϥ|ⲥⲱ
ⲉⲩϩⲁⲡ	ⲉ|ⲩ|ϩⲁⲡ
ⲛⲣⲉϥⲉⲣⲇⲓⲁⲕⲣⲓⲛⲓⲛ	ⲛ|ⲣⲉϥⲉⲣⲇⲓⲁⲕⲣⲓⲛⲓⲛ
ⲟⲩⲟⲛⲟⲩⲙⲏϣ	ⲟⲩⲟⲛ|ⲟⲩ|ⲙⲏϣ
ϣⲱⲛⲓ	ϣⲱⲛⲓ
ⲥⲉⲙⲟⲕϩ	ⲥⲉ|ⲙⲟⲕϩ
ⲥⲉⲛⲕⲟⲧ	ⲥⲉ|ⲛⲕⲟⲧ
ⲉⲛⲁⲛⲉⲣⲇⲓⲁⲕⲣⲓⲛⲓⲛ	ⲉ|ⲛⲁ|ⲛ|ⲉⲣⲇⲓⲁⲕⲣⲓⲛⲓⲛ
ⲛⲁⲩⲛⲁϯϩⲁⲡ	ⲛⲁ|ⲩ|ⲛⲁ|ϯϩⲁⲡ
ⲉϥϯϩⲁⲡ	ⲉ|ϥ|ϯϩⲁⲡ
ⲛⲥⲉϣⲧⲉⲙϩⲓⲧⲉⲛ	ⲛ|ⲥⲉ|ϣⲧⲉⲙ|ϩⲓⲧ|ⲉⲛ
ⲙⲡϩⲁⲡ	ⲙ|ⲡ|ϩⲁⲡ
ⲛⲉⲙⲛⲓⲉⲑⲛⲟⲥ	ⲛⲉⲙ|ⲛⲓ|ⲉⲑⲛⲟⲥ
ⲁⲣⲉⲧⲉⲛϣⲁⲛⲑⲱⲟⲩϯ	ⲁⲣⲉⲧⲉⲛϣⲁⲛ|ⲑⲱⲟⲩϯ
ⲓⲥϫⲉⲟⲩⲟⲛⲡⲉⲧϩⲟⲕⲉⲣ	ⲓⲥϫⲉ|ⲟⲩⲟⲛ|ⲡ|ⲉⲧ|ϩⲟⲕⲉⲣ
ⲛⲧⲉⲧⲉⲛϣⲧⲉⲙⲑⲱⲟⲩϯ	ⲛⲧⲉ|ⲧⲉⲛ|ϣⲧⲉⲙ|ⲑⲱⲟⲩϯ
ⲉⲓⲉⲑⲁϣⲟⲩ	ⲉⲓⲉ|ⲑⲁϣ|ⲟⲩ
ⲥⲉⲥⲱⲧⲉⲙ	ⲥⲉ|ⲥⲱⲧⲉⲙ
ⲉⲟⲩⲡⲟⲣⲛⲓⲁ	ⲉ|ⲟⲩ|ⲡⲟⲣⲛⲓⲁ
ⲟⲩⲡⲟⲣⲛⲓⲁ	ⲟⲩ|ⲡⲟⲣⲛⲓⲁ
ⲉⲧⲉⲛⲥϣⲟⲡ	ⲉⲧⲉ|ⲛ|ⲥ|ϣⲟⲡ
ϧⲉⲛⲛⲓⲕⲉⲉⲑⲛⲟⲥ	ϧⲉⲛ|ⲛⲓ|ⲕⲉ|ⲉⲑⲛⲟⲥ
ⲧⲉⲧⲉⲛϭⲟⲥⲓ	ⲧⲉⲧⲉⲛ|ϭⲟⲥⲓ
ⲙⲡⲉⲧⲉⲛⲉⲣϩⲏⲃⲓ	ⲙⲡⲉ|ⲧⲉⲛ|ⲉⲣϩⲏⲃⲓ
ⲛⲥⲉⲱⲗⲓ	ⲛ|ⲥⲉ|ⲱⲗⲓ
ϧⲉⲛⲧⲉⲧⲉⲛⲙⲏϯ	ϧⲉⲛ|ⲧⲉⲧⲉⲛ|ⲙⲏϯ
ⲉⲧⲁϥⲓⲣⲓ	ⲉⲧ|ⲁ|ϥ|ⲓⲣⲓ
ⲙⲡⲁⲓϩⲱⲃ	ⲙ|ⲡⲁⲓ|ϩⲱⲃ
ⲛϯⲛⲉⲙⲱⲧⲉⲛ	ⲛ|ϯ|ⲛⲉⲙⲱ|ⲧⲉⲛ
ⲉⲓϯϩⲁⲡ	ⲉ|ⲓ|ϯϩⲁⲡ
ⲉⲓⲛⲉⲙⲱⲧⲉⲛ	ⲉ|ⲓ|ⲛⲉⲙⲱ|ⲧⲉⲛ
ⲛⲧⲉⲧⲉⲛⲑⲱⲟⲩϯ	ⲛⲧⲉ|ⲧⲉⲛ|ⲑⲱⲟⲩϯ
ⲛⲉⲙⲡⲁⲡⲛⲉⲩⲙⲁ	ⲛⲉⲙ|ⲡⲁ|ⲡⲛⲉⲩⲙⲁ
ⲛⲉⲙϯϫⲟⲙ	ⲛⲉⲙ|ϯ|ϫⲟⲙ
ⲙⲡⲥⲁⲧⲁⲛⲁⲥ	ⲙ|ⲡ|ⲥⲁⲧⲁⲛⲁⲥ
ⲛⲟϩⲉⲙ	ⲛⲟϩⲉⲙ
ⲛⲁⲛⲉⲡⲉⲧⲉⲛϣⲟⲩϣⲟⲩ	ⲛⲁⲛⲉ|ⲡⲉⲧⲉⲛ|ϣⲟⲩϣⲟⲩ
ϫⲉⲟⲩⲕⲟⲩϫⲓ	ϫⲉ|ⲟⲩ|ⲕⲟⲩϫⲓ
ⲛϣⲉⲙⲏⲣ	ⲛ|ϣⲉⲙⲏⲣ
ϣⲁϥⲑⲣⲉⲡⲓⲟⲩⲱϣⲉⲙ	ϣⲁ|ϥ|ⲑⲣⲉ|ⲡⲓ|ⲟⲩⲱϣⲉⲙ
ϭⲓϣⲉⲙⲏⲣ	ϭⲓϣⲉⲙⲏⲣ
ⲙⲁⲧⲟⲩⲃⲉⲡⲓϣⲉⲙⲏⲣ	ⲙⲁ|ⲧⲟⲩⲃⲉ|ⲡⲓ|ϣⲉⲙⲏⲣ
ⲛⲁⲡⲁⲥ	ⲛ|ⲁⲡⲁⲥ
ⲛⲟⲩⲱϣⲉⲙ	ⲛ|ⲟⲩⲱϣⲉⲙ
ⲉⲧⲉⲧⲉⲛⲟⲓ	ⲉ|ⲧⲉⲧⲉⲛ|ⲟⲓ
ⲛⲁⲧϣⲉⲙⲏⲣ	ⲛ|ⲁⲧϣⲉⲙⲏⲣ
ⲡⲉⲛⲡⲁⲥⲭⲁ	ⲡⲉⲛ|ⲡⲁⲥⲭⲁ
ⲁⲩϣⲁⲧϥ	ⲁ|ⲩ|ϣⲁⲧ|ϥ
ⲙⲁⲣⲉⲛⲉⲣϣⲁⲓ	ⲙⲁⲣⲉ|ⲛ|ⲉⲣϣⲁⲓ
ϧⲉⲛⲟⲩϣⲉⲙⲏⲣ	ϧⲉⲛ|ⲟⲩ|ϣⲉⲙⲏⲣ
ⲛⲕⲁⲕⲓⲁ	ⲛ|ⲕⲁⲕⲓⲁ
ⲛⲉⲙⲡⲟⲛⲏⲣⲓⲁ	ⲛⲉⲙ|ⲡⲟⲛⲏⲣⲓⲁ
ⲛⲧⲉⲟⲩⲧⲟⲩⲃⲟ	ⲛⲧⲉ|ⲟⲩ|ⲧⲟⲩⲃⲟ
ⲛⲉⲙⲟⲩⲙⲉⲑⲙⲏⲓ	ⲛⲉⲙ|ⲟⲩ|ⲙⲉⲑⲙⲏⲓ
ⲁⲓⲥϧⲁⲓ	ⲁ|ⲓ|ⲥϧⲁⲓ
ϩⲓϯⲉⲡⲓⲥⲧⲟⲗⲏ	ϩⲓ|ϯ|ⲉⲡⲓⲥⲧⲟⲗⲏ
ⲉϣⲧⲉⲙⲙⲟⲩϫⲧ	ⲉ|ϣⲧⲉⲙ|ⲙⲟⲩϫⲧ
ⲛⲉⲙⲛⲓⲡⲟⲣⲛⲟⲥ	ⲛⲉⲙ|ⲛⲓ|ⲡⲟⲣⲛⲟⲥ
ⲛⲁⲓϫⲉⲣⲉ	ⲛⲁ|ⲓ|ϫⲉⲣⲉ
ⲛⲓⲡⲟⲣⲛⲟⲥ	ⲛⲓ|ⲡⲟⲣⲛⲟⲥ
ⲛⲓⲣⲉϥϭⲓⲛϫⲟⲛⲥ	ⲛⲓ|ⲣⲉϥϭⲓⲛϫⲟⲛⲥ
ⲛⲓⲣⲉϥϩⲱⲗⲉⲙ	ⲛⲓ|ⲣⲉϥϩⲱⲗⲉⲙ
ⲛⲓⲣⲉϥϣⲁⲙϣⲉⲓⲇⲱⲗⲟⲛ	ⲛⲓ|ⲣⲉϥϣⲁⲙϣⲉⲓⲇⲱⲗⲟⲛ
ⲛⲁⲥⲙⲡϣⲁ	ⲛⲁ|ⲥ|ⲙⲡϣⲁ
ⲉⲩϯⲣⲁⲛ	ⲉ|ⲩ|ϯⲣⲁⲛ
ϫⲉⲥⲟⲛ	ϫⲉ|ⲥⲟⲛ
ⲉⲟⲩⲡⲟⲣⲛⲟⲥ	ⲉ|ⲟⲩ|ⲡⲟⲣⲛⲟⲥ
ⲟⲩⲣⲉϥϭⲓⲛϫⲟⲛⲥ	ⲟⲩ|ⲣⲉϥϭⲓⲛϫⲟⲛⲥ
ⲟⲩⲣⲉϥϣⲁⲙϣⲉⲓⲇⲱⲗⲟⲛ	ⲟⲩ|ⲣⲉϥϣⲁⲙϣⲉⲓⲇⲱⲗⲟⲛ
ⲟⲩⲣⲉϥϩⲱⲟⲩϣ	ⲟⲩ|ⲣⲉϥϩⲱⲟⲩϣ
ⲟⲩⲣⲉϥⲑⲓϧⲓ	ⲟⲩ|ⲣⲉϥⲑⲓϧⲓ
ⲟⲩⲣⲉϥϩⲱⲗⲉⲙ	ⲟⲩ|ⲣⲉϥϩⲱⲗⲉⲙ
ⲙⲡⲉⲣⲉⲣϣⲫⲏⲣ	ⲙⲡⲉⲣ|ⲉⲣϣⲫⲏⲣ
ⲛⲟⲩⲱⲙ	ⲛ|ⲟⲩⲱⲙ
ⲉⲣⲟⲩ	ⲉⲣ|ⲟⲩ
ⲉϯϩⲁⲡ	ⲉ|ϯϩⲁⲡ
ⲉϥⲉϯϩⲁⲡ	ⲉϥⲉ|ϯϩⲁⲡ
ⲁⲗⲓⲟⲩⲓ	ⲁⲗⲓⲟⲩⲓ
ⲙⲡⲓⲡⲉⲧϩⲱⲟⲩ	ⲙ|ⲡⲓ|ⲡⲉⲧϩⲱⲟⲩ
ⲉⲑⲃⲉⲛⲓϣⲱⲧ	ⲉⲑⲃⲉ|ⲛⲓ|ϣⲱⲧ
ⲧⲉⲛⲥⲱⲟⲩⲛ	ⲧⲉⲛ|ⲥⲱⲟⲩⲛ
ⲛϧⲏⲧⲉⲛ	ⲛϧⲏⲧ|ⲉⲛ
ϣⲁϥϭⲓⲥⲓ	ϣⲁ|ϥ|ϭⲓⲥⲓ
ϣⲁⲥⲕⲱⲧ	ϣⲁ|ⲥ|ⲕⲱⲧ
ⲙⲡⲁⲧϥⲉⲙⲓ	ⲙⲡⲁⲧ|ϥ|ⲉⲙⲓ
ⲉⲧⲥϣⲉ	ⲉⲧ|ⲥϣⲉ
ⲉⲧⲉⲣⲁⲅⲁⲡⲁⲛ	ⲉⲧ|ⲉⲣⲁⲅⲁⲡⲁⲛ
ⲉⲑⲃⲉⲛⲓϧⲣⲏⲟⲩⲓ	ⲉⲑⲃⲉ|ⲛⲓ|ϧⲣⲏⲟⲩⲓ
ⲛⲧⲉⲛⲓϣⲱⲧ	ⲛⲧⲉ|ⲛⲓ|ϣⲱⲧ
ϫⲉϩⲗⲓ	ϫⲉ|ϩⲗⲓ
ϫⲉⲙⲙⲟⲛϩⲗⲓ	ϫⲉ|ⲙⲙⲟⲛ|ϩⲗⲓ
ⲓⲥϫⲉⲟⲩⲟⲛϩⲁⲛⲟⲩⲟⲛ	ⲓⲥϫⲉ|ⲟⲩⲟⲛ|ϩⲁⲛ|ⲟⲩⲟⲛ
ϫⲉⲛⲟⲩϯ	ϫⲉ|ⲛⲟⲩϯ
ⲉⲧⲉⲟⲩⲟⲛⲟⲩⲙⲏϣ	ⲉⲧⲉ|ⲟⲩⲟⲛ|ⲟⲩ|ⲙⲏϣ
ⲛϭⲟⲓⲥ	ⲛ|ϭⲟⲓⲥ
ⲉⲧⲁⲉⲛⲭⲁⲓ	ⲉⲧ|ⲁ|ⲉⲛⲭⲁⲓ
ϧⲉⲛϯⲕⲁϩⲥ	ϧⲉⲛ|ϯ|ⲕⲁϩⲥ
ⲛⲧⲉⲛⲓⲓⲇⲱⲗⲟⲛ	ⲛⲧⲉ|ⲛⲓ|ⲓⲇⲱⲗⲟⲛ
ⲛϩⲁⲛϣⲱⲧ	ⲛ|ϩⲁⲛ|ϣⲱⲧ
ⲧⲟⲩⲥⲩⲛⲏⲇⲉⲥⲓⲥ	ⲧⲟⲩ|ⲥⲩⲛⲏⲇⲉⲥⲓⲥ
ⲉⲥϣⲱⲛⲓ	ⲉ|ⲥ|ϣⲱⲛⲓ
ϣⲁⲥϭⲱϧⲉⲙ	ϣⲁ|ⲥ|ϭⲱϧⲉⲙ
ⲟⲩϧⲣⲉ	ⲟⲩ|ϧⲣⲉ
ⲉⲧⲛⲁⲧⲁϩⲟⲛ	ⲉⲧ|ⲛⲁ|ⲧⲁϩⲟ|ⲛ
ⲉⲣⲁⲧⲉⲛ	ⲉⲣⲁ|ⲧⲉⲛ
ⲁⲛϣⲧⲉⲙⲟⲩⲱⲙ	ⲁ|ⲛ|ϣⲧⲉⲙ|ⲟⲩⲱⲙ
ⲧⲉⲛⲛⲁϭⲣⲟϩ	ⲧⲉⲛ|ⲛⲁ|ϭⲣⲟϩ
ⲁⲛϣⲁⲛⲟⲩⲱⲙ	ⲁⲛ|ϣⲁⲛ|ⲟⲩⲱⲙ
ⲧⲉⲛⲛⲁⲉⲣϩⲟⲩⲟ	ⲧⲉⲛ|ⲛⲁ|ⲉⲣϩⲟⲩⲟ
ⲛⲧⲉⲡⲉⲧⲉⲛⲉⲣϣⲓϣⲓ	ⲛⲧⲉ|ⲡⲉⲧⲉⲛ|ⲉⲣϣⲓϣⲓ
ⲛϭⲣⲟⲡ	ⲛ|ϭⲣⲟⲡ
ⲁϥϣⲁⲛⲛⲁⲩ	ⲁϥϣⲁⲛ|ⲛⲁⲩ
ϧⲁⲫⲏ	ϧⲁ|ⲫⲏ
ⲉⲧⲉⲡⲉⲙⲓ	ⲉⲧⲉ|ⲡ|ⲉⲙⲓ
ⲉⲕⲣⲱⲧⲉⲃ	ⲉ|ⲕ|ⲣⲱⲧⲉⲃ
ϧⲉⲛⲟⲩⲙⲁ	ϧⲉⲛ|ⲟⲩ|ⲙⲁ
ⲧⲉϥⲥⲩⲛⲏⲇⲉⲥⲓⲥ	ⲧⲉϥ|ⲥⲩⲛⲏⲇⲉⲥⲓⲥ
ⲥⲛⲁⲕⲱⲧ	ⲥ|ⲛⲁ|ⲕⲱⲧ
ⲉⲡϫⲓⲛⲑⲣⲉϥⲟⲩⲉⲙϣⲱⲧ	ⲉ|ⲡ|ϫⲓⲛⲑⲣⲉϥⲟⲩⲉⲙϣⲱⲧ
ϣⲁϥⲧⲁⲕⲟ	ϣⲁ|ϥ|ⲧⲁⲕⲟ
ϧⲉⲛⲡⲉⲕⲉⲙⲓ	ϧⲉⲛ|ⲡⲉⲕ|ⲉⲙⲓ
ⲉⲧⲁⲡⲭⲣⲓⲥⲧⲟⲥ	ⲉⲧ|ⲁ|ⲡ|ⲭⲣⲓⲥⲧⲟⲥ
ⲉⲣⲉⲧⲉⲛⲉⲣⲛⲟⲃⲓ	ⲉⲣⲉ|ⲧⲉⲛ|ⲉⲣⲛⲟⲃⲓ
ⲉⲛⲓⲥⲛⲏⲩ	ⲉ|ⲛⲓ|ⲥⲛⲏⲩ
ⲉⲣⲉⲧⲉⲛⲙⲓϣⲓ	ⲉⲣⲉ|ⲧⲉⲛ|ⲙⲓϣⲓ
ⲉⲧⲟⲩⲥⲩⲛⲏⲇⲉⲥⲓⲥ	ⲉ|ⲧⲟⲩ|ⲥⲩⲛⲏⲇⲉⲥⲓⲥ
ⲁⲣⲉⲧⲉⲛⲉⲣⲛⲟⲃⲓ	ⲁⲣⲉ|ⲧⲉⲛ|ⲉⲣⲛⲟⲃⲓ
ⲓⲥϫⲉⲟⲩϧⲣⲉ	ⲓⲥϫⲉ|ⲟⲩ|ϧⲣⲉ
ⲉⲧⲛⲁⲉⲣⲥⲕⲁⲛⲇⲁⲗⲓⲍⲓⲛ	ⲉⲧ|ⲛⲁ|ⲉⲣⲥⲕⲁⲛⲇⲁⲗⲓⲍⲓⲛ
ⲙⲡⲁⲥⲟⲛ	ⲙ|ⲡⲁ|ⲥⲟⲛ
ⲛⲛⲁⲟⲩⲉⲙⲁϥ	ⲛⲛ|ⲁ|ⲟⲩⲉⲙⲁϥ
ⲛⲧⲁϣⲧⲉⲙⲉⲣⲥⲕⲁⲛⲇⲁⲗⲓⲍⲓⲛ	ⲛⲧ|ⲁ|ϣⲧⲉⲙ|ⲉⲣⲥⲕⲁⲛⲇⲁⲗⲓⲍⲓⲛ
ⲟⲩⲣⲉⲙϩⲉ	ⲟⲩ|ⲣⲉⲙϩⲉ
ⲟⲩⲁⲡⲟⲥⲧⲟⲗⲟⲥ	ⲟⲩ|ⲁⲡⲟⲥⲧⲟⲗⲟⲥ
ⲡⲁϩⲱⲃ	ⲡⲁ|ϩⲱⲃ
ⲓⲥϫⲉϯⲟⲓ	ⲓⲥϫⲉ|ϯ|ⲟⲓ
ϯⲥⲫⲣⲁⲅⲓⲥ	ϯ|ⲥⲫⲣⲁⲅⲓⲥ
ⲛⲧⲉⲧⲁⲙⲉⲧⲁⲡⲟⲥⲧⲟⲗⲟⲥ	ⲛⲧⲉ|ⲧⲁ|ⲙⲉⲧⲁⲡⲟⲥⲧⲟⲗⲟⲥ
ⲧⲁⲁⲡⲟⲗⲟⲅⲓⲁ	ⲧⲁ|ⲁⲡⲟⲗⲟⲅⲓⲁ
ⲉⲧϧⲟⲧϧⲉⲧ	ⲉⲧ|ϧⲟⲧϧⲉⲧ
ⲙⲙⲟⲛⲧⲉⲛ	ⲙⲙⲟⲛⲧⲉ|ⲛ
ⲟⲩⲟⲛⲧⲉⲛ	ⲟⲩⲟⲛⲧⲉ|ⲛ
ⲉⲑⲣⲉⲟⲩⲥⲱⲛⲓ	ⲉ|ⲑⲣⲉ|ⲟⲩ|ⲥⲱⲛⲓ
ⲛⲉⲙⲕⲏⲫⲁ	ⲛⲉⲙ|ⲕⲏⲫⲁ
ⲛⲉⲙⲃⲁⲣⲛⲁⲃⲁⲥ	ⲛⲉⲙ|ⲃⲁⲣⲛⲁⲃⲁⲥ
ⲉⲧⲉⲙⲙⲟⲛⲧⲉⲛ	ⲉⲧⲉ|ⲙⲙⲟⲛⲧⲉ|ⲛ
ⲉϣⲧⲉⲙⲉⲣϩⲱⲃ	ⲉ|ϣⲧⲉⲙ|ⲉⲣϩⲱⲃ
ⲉϣⲁϥⲉⲣⲙⲁⲧⲟⲓ	ⲉ|ϣⲁ|ϥ|ⲉⲣⲙⲁⲧⲟⲓ
ϧⲉⲛⲛⲉⲧⲉⲛⲟⲩϥ	ϧⲉⲛ|ⲛ|ⲉⲧⲉ|ⲛⲟⲩϥ
ⲛⲟⲯⲱⲛⲓⲟⲛ	ⲛ|ⲟⲯⲱⲛⲓⲟⲛ
ⲉϣⲁϥϭⲟ	ⲉ|ϣⲁ|ϥ|ϭⲟ
ⲛⲟⲩⲓⲁϩⲁⲗⲟⲗⲓ	ⲛ|ⲟⲩ|ⲓⲁϩⲁⲗⲟⲗⲓ
ⲙⲡⲁϥⲟⲩⲱⲙ	ⲙⲡⲁ|ϥ|ⲟⲩⲱⲙ
ϧⲉⲛⲡⲉϥⲟⲩⲧⲁϩ	ϧⲉⲛ|ⲡⲉϥ|ⲟⲩⲧⲁϩ
ⲉϣⲁϥⲙⲟⲛⲓ	ⲉ|ϣⲁ|ϥ|ⲙⲟⲛⲓ
ⲛⲟⲩⲟϩⲓ	ⲛ|ⲟⲩ|ⲟϩⲓ
ⲛⲧⲉϥϣⲧⲉⲙⲟⲩⲱⲙ	ⲛⲧⲉ|ϥ|ϣⲧⲉⲙ|ⲟⲩⲱⲙ
ϧⲉⲛⲡⲉⲣⲱϯ	ϧⲉⲛ|ⲡ|ⲉⲣⲱϯ
ⲛⲧⲉⲡⲓⲟϩⲓ	ⲛⲧⲉ|ⲡⲓ|ⲟϩⲓ
ⲕⲁⲧⲁⲣⲱⲙⲓ	ⲕⲁⲧⲁ|ⲣⲱⲙⲓ
ⲡⲓⲕⲉⲛⲟⲙⲟⲥ	ⲡⲓ|ⲕⲉ|ⲛⲟⲙⲟⲥ
ϥϫⲱ	ϥ|ϫⲱ
ϧⲉⲛⲫⲛⲟⲙⲟⲥ	ϧⲉⲛ|ⲫ|ⲛⲟⲙⲟⲥ
ϫⲉⲛⲛⲉⲕϯ	ϫⲉ|ⲛⲛⲉ|ⲕ|ϯ
ⲥⲁⲭⲟⲗ	ⲥⲁⲭⲟⲗ
ⲉϩⲣⲉⲛⲉϩⲉ	ⲉϩⲣⲉⲛ|ⲉϩⲉ
ⲁⲥⲉⲣⲙⲉⲗⲓⲛ	ⲁ|ⲥ|ⲉⲣⲙⲉⲗⲓⲛ
ϧⲁⲛⲓⲉϩⲱⲟⲩ	ϧⲁ|ⲛⲓ|ⲉϩⲱⲟⲩ
ⲉⲧⲁⲩⲥϧⲏⲧⲟⲩ	ⲉⲧ|ⲁ|ⲩ|ⲥϧⲏⲧ|ⲟⲩ
ϫⲉⲥⲉⲙⲡϣⲁ	ϫⲉ|ⲥ|ⲉⲙⲡϣⲁ
ⲛⲧⲉⲫⲏ	ⲛⲧⲉ|ⲫⲏ
ⲉⲧⲥⲭⲁⲓ	ⲉⲧ|ⲥⲭⲁⲓ
ⲛⲧⲉϥⲥⲭⲁⲓ	ⲛⲧⲉ|ϥ|ⲥⲭⲁⲓ
ϧⲉⲛⲟⲩϩⲉⲗⲡⲓⲥ	ϧⲉⲛ|ⲟⲩ|ϩⲉⲗⲡⲓⲥ
ⲉⲧϩⲓ	ⲉⲧ|ϩⲓ
ⲛⲧⲉϥⲉⲣϩⲉⲗⲡⲓⲥ	ⲛⲧⲉ|ϥ|ⲉⲣϩⲉⲗⲡⲓⲥ
ⲓⲥϫⲉⲁⲛⲟⲛ	ⲓⲥϫⲉ|ⲁⲛⲟⲛ
ⲁⲛⲥⲓϯ	ⲁ|ⲛ|ⲥⲓϯ
ⲛⲛⲓⲡⲛⲉⲩⲙⲁⲧⲓⲕⲟⲛ	ⲛ|ⲛⲓ|ⲡⲛⲉⲩⲙⲁⲧⲓⲕⲟⲛ
ⲁⲛϣⲁⲛⲱⲥϧ	ⲁⲛϣⲁⲛ|ⲱⲥϧ
ⲛⲧⲉⲧⲉⲛⲥⲁⲣⲕⲓⲕⲟⲛ	ⲛ|ⲧⲉⲧⲉⲛ|ⲥⲁⲣⲕⲓⲕⲟⲛ
ⲓⲥϫⲉϩⲁⲛⲕⲉⲭⲱⲟⲩⲛⲓ	ⲓⲥϫⲉ|ϩⲁⲛ|ⲕⲉ|ⲭⲱⲟⲩⲛⲓ
ϧⲉⲛⲡⲉⲧⲉⲛⲉⲣϣⲓϣⲓ	ϧⲉⲛ|ⲡⲉⲧⲉⲛ|ⲉⲣϣⲓϣⲓ
ⲙⲡⲉⲛⲭⲣⲁⲥⲑⲉ	ⲙⲡⲉ|ⲛ|ⲭⲣⲁⲥⲑⲉ
ⲧⲉⲛⲱⲟⲩ	ⲧⲉⲛ|ⲱⲟⲩ
ⲛⲧⲉⲛϣⲧⲉⲙϯ	ⲛⲧⲉ|ⲛ|ϣⲧⲉⲙ|ϯ
ⲉⲛⲓⲉⲣⲫⲏⲟⲩⲓ	ⲉ|ⲛⲓ|ⲉⲣⲫⲏⲟⲩⲓ
ϣⲁⲩⲟⲩⲱⲙ	ϣⲁ|ⲩ|ⲟⲩⲱⲙ
ϧⲉⲛⲛⲁⲡⲓⲉⲣⲫⲉⲓ	ϧⲉⲛ|ⲛⲁ|ⲡⲓ|ⲉⲣⲫⲉⲓ
ⲉⲧⲙⲏⲛ	ⲉⲧ|ⲙⲏⲛ
ϣⲁⲩⲫⲱϣ	ϣⲁ|ⲩ|ⲫⲱϣ
ⲁϥⲑⲱϣ	ⲁ|ϥ|ⲑⲱϣ
ⲉⲧϩⲓⲱⲓϣ	ⲉⲧ|ϩⲓⲱⲓϣ
ⲉⲱⲛϧ	ⲉ|ⲱⲛϧ
ⲙⲡⲓⲉⲣⲭⲣⲁⲥⲑⲉ	ⲙⲡ|ⲓ|ⲉⲣⲭⲣⲁⲥⲑⲉ
ⲛⲉⲧⲁⲓⲥϧⲉ	ⲛ|ⲉⲧ|ⲁ|ⲓ|ⲥϧⲉ
ⲛⲥⲉϣⲱⲡⲓ	ⲛ|ⲥⲉ|ϣⲱⲡⲓ
ⲡⲁϣⲟⲩϣⲟⲩ	ⲡⲁ|ϣⲟⲩϣⲟⲩ
ϣⲟⲩⲱϥ	ϣⲟⲩⲱ|ϥ
ⲁⲓϣⲁⲛϩⲓϣⲉⲛⲛⲟⲩϥⲓ	ⲁⲓϣⲁⲛ|ϩⲓϣⲉⲛⲛⲟⲩϥⲓ
ⲛⲟⲩϣⲟⲩϣⲟⲩ	ⲛ|ⲟⲩ|ϣⲟⲩϣⲟⲩ
ⲟⲩⲁⲛⲁⲅⲕⲏ	ⲟⲩ|ⲁⲛⲁⲅⲕⲏ
ϩⲓϫⲱⲓ	ϩⲓϫⲱ|ⲓ
ⲟⲩⲟⲓ	ⲟⲩⲟⲓ
ⲁⲓϣⲧⲉⲙϩⲓϣⲉⲛⲛⲟⲩϥⲓ	ⲁ|ⲓ|ϣⲧⲉⲙ|ϩⲓϣⲉⲛⲛⲟⲩϥⲓ
ⲁⲓⲓⲣⲓ	ⲁ|ⲓ|ⲓⲣⲓ
ⲉϩⲛⲏⲓ	ⲉ|ϩⲛⲏ|ⲓ
ⲟⲩⲟⲛϯ	ⲟⲩⲟⲛ|ϯ
ⲃⲉⲭⲉ	ⲃⲉⲭⲉ
ⲓⲥϫⲉⲉϩⲛⲏⲓ	ⲓⲥϫⲉ|ⲉ|ϩⲛⲏ|ⲓ
ⲟⲩⲟⲓⲕⲟⲛⲟⲙⲓⲁ	ⲟⲩ|ⲟⲓⲕⲟⲛⲟⲙⲓⲁ
ⲡⲉⲧⲁⲩⲧⲉⲛϩⲟⲩⲧ	ⲡ|ⲉⲧ|ⲁ|ⲩ|ⲧⲉⲛϩⲟⲩⲧ
ⲁϣ	ⲁϣ
ⲡⲁⲃⲉⲭⲉ	ⲡⲁ|ⲃⲉⲭⲉ
ⲉⲓϩⲓϣⲉⲛⲛⲟⲩϥⲓ	ⲉ|ⲓ|ϩⲓϣⲉⲛⲛⲟⲩϥⲓ
ⲛⲧⲁⲭⲁⲡⲓⲉⲩⲁⲅⲅⲉⲗⲓⲟⲛ	ⲛ|ⲧⲁ|ⲭⲁ|ⲡⲓ|ⲉⲩⲁⲅⲅⲉⲗⲓⲟⲛ
ⲁϭⲛⲉⲧⲁⲡⲁⲛⲏ	ⲁϭⲛⲉ|ⲧⲁⲡⲁⲛⲏ
ⲉϣⲧⲉⲙⲉⲣⲭⲣⲁⲥⲑⲉ	ⲉ|ϣⲧⲉⲙ|ⲉⲣⲭⲣⲁⲥⲑⲉ
ϩⲁⲟⲩⲟⲛ	ϩⲁ|ⲟⲩⲟⲛ
ⲁⲓⲁⲓⲧ	ⲁ|ⲓ|ⲁⲓ|ⲧ
ⲛⲧⲁϫⲉⲙϩⲏⲟⲩ	ⲛ|ⲧⲁ|ϫⲉⲙϩⲏⲟⲩ
ⲙⲡⲓϩⲟⲩⲟ	ⲙ|ⲡⲓ|ϩⲟⲩⲟ
ⲁⲓϣⲱⲡⲓ	ⲁ|ⲓ|ϣⲱⲡⲓ
ⲛⲟⲩⲓⲟⲩⲇⲁⲓ	ⲛ|ⲟⲩ|ⲓⲟⲩⲇⲁⲓ
ϧⲁⲫⲛⲟⲙⲟⲥ	ϧⲁ|ⲫ|ⲛⲟⲙⲟⲥ
ⲛⲉⲓⲭⲏ	ⲛ|ⲉ|ⲓ|ⲭⲏ
ⲛϯⲭⲏ	ⲛ|ϯ|ⲭⲏ
ⲛⲟⲩⲁⲛⲟⲙⲟⲥ	ⲛ|ⲟⲩ|ⲁⲛⲟⲙⲟⲥ
ⲉⲁⲛⲟⲕ	ⲉ|ⲁⲛⲟⲕ
ⲟⲩⲁⲛⲟⲙⲟⲥ	ⲟⲩ|ⲁⲛⲟⲙⲟⲥ
ⲛⲟⲩⲣⲉϥϣⲱⲛⲓ	ⲛ|ⲟⲩ|ⲣⲉϥϣⲱⲛⲓ
ⲛⲧⲁⲛⲟϩⲉⲙ	ⲛ|ⲧⲁ|ⲛⲟϩⲉⲙ
ϯⲓⲣⲓ	ϯ|ⲓⲣⲓ
ⲛⲧⲁⲉⲣϣⲫⲏⲣ	ⲛ|ⲧⲁ|ⲉⲣϣⲫⲏⲣ
ⲉⲧϭⲟϫⲓ	ⲉⲧ|ϭⲟϫⲓ
ϧⲉⲛⲡⲓⲥⲧⲁⲇⲓⲟⲛ	ϧⲉⲛ|ⲡⲓ|ⲥⲧⲁⲇⲓⲟⲛ
ⲥⲉϭⲟϫⲓ	ⲥⲉ|ϭⲟϫⲓ
ⲉϣⲁϥϭⲓ	ⲉ|ϣⲁ|ϥ|ϭⲓ
ⲙⲡⲓⲃⲁⲓ	ⲙ|ⲡⲓ|ⲃⲁⲓ
ⲛⲧⲉⲧⲉⲛⲧⲁϩⲟ	ⲛⲧⲉ|ⲧⲉⲛ|ⲧⲁϩⲟ
ⲉⲧⲉⲣⲁⲅⲱⲛⲓⲍⲉⲥⲑⲉ	ⲉⲧ|ⲉⲣⲁⲅⲱⲛⲓⲍⲉⲥⲑⲉ
ϣⲁϥⲁⲙⲟⲛⲓ	ϣⲁ|ϥ|ⲁⲙⲟⲛⲓ
ⲛⲥⲉϭⲓ	ⲛ|ⲥⲉ|ϭⲓ
ⲉϥⲛⲁⲧⲁⲕⲟ	ⲉ|ϥ|ⲛⲁ|ⲧⲁⲕⲟ
ⲟⲩⲁⲧⲧⲁⲕⲟ	ⲟⲩ|ⲁⲧⲧⲁⲕⲟ
ϯϭⲟϫⲓ	ϯ|ϭⲟϫⲓ
ϧⲉⲛⲟⲩϩⲱⲡ	ϧⲉⲛ|ⲟⲩ|ϩⲱⲡ
ϯϯ	ϯ|ϯ
ⲉⲓϩⲓⲟⲩⲓ	ⲉ|ⲓ|ϩⲓⲟⲩⲓ
ⲉⲡⲓⲁⲏⲣ	ⲉ|ⲡⲓ|ⲁⲏⲣ
ϯⲱϥⲓ	ϯ|ⲱϥⲓ
ⲙⲡⲁⲥⲱⲙⲁ	ⲙ|ⲡⲁ|ⲥⲱⲙⲁ
ⲉⲁⲓϩⲓⲱⲓϣ	ⲉ|ⲁ|ⲓ|ϩⲓⲱⲓϣ
ⲛⲥⲉϫⲉⲙⲧ	ⲛ|ⲥⲉ|ϫⲉⲙ|ⲧ
ⲛⲁⲇⲟⲕⲓⲙⲟⲥ	ⲛ|ⲁⲇⲟⲕⲓⲙⲟⲥ
ϧⲉⲛϩⲁⲛⲡⲁⲣⲁⲃⲟⲗⲏ	ϧⲉⲛ|ϩⲁⲛ|ⲡⲁⲣⲁⲃⲟⲗⲏ
ⲁϥϭⲟ	ⲁ|ϥ|ϭⲟ
ⲁϥⲕⲱⲧ	ⲁ|ϥ|ⲕⲱⲧ
ⲛⲟⲩϫⲟⲉⲓ	ⲛ|ⲟⲩ|ϫⲟⲉⲓ
ⲁϥϣⲱⲕ	ⲁ|ϥ|ϣⲱⲕ
ⲛⲟⲩϩⲣⲱⲧ	ⲛ|ⲟⲩ|ϩⲣⲱⲧ
ⲛⲟⲩⲡⲩⲣⲅⲟⲥ	ⲛ|ⲟⲩ|ⲡⲩⲣⲅⲟⲥ
ⲛϩⲁⲛⲟⲩⲓⲏ	ⲛ|ϩⲁⲛ|ⲟⲩⲓⲏ
ⲉⲡϣⲉⲙⲙⲟ	ⲉ|ⲡ|ϣⲉⲙⲙⲟ
ϩⲁⲛⲓⲟⲩⲓⲏ	ϩⲁ|ⲛⲓ|ⲟⲩⲓⲏ
ϧⲉⲛⲡⲥⲏⲟⲩ	ϧⲉⲛ|ⲡ|ⲥⲏⲟⲩ
ⲛⲟⲩⲃⲱⲕ	ⲛ|ⲟⲩ|ⲃⲱⲕ
ⲛⲛⲓⲟⲩⲓⲏ	ⲛ|ⲛⲓ|ⲟⲩⲓⲏ
ⲛⲧⲉⲡⲓⲓⲁϩⲁⲗⲟⲗⲓ	ⲛⲧⲉ|ⲡⲓ|ⲓⲁϩⲁⲗⲟⲗⲓ
ⲉⲧⲁⲩϭⲓⲧϥ	ⲉⲧ|ⲁ|ⲩ|ϭⲓⲧ|ϥ
ⲁⲩⲟⲩⲟⲣⲡϥ	ⲁ|ⲩ|ⲟⲩⲟⲣⲡ|ϥ
ⲛⲕⲉⲃⲱⲕ	ⲛ|ⲕⲉ|ⲃⲱⲕ
ⲡⲓⲕⲉⲟⲩⲁⲓ	ⲡⲓ|ⲕⲉ|ⲟⲩⲁⲓ
ⲁⲩⲫⲟⲗϩϥ	ⲁ|ⲩ|ⲫⲟⲗϩ|ϥ
ⲁⲩϣⲟϣϥ	ⲁ|ⲩ|ϣⲟϣ|ϥ
ⲁⲩϧⲟⲑⲃϥ	ⲁ|ⲩ|ϧⲟⲑⲃ|ϥ
ⲛϩⲁⲛⲕⲉⲙⲏϣ	ⲛ|ϩⲁⲛ|ⲕⲉ|ⲙⲏϣ
ⲁⲩϩⲓⲱⲛⲓ	ⲁ|ⲩ|ϩⲓⲱⲛⲓ
ⲁⲩϧⲱⲧⲉⲃ	ⲁ|ⲩ|ϧⲱⲧⲉⲃ
ⲙⲙⲉⲛⲣⲓⲧ	ⲙ|ⲙⲉⲛⲣⲓⲧ
ⲉⲛⲁϥⲛⲧⲁϥ	ⲉ|ⲛⲁ|ϥ|ⲛⲧⲁ|ϥ
ϫⲉⲥⲉⲛⲁϣⲫⲓⲧ	ϫⲉ|ⲥⲉ|ⲛⲁ|ϣⲫⲓⲧ
ⲛⲓⲟⲩⲓⲏ	ⲛⲓ|ⲟⲩⲓⲏ
ⲡⲓⲕⲗⲏⲣⲟⲛⲟⲙⲟⲥ	ⲡⲓ|ⲕⲗⲏⲣⲟⲛⲟⲙⲟⲥ
ⲙⲁⲣⲉⲛϧⲟⲑⲃϥ	ⲙⲁⲣⲉ|ⲛ|ϧⲟⲑⲃ|ϥ
ⲛⲧⲉϯⲕⲗⲏⲣⲟⲛⲟⲙⲓⲁ	ⲛⲧⲉ|ϯ|ⲕⲗⲏⲣⲟⲛⲟⲙⲓⲁ
ⲉⲣⲑⲱⲛ	ⲉⲣ|ⲑⲱⲛ
ⲁⲩϩⲓⲧϥ	ⲁ|ⲩ|ϩⲓⲧ|ϥ
ⲙⲡⲓⲓⲁϩⲁⲗⲟⲗⲓ	ⲙ|ⲡⲓ|ⲓⲁϩⲁⲗⲟⲗⲓ
ⲉⲧⲉϥⲛⲁⲁⲓϥ	ⲉⲧⲉ|ϥ|ⲛⲁ|ⲁⲓ|ϥ
ⲛϫⲉⲡϭⲟⲓⲥ	ⲛϫⲉ|ⲡ|ϭⲟⲓⲥ
ϥⲛⲁⲓ	ϥ|ⲛⲁ|ⲓ
ϥⲛⲁⲧⲁⲕⲟ	ϥ|ⲛⲁ|ⲧⲁⲕⲟ
ⲧⲁⲓⲅⲣⲁⲫⲏ	ⲧⲁⲓ|ⲅⲣⲁⲫⲏ
ⲙⲡⲉⲧⲉⲛⲱϣ	ⲙⲡⲉ|ⲧⲉⲛ|ⲱϣ
ϫⲉⲡⲓⲱⲛⲓ	ϫⲉ|ⲡⲓ|ⲱⲛⲓ
ⲉⲧⲁⲩϣⲟϣϥ	ⲉⲧ|ⲁ|ⲩ|ϣⲟϣ|ϥ
ⲉⲧⲕⲱⲧ	ⲉⲧ|ⲕⲱⲧ
ⲛⲟⲩϫⲱϫ	ⲛ|ⲟⲩ|ϫⲱϫ
ⲉⲧⲁⲫⲁⲓ	ⲉⲧ|ⲁ|ⲫⲁⲓ
ϥⲟⲓ	ϥ|ⲟⲓ
ϧⲉⲛⲛⲉⲛⲃⲁⲗ	ϧⲉⲛ|ⲛⲉⲛ|ⲃⲁⲗ
ⲛⲥⲁⲁⲙⲟⲛⲓ	ⲛⲥⲁ|ⲁⲙⲟⲛⲓ
ϫⲉⲉⲧⲁϥϫⲉⲧⲁⲓⲡⲁⲣⲁⲃⲟⲗⲏ	ϫⲉ|ⲉⲧ|ⲁ|ϥ|ϫⲉ|ⲧⲁⲓ|ⲡⲁⲣⲁⲃⲟⲗⲏ
ⲁⲩⲟⲩⲱⲣⲡ	ⲁ|ⲩ|ⲟⲩⲱⲣⲡ
ⲛⲉⲙⲛⲓⲏⲣⲱⲇⲓⲁⲛⲟⲥ	ⲛⲉⲙ|ⲛⲓ|ⲏⲣⲱⲇⲓⲁⲛⲟⲥ
ⲛⲧⲟⲩϫⲟⲣϫϥ	ⲛⲧ|ⲟⲩ|ϫⲟⲣϫ|ϥ
ⲧⲉⲛⲓ	ⲧⲉⲛ|ⲓ
ⲟⲩⲑⲙⲏⲓ	ⲟⲩ|ⲑⲙⲏⲓ
ⲥⲉⲣⲙⲉⲗⲓⲛ	ⲥ|ⲉⲣⲙⲉⲗⲓⲛ
ϧⲁϩⲗⲓ	ϧⲁ|ϩⲗⲓ
ⲕϫⲟⲩϣⲧ	ⲕ|ϫⲟⲩϣⲧ
ⲉϩⲟ	ⲉ|ϩⲟ
ⲕϯⲥⲃⲱ	ⲕ|ϯⲥⲃⲱ
ⲛϯϩⲱϯ	ⲛ|ϯ|ϩⲱϯ
ⲛⲧⲟⲩⲙⲉⲧϣⲟⲃⲓ	ⲛ|ⲧⲟⲩ|ⲙⲉⲧϣⲟⲃⲓ
ⲧⲉⲧⲉⲛϭⲱⲛⲧ	ⲧⲉⲧⲉⲛ|ϭⲱⲛⲧ
ⲁⲛⲓⲟⲩⲓ	ⲁⲛⲓⲟⲩⲓ
ⲛⲟⲩⲥⲁⲑⲉⲣⲓ	ⲛ|ⲟⲩ|ⲥⲁⲑⲉⲣⲓ
ϫⲉⲑⲁ	ϫⲉ|ⲑⲁ
ⲧⲁⲓϩⲓⲕⲱⲛ	ⲧⲁⲓ|ϩⲓⲕⲱⲛ
ⲛⲉⲙⲧⲁⲓⲉⲡⲓⲅⲣⲁⲫⲏ	ⲛⲉⲙ|ⲧⲁⲓ|ⲉⲡⲓⲅⲣⲁⲫⲏ
ϫⲉⲛⲁⲡⲟⲩⲣⲟ	ϫⲉ|ⲛⲁ|ⲡ|ⲟⲩⲣⲟ
ⲙⲏⲓⲧⲟⲩ	ⲙⲏⲓⲧ|ⲟⲩ
ⲛϫⲉϩⲁⲛⲥⲁⲇⲇⲟⲩⲕⲉⲟⲥ	ⲛϫⲉ|ϩⲁⲛ|ⲥⲁⲇⲇⲟⲩⲕⲉⲟⲥ
ⲁⲛⲁⲥⲧⲁⲥⲓⲥ	ⲁⲛⲁⲥⲧⲁⲥⲓⲥ
ⲛⲧⲉⲡⲥⲟⲛ	ⲛⲧⲉ|ⲡ|ⲥⲟⲛ
ⲛⲧⲉϥⲥⲉϫⲡⲟⲩⲥϩⲓⲙⲓ	ⲛⲧⲉ|ϥ|ⲥⲉϫⲡ|ⲟⲩ|ⲥϩⲓⲙⲓ
ⲛⲧⲉϥϣⲧⲉⲙⲭⲁϣⲏⲣⲓ	ⲛⲧⲉ|ϥ|ϣⲧⲉⲙ|ⲭⲁϣⲏⲣⲓ
ⲛⲧⲉⲡⲉϥⲥⲟⲛ	ⲛⲧⲉ|ⲡⲉϥ|ⲥⲟⲛ
ⲛⲧⲉϥⲧⲟⲩⲛⲟⲥ	ⲛⲧⲉ|ϥ|ⲧⲟⲩⲛⲟⲥ
ⲟⲩϫⲣⲟϫ	ⲟⲩ|ϫⲣⲟϫ
ⲙⲡⲉϥⲥⲟⲛ	ⲙ|ⲡⲉϥ|ⲥⲟⲛ
ϭⲓⲥϩⲓⲙⲓ	ϭⲓⲥϩⲓⲙⲓ
ⲛⲁϥⲙⲟⲩ	ⲛⲁ|ϥ|ⲙⲟⲩ
ⲙⲡⲉϥⲭⲁϫⲣⲟϫ	ⲙⲡⲉ|ϥ|ⲭⲁϫⲣⲟϫ
ⲁϥϭⲓⲧⲥ	ⲁ|ϥ|ϭⲓⲧ|ⲥ
ⲡⲓⲙⲁϩⲅ	ⲡⲓ|ⲙⲁϩⲅ
ⲡⲓⲙⲁϩⲍ	ⲡⲓ|ⲙⲁϩⲍ
ⲙⲡⲟⲩⲭⲁϫⲣⲟϫ	ⲙⲡ|ⲟⲩ|ⲭⲁϫⲣⲟϫ
ⲁⲥⲙⲟⲩ	ⲁ|ⲥ|ⲙⲟⲩ
ⲛϫⲉϯⲕⲉⲥϩⲓⲙⲓ	ⲛϫⲉ|ϯ|ⲕⲉ|ⲥϩⲓⲙⲓ
ϧⲉⲛϯⲁⲛⲁⲥⲧⲁⲥⲓⲥ	ϧⲉⲛ|ϯ|ⲁⲛⲁⲥⲧⲁⲥⲓⲥ
ⲁⲥⲛⲁⲉⲣⲥϩⲓⲙⲓ	ⲁ|ⲥ|ⲛⲁ|ⲉⲣⲥϩⲓⲙⲓ
ⲛⲛⲓⲙ	ⲛ|ⲛⲓⲙ
ⲁⲩϭⲓⲧⲥ	ⲁ|ⲩ|ϭⲓⲧ|ⲥ
ⲧⲉⲧⲉⲛⲥⲟⲣⲉⲙ	ⲧⲉⲧⲉⲛ|ⲥⲟⲣⲉⲙ
ⲛⲧⲉⲧⲉⲛⲥⲱⲟⲩⲛ	ⲛⲧⲉ|ⲧⲉⲛ|ⲥⲱⲟⲩⲛ
ϯϫⲟⲙ	ϯ|ϫⲟⲙ
ⲁⲩϣⲁⲛⲧⲱⲟⲩⲛⲟⲩ	ⲁⲩϣⲁⲛ|ⲧⲱⲟⲩⲛ|ⲟⲩ
ⲙⲡⲁⲩϭⲓ	ⲙⲡⲁ|ⲩ|ϭⲓ
ⲙⲡⲁⲩϭⲓⲧⲟⲩ	ⲙⲡⲁ|ⲩ|ϭⲓⲧ|ⲟⲩ
ⲁⲩⲙⲫⲣⲏϯ	ⲁ|ⲩ|ⲙ|ⲫ|ⲣⲏϯ
ⲛⲛⲓⲁⲅⲅⲉⲗⲟⲥ	ⲛ|ⲛⲓ|ⲁⲅⲅⲉⲗⲟⲥ
ϫⲉⲥⲉⲛⲁⲧⲱⲟⲩⲛⲟⲩ	ϫⲉ|ⲥⲉ|ⲛⲁ|ⲧⲱⲟⲩⲛ|ⲟⲩ
ϩⲓⲡϫⲱⲙ	ϩⲓ|ⲡ|ϫⲱⲙ
ϩⲓϫⲉⲛⲡⲓⲃⲁⲧⲟⲥ	ϩⲓϫⲉⲛ|ⲡⲓ|ⲃⲁⲧⲟⲥ
ⲛⲁⲃⲣⲁⲁⲙ	ⲛ|ⲁⲃⲣⲁⲁⲙ
ⲫⲁⲛⲏ	ⲫⲁ|ⲛⲏ
ⲉⲧⲟⲛϧ	ⲉⲧ|ⲟⲛϧ
ⲛⲛⲓⲥⲁϧ	ⲛ|ⲛⲓ|ⲥⲁϧ
ⲉϥⲉⲙⲓ	ⲉ|ϥ|ⲉⲙⲓ
ϫⲉⲁϣ	ϫⲉ|ⲁϣ
ϯⲉⲛⲧⲟⲗⲏ	ϯ|ⲉⲛⲧⲟⲗⲏ
ϫⲉϯϣⲟⲣⲡ	ϫⲉ|ϯ|ϣⲟⲣⲡ
ⲡⲓⲥⲗ	ⲡ|ⲓⲥⲗ
ⲡⲉⲕⲛⲟⲩϯ	ⲡⲉⲕ|ⲛⲟⲩϯ
ⲉⲕⲉⲙⲉⲛⲣⲉⲡϭⲟⲓⲥ	ⲉⲕⲉ|ⲙⲉⲛⲣⲉ|ⲡ|ϭⲟⲓⲥ
ϧⲉⲛⲡⲉⲕϩⲏⲧ	ϧⲉⲛ|ⲡⲉⲕ|ϩⲏⲧ
ϧⲉⲛⲧⲉⲕⲯⲩⲭⲏ	ϧⲉⲛ|ⲧⲉⲕ|ⲯⲩⲭⲏ
ϧⲉⲛⲛⲉⲕⲙⲉⲩⲓ	ϧⲉⲛ|ⲛⲉⲕ|ⲙⲉⲩⲓ
ϧⲉⲛⲧⲉⲕϫⲟⲙ	ϧⲉⲛ|ⲧⲉⲕ|ϫⲟⲙ
ⲉⲕⲉⲙⲉⲛⲣⲉⲡⲉⲕϣⲫⲏⲣ	ⲉⲕⲉ|ⲙⲉⲛⲣⲉ|ⲡⲉⲕ|ϣⲫⲏⲣ
ⲙⲡⲉⲕⲣⲏϯ	ⲙ|ⲡⲉⲕ|ⲣⲏϯ
ⲕⲉⲉⲛⲧⲟⲗⲏ	ⲕⲉ|ⲉⲛⲧⲟⲗⲏ
ⲛϫⲉⲡⲓⲥⲁϧ	ⲛϫⲉ|ⲡⲓ|ⲥⲁϧ
ⲁⲕϫⲟⲥ	ⲁ|ⲕ|ϫⲟ|ⲥ
ⲡⲓⲙⲉⲛⲣⲓⲧϥ	ⲡⲓ|ⲙⲉⲛⲣⲓⲧϥ
ϧⲉⲛⲡⲓⲕⲁϯ	ϧⲉⲛ|ⲡⲓ|ⲕⲁϯ
ⲡⲓⲙⲉⲛⲣⲉⲡⲉⲕϣⲫⲏⲣ	ⲡⲓ|ⲙⲉⲛⲣⲉⲡⲉⲕϣⲫⲏⲣ
ⲉⲛⲓϭⲗⲓⲗ	ⲉ|ⲛⲓ|ϭⲗⲓⲗ
ⲛⲉⲙⲛⲓϣⲟⲩϣⲱⲟⲩϣⲓ	ⲛⲉⲙ|ⲛⲓ|ϣⲟⲩϣⲱⲟⲩϣⲓ
ϫⲉⲁϥⲉⲣⲟⲩⲱ	ϫⲉ|ⲁ|ϥ|ⲉⲣⲟⲩⲱ
ϫⲉⲭⲟⲩⲏⲟⲩ	ϫⲉ|ⲭ|ⲟⲩⲏⲟⲩ
ϩⲁϯⲙⲉⲧⲟⲩⲣⲟ	ϩⲁ|ϯ|ⲙⲉⲧⲟⲩⲣⲟ
ϣⲉⲣⲧⲟⲗⲙⲁⲛ	ϣ|ⲉⲣⲧⲟⲗⲙⲁⲛ
ⲛϫⲉⲛⲓⲥⲁϧ	ⲛϫⲉ|ⲛⲓ|ⲥⲁϧ
ⲛⲇⲁⲩⲓⲇ	ⲛ|ⲇⲁⲩⲓⲇ
ⲙⲡⲁϭⲟⲓⲥ	ⲙ|ⲡⲁ|ϭⲟⲓⲥ
ⲥⲁⲧⲁⲟⲩⲓⲛⲁⲙ	ⲥⲁ|ⲧⲁ|ⲟⲩⲓⲛⲁⲙ
ϣⲁϯⲭⲁⲛⲉⲕϫⲁϫⲓ	ϣⲁ|ϯ|ⲭⲁ|ⲛⲉⲕ|ϫⲁϫⲓ
ⲛⲛⲉⲕϭⲁⲗⲁⲩϫ	ⲛ|ⲛⲉⲕ|ϭⲁⲗⲁⲩϫ
ⲡⲉϥϣⲏⲣⲓ	ⲡⲉϥ|ϣⲏⲣⲓ
ⲉⲧⲟϣ	ⲉⲧ|ⲟϣ
ϧⲉⲛⲧⲉϥⲥⲃⲱ	ϧⲉⲛ|ⲧⲉϥ|ⲥⲃⲱ
ϩⲁⲛⲓⲥⲁϧ	ϩⲁ|ⲛⲓ|ⲥⲁϧ
ⲉⲙⲟϣⲓ	ⲉ|ⲙⲟϣⲓ
ϧⲉⲛϩⲁⲛⲥⲧⲟⲗⲏ	ϧⲉⲛ|ϩⲁⲛ|ⲥⲧⲟⲗⲏ
ⲛⲉⲙϩⲁⲛⲁⲥⲡⲁⲥⲙⲟⲥ	ⲛⲉⲙ|ϩⲁⲛ|ⲁⲥⲡⲁⲥⲙⲟⲥ
ϧⲉⲛⲛⲓⲁⲅⲟⲣⲁ	ϧⲉⲛ|ⲛⲓ|ⲁⲅⲟⲣⲁ
ⲛⲉⲙϩⲁⲛϣⲟⲣⲡ	ⲛⲉⲙ|ϩⲁⲛ|ϣⲟⲣⲡ
ϧⲉⲛⲛⲓⲕⲁⲑⲉⲇⲣⲁ	ϧⲉⲛ|ⲛⲓ|ⲕⲁⲑⲉⲇⲣⲁ
ϧⲉⲛⲛⲓⲥⲩⲛⲁⲅⲱⲅⲏ	ϧⲉⲛ|ⲛⲓ|ⲥⲩⲛⲁⲅⲱⲅⲏ
ⲛⲣⲱⲧⲉⲃ	ⲛ|ⲣⲱⲧⲉⲃ
ϧⲉⲛⲛⲓⲇⲓⲡⲛⲟⲛ	ϧⲉⲛ|ⲛⲓ|ⲇⲓⲡⲛⲟⲛ
ⲛⲛⲓⲏⲓ	ⲛ|ⲛⲓ|ⲏⲓ
ⲛⲧⲉⲛⲓⲭⲏⲣⲁ	ⲛⲧⲉ|ⲛⲓ|ⲭⲏⲣⲁ
ϧⲉⲛⲟⲩⲗⲱⲓϫⲓ	ϧⲉⲛ|ⲟⲩ|ⲗⲱⲓϫⲓ
ⲉⲥⲟⲩⲏⲟⲩ	ⲉ|ⲥ|ⲟⲩⲏⲟⲩ
ⲥⲉⲉⲣⲡⲣⲟⲥⲉⲩⲭⲉⲥⲑⲉ	ⲥⲉ|ⲉⲣⲡⲣⲟⲥⲉⲩⲭⲉⲥⲑⲉ
ⲉⲧⲛⲁϭⲓ	ⲉⲧ|ⲛⲁ|ϭⲓ
ⲙⲡⲓⲅⲁⲍⲟⲫⲩⲗⲁⲕⲓⲟⲛ	ⲙ|ⲡⲓ|ⲅⲁⲍⲟⲫⲩⲗⲁⲕⲓⲟⲛ
ⲛⲓⲙⲏϣ	ⲛⲓ|ⲙⲏϣ
ϩⲓϩⲟⲙⲧ	ϩⲓϩⲟⲙⲧ
ⲉⲡⲓⲅⲁⲍⲟⲫⲩⲗⲁⲕⲓⲟⲛ	ⲉ|ⲡⲓ|ⲅⲁⲍⲟⲫⲩⲗⲁⲕⲓⲟⲛ
ⲛⲣⲁⲙⲁⲟ	ⲛ|ⲣⲁⲙⲁⲟ
ⲛⲁⲩϩⲓⲟⲩⲓ	ⲛⲁ|ⲩ|ϩⲓⲟⲩⲓ
ⲛϫⲉⲟⲩⲭⲏⲣⲁ	ⲛϫⲉ|ⲟⲩ|ⲭⲏⲣⲁ
ⲛϩⲏⲕⲓ	ⲛ|ϩⲏⲕⲓ
ⲁⲥϩⲓⲟⲩⲓ	ⲁ|ⲥ|ϩⲓⲟⲩⲓ
ⲛⲧⲉⲃⲓ	ⲛ|ⲧ|ⲉⲃⲓ
ⲉⲧⲉⲟⲩⲕⲟⲛⲇⲣⲁⲛⲧⲏⲥ	ⲉⲧⲉ|ⲟⲩ|ⲕⲟⲛⲇⲣⲁⲛⲧⲏⲥ
ϫⲉⲧⲁⲓⲭⲏⲣⲁ	ϫⲉ|ⲧⲁⲓ|ⲭⲏⲣⲁ
ⲉϩⲟⲧⲉⲛⲁⲓ	ⲉϩⲟⲧⲉ|ⲛⲁⲓ
ⲉⲧϩⲓⲟⲩⲓ	ⲉⲧ|ϩⲓⲟⲩⲓ
ⲉⲧⲁⲩϩⲓⲟⲩⲓ	ⲉⲧ|ⲁ|ⲩ|ϩⲓⲟⲩⲓ
ϧⲉⲛⲡⲉⲧⲉⲣϩⲟⲩⲟ	ϧⲉⲛ|ⲡ|ⲉⲧ|ⲉⲣϩⲟⲩⲟ
ϧⲉⲛⲡⲉⲧⲉⲥⲉⲣϧⲁⲉ	ϧⲉⲛ|ⲡ|ⲉⲧⲉ|ⲥ|ⲉⲣϧⲁⲉ
ⲉⲧⲉⲛⲧⲁⲥ	ⲉⲧⲉ|ⲛⲧⲁ|ⲥ
ⲁⲥϩⲓⲧⲟⲩ	ⲁ|ⲥ|ϩⲓⲧ|ⲟⲩ
ⲡⲉⲥⲱⲛϧ	ⲡⲉⲥ|ⲱⲛϧ
ϯⲛⲁⲟϩⲓ	ϯ|ⲛⲁ|ⲟϩⲓ
ⲉϫⲉⲛⲡⲁⲙⲁ	ⲉϫⲉⲛ|ⲡⲁ|ⲙⲁ
ⲛⲁⲣⲉϩ	ⲛ|ⲁⲣⲉϩ
ϯⲛⲁϣⲉ	ϯ|ⲛⲁ|ϣⲉ
ⲉϫⲉⲛⲟⲩⲡⲉⲧⲣⲁ	ⲉϫⲉⲛ|ⲟⲩ|ⲡⲉⲧⲣⲁ
ϯⲛⲁϫⲟⲩϣⲧ	ϯ|ⲛⲁ|ϫⲟⲩϣⲧ
ⲉⲑⲣⲓⲛⲁⲩ	ⲉ|ⲑⲣ|ⲓ|ⲛⲁⲩ
ⲉⲧⲉϥⲛⲁⲥⲁϫⲓ	ⲉⲧⲉ|ϥ|ⲛⲁ|ⲥⲁϫⲓ
ⲡⲉⲧⲓⲛⲁⲉⲣⲟⲩⲱ	ⲡ|ⲉⲧ|ⲓ|ⲛⲁ|ⲉⲣⲟⲩⲱ
ⲉϫⲉⲛⲡⲁⲥⲟϩⲓ	ⲉϫⲉⲛ|ⲡⲁ|ⲥⲟϩⲓ
ⲛϫⲉⲡϭⲟⲉⲓⲥ	ⲛϫⲉ|ⲡ|ϭⲟⲉⲓⲥ
ϫⲉⲥϧⲁⲓ	ϫⲉ|ⲥϧⲁⲓ
ⲛⲟⲩϩⲟⲣⲁⲥⲓⲥ	ⲛ|ⲟⲩ|ϩⲟⲣⲁⲥⲓⲥ
ⲉϫⲉⲛⲟⲩⲡⲓⲝⲓⲟⲛ	ⲉϫⲉⲛ|ⲟⲩ|ⲡⲓⲝⲓⲟⲛ
ⲛⲧⲉϥⲓⲱⲥ	ⲛⲧⲉ|ϥ|ⲓⲱⲥ
ϫⲉⲟⲩϩⲟⲣⲁⲥⲓⲥ	ϫⲉ|ⲟⲩ|ϩⲟⲣⲁⲥⲓⲥ
ⲛⲧⲉⲟⲩⲥⲏⲟⲩ	ⲛⲧⲉ|ⲟⲩ|ⲥⲏⲟⲩ
ⲉⲥⲉⲉⲣⲟⲩⲱⲓⲛⲓ	ⲉⲥⲉ|ⲉⲣⲟⲩⲱⲓⲛⲓ
ⲉⲩϧⲁⲉ	ⲉ|ⲩ|ϧⲁⲉ
ⲡⲉⲧϣⲟⲩⲓⲧ	ⲡ|ⲉⲧ|ϣⲟⲩⲓⲧ
ⲁϥϣⲁⲛϭⲓϩⲟ	ⲁϥϣⲁⲛ|ϭⲓϩⲟ
ϫⲉϧⲉⲛⲟⲩⲓ	ϫⲉ|ϧⲉⲛ|ⲟⲩ|ⲓ
ⲛⲛⲉϥⲱⲥⲕ	ⲛⲛⲉ|ϥ|ⲱⲥⲕ
ⲁϥϣⲁⲛϩⲉⲛϥ	ⲁϥϣⲁⲛ|ϩⲉⲛ|ϥ
ⲛⲛⲉⲧⲁⲯⲩⲭⲏ	ⲛⲛⲉ|ⲧⲁ|ⲯⲩⲭⲏ
ⲡⲓⲑⲙⲏⲓ	ⲡⲓ|ⲑⲙⲏⲓ
ⲉϥⲉⲱⲛϧ	ⲉϥⲉ|ⲱⲛϧ
ⲡⲓⲕⲁⲧⲁⲫⲣⲟⲛⲓⲧⲏⲥ	ⲡⲓ|ⲕⲁⲧⲁⲫⲣⲟⲛⲓⲧⲏⲥ
ⲡⲣⲱⲙⲓ	ⲡ|ⲣⲱⲙⲓ
ⲛϭⲁⲥⲓϩⲏⲧ	ⲛ|ϭⲁⲥⲓϩⲏⲧ
ⲉⲛⲁϣⲉⲡⲉϥⲟⲩⲟⲓ	ⲉ|ⲛⲁϣⲉ|ⲡⲉϥ|ⲟⲩⲟⲓ
ⲛⲛⲉϥϫⲉⲕϩⲗⲓ	ⲛⲛⲉ|ϥ|ϫⲉⲕ|ϩⲗⲓ
ⲉⲧⲁϥⲟⲩⲟⲥⲑⲉⲛ	ⲉⲧ|ⲁ|ϥ|ⲟⲩⲟⲥⲑⲉⲛ
ⲛⲁⲙⲉⲛϯ	ⲛ|ⲁⲙⲉⲛϯ
ⲙⲡⲁϥⲥⲓ	ⲙⲡⲁ|ϥ|ⲥⲓ
ⲉϥⲉⲑⲱⲟⲩϯ	ⲉϥⲉ|ⲑⲱⲟⲩϯ
ⲉϥⲉϣⲱⲡ	ⲉϥⲉ|ϣⲱⲡ
ⲛⲛⲓⲗⲁⲟⲥ	ⲛ|ⲛⲓ|ⲗⲁⲟⲥ
ⲉⲩⲉϭⲓⲧⲟⲩ	ⲉⲩⲉ|ϭⲓⲧ|ⲟⲩ
ϧⲉⲛⲟⲩⲡⲁⲣⲁⲃⲟⲗⲏ	ϧⲉⲛ|ⲟⲩ|ⲡⲁⲣⲁⲃⲟⲗⲏ
ⲛⲉⲙⲟⲩⲡⲣⲟⲃⲗⲏⲙⲁ	ⲛⲉⲙ|ⲟⲩ|ⲡⲣⲟⲃⲗⲏⲙⲁ
ⲉⲑⲣⲟⲩⲥⲁϫⲓ	ⲉ|ⲑⲣ|ⲟⲩ|ⲥⲁϫⲓ
ⲉⲩⲉϫⲟⲥ	ⲉⲩⲉ|ϫⲟ|ⲥ
ϫⲉⲟⲩⲟⲓ	ϫⲉ|ⲟⲩⲟⲓ
ⲉⲧⲑⲣⲟ	ⲉⲧ|ⲑⲣⲟ
ⲁϣⲁⲓ	ⲁϣⲁⲓ
ⲉϥⲑⲣⲟ	ⲉ|ϥ|ⲑⲣⲟ
ⲙⲡⲉϥⲭⲗⲁⲗ	ⲙ|ⲡⲉϥ|ⲭⲗⲁⲗ
ϩⲣⲟϣ	ϩⲣⲟϣ
ϧⲉⲛⲟⲩⲉⲛϣⲟⲧ	ϧⲉⲛ|ⲟⲩ|ⲉⲛϣⲟⲧ
ϫⲉⲉⲩⲉⲧⲱⲟⲩⲛⲟⲩ	ϫⲉ|ⲉⲩⲉ|ⲧⲱⲟⲩⲛ|ⲟⲩ
ⲛⲟⲩϩⲟϯ	ⲛ|ⲟⲩ|ϩⲟϯ
ϧⲉⲛⲟⲩϩⲟϯ	ϧⲉⲛ|ⲟⲩ|ϩⲟϯ
ⲉⲩⲉϭⲓⲗⲁⲡⲥⲓ	ⲉⲩⲉ|ϭⲓⲗⲁⲡⲥⲓ
ⲉⲩⲉⲉⲣⲛⲏⲫⲓⲛ	ⲉⲩⲉ|ⲉⲣⲛⲏⲫⲓⲛ
ⲛϫⲉⲛⲉⲕⲉⲡⲓⲃⲟⲩⲗⲟⲥ	ⲛϫⲉ|ⲛⲉⲕ|ⲉⲡⲓⲃⲟⲩⲗⲟⲥ
ⲉⲕⲉϣⲱⲡⲓ	ⲉⲕⲉ|ϣⲱⲡⲓ
ⲛⲟⲩϩⲱⲗⲉⲙ	ⲛ|ⲟⲩ|ϩⲱⲗⲉⲙ
ⲁⲕϣⲉⲗⲟⲩⲙⲏϣ	ⲁ|ⲕ|ϣⲉⲗ|ⲟⲩ|ⲙⲏϣ
ⲉⲩⲉϣⲟⲗⲕ	ⲉⲩⲉ|ϣⲟⲗ|ⲕ
ⲛϫⲉⲛⲓⲗⲁⲟⲥ	ⲛϫⲉ|ⲛⲓ|ⲗⲁⲟⲥ
ⲉⲧⲁⲩⲥⲉⲡⲓ	ⲉⲧ|ⲁ|ⲩ|ⲥⲉⲡⲓ
ⲉⲑⲃⲉϩⲁⲛⲥⲛⲟϥ	ⲉⲑⲃⲉ|ϩⲁⲛ|ⲥⲛⲟϥ
ⲛⲧⲉϩⲁⲛⲣⲱⲙⲓ	ⲛⲧⲉ|ϩⲁⲛ|ⲣⲱⲙⲓ
ⲛⲉⲙϯⲙⲉⲧⲁⲥⲉⲃⲏⲥ	ⲛⲉⲙ|ϯ|ⲙⲉⲧⲁⲥⲉⲃⲏⲥ
ⲛⲧⲉϯⲃⲁⲕⲓ	ⲛⲧⲉ|ϯ|ⲃⲁⲕⲓ
ⲛⲟⲩϭⲓⲛϫⲟⲛⲥ	ⲛ|ⲟⲩ|ϭⲓⲛϫⲟⲛⲥ
ⲙⲡⲉϥⲏⲓ	ⲙ|ⲡⲉϥ|ⲏⲓ
ⲉⲑⲣⲉϥⲑⲱϣ	ⲉ|ⲑⲣⲉ|ϥ|ⲑⲱϣ
ⲙⲡⲉϥⲙⲟϩ	ⲙ|ⲡⲉϥ|ⲙⲟϩ
ϧⲉⲛⲡϭⲓⲥⲓ	ϧⲉⲛ|ⲡ|ϭⲓⲥⲓ
ⲛⲡϫⲓⲛⲥⲁϧⲙⲉϥ	ⲛ|ⲡ|ϫⲓⲛⲥⲁϧⲙⲉϥ
ϧⲉⲛⲧϫⲓϫ	ϧⲉⲛ|ⲧ|ϫⲓϫ
ⲁⲕⲥⲟϭⲛⲓ	ⲁ|ⲕ|ⲥⲟϭⲛⲓ
ⲉⲩϣⲓⲡⲓ	ⲉ|ⲩ|ϣⲓⲡⲓ
ⲙⲡⲉⲕⲏⲓ	ⲙ|ⲡⲉⲕ|ⲏⲓ
ⲁⲕϫⲟⲩϣⲧ	ⲁ|ⲕ|ϫⲟⲩϣⲧ
ⲉϫⲉⲛϩⲁⲛⲗⲁⲟⲥ	ⲉϫⲉⲛ|ϩⲁⲛ|ⲗⲁⲟⲥ
ⲁⲥⲉⲣⲛⲟⲃⲓ	ⲁ|ⲥ|ⲉⲣⲛⲟⲃⲓ
ⲛϫⲉⲧⲉⲕⲯⲩⲭⲏ	ⲛϫⲉ|ⲧⲉⲕ|ⲯⲩⲭⲏ
ⲟⲩⲱⲛⲓ	ⲟⲩ|ⲱⲛⲓ
ⲉϥⲉⲱϣ	ⲉϥⲉ|ⲱϣ
ϧⲉⲛⲟⲩϫⲱ	ϧⲉⲛ|ⲟⲩ|ϫⲱ
ⲟⲩⲕⲁⲛⲑⲁⲣⲟⲥ	ⲟⲩ|ⲕⲁⲛⲑⲁⲣⲟⲥ
ⲉϥⲉⲉⲣⲟⲩⲱ	ⲉϥⲉ|ⲉⲣⲟⲩⲱ
ϧⲉⲛⲟⲩϣⲉ	ϧⲉⲛ|ⲟⲩ|ϣⲉ
ⲛⲟⲩⲃⲁⲕⲓ	ⲛ|ⲟⲩ|ⲃⲁⲕⲓ
ϧⲉⲛϩⲁⲛⲥⲛⲟϥ	ϧⲉⲛ|ϩⲁⲛ|ⲥⲛⲟϥ
ⲉϥⲥⲟⲃϯ	ⲉ|ϥ|ⲥⲟⲃϯ
ⲛϩⲁⲛⲃⲁⲕⲓ	ⲛ|ϩⲁⲛ|ⲃⲁⲕⲓ
ϧⲉⲛϩⲁⲛϭⲓⲛϫⲟⲛⲥ	ϧⲉⲛ|ϩⲁⲛ|ϭⲓⲛϫⲟⲛⲥ
ϧⲉⲛⲟⲩⲭⲣⲱⲙ	ϧⲉⲛ|ⲟⲩ|ⲭⲣⲱⲙ
ⲁⲩⲉⲣⲕⲟⲩϫⲓ	ⲁ|ⲩ|ⲉⲣⲕⲟⲩϫⲓ
ϫⲉⲁϥⲙⲟϩ	ϫⲉ|ⲁ|ϥ|ⲙⲟϩ
ⲛϫⲉⲙⲁⲓ	ⲛϫⲉ|ⲙⲁⲓ
ⲉⲥⲟⲩⲉⲛⲡⲱⲟⲩ	ⲉ|ⲥⲟⲩⲉⲛ|ⲡ|ⲱⲟⲩ
ⲉϥⲉϩⲟⲃⲥⲟⲩ	ⲉϥⲉ|ϩⲟⲃⲥ|ⲟⲩ
ⲉⲧⲧⲥⲟ	ⲉⲧ|ⲧⲥⲟ
ⲙⲡⲉϥϣⲫⲏⲣ	ⲙ|ⲡⲉϥ|ϣⲫⲏⲣ
ϧⲉⲛⲟⲩϩⲉⲓ	ϧⲉⲛ|ⲟⲩ|ϩⲉⲓ
ⲉⲑⲓϧⲓ	ⲉ|ⲑⲓϧⲓ
ⲛⲧⲉϥϫⲟⲩϣⲧ	ⲛⲧⲉ|ϥ|ϫⲟⲩϣⲧ
ⲉϫⲉⲛⲟⲩⲥⲡⲉⲗⲉⲟⲛ	ⲉϫⲉⲛ|ⲟⲩ|ⲥⲡⲉⲗⲉⲟⲛ
ⲥⲱ	ⲥⲱ
ⲛⲟⲩϣⲱϣ	ⲛ|ⲟⲩ|ϣⲱϣ
ϧⲉⲛⲟⲩⲙⲱⲟⲩ	ϧⲉⲛ|ⲟⲩ|ⲙⲱⲟⲩ
ⲡⲓϩⲏⲧ	ⲡⲓ|ϩⲏⲧ
ⲕⲓⲙ	ⲕⲓⲙ
ⲙⲟⲛⲙⲉⲛ	ⲙⲟⲛⲙⲉⲛ
ϫⲉⲁϥⲕⲱϯ	ϫⲉ|ⲁ|ϥ|ⲕⲱϯ
ⲛϫⲉⲡⲓⲁⲫⲟⲧ	ⲛϫⲉ|ⲡⲓ|ⲁⲫⲟⲧ
ⲛⲧⲉⲑⲟⲩⲓⲛⲁⲙ	ⲛⲧⲉ|ⲑ|ⲟⲩⲓⲛⲁⲙ
ⲁϥⲑⲱⲟⲩϯ	ⲁ|ϥ|ⲑⲱⲟⲩϯ
ⲛϫⲉⲟⲩϣⲱϣ	ⲛϫⲉ|ⲟⲩ|ϣⲱϣ
ⲉϫⲉⲛⲡⲉⲕⲱⲟⲩ	ⲉϫⲉⲛ|ⲡⲉⲕ|ⲱⲟⲩ
ϯⲙⲉⲧⲁⲥⲉⲃⲏⲥ	ϯ|ⲙⲉⲧⲁⲥⲉⲃⲏⲥ
ⲛⲧⲉⲡⲓⲗⲓⲃⲁⲛⲟⲥ	ⲛⲧⲉ|ⲡⲓ|ⲗⲓⲃⲁⲛⲟⲥ
ⲉⲥⲉϩⲟⲃⲥⲕ	ⲉⲥⲉ|ϩⲟⲃⲥ|ⲕ
ϯⲧⲁⲗⲉⲡⲱⲣⲓⲁ	ϯ|ⲧⲁⲗⲉⲡⲱⲣⲓⲁ
ⲛⲧⲉⲛⲓⲑⲏⲣⲓⲟⲛ	ⲛⲧⲉ|ⲛⲓ|ⲑⲏⲣⲓⲟⲛ
ⲉⲥⲉⲑⲣⲉⲕⲛⲟⲩϣⲡ	ⲉⲥⲉ|ⲑⲣⲉ|ⲕ|ⲛⲟⲩϣⲡ
ⲡϩⲏⲟⲩ	ⲡ|ϩⲏⲟⲩ
ⲉⲧⲉϥϯ	ⲉⲧⲉ|ϥ|ϯ
ⲛϫⲉⲡⲓⲫⲱⲧϩ	ⲛϫⲉ|ⲡⲓ|ⲫⲱⲧϩ
ⲁⲩⲙⲟⲛⲕϥ	ⲁ|ⲩ|ⲙⲟⲛⲕ|ϥ
ⲛⲟⲩⲫⲱⲧϩ	ⲛ|ⲟⲩ|ⲫⲱⲧϩ
ⲛϩⲟⲣⲧϥ	ⲛ|ϩⲟⲣⲧϥ
ⲙⲙⲉⲑⲛⲟⲩϫ	ⲙ|ⲙⲉⲑⲛⲟⲩϫ
ϫⲉⲁϥⲭⲁϩⲑⲏϥ	ϫⲉ|ⲁ|ϥ|ⲭⲁ|ϩⲑⲏ|ϥ
ⲉϫⲉⲛⲡⲉϥⲙⲟⲛⲕ	ⲉϫⲉⲛ|ⲡⲉϥ|ⲙⲟⲛⲕ
ⲉⲑⲣⲉϥⲑⲁⲙⲓⲟ	ⲉ|ⲑⲣⲉ|ϥ|ⲑⲁⲙⲓⲟ
ⲛϩⲁⲛⲓⲇⲱⲗⲟⲛ	ⲛ|ϩⲁⲛ|ⲓⲇⲱⲗⲟⲛ
ⲉⲡⲓϣⲉ	ⲉ|ⲡⲓ|ϣⲉ
ϫⲉⲁⲣⲓⲛⲏⲫⲓⲛ	ϫⲉ|ⲁⲣⲓⲛⲏⲫⲓⲛ
ⲡⲓⲱⲛⲓ	ⲡⲓ|ⲱⲛⲓ
ⲧⲱⲛⲕ	ⲧⲱⲛ|ⲕ
ϫⲉϭⲓⲥⲓ	ϫⲉ|ϭⲓⲥⲓ
ⲟⲩϩⲟⲣⲧϥ	ⲟⲩ|ϩⲟⲣⲧϥ
ⲟⲩϫⲁϫϩ	ⲟⲩ|ϫⲁϫϩ
ⲛⲛⲟⲩⲃ	ⲛ|ⲛⲟⲩⲃ
ⲛⲉⲙϩⲁⲧ	ⲛⲉⲙ|ϩⲁⲧ
ⲙⲙⲟⲛϩⲗⲓ	ⲙⲙⲟⲛ|ϩⲗⲓ
ϧⲉⲛⲡⲉϥⲉⲣⲫⲉⲓ	ϧⲉⲛ|ⲡⲉϥ|ⲉⲣⲫⲉⲓ
ⲙⲁⲣⲉϥⲉⲣϩⲟϯ	ⲙⲁⲣⲉ|ϥ|ⲉⲣϩⲟϯ
ⲉⲛⲓⲑⲟϣ	ⲉ|ⲛⲓ|ⲑⲟϣ
ⲛⲧⲉϯⲓⲟⲩⲇⲉⲁ	ⲛⲧⲉ|ϯ|ⲓⲟⲩⲇⲉⲁ
ⲛⲉⲙϩⲓⲙⲏⲣ	ⲛⲉⲙ|ϩⲓ|ⲙⲏⲣ
ⲙⲡⲓⲓⲟⲣⲇⲁⲛⲏⲥ	ⲙ|ⲡⲓ|ⲓⲟⲣⲇⲁⲛⲏⲥ
ⲉⲧⲉⲧⲉϥⲥⲩⲛⲏⲑⲓⲁ	ⲉⲧⲉ|ⲧⲉϥ|ⲥⲩⲛⲏⲑⲓⲁ
ⲛϫⲉϩⲁⲛⲫⲁⲣⲓⲥⲉⲟⲥ	ⲛϫⲉ|ϩⲁⲛ|ⲫⲁⲣⲓⲥⲉⲟⲥ
ⲉϩⲓⲧⲉϥⲥϩⲓⲙⲓ	ⲉ|ϩⲓ|ⲧⲉϥ|ⲥϩⲓⲙⲓ
ⲡⲉⲧⲁϥϩⲟⲛϩⲉⲛ	ⲡ|ⲉⲧ|ⲁ|ϥ|ϩⲟⲛϩⲉⲛ
ϩⲓⲧⲉⲛⲑⲏⲛⲟⲩ	ϩⲓⲧⲉⲛ|ⲑⲏⲛⲟⲩ
ⲛϫⲉⲙⲱⲩⲥⲏⲥ	ⲛϫⲉ|ⲙⲱⲩⲥⲏⲥ
ϫⲉⲁϥⲟⲩⲁϩⲥⲁϩⲛⲓ	ϫⲉ|ⲁ|ϥ|ⲟⲩⲁϩⲥⲁϩⲛⲓ
ⲉⲥϧⲉⲟⲩϫⲱⲙ	ⲉ|ⲥϧⲉ|ⲟⲩ|ϫⲱⲙ
ⲛⲥϧⲓ	ⲛ|ⲥϧⲓ
ⲛⲟⲩⲉⲓ	ⲛ|ⲟⲩⲉⲓ
ϫⲉⲉⲑⲃⲉⲧⲉⲧⲉⲛⲙⲉⲧⲛⲁϣⲧϩⲏⲧ	ϫⲉ|ⲉⲑⲃⲉ|ⲧⲉⲧⲉⲛ|ⲙⲉⲧⲛⲁϣⲧϩⲏⲧ
ⲁϥⲥϧⲉⲧⲁⲓⲉⲛⲧⲟⲗⲏ	ⲁ|ϥ|ⲥϧⲉ|ⲧⲁⲓ|ⲉⲛⲧⲟⲗⲏ
ⲓⲥϫⲉⲛⲧⲁⲣⲭⲏ	ⲓⲥϫⲉⲛ|ⲧ|ⲁⲣⲭⲏ
ⲙⲡⲓⲥⲱⲛⲧ	ⲙ|ⲡⲓ|ⲥⲱⲛⲧ
ⲟⲩϩⲱⲟⲩⲧ	ⲟⲩ|ϩⲱⲟⲩⲧ
ⲡⲉⲧⲁϥⲥⲟⲛⲧⲟⲩ	ⲡ|ⲉⲧ|ⲁ|ϥ|ⲥⲟⲛⲧ|ⲟⲩ
ⲭⲁⲡⲉϥⲓⲱⲧ	ⲭⲁ|ⲡⲉϥ|ⲓⲱⲧ
ⲉϥⲉⲧⲟⲙϥ	ⲉϥⲉ|ⲧⲟⲙ|ϥ
ⲉⲧⲉϥⲥϩⲓⲙⲓ	ⲉ|ⲧⲉϥ|ⲥϩⲓⲙⲓ
ⲟⲩⲥⲁⲣⲝ	ⲟⲩ|ⲥⲁⲣⲝ
ⲧⲟⲙϥ	ⲧⲟⲙ|ϥ
ⲙⲡⲉⲛⲑⲣⲉⲫⲣⲱⲙⲓ	ⲙⲡⲉ|ⲛ|ⲑⲣⲉ|ⲫ|ⲣⲱⲙⲓ
ⲫⲟⲣϫϥ	ⲫⲟⲣϫ|ϥ
ⲁⲛⲓⲙⲁⲑⲏⲧⲏⲥ	ⲁ|ⲛⲓ|ⲙⲁⲑⲏⲧⲏⲥ
ⲉⲧⲛⲁⲭⲁⲧⲉϥⲥϩⲓⲙⲓ	ⲉⲧ|ⲛⲁ|ⲭⲁ|ⲧⲉϥ|ⲥϩⲓⲙⲓ
ⲛⲕⲉⲟⲩⲓ	ⲛ|ⲕⲉ|ⲟⲩⲓ
ⲛⲧⲉⲥⲭⲁⲡⲉⲥϩⲁⲓ	ⲛⲧⲉ|ⲥ|ⲭⲁ|ⲡⲉⲥ|ϩⲁⲓ
ⲛⲧⲉⲥϭⲓ	ⲛⲧⲉ|ⲥ|ϭⲓ
ⲛϩⲁⲛⲁⲗⲱⲟⲩⲓ	ⲛ|ϩⲁⲛ|ⲁⲗⲱⲟⲩⲓ
ⲛⲓⲙⲁⲑⲏⲧⲏⲥ	ⲛⲓ|ⲙⲁⲑⲏⲧⲏⲥ
ⲁⲩⲉⲣⲉⲡⲓⲧⲓⲙⲁⲛ	ⲁ|ⲩ|ⲉⲣⲉⲡⲓⲧⲓⲙⲁⲛ
ⲁⲡⲉϥϩⲏⲧ	ⲁ|ⲡⲉϥ|ϩⲏⲧ
ϫⲉⲭⲁⲛⲓⲁⲗⲱⲟⲩⲓ	ϫⲉ|ⲭⲁ|ⲛⲓ|ⲁⲗⲱⲟⲩⲓ
ⲛⲧⲟⲩⲓ	ⲛⲧ|ⲟⲩ|ⲓ
ⲙⲡⲣⲧⲁϩⲛⲟ	ⲙⲡⲣ|ⲧⲁϩⲛⲟ
ⲑⲁⲛⲁⲓ	ⲑⲁ|ⲛⲁⲓ
ⲉⲧⲛⲁϣⲉⲡϯⲙⲉⲧⲟⲩⲣⲟ	ⲉⲧ|ⲛⲁ|ϣⲉⲡ|ϯ|ⲙⲉⲧⲟⲩⲣⲟ
ⲛⲛⲉϥⲓ	ⲛⲛⲉ|ϥ|ⲓ
ⲁϥⲭⲁϫⲓϫ	ⲁ|ϥ|ⲭⲁϫⲓϫ
ⲉⲟⲩⲙⲱⲓⲧ	ⲉ|ⲟⲩ|ⲙⲱⲓⲧ
ⲉϫⲉⲛⲛⲉϥⲕⲉⲗⲓ	ⲉϫⲉⲛ|ⲛⲉϥ|ⲕⲉⲗⲓ
ⲛⲧⲁⲉⲣⲕⲗⲏⲣⲟⲛⲟⲙⲟⲥ	ⲛ|ⲧⲁ|ⲉⲣⲕⲗⲏⲣⲟⲛⲟⲙⲟⲥ
ⲛⲟⲩⲱⲛϧ	ⲛ|ⲟⲩ|ⲱⲛϧ
ϫⲉⲡⲓⲁⲅⲁⲑⲟⲥ	ϫⲉ|ⲡⲓ|ⲁⲅⲁⲑⲟⲥ
ⲛⲓⲉⲛⲧⲟⲗⲏ	ⲛⲓ|ⲉⲛⲧⲟⲗⲏ
ⲕⲥⲱⲟⲩⲛ	ⲕ|ⲥⲱⲟⲩⲛ
ⲙⲡⲣϧⲱⲧⲉⲃ	ⲙⲡⲣ|ϧⲱⲧⲉⲃ
ⲙⲡⲣⲉⲣⲛⲱⲓⲕ	ⲙⲡⲣ|ⲉⲣⲛⲱⲓⲕ
ⲙⲡⲣϭⲓⲟⲩⲓ	ⲙⲡⲣ|ϭⲓⲟⲩⲓ
ⲙⲡⲣⲉⲣⲙⲉⲑⲣⲉ	ⲙⲡⲣ|ⲉⲣ|ⲙⲉⲑⲣⲉ
ⲙⲡⲣϥⲱϫⲓ	ⲙⲡⲣ|ϥⲱϫⲓ
ⲁⲣⲓⲧⲓⲙⲁⲛ	ⲁⲣⲓⲧⲓⲙⲁⲛ
ⲓⲥϫⲉⲛⲧⲁⲙⲉⲧⲁⲗⲟⲩ	ⲓⲥϫⲉⲛ|ⲧⲁ|ⲙⲉⲧⲁⲗⲟⲩ
ⲁϥⲙⲉⲛⲣⲓⲧϥ	ⲁ|ϥ|ⲙⲉⲛⲣⲓⲧ|ϥ
ϫⲉⲕⲉⲟⲩⲁⲓ	ϫⲉ|ⲕⲉ|ⲟⲩⲁⲓ
ⲡⲉⲧⲉⲕⲉⲣϧⲁⲉ	ⲡ|ⲉⲧⲉ|ⲕ|ⲉⲣϧⲁⲉ
ⲡⲉⲧⲉⲛⲧⲁⲕ	ⲡ|ⲉⲧⲉ|ⲛⲧⲁ|ⲕ
ⲉⲕⲉϫⲫⲟ	ⲉⲕⲉ|ϫⲫⲟ
ⲛⲟⲩⲁϩⲟ	ⲛ|ⲟⲩ|ⲁϩⲟ
ⲟⲩⲁϩⲕ	ⲟⲩⲁϩ|ⲕ
ⲉⲧⲁϥⲱⲕⲉⲙ	ⲉⲧ|ⲁ|ϥ|ⲱⲕⲉⲙ
ⲉϫⲉⲛⲡⲓⲥⲁϫⲓ	ⲉϫⲉⲛ|ⲡⲓ|ⲥⲁϫⲓ
ⲛϫⲫⲟ	ⲛ|ϫⲫⲟ
ⲥⲙⲟⲕϩ	ⲥ|ⲙⲟⲕϩ
ⲛⲓⲭⲣⲏⲙⲁ	ⲛⲓ|ⲭⲣⲏⲙⲁ
ϫⲉⲛⲁϣⲏⲣⲓ	ϫⲉ|ⲛⲁ|ϣⲏⲣⲓ
ⲉⲧⲉϩⲑⲏⲟⲩ	ⲉⲧⲉ|ϩⲑⲏ|ⲟⲩ
ⲉϩⲁⲛⲭⲣⲏⲙⲁ	ⲉ|ϩⲁⲛ|ⲭⲣⲏⲙⲁ
ⲥⲙⲟⲧⲉⲛ	ⲥ|ⲙⲟⲧⲉⲛ
ⲛⲟⲩϭⲁⲙⲟⲩⲗ	ⲛ|ⲟⲩ|ϭⲁⲙⲟⲩⲗ
ϩⲓⲧⲉⲛⲫⲟⲩⲱⲧⲉⲛ	ϩⲓⲧⲉⲛ|ⲫ|ⲟⲩⲱⲧⲉⲛ
ⲛⲑⲱⲣⲡ	ⲛ|ⲑⲱⲣⲡ
ⲟⲩⲣⲁⲙⲁⲟ	ⲟⲩ|ⲣⲁⲙⲁⲟ
ⲉⲧⲛⲁϣⲛⲟϩⲉⲙ	ⲉⲧ|ⲛⲁ|ϣ|ⲛⲟϩⲉⲙ
ϫⲉϧⲁⲧⲉⲛⲛⲓⲣⲱⲙⲓ	ϫⲉ|ϧⲁⲧⲉⲛ|ⲛⲓ|ⲣⲱⲙⲓ
ⲟⲩⲙⲉⲧⲁⲧϫⲟⲙ	ⲟⲩ|ⲙⲉⲧⲁⲧϫⲟⲙ
ⲙⲡⲧⲏⲣϥ	ⲙ|ⲡ|ⲧⲏⲣϥ
ⲛϫⲟⲥ	ⲛ|ϫⲟ|ⲥ
ⲁⲛⲭⲁⲡⲧⲏⲣϥ	ⲁ|ⲛ|ⲭⲁ|ⲡ|ⲧⲏⲣϥ
ⲁⲛⲟⲩⲁϩⲧⲉⲛ	ⲁ|ⲛ|ⲟⲩⲁϩⲧⲉ|ⲛ
ⲉⲁϥⲭⲁⲏⲓ	ⲉ|ⲁ|ϥ|ⲭⲁⲏⲓ
ϩⲁⲛⲥⲛⲏⲩ	ϩⲁⲛ|ⲥⲛⲏⲩ
ϩⲁⲛⲥⲱⲛⲓ	ϩⲁⲛ|ⲥⲱⲛⲓ
ⲓⲟϩⲓ	ⲓⲟϩⲓ
ⲁϥϣⲧⲉⲙϭⲓⲧⲟⲩ	ⲁ|ϥ|ϣⲧⲉⲙ|ϭⲓⲧ|ⲟⲩ
ⲛⲕⲱⲃ	ⲛ|ⲕⲱⲃ
ϧⲉⲛⲡⲁⲓⲥⲏⲟⲩ	ϧⲉⲛ|ⲡⲁⲓ|ⲥⲏⲟⲩ
ϩⲁⲛⲏⲓ	ϩⲁⲛ|ⲏⲓ
ⲛⲉⲙϩⲁⲛⲥⲛⲏⲩ	ⲛⲉⲙ|ϩⲁⲛ|ⲥⲛⲏⲩ
ⲛⲉⲙϩⲁⲛⲥⲱⲛⲓ	ⲛⲉⲙ|ϩⲁⲛ|ⲥⲱⲛⲓ
ⲛⲉⲙϩⲁⲛⲙⲁⲩ	ⲛⲉⲙ|ϩⲁⲛ|ⲙⲁⲩ
ⲛⲉⲙϩⲁⲛⲓⲱⲧ	ⲛⲉⲙ|ϩⲁⲛ|ⲓⲱⲧ
ⲛⲉⲙϩⲁⲛϣⲏⲣⲓ	ⲛⲉⲙ|ϩⲁⲛ|ϣⲏⲣⲓ
ⲛⲉⲙϩⲁⲛⲓⲟϩⲓ	ⲛⲉⲙ|ϩⲁⲛ|ⲓⲟϩⲓ
ϧⲉⲛⲛⲓⲇⲓⲱⲅⲙⲟⲥ	ϧⲉⲛ|ⲛⲓ|ⲇⲓⲱⲅⲙⲟⲥ
ϧⲉⲛⲡⲓⲉⲱⲛ	ϧⲉⲛ|ⲡⲓ|ⲉⲱⲛ
ⲉⲩⲉⲉⲣϧⲁⲉ	ⲉⲩⲉ|ⲉⲣϧⲁⲉ
ϩⲁⲛϧⲁⲉⲩ	ϩⲁⲛ|ϧⲁⲉⲩ
ⲉⲩⲛⲁⲉⲣϣⲟⲣⲡ	ⲉ|ⲩ|ⲛⲁ|ⲉⲣϣⲟⲣⲡ
ⲛⲁⲩϩⲓ	ⲛⲁ|ⲩ|ϩⲓ
ⲫⲙⲱⲓⲧ	ⲫ|ⲙⲱⲓⲧ
ⲉⲛⲁⲩⲉⲣⲁⲕⲟⲗⲟⲩⲑⲓⲛ	ⲉ|ⲛⲁ|ⲩ|ⲉⲣⲁⲕⲟⲗⲟⲩⲑⲓⲛ
ⲙⲡⲓⲓⲃ	ⲙ|ⲡⲓ|ⲓⲃ
ⲧⲉⲛⲛⲁϣⲉ	ⲧⲉⲛ|ⲛⲁ|ϣⲉ
ⲛⲛⲓⲁⲣⲭⲓⲉⲣⲉⲩⲥ	ⲛ|ⲛⲓ|ⲁⲣⲭⲓⲉⲣⲉⲩⲥ
ⲙⲙⲟⲩ	ⲙⲙⲟ|ⲩ
ⲥⲉⲛⲁⲥⲱⲃⲓ	ⲥⲉ|ⲛⲁ|ⲥⲱⲃⲓ
ⲥⲉⲛⲁϩⲓⲑⲁϥ	ⲥⲉ|ⲛⲁ|ϩⲓⲑⲁϥ
ⲥⲉⲛⲁⲉⲣⲙⲁⲥⲧⲓⲅⲅⲟⲓⲛ	ⲥⲉ|ⲛⲁ|ⲉⲣⲙⲁⲥⲧⲓⲅⲅⲟⲓⲛ
ⲛϫⲉⲓⲁⲕⲱⲃⲟⲥ	ⲛϫⲉ|ⲓⲁⲕⲱⲃⲟⲥ
ⲛⲍⲉⲃⲉⲇⲉⲟⲥ	ⲛ|ⲍⲉⲃⲉⲇⲉⲟⲥ
ⲧⲉⲛⲟⲩⲱϣ	ⲧⲉⲛ|ⲟⲩⲱϣ
ⲉⲧⲉⲛⲛⲁⲉⲣⲉⲧⲓⲛ	ⲉⲧⲉ|ⲛ|ⲛⲁ|ⲉⲣⲉⲧⲓⲛ
ⲛⲧⲉⲕⲁⲓϥ	ⲛⲧⲉ|ⲕ|ⲁⲓ|ϥ
ⲧⲉⲧⲉⲛⲟⲩⲁϣϥ	ⲧⲉⲧⲉⲛ|ⲟⲩⲁϣ|ϥ
ⲛⲧⲁⲁⲓϥ	ⲛ|ⲧⲁ|ⲁⲓ|ϥ
ϫⲉⲙⲏⲓⲥ	ϫⲉ|ⲙⲏⲓ|ⲥ
ⲥⲁⲧⲉⲕⲟⲩⲓⲛⲁⲙ	ⲥⲁ|ⲧⲉⲕ|ⲟⲩⲓⲛⲁⲙ
ⲥⲁⲧⲉⲕϫⲁϭⲏ	ⲥⲁ|ⲧⲉⲕ|ϫⲁϭⲏ
ϧⲉⲛⲡⲉⲕⲱⲟⲩ	ϧⲉⲛ|ⲡⲉⲕ|ⲱⲟⲩ
ϫⲉⲛⲧⲉⲧⲉⲛⲉⲙⲓ	ϫⲉ|ⲛ|ⲧⲉⲧⲉⲛ|ⲉⲙⲓ
ⲡⲉⲧⲉⲧⲉⲛⲛⲁⲉⲣⲉⲧⲓⲛ	ⲡ|ⲉⲧⲉ|ⲧⲉⲛ|ⲛⲁ|ⲉⲣⲉⲧⲓⲛ
ⲉⲥⲉ	ⲉ|ⲥⲉ
ⲉϯⲥⲱ	ⲉ|ϯ|ⲥⲱ
ϫⲉⲡⲓⲁⲫⲟⲧ	ϫⲉ|ⲡⲓ|ⲁⲫⲟⲧ
ⲉⲣⲉⲧⲉⲛⲉⲥⲟϥ	ⲉⲣⲉ|ⲧⲉⲛⲉ|ⲥⲟ|ϥ
ⲉⲣⲉⲧⲉⲛⲉⲉⲙⲥⲑⲏⲛⲟⲩ	ⲉⲣⲉ|ⲧⲉⲛⲉ|ⲉⲙⲥ|ⲑⲏⲛⲟⲩ
ⲡⲓϩⲉⲙⲥⲓ	ⲡⲓ|ϩⲉⲙⲥⲓ
ⲛⲥⲁⲟⲩⲓⲛⲁⲙ	ⲛⲥⲁ|ⲟⲩⲓⲛⲁⲙ
ϫⲁϭⲏ	ϫⲁϭⲏ
ⲙⲫⲱⲓ	ⲙ|ⲫⲱⲓ
ⲉⲧⲁϥⲥⲉⲃⲧⲱⲧϥ	ⲉⲧ|ⲁ|ϥ|ⲥⲉⲃⲧⲱⲧ|ϥ
ⲛϫⲉⲡⲓⲕⲉⲓ	ⲛϫⲉ|ⲡⲓ|ⲕⲉⲓ
ⲛⲭⲣⲉⲙⲣⲉⲙ	ⲛ|ⲭⲣⲉⲙⲣⲉⲙ
ⲉⲑⲃⲉⲓⲁⲕⲱⲃⲟⲥ	ⲉⲑⲃⲉ|ⲓⲁⲕⲱⲃⲟⲥ
ϫⲉⲧⲉⲧⲉⲛⲉⲙⲓ	ϫⲉ|ⲧⲉⲧⲉⲛ|ⲉⲙⲓ
ⲉⲛⲓⲉⲑⲛⲟⲥ	ⲉ|ⲛⲓ|ⲉⲑⲛⲟⲥ
ⲡⲉⲧϣⲟⲡ	ⲡ|ⲉⲧ|ϣⲟⲡ
ⲉⲧⲛⲁⲟⲩⲱϣ	ⲉⲧ|ⲛⲁ|ⲟⲩⲱϣ
ⲉⲉⲣⲛⲓϣϯ	ⲉ|ⲉⲣⲛⲓϣϯ
ⲉϥⲉⲉⲣⲇⲓⲁⲕⲱⲛ	ⲉϥⲉ|ⲉⲣⲇⲓⲁⲕⲱⲛ
ⲉϥⲉⲉⲣⲃⲱⲕ	ⲉϥⲉ|ⲉⲣⲃⲱⲕ
ⲡⲱⲏⲣⲓ	ⲡ|ⲱⲏⲣⲓ
ⲛⲉⲧⲁϥⲓ	ⲛ|ⲉⲧ|ⲁ|ϥ|ⲓ
ⲉⲑⲣⲟⲩϣⲉⲙϣⲏⲧϥ	ⲉ|ⲑⲣ|ⲟⲩ|ϣⲉⲙϣⲏⲧ|ϥ
ⲉϣⲉⲙϣⲓ	ⲉ|ϣⲉⲙϣⲓ
ⲛⲥⲱϯ	ⲛ|ⲥⲱϯ
ⲛϣⲉⲃⲓⲱ	ⲛ|ϣⲉⲃⲓⲱ
ⲉⲓⲉⲣⲓⲭⲱ	ⲉ|ⲓⲉⲣⲓⲭⲱ
ϧⲉⲛⲓⲉⲣⲓⲭⲱ	ϧⲉⲛ|ⲓⲉⲣⲓⲭⲱ
ⲃⲁⲣⲧⲓⲙⲉⲟⲥ	ⲃⲁⲣⲧⲓⲙⲉⲟⲥ
ⲛⲧⲓⲙⲉⲟⲥ	ⲛ|ⲧⲓⲙⲉⲟⲥ
ⲉⲟⲩⲃⲉⲗⲗⲉ	ⲉ|ⲟⲩ|ⲃⲉⲗⲗⲉ
ⲛⲣⲉϥⲧⲱⲃϩ	ⲛ|ⲣⲉϥⲧⲱⲃϩ
ⲛⲁϥϩⲉⲙⲥⲓ	ⲛⲁ|ϥ|ϩⲉⲙⲥⲓ
ⲉⲥⲕⲉⲛⲡⲓⲙⲱⲓⲧ	ⲉⲥⲕⲉⲛ|ⲡⲓ|ⲙⲱⲓⲧ
ϫⲉⲓⲏⲥⲟⲩⲥ	ϫⲉ|ⲓⲏⲥⲟⲩⲥ
ⲡⲓⲣⲉⲙⲛⲁⲍⲁⲣⲉⲑ	ⲡⲓ|ⲣⲉⲙⲛⲁⲍⲁⲣⲉⲑ
ⲛⲁⲩⲉⲣⲉⲡⲓⲧⲓⲙⲁⲛ	ⲛⲁ|ⲩ|ⲉⲣⲉⲡⲓⲧⲓⲙⲁⲛ
ⲛⲧⲉϥⲭⲁⲣⲱϥ	ⲛⲧⲉ|ϥ|ⲭⲁ|ⲣⲱ|ϥ
ⲛⲁϥⲱϣ	ⲛⲁ|ϥ|ⲱϣ
ⲉⲧⲁϥⲟϩⲓ	ⲉⲧ|ⲁ|ϥ|ⲟϩⲓ
ϫⲉⲙⲟⲩϯ	ϫⲉ|ⲙⲟⲩϯ
ⲉⲧⲁϥⲥⲉⲧⲡⲉϥϩⲃⲟⲥ	ⲉⲧ|ⲁ|ϥ|ⲥⲉⲧ|ⲡⲉϥ|ϩⲃⲟⲥ
ⲉⲧⲁϥϥⲟϫϥ	ⲉⲧ|ⲁ|ϥ|ϥⲟϫ|ϥ
ⲡⲉⲧⲉⲕⲟⲩⲁϣϥ	ⲡ|ⲉⲧⲉ|ⲕ|ⲟⲩⲁϣ|ϥ
ⲡⲓⲃⲉⲗⲗⲉ	ⲡⲓ|ⲃⲉⲗⲗⲉ
ϫⲉⲣⲁⲃⲃⲟⲩⲛⲓ	ϫⲉ|ⲣⲁⲃⲃⲟⲩⲛⲓ
ⲡⲉⲕⲛⲁϩϯ	ⲡⲉⲕ|ⲛⲁϩϯ
ⲡⲉⲧⲁϥⲛⲁϩⲙⲉⲕ	ⲡ|ⲉⲧ|ⲁ|ϥ|ⲛⲁϩⲙⲉ|ⲕ
ⲛⲥⲁϯⲁⲅⲁⲡⲏ	ⲛⲥⲁ|ϯ|ⲁⲅⲁⲡⲏ
ⲉⲛⲓⲡⲛⲉⲩⲙⲁⲧⲓⲕⲟⲛ	ⲉ|ⲛⲓ|ⲡⲛⲉⲩⲙⲁⲧⲓⲕⲟⲛ
ⲛⲧⲉⲧⲉⲛⲉⲣⲡⲣⲟⲫⲏⲧⲉⲩⲓⲛ	ⲛⲧⲉ|ⲧⲉⲛ|ⲉⲣⲡⲣⲟⲫⲏⲧⲉⲩⲓⲛ
ⲡⲉⲧⲥⲁϫⲓ	ⲡ|ⲉⲧ|ⲥⲁϫⲓ
ϫⲉϥⲥⲁϫⲓ	ϫⲉ|ϥ|ⲥⲁϫⲓ
ⲛϩⲁⲛⲙⲩⲥⲧⲏⲣⲓⲟⲛ	ⲛ|ϩⲁⲛ|ⲙⲩⲥⲧⲏⲣⲓⲟⲛ
ⲉⲧⲉⲣⲡⲣⲟⲫⲏⲧⲉⲩⲓⲛ	ⲉⲧ|ⲉⲣⲡⲣⲟⲫⲏⲧⲉⲩⲓⲛ
ⲛⲟⲩⲕⲱⲧ	ⲛ|ⲟⲩ|ⲕⲱⲧ
ⲛⲉⲙⲟⲩⲛⲟⲙϯ	ⲛⲉⲙ|ⲟⲩ|ⲛⲟⲙϯ
ⲛⲉⲙⲟⲩⲑⲱⲧ	ⲛⲉⲙ|ⲟⲩ|ⲑⲱⲧ
ⲉⲣⲉⲧⲉⲛⲥⲁϫⲓ	ⲉⲣⲉ|ⲧⲉⲛ|ⲥⲁϫⲓ
ⲛⲁⲁⲡⲉⲧⲉⲣⲡⲣⲟⲫⲏⲧⲉⲩⲓⲛ	ⲛⲁⲁ|ⲡ|ⲉⲧ|ⲉⲣⲡⲣⲟⲫⲏⲧⲉⲩⲓⲛ
ⲛⲧⲉϥⲉⲣⲙⲉⲛⲉⲩⲓⲛ	ⲛⲧⲉ|ϥ|ⲉⲣⲙⲉⲛⲉⲩⲓⲛ
ⲉⲓⲥⲁϫⲓ	ⲉ|ⲓ|ⲥⲁϫⲓ
ⲛϩⲏⲟⲩ	ⲛ|ϩⲏⲟⲩ
ϯⲛⲁⲧⲏⲓϥ	ϯ|ⲛⲁ|ⲧⲏⲓ|ϥ
ⲁⲓϣⲧⲉⲙⲥⲁϫⲓ	ⲁ|ⲓ|ϣⲧⲉⲙ|ⲥⲁϫⲓ
ϧⲉⲛⲟⲩϭⲱⲣⲡ	ϧⲉⲛ|ⲟⲩ|ϭⲱⲣⲡ
ϧⲉⲛⲟⲩⲉⲙⲓ	ϧⲉⲛ|ⲟⲩ|ⲉⲙⲓ
ϧⲉⲛⲟⲩⲡⲣⲟⲫⲏⲧⲓⲁ	ϧⲉⲛ|ⲟⲩ|ⲡⲣⲟⲫⲏⲧⲓⲁ
ⲟⲙⲱⲥ	ⲟⲙⲱⲥ
ⲛⲓⲁⲧⲯⲩⲭⲏ	ⲛⲓ|ⲁⲧⲯⲩⲭⲏ
ⲉⲩϯ	ⲉ|ⲩ|ϯ
ⲟⲩⲥⲏⲃⲓ	ⲟⲩ|ⲥⲏⲃⲓ
ⲛϫⲱ	ⲛ|ϫⲱ
ⲟⲩⲕⲩⲑⲁⲣⲁ	ⲟⲩ|ⲕⲩⲑⲁⲣⲁ
ⲁⲩϣⲧⲉⲙϣⲓⲃϯ	ⲁ|ⲩ|ϣⲧⲉⲙ|ϣⲓⲃϯ
ⲥⲉⲛⲁⲉⲙⲓ	ⲥⲉ|ⲛⲁ|ⲉⲙⲓ
ⲉⲡⲉⲧⲟⲩϫⲱ	ⲉ|ⲡ|ⲉⲧ|ⲟⲩ|ϫⲱ
ⲉⲧⲟⲩⲉⲣⲕⲩⲑⲁⲣⲓⲍⲓⲛ	ⲉⲧ|ⲟⲩ|ⲉⲣⲕⲩⲑⲁⲣⲓⲍⲓⲛ
ⲁⲣⲉϣⲁⲛⲟⲩⲥⲁⲗⲡⲓⲅⲝ	ⲁⲣⲉϣⲁⲛ|ⲟⲩ|ⲥⲁⲗⲡⲓⲅⲝ
ⲛⲟⲩⲥⲙⲏ	ⲛ|ⲟⲩ|ⲥⲙⲏ
ⲉⲥⲟⲩⲟⲛϩ	ⲉ|ⲥ|ⲟⲩⲟⲛϩ
ⲉⲧⲛⲁϣⲥⲉⲃⲧⲱⲧϥ	ⲉⲧ|ⲛⲁ|ϣⲥⲉⲃⲧⲱⲧ|ϥ
ⲉⲡⲡⲟⲗⲉⲙⲟⲥ	ⲉ|ⲡ|ⲡⲟⲗⲉⲙⲟⲥ
ϩⲓⲧⲉⲛⲫⲗⲁⲥ	ϩⲓⲧⲉⲛ|ⲫ|ⲗⲁⲥ
ⲁⲣⲉϣⲧⲉⲙϫⲉⲟⲩⲥⲁϫⲓ	ⲁⲣⲉ|ϣⲧⲉⲙ|ϫⲉ|ⲟⲩ|ⲥⲁϫⲓ
ⲉϥⲟⲩⲟⲛϩ	ⲉ|ϥ|ⲟⲩⲟⲛϩ
ⲉⲡⲉⲧⲉⲛϫⲱ	ⲉ|ⲡ|ⲉⲧ|ⲉⲛ|ϫⲱ
ⲧⲉⲧⲉⲛⲛⲁϣⲱⲡⲓ	ⲧⲉⲧⲉⲛ|ⲛⲁ|ϣⲱⲡⲓ
ⲉⲡⲁⲏⲣ	ⲉ|ⲡ|ⲁⲏⲣ
ⲛϣⲗⲱⲗ	ⲛ|ϣⲗⲱⲗ
ⲛⲁⲧⲥⲙⲏ	ⲛⲁ|ⲧ|ⲥⲙⲏ
ⲁⲓϣⲧⲉⲙⲉⲙⲓ	ⲁ|ⲓ|ϣⲧⲉⲙ|ⲉⲙⲓ
ⲛⲧⲉϯⲥⲙⲏ	ⲛⲧⲉ|ϯ|ⲥⲙⲏ
ⲙⲃⲁⲣⲃⲁⲣⲟⲥ	ⲙ|ⲃⲁⲣⲃⲁⲣⲟⲥ
ⲙⲡⲉⲧⲥⲁϫⲓ	ⲙ|ⲡ|ⲉⲧ|ⲥⲁϫⲓ
ⲧⲉⲧⲉⲛⲟⲓ	ⲧⲉⲧⲉⲛ|ⲟⲓ
ⲛⲣⲉϥⲭⲟϩ	ⲛ|ⲣⲉϥⲭⲟϩ
ⲉⲡⲕⲱⲧ	ⲉ|ⲡ|ⲕⲱⲧ
ⲛⲧⲉⲧⲉⲛⲉⲣϩⲟⲩⲟ	ⲛⲧⲉ|ⲧⲉⲛ|ⲉⲣϩⲟⲩⲟ
ⲙⲁⲣⲉϥⲧⲱⲃϩ	ⲙⲁⲣⲉ|ϥ|ⲧⲱⲃϩ
ⲁⲓϣⲁⲛⲧⲱⲃϩ	ⲁⲓϣⲁⲛ|ⲧⲱⲃϩ
ⲡⲁⲡⲛⲉⲩⲙⲁ	ⲡⲁ|ⲡⲛⲉⲩⲙⲁ
ⲡⲉⲧⲧⲱⲃϩ	ⲡ|ⲉⲧ|ⲧⲱⲃϩ
ⲡⲁϩⲏⲧ	ⲡⲁ|ϩⲏⲧ
ⲛⲁⲧⲟⲩⲧⲁϩ	ⲛ|ⲁⲧⲟⲩⲧⲁϩ
ϫⲉⲡⲉ	ϫⲉ|ⲡⲉ
ϯⲛⲁⲁⲓϥ	ϯ|ⲛⲁ|ⲁⲓ|ϥ
ϯⲛⲁⲧⲱⲃϩ	ϯ|ⲛⲁ|ⲧⲱⲃϩ
ϧⲉⲛⲡⲓⲕⲉϩⲏⲧ	ϧⲉⲛ|ⲡⲓ|ⲕⲉ|ϩⲏⲧ
ϯⲛⲁⲉⲣⲯⲁⲗⲓⲛ	ϯ|ⲛⲁ|ⲉⲣⲯⲁⲗⲓⲛ
ⲁⲕϣⲁⲛⲥⲙⲟⲩ	ⲁⲕϣⲁⲛ|ⲥⲙⲟⲩ
ⲡⲉⲧϫⲱⲕ	ⲡ|ⲉⲧ|ϫⲱⲕ
ⲙⲡⲓⲓⲇⲓⲱⲧⲏⲥ	ⲙ|ⲡⲓ|ⲓⲇⲓⲱⲧⲏⲥ
ϥⲛⲁϫⲉⲡⲓⲁⲙⲏⲛ	ϥ|ⲛⲁ|ϫⲉ|ⲡⲓ|ⲁⲙⲏⲛ
ⲉϫⲉⲛⲡⲉⲕϣⲉⲡϩⲙⲟⲧ	ⲉϫⲉⲛ|ⲡⲉⲕ|ϣⲉⲡϩⲙⲟⲧ
ⲡⲉⲧⲉⲕϫⲱ	ⲡ|ⲉⲧ|ⲉⲕ|ϫⲱ
ϥⲉⲙⲓ	ϥ|ⲉⲙⲓ
ⲕϣⲉⲡϩⲙⲟⲧ	ⲕ|ϣⲉⲡϩⲙⲟⲧ
ϥⲕⲏⲧ	ϥ|ⲕⲏⲧ
ϫⲉϯⲥⲁϫⲓ	ϫⲉ|ϯ|ⲥⲁϫⲓ
ⲉϫⲉⲉ	ⲉ|ϫⲉ|ⲉ
ϧⲉⲛⲡⲁⲕⲁϯ	ϧⲉⲛ|ⲡⲁ|ⲕⲁϯ
ⲛⲧⲁⲉⲣⲕⲁⲧⲏⲭⲓⲛ	ⲛ|ⲧⲁ|ⲉⲣⲕⲁⲧⲏⲭⲓⲛ
ⲟⲩⲑⲃⲁ	ⲟⲩ|ⲑⲃⲁ
ⲙⲡⲣⲉⲣⲁⲗⲟⲩ	ⲙⲡⲣ|ⲉⲣⲁⲗⲟⲩ
ϧⲉⲛⲛⲉⲧⲉⲛⲕⲁϯ	ϧⲉⲛ|ⲛⲉⲧⲉⲛ|ⲕⲁϯ
ⲁⲣⲓⲁⲗⲟⲩ	ⲁⲣⲓⲁⲗⲟⲩ
ϧⲉⲛϯⲕⲁⲕⲓⲁ	ϧⲉⲛ|ϯ|ⲕⲁⲕⲓⲁ
ⲉⲣⲉⲧⲉⲛϫⲏϫ	ⲉⲣⲉ|ⲧⲉⲛ|ϫⲏϫ
ϩⲓⲫⲛⲟⲙⲟⲥ	ϩⲓ|ⲫ|ⲛⲟⲙⲟⲥ
ϫⲉϧⲉⲛϩⲁⲛⲕⲉⲗⲁⲥ	ϫⲉ|ϧⲉⲛ|ϩⲁⲛ|ⲕⲉ|ⲗⲁⲥ
ⲛⲉⲙϩⲁⲛⲕⲉⲥⲫⲟⲧⲟⲩ	ⲛⲉⲙ|ϩⲁⲛ|ⲕⲉ|ⲥⲫⲟⲧⲟⲩ
ϯⲛⲁⲥⲁϫⲓ	ϯ|ⲛⲁ|ⲥⲁϫⲓ
ⲛⲉⲙⲡⲁⲓⲗⲁⲟⲥ	ⲛⲉⲙ|ⲡⲁⲓ|ⲗⲁⲟⲥ
ⲛⲛⲟⲩⲥⲱⲧⲉⲙ	ⲛⲛⲟ|ⲩ|ⲥⲱⲧⲉⲙ
ⲉⲩⲙⲏⲓⲛⲓ	ⲉ|ⲩ|ⲙⲏⲓⲛⲓ
ⲉⲧⲛⲁϩϯ	ⲉⲧ|ⲛⲁϩϯ
ⲛⲓⲁⲑⲛⲁϩϯ	ⲛⲓ|ⲁⲑⲛⲁϩϯ
ϯⲡⲣⲟⲫⲏⲧⲓⲁ	ϯ|ⲡⲣⲟⲫⲏⲧⲓⲁ
ⲛⲁⲥⲭⲏ	ⲛⲁ|ⲥ|ⲭⲏ
ⲁⲥϣⲁⲛⲓ	ⲁⲥϣⲁⲛ|ⲓ
ⲛϫⲉϯⲉⲕⲕⲗⲏⲥⲓⲁ	ⲛϫⲉ|ϯ|ⲉⲕⲕⲗⲏⲥⲓⲁ
ⲛⲥⲉⲥⲁϫⲓ	ⲛ|ⲥⲉ|ⲥⲁϫⲓ
ⲛⲥⲉⲓ	ⲛ|ⲥⲉ|ⲓ
ⲛϫⲉϩⲁⲛⲓⲇⲓⲱⲧⲏⲥ	ⲛϫⲉ|ϩⲁⲛ|ⲓⲇⲓⲱⲧⲏⲥ
ϩⲁⲛⲁⲑⲛⲁϩϯ	ϩⲁⲛ|ⲁⲑⲛⲁϩϯ
ⲥⲉⲛⲁϫⲟⲥ	ⲥⲉ|ⲛⲁ|ϫⲟ|ⲥ
ϫⲉⲁⲣⲉⲛⲁⲓ	ϫⲉ|ⲁⲣⲉ|ⲛⲁⲓ
ⲗⲟⲃⲓ	ⲗⲟⲃⲓ
ⲉⲩⲉⲣⲡⲣⲟⲫⲏⲧⲉⲩⲓⲛ	ⲉ|ⲩ|ⲉⲣⲡⲣⲟⲫⲏⲧⲉⲩⲓⲛ
ⲛϫⲉⲟⲩⲁⲑⲛⲁϩϯ	ⲛϫⲉ|ⲟⲩ|ⲁⲑⲛⲁϩϯ
ⲟⲩⲓⲇⲓⲱⲧⲏⲥ	ⲟⲩ|ⲓⲇⲓⲱⲧⲏⲥ
ⲥⲉⲛⲁⲥⲁϩⲱϥ	ⲥⲉ|ⲛⲁ|ⲥⲁϩⲱ|ϥ
ⲥⲉⲛⲁϧⲉⲧϧⲱⲧϥ	ⲥⲉ|ⲛⲁ|ϧⲉⲧϧⲱⲧ|ϥ
ⲛⲧⲉⲡⲉϥϩⲏⲧ	ⲛⲧⲉ|ⲡⲉϥ|ϩⲏⲧ
ⲥⲉⲛⲁⲟⲩⲟⲛϩ	ⲥⲉ|ⲛⲁ|ⲟⲩⲟⲛϩ
ϥⲛⲁϩⲓⲧϥ	ϥ|ⲛⲁ|ϩⲓⲧ|ϥ
ⲉϫⲉⲛⲡⲉϥϩⲟ	ⲉϫⲉⲛ|ⲡⲉϥ|ϩⲟ
ⲛⲧⲉϥⲟⲩⲱϣⲧ	ⲛⲧⲉ|ϥ|ⲟⲩⲱϣⲧ
ⲉϥⲟⲩⲱⲛϩ	ⲉ|ϥ|ⲟⲩⲱⲛϩ
ⲛⲟⲩⲯⲁⲗⲙⲟⲥ	ⲛ|ⲟⲩ|ⲯⲁⲗⲙⲟⲥ
ⲛⲟⲩⲥⲃⲱ	ⲛ|ⲟⲩ|ⲥⲃⲱ
ⲛⲟⲩϭⲱⲣⲡ	ⲛ|ⲟⲩ|ϭⲱⲣⲡ
ⲛⲟⲩⲁⲥⲡⲓ	ⲛ|ⲟⲩ|ⲁⲥⲡⲓ
ⲛⲟⲩⲉⲣⲙⲏⲛⲓⲁ	ⲛ|ⲟⲩ|ⲉⲣⲙⲏⲛⲓⲁ
ⲕⲁⲧⲁ	ⲕⲁⲧⲁ
ⲡⲓϩⲟⲩⲟ	ⲡⲓ|ϩⲟⲩⲟ
ⲟⲩⲙⲉⲣⲟⲥ	ⲟⲩ|ⲙⲉⲣⲟⲥ
ⲉⲫⲟⲩⲁⲓ	ⲉ|ⲫ|ⲟⲩⲁⲓ
ⲙⲁⲣⲉⲟⲩⲁⲓ	ⲙⲁⲣⲉ|ⲟⲩⲁⲓ
ⲉⲣⲙⲉⲛⲉⲩⲓⲛ	ⲉⲣⲙⲉⲛⲉⲩⲓⲛ
ⲛⲟⲩⲉⲣⲙⲉⲛⲉⲩⲧⲏⲥ	ⲛ|ⲟⲩ|ⲉⲣⲙⲉⲛⲉⲩⲧⲏⲥ
ⲙⲁⲣⲉϥⲭⲁⲣⲱϥ	ⲙⲁⲣⲉ|ϥ|ⲭⲁ|ⲣⲱ|ϥ
ⲙⲁⲣⲉϥⲥⲁϫⲓ	ⲙⲁⲣⲉ|ϥ|ⲥⲁϫⲓ
ⲡⲣⲟⲫⲏⲧⲏⲥ	ⲡⲣⲟⲫⲏⲧⲏⲥ
ⲙⲁⲣⲟⲩⲥⲁϫⲓ	ⲙⲁⲣ|ⲟⲩ|ⲥⲁϫⲓ
ⲛⲓⲕⲉⲭⲱⲟⲩⲛⲓ	ⲛⲓ|ⲕⲉ|ⲭⲱⲟⲩⲛⲓ
ⲙⲁⲣⲟⲩⲉⲣⲇⲓⲁⲕⲣⲓⲛⲓⲛ	ⲙⲁⲣ|ⲟⲩ|ⲉⲣⲇⲓⲁⲕⲣⲓⲛⲓⲛ
ⲁⲣⲉϣⲁⲛⲟⲩϭⲱⲣⲡ	ⲁⲣⲉϣⲁⲛ|ⲟⲩ|ϭⲱⲣⲡ
ϧⲉⲛⲕⲉⲟⲩⲁⲓ	ϧⲉⲛ|ⲕⲉ|ⲟⲩⲁⲓ
ⲙⲁⲣⲉϥⲭⲁⲣⲟϥ	ⲙⲁⲣⲉ|ϥ|ⲭⲁⲣⲟ|ϥ
ⲕⲁⲧⲁⲟⲩⲁⲓ	ⲕⲁⲧⲁ|ⲟⲩⲁⲓ
ⲉⲉⲣⲡⲣⲟⲫⲏⲧⲉⲩⲓⲛ	ⲉ|ⲉⲣⲡⲣⲟⲫⲏⲧⲉⲩⲓⲛ
ⲛⲥⲉϭⲓⲥⲃⲱ	ⲛ|ⲥⲉ|ϭⲓⲥⲃⲱ
ⲛⲥⲉϫⲉⲙⲛⲟⲙϯ	ⲛ|ⲥⲉ|ϫⲉⲙⲛⲟⲙϯ
ⲛⲓⲡⲛⲉⲩⲙⲁ	ⲛⲓ|ⲡⲛⲉⲩⲙⲁ
ⲫⲁⲫⲱⲣϫ	ⲫⲁ|ⲫⲱⲣϫ
ⲫⲁⲧϩⲓⲣⲏⲛⲏ	ⲫⲁ|ⲧ|ϩⲓⲣⲏⲛⲏ
ⲛⲓϩⲓⲟⲙⲓ	ⲛⲓ|ϩⲓⲟⲙⲓ
ⲙⲁⲣⲟⲩⲭⲁⲣⲱⲟⲩ	ⲙⲁⲣ|ⲟⲩ|ⲭⲁⲣⲱ|ⲟⲩ
ⲛⲥⲉⲟⲩⲁϩⲥⲁϩⲛⲓ	ⲛ|ⲥⲉ|ⲟⲩⲁϩⲥⲁϩⲛⲓ
ⲙⲁⲣⲟⲩϭⲛⲉϫⲱⲟⲩ	ⲙⲁⲣ|ⲟⲩ|ϭⲛⲉϫⲱ|ⲟⲩ
ⲉⲧⲉⲡⲓⲕⲉⲛⲟⲙⲟⲥ	ⲉⲧⲉ|ⲡⲓ|ⲕⲉ|ⲛⲟⲙⲟⲥ
ⲥⲉⲟⲩⲱϣ	ⲥⲉ|ⲟⲩⲱϣ
ⲉⲟⲩϩⲱⲃ	ⲉ|ⲟⲩ|ϩⲱⲃ
ⲙⲁⲣⲟⲩϣⲉⲛ	ⲙⲁⲣ|ⲟⲩ|ϣⲉⲛ
ϧⲉⲛⲛⲟⲩⲏⲓ	ϧⲉⲛ|ⲛⲟⲩ|ⲏⲓ
ⲉⲧⲁⲡⲥⲁϫⲓ	ⲉⲧ|ⲁ|ⲡ|ⲥⲁϫⲓ
ⲙⲙⲁⲩⲁⲧⲉⲛⲑⲏⲛⲟⲩ	ⲙⲙⲁⲩⲁⲧⲉⲛ|ⲑⲏⲛⲟⲩ
ⲟⲩⲡⲛⲉⲩⲙⲁⲧⲓⲕⲟⲥ	ⲟⲩ|ⲡⲛⲉⲩⲙⲁⲧⲓⲕⲟⲥ
ⲙⲁⲣⲉϥⲉⲙⲓ	ⲙⲁⲣⲉ|ϥ|ⲉⲙⲓ
ⲉϯⲥϧⲁⲓ	ⲉ|ϯ|ⲥϧⲁⲓ
ϫⲉⲟⲩⲉⲛⲧⲟⲗⲏ	ϫⲉ|ⲟⲩ|ⲉⲛⲧⲟⲗⲏ
ⲉⲩⲕⲱⲧ	ⲉ|ⲩ|ⲕⲱⲧ
ⲉⲩⲑⲏϣ	ⲉ|ⲩ|ⲑⲏϣ
ⲛϫⲉⲡⲓⲥⲁⲃⲃⲁⲧⲟⲛ	ⲛϫⲉ|ⲡⲓ|ⲥⲁⲃⲃⲁⲧⲟⲛ
ⲁⲩϣⲱⲡ	ⲁ|ⲩ|ϣⲱⲡ
ⲛⲧⲟⲩⲑⲁϩⲥϥ	ⲛⲧ|ⲟⲩ|ⲑⲁϩⲥ|ϥ
ⲙⲫⲟⲩⲁⲓ	ⲙ|ⲫ|ⲟⲩⲁⲓ
ⲉⲡⲓⲙϩⲁⲩ	ⲉ|ⲡⲓ|ⲙϩⲁⲩ
ⲉⲧⲁⲫⲣⲏ	ⲉⲧ|ⲁ|ⲫ|ⲣⲏ
ϣⲁⲓ	ϣⲁⲓ
ⲉⲧⲛⲁⲥⲕⲉⲣⲕⲉⲣ	ⲉⲧ|ⲛⲁ|ⲥⲕⲉⲣⲕⲉⲣ
ϩⲓⲣⲱϥ	ϩⲓ|ⲣⲱ|ϥ
ⲉⲧⲁⲩϥⲁⲓ	ⲉⲧ|ⲁ|ⲩ|ϥⲁⲓ
ⲛⲛⲟⲩⲃⲁⲗ	ⲛ|ⲛⲟⲩ|ⲃⲁⲗ
ⲉⲡⲓⲱⲛⲓ	ⲉ|ⲡⲓ|ⲱⲛⲓ
ϫⲉⲁⲩⲥⲕⲉⲣⲕⲱⲣϥ	ϫⲉ|ⲁ|ⲩ|ⲥⲕⲉⲣⲕⲱⲣ|ϥ
ⲛⲉⲟⲩⲛⲓϣϯ	ⲛⲉ|ⲟⲩ|ⲛⲓϣϯ
ⲉⲟⲩϧⲉⲗϣⲓⲣⲓ	ⲉ|ⲟⲩ|ϧⲉⲗϣⲓⲣⲓ
ⲛⲟⲩⲥⲧⲟⲗⲏ	ⲛ|ⲟⲩ|ⲥⲧⲟⲗⲏ
ⲉⲥⲟⲩⲟⲃϣ	ⲉ|ⲥ|ⲟⲩⲟⲃϣ
ⲡⲉⲧⲉⲧⲉⲛⲕⲱϯ	ⲡ|ⲉⲧⲉ|ⲧⲉⲛ|ⲕⲱϯ
ⲉⲧⲁⲩⲁϣϥ	ⲉⲧ|ⲁ|ⲩ|ⲁϣ|ϥ
ϥϩⲁⲙⲛⲁⲓ	ϥ|ϩⲁ|ⲙⲛⲁⲓ
ⲛⲉⲙⲡⲉⲧⲣⲟⲥ	ⲛⲉⲙ|ⲡⲉⲧⲣⲟⲥ
ϫⲉϥⲛⲁⲉⲣϣⲟⲣⲡ	ϫⲉ|ϥ|ⲛⲁ|ⲉⲣϣⲟⲣⲡ
ⲁⲣⲉⲧⲉⲛⲛⲁⲛⲁⲩ	ⲁⲣⲉ|ⲧⲉⲛ|ⲛⲁ|ⲛⲁⲩ
ϩⲁⲡⲓⲙϩⲁⲩ	ϩⲁ|ⲡⲓ|ⲙϩⲁⲩ
ⲛⲉⲁⲟⲩⲥⲑⲉⲣⲧⲉⲣ	ⲛⲉ|ⲁ|ⲟⲩ|ⲥⲑⲉⲣⲧⲉⲣ
ⲧⲁϩⲱⲟⲩ	ⲧⲁϩⲱ|ⲟⲩ
ⲛⲉⲙⲟⲩⲧⲱⲙⲧ	ⲛⲉⲙ|ⲟⲩ|ⲧⲱⲙⲧ
ⲙⲡⲟⲩϫⲉϩⲗⲓ	ⲙⲡ|ⲟⲩ|ϫⲉ|ϩⲗⲓ
ⲛⲧⲉⲛⲓⲥⲁⲃⲃⲁⲧⲟⲛ	ⲛⲧⲉ|ⲛⲓ|ⲥⲁⲃⲃⲁⲧⲟⲛ
ⲁⲥϣⲉ	ⲁ|ⲥ|ϣⲉ
ⲁⲥϫⲟⲥ	ⲁ|ⲥ|ϫⲟ|ⲥ
ⲉⲛⲁⲩϣⲱⲡⲓ	ⲉ|ⲛⲁ|ⲩ|ϣⲱⲡⲓ
ϫⲉϥⲟⲛϧ	ϫⲉ|ϥ|ⲟⲛϧ
ϫⲉⲁⲛⲛⲁⲩ	ϫⲉ|ⲁ|ⲛ|ⲛⲁⲩ
ⲛⲁⲣⲉⲃ	ⲛⲁⲣⲉ|ⲃ
ϩⲓⲟⲩⲙⲱⲓⲧ	ϩⲓ|ⲟⲩ|ⲙⲱⲓⲧ
ϧⲉⲛⲕⲉⲙⲟⲣⲫⲏ	ϧⲉⲛ|ⲕⲉ|ⲙⲟⲣⲫⲏ
ⲛⲁⲓⲕⲉⲭⲱⲟⲩⲛⲓ	ⲛⲁⲓ|ⲕⲉ|ⲭⲱⲟⲩⲛⲓ
ⲛⲛⲓⲥⲱϫⲡ	ⲛ|ⲛⲓ|ⲥⲱϫⲡ
ⲙⲡⲟⲩⲛⲁϩϯ	ⲙⲡ|ⲟⲩ|ⲛⲁϩϯ
ⲛϫⲉⲡⲓⲓⲁ	ⲛϫⲉ|ⲡⲓ|ⲓⲁ
ⲙⲙⲁⲑⲏⲧⲏⲥ	ⲙ|ⲙⲁⲑⲏⲧⲏⲥ
ⲛⲁϥϯϣⲱϣ	ⲛⲁ|ϥ|ϯϣⲱϣ
ⲛⲧⲟⲩⲙⲉⲧⲁⲑⲛⲁϩϯ	ⲛ|ⲧⲟⲩ|ⲙⲉⲧⲁⲑⲛⲁϩϯ
ⲛⲉⲙⲧⲟⲩⲙⲉⲑⲛⲁϣⲧϩⲏⲧ	ⲛⲉⲙ|ⲧⲟⲩ|ⲙⲉⲑⲛⲁϣⲧϩⲏⲧ
ϫⲉⲙⲡⲟⲩⲛⲁϩϯ	ϫⲉ|ⲙⲡ|ⲟⲩ|ⲛⲁϩϯ
ϩⲓⲱⲓϣ	ϩⲓⲱⲓϣ
ⲉⲧⲁϥⲛⲁϩϯ	ⲉⲧ|ⲁ|ϥ|ⲛⲁϩϯ
ⲉⲧⲁϥϭⲓⲱⲙⲥ	ⲉⲧ|ⲁ|ϥ|ϭⲓⲱⲙⲥ
ⲉϥⲉⲛⲟϩⲉⲙ	ⲉϥⲉ|ⲛⲟϩⲉⲙ
ⲉⲧⲁϥⲉⲣⲁⲑⲛⲁϩϯ	ⲉⲧ|ⲁ|ϥ|ⲉⲣⲁⲑⲛⲁϩϯ
ⲛⲁⲓⲙⲏⲓⲛⲓ	ⲛⲁⲓ|ⲙⲏⲓⲛⲓ
ⲉⲩⲉϩⲓ	ⲉⲩⲉ|ϩⲓ
ϩⲁⲛⲇⲁⲓⲙⲱⲛ	ϩⲁⲛ|ⲇⲁⲓⲙⲱⲛ
ϧⲉⲛϩⲁⲛⲁⲥⲡⲓ	ϧⲉⲛ|ϩⲁⲛ|ⲁⲥⲡⲓ
ϩⲁⲛϩⲟϥ	ϩⲁⲛ|ϩⲟϥ
ⲉⲩⲉϥⲓⲧⲟⲩ	ⲉⲩⲉ|ϥⲓⲧ|ⲟⲩ
ϧⲉⲛⲛⲟⲩϫⲓϫ	ϧⲉⲛ|ⲛⲟⲩ|ϫⲓϫ
ⲁⲩϣⲁⲛⲟⲩⲱⲙ	ⲁⲩϣⲁⲛ|ⲟⲩⲱⲙ
ⲛⲟⲩⲉⲛⲭⲁⲓ	ⲛ|ⲟⲩ|ⲉⲛⲭⲁⲓ
ⲛⲛⲉϥⲉⲣⲃⲗⲁⲡⲧⲓⲛ	ⲛⲛⲉ|ϥ|ⲉⲣⲃⲗⲁⲡⲧⲓⲛ
ⲉⲩⲉⲭⲱ	ⲉⲩⲉ|ⲭⲱ
ⲛⲛⲟⲩϫⲓϫ	ⲛ|ⲛⲟⲩ|ϫⲓϫ
ⲉϫⲉⲛϩⲁⲛⲟⲩⲟⲛ	ⲉϫⲉⲛ|ϩⲁⲛ|ⲟⲩⲟⲛ
ⲉⲩϣⲱⲛⲓ	ⲉ|ⲩ|ϣⲱⲛⲓ
ⲉⲩⲉⲟⲩϫⲁⲓ	ⲉⲩⲉ|ⲟⲩϫⲁⲓ
ⲙⲉⲛⲉⲛⲥⲁⲑⲣⲉϥⲥⲁϫⲓ	ⲙⲉⲛⲉⲛⲥⲁ|ⲑⲣⲉ|ϥ|ⲥⲁϫⲓ
ⲛⲁⲣⲉⲡϭⲟⲓⲥ	ⲛⲁⲣⲉ|ⲡ|ϭⲟⲓⲥ
ⲉⲣϩⲱⲃ	ⲉⲣϩⲱⲃ
ⲉϥⲧⲁϫⲣⲟ	ⲉ|ϥ|ⲧⲁϫⲣⲟ
ⲛⲧⲉⲛⲓⲙⲏⲓⲛⲓ	ⲛⲧⲉ|ⲛⲓ|ⲙⲏⲓⲛⲓ
ⲉⲧⲙⲟϣⲓ	ⲉⲧ|ⲙⲟϣⲓ
ϫⲉϩⲁⲛⲁϣ	ϫⲉ|ϩⲁⲛ|ⲁϣ
ⲛⲁⲓⲱⲛⲓ	ⲛⲁⲓ|ⲱⲛⲓ
ϩⲁⲛⲕⲱⲧ	ϩⲁⲛ|ⲕⲱⲧ
ⲉⲛⲁⲓⲛⲓϣϯ	ⲉ|ⲛⲁⲓ|ⲛⲓϣϯ
ⲛⲱⲛⲓ	ⲛ|ⲱⲛⲓ
ⲛⲛⲟⲩⲭⲁⲟⲩⲱⲛⲓ	ⲛⲛ|ⲟⲩ|ⲭⲁ|ⲟⲩ|ⲱⲛⲓ
ⲉϫⲉⲛⲟⲩⲱⲛⲓ	ⲉϫⲉⲛ|ⲟⲩ|ⲱⲛⲓ
ⲛⲥⲉⲛⲁⲃⲟⲗϥ	ⲛ|ⲥⲉ|ⲛⲁ|ⲃⲟⲗ|ϥ
ϩⲓϫⲉⲛⲡⲓⲧⲱⲟⲩ	ϩⲓϫⲉⲛ|ⲡⲓ|ⲧⲱⲟⲩ
ⲙⲡⲓⲉⲣⲫⲉⲓ	ⲙ|ⲡⲓ|ⲉⲣⲫⲉⲓ
ⲛⲥⲁⲡⲥⲁ	ⲛⲥⲁ|ⲡ|ⲥⲁ
ⲛⲉⲙⲁⲛⲇⲣⲉⲁⲥ	ⲛⲉⲙ|ⲁⲛⲇⲣⲉⲁⲥ
ϫⲉⲁϫⲟⲥ	ϫⲉ|ⲁϫⲟ|ⲥ
ⲛⲧⲛⲁⲩ	ⲛ|ⲧ|ⲛⲁⲩ
ⲡⲓⲙⲏⲓⲛⲓ	ⲡⲓ|ⲙⲏⲓⲛⲓ
ⲁⲣⲉϣⲁⲛⲛⲁⲓ	ⲁⲣⲉϣⲁⲛ|ⲛⲁⲓ
ⲛⲟⲩⲓ	ⲛ|ⲟⲩⲓ
ⲥⲉⲣⲉⲙⲑⲏⲛⲟⲩ	ⲥⲉⲣⲉⲙ|ⲑⲏⲛⲟⲩ
ⲥⲉⲛⲁⲥⲉⲣⲉⲙⲟⲩⲙⲏϣ	ⲥⲉ|ⲛⲁ|ⲥⲉⲣⲉⲙ|ⲟⲩ|ⲙⲏϣ
ⲁⲣⲉⲧⲉⲛϣⲁⲛⲥⲱⲧⲉⲙ	ⲁⲣⲉⲧⲉⲛϣⲁⲛ|ⲥⲱⲧⲉⲙ
ⲉϩⲁⲛⲡⲟⲗⲉⲙⲟⲥ	ⲉ|ϩⲁⲛ|ⲡⲟⲗⲉⲙⲟⲥ
ⲛⲉⲙϩⲁⲛⲥⲙⲏ	ⲛⲉⲙ|ϩⲁⲛ|ⲥⲙⲏ
ⲙⲡⲣϣⲑⲟⲣⲧⲉⲣ	ⲙⲡⲣ|ϣⲑⲟⲣⲧⲉⲣ
ⲛⲧⲟⲩϣⲱⲡⲓ	ⲛⲧ|ⲟⲩ|ϣⲱⲡⲓ
ⲙⲡⲁⲧϥⲓ	ⲙⲡⲁⲧ|ϥ|ⲓ
ⲛϫⲉⲡⲓϫⲱⲕ	ⲛϫⲉ|ⲡⲓ|ϫⲱⲕ
ⲉϥⲉⲧⲱⲛϥ	ⲉϥⲉ|ⲧⲱⲛ|ϥ
ⲛϫⲉⲟⲩⲉⲑⲛⲟⲥ	ⲛϫⲉ|ⲟⲩ|ⲉⲑⲛⲟⲥ
ⲉϫⲉⲛⲟⲩⲉⲑⲛⲟⲥ	ⲉϫⲉⲛ|ⲟⲩ|ⲉⲑⲛⲟⲥ
ⲟⲩⲙⲉⲧⲟⲩⲣⲟ	ⲟⲩ|ⲙⲉⲧⲟⲩⲣⲟ
ⲉϫⲉⲛⲟⲩⲙⲉⲧⲟⲩⲣⲟ	ⲉϫⲉⲛ|ⲟⲩ|ⲙⲉⲧⲟⲩⲣⲟ
ⲛϫⲉϩⲁⲛⲙⲟⲛⲙⲉⲛ	ⲛϫⲉ|ϩⲁⲛ|ⲙⲟⲛⲙⲉⲛ
ⲕⲁⲧⲁⲙⲁ	ⲕⲁⲧⲁ|ⲙⲁ
ⲛϫⲉϩⲁⲛϩⲃⲱⲛ	ⲛϫⲉ|ϩⲁⲛ|ϩⲃⲱⲛ
ϩⲏ	ϩⲏ
ⲛⲛⲓⲛⲁⲕϩⲓ	ⲛ|ⲛⲓ|ⲛⲁⲕϩⲓ
ⲥⲉⲛⲁϯⲑⲏⲛⲟⲩ	ⲥⲉ|ⲛⲁ|ϯ|ⲑⲏⲛⲟⲩ
ⲉϩⲁⲛⲙⲁ	ⲉ|ϩⲁⲛ|ⲙⲁ
ⲥⲉⲛⲁϩⲓⲟⲩⲓ	ⲥⲉ|ⲛⲁ|ϩⲓⲟⲩⲓ
ⲛⲧⲟⲩⲧⲁϩⲱⲧⲉⲛ	ⲛⲧ|ⲟⲩ|ⲧⲁϩⲱ|ⲧⲉⲛ
ⲛⲁϩⲣⲉⲛϩⲁⲛϩⲏⲅⲉⲙⲱⲛ	ⲛⲁϩⲣⲉⲛ|ϩⲁⲛ|ϩⲏⲅⲉⲙⲱⲛ
ⲛⲉⲙϩⲁⲛⲟⲩⲣⲱⲟⲩ	ⲛⲉⲙ|ϩⲁⲛ|ⲟⲩⲣⲱⲟⲩ
ⲛⲧⲟⲩϩⲓⲱⲓϣ	ⲛⲧ|ⲟⲩ|ϩⲓⲱⲓϣ
ⲙⲡⲣⲉⲣ=ϣⲟⲣⲡ	ⲙⲡⲣ|ⲉⲣ=ϣⲟⲣⲡ
ⲛϥⲓⲣⲱⲟⲩϣ	ⲛ|ϥⲓⲣⲱⲟⲩϣ
ⲡⲉⲧⲉⲧⲉⲛⲛⲁⲥⲁϫⲓ	ⲡ|ⲉⲧⲉ|ⲧⲉⲛ|ⲛⲁ|ⲥⲁϫⲓ
ⲡⲉⲧⲟⲩⲛⲁⲧⲏⲓϥ	ⲡ|ⲉⲧ|ⲟⲩ|ⲛⲁ|ⲧⲏⲓ|ϥ
ⲡⲉⲧⲛⲁⲥⲁϫⲓ	ⲡ|ⲉⲧ|ⲛⲁ|ⲥⲁϫⲓ
ⲉⲣⲉⲟⲩⲥⲟⲛ	ⲉⲣⲉ|ⲟⲩ|ⲥⲟⲛ
ϯⲛⲟⲩⲥⲟⲛ	ϯ|ⲛⲟⲩ|ⲥⲟⲛ
ⲉⲣⲉⲟⲩⲉⲓⲱⲧ	ⲉⲣⲉ|ⲟⲩ|ⲉⲓⲱⲧ
ⲉϥⲉϯ	ⲉϥⲉ|ϯ
ⲛⲟⲩϣⲏⲣⲓ	ⲛ|ⲟⲩ|ϣⲏⲣⲓ
ⲥⲉⲛⲁⲧⲱⲟⲩⲛⲟⲩ	ⲥⲉ|ⲛⲁ|ⲧⲱⲟⲩⲛ|ⲟⲩ
ⲛϫⲉϩⲁⲛϣⲏⲣⲓ	ⲛϫⲉ|ϩⲁⲛ|ϣⲏⲣⲓ
ⲉϫⲉⲛϩⲁⲛⲓⲟϯ	ⲉϫⲉⲛ|ϩⲁⲛ|ⲓⲟϯ
ⲥⲉⲛⲁϧⲟⲑⲃⲟⲩ	ⲥⲉ|ⲛⲁ|ϧⲟⲑⲃ|ⲟⲩ
ⲉⲣⲉⲧⲉⲛⲉϣⲱⲡⲓ	ⲉⲣⲉⲧⲉⲛⲉ|ϣⲱⲡⲓ
ⲉⲩⲙⲟⲥϯ	ⲉ|ⲩ|ⲙⲟⲥϯ
ⲉⲑⲃⲉⲡⲁⲣⲁⲛ	ⲉⲑⲃⲉ|ⲡⲁ|ⲣⲁⲛ
ⲉⲧⲛⲁⲁⲙⲟⲛⲓ	ⲉⲧ|ⲛⲁ|ⲁⲙⲟⲛⲓ
ⲉⲧⲛⲁⲛⲟϩⲉⲙ	ⲉⲧ|ⲛⲁ|ⲛⲟϩⲉⲙ
ⲉⲡⲓⲥⲱϥ	ⲉ|ⲡⲓ|ⲥⲱϥ
ⲛⲧⲉⲡⲓϣⲱϥ	ⲛⲧⲉ|ⲡⲓ|ϣⲱϥ
ⲉⲧⲉⲥϣⲉ	ⲉⲧⲉ|ⲥϣⲉ
ⲙⲁⲣⲉϥⲕⲁϯ	ⲙⲁⲣⲉ|ϥ|ⲕⲁϯ
ϧⲉⲛϯⲓⲟⲩⲇⲉⲁ	ϧⲉⲛ|ϯ|ⲓⲟⲩⲇⲉⲁ
ⲙⲁⲣⲟⲩⲫⲱⲧ	ⲙⲁⲣ|ⲟⲩ|ⲫⲱⲧ
ⲉϫⲉⲛⲛⲓⲧⲱⲟⲩ	ⲉϫⲉⲛ|ⲛⲓ|ⲧⲱⲟⲩ
ⲉⲧϩⲓϫⲉⲛⲡϫⲉⲛⲉⲫⲱⲣ	ⲉⲧ|ϩⲓϫⲉⲛ|ⲡ|ϫⲉⲛⲉⲫⲱⲣ
ⲙⲡⲉⲛⲑⲣⲉϥⲓ	ⲙⲡⲉⲛⲑⲣⲉ|ϥ|ⲓ
ⲙⲡⲉⲛⲑⲣⲉϥϣⲉ	ⲙⲡⲉⲛⲑⲣⲉ|ϥ|ϣⲉ
ⲉⲉⲗϩⲗⲓ	ⲉ|ⲉⲗ|ϩⲗⲓ
ⲉⲧϧⲉⲛⲧⲕⲟⲓ	ⲉⲧ|ϧⲉⲛ|ⲧ|ⲕⲟⲓ
ⲉⲫⲁϩⲟⲩ	ⲉ|ⲫⲁϩⲟⲩ
ⲉⲉⲗⲡⲉϥϩⲃⲟⲥ	ⲉ|ⲉⲗ|ⲡⲉϥ|ϩⲃⲟⲥ
ⲟⲩⲟⲩⲟⲓ	ⲟⲩⲟⲩⲟⲓ
ⲉⲧⲉⲙⲃⲟⲕⲓ	ⲉⲧⲉ|ⲙ|ⲃⲟⲕⲓ
ⲉⲧϯϭⲓ	ⲉⲧ|ϯϭⲓ
ϧⲉⲛⲧⲫⲣⲱ	ϧⲉⲛ|ⲧ|ⲫⲣⲱ
ⲛϫⲉⲡⲉⲧⲉⲛⲫⲱⲧ	ⲛϫⲉ|ⲡⲉⲧⲉⲛ|ⲫⲱⲧ
ϩⲟϫϩⲉϫ	ϩⲟϫϩⲉϫ
ⲙⲡⲉⲟⲩⲟⲛ	ⲙⲡⲉ|ⲟⲩⲟⲛ
ⲓⲥϫⲉⲛϩⲏ	ⲓⲥϫⲉⲛ|ϩⲏ
ⲉⲧⲁϥⲥⲟⲛⲧϥ	ⲉⲧ|ⲁ|ϥ|ⲥⲟⲛⲧ|ϥ
ⲛⲛⲉⲟⲩⲟⲛ	ⲛⲛⲉ|ⲟⲩⲟⲛ
ⲉⲛⲉ	ⲉⲛⲉ
ⲙⲡⲉⲡϭⲟⲓⲥ	ⲙⲡⲉ|ⲡ|ϭⲟⲓⲥ
ⲉⲑⲣⲉⲛⲓⲉϩⲟⲟⲩ	ⲉⲑⲣⲉ|ⲛⲓ|ⲉϩⲟⲟⲩ
ⲛⲁⲩⲛⲁⲛⲟϩⲉⲙ	ⲛⲁ|ⲩ|ⲛⲁ|ⲛⲟϩⲉⲙ
ⲛϫⲉⲥⲁⲣⲝ	ⲛϫⲉ|ⲥⲁⲣⲝ
ⲉⲑⲃⲉⲛⲓⲥⲱⲧⲡ	ⲉⲑⲃⲉ|ⲛⲓ|ⲥⲱⲧⲡ
ⲉⲧⲁϥⲥⲟⲧⲡⲟⲩ	ⲉⲧ|ⲁ|ϥ|ⲥⲟⲧⲡ|ⲟⲩ
ⲁϥϫⲉϫⲉⲃ	ⲁ|ϥ|ϫⲉϫⲉⲃ
ⲛⲓⲉϩⲟⲟⲩ	ⲛⲓ|ⲉϩⲟⲟⲩ
ϩⲁⲙⲛⲏ	ϩⲁ|ⲙⲛⲏ
ⲙⲡⲣⲛⲁϩϯ	ⲙⲡⲣ|ⲛⲁϩϯ
ⲛϫⲉϩⲁⲛⲭⲣⲓⲥⲧⲟⲥ	ⲛϫⲉ|ϩⲁⲛ|ⲭⲣⲓⲥⲧⲟⲥ
ⲛⲉⲙϩⲁⲛⲡⲣⲟⲫⲏⲧⲏⲥ	ⲛⲉⲙ|ϩⲁⲛ|ⲡⲣⲟⲫⲏⲧⲏⲥ
ⲛⲧⲟⲩϯ	ⲛⲧ|ⲟⲩ|ϯ
ⲛⲉⲙϩⲁⲛϣⲫⲏⲣⲓ	ⲛⲉⲙ|ϩⲁⲛ|ϣⲫⲏⲣⲓ
ⲉⲡϫⲓⲛⲥⲱⲣⲉⲙ	ⲉ|ⲡ|ϫⲓⲛⲥⲱⲣⲉⲙ
ⲁⲩϣⲁⲛϣϫⲉⲙϫⲟⲙ	ⲁⲩϣⲁⲛ|ϣϫⲉⲙϫⲟⲙ
ⲛⲛⲓⲕⲉⲥⲱⲧⲡ	ⲛ|ⲛⲓ|ⲕⲉ|ⲥⲱⲧⲡ
ϫⲉⲁⲓⲉⲣϣⲟⲣⲡ	ϫⲉ|ⲁ|ⲓ|ⲉⲣϣⲟⲣⲡ
ⲛϫⲉϩⲱⲃ	ⲛϫⲉ|ϩⲱⲃ
ⲙⲉⲛⲉⲛⲥⲁⲡϩⲟϫϩⲉϫ	ⲙⲉⲛⲉⲛⲥⲁ|ⲡ|ϩⲟϫϩⲉϫ
ⲡⲓⲣⲏ	ⲡⲓ|ⲣⲏ
ⲉϥⲉⲉⲣⲭⲁⲕⲓ	ⲉϥⲉ|ⲉⲣⲭⲁⲕⲓ
ⲛⲛⲉϥϯ	ⲛⲛⲉ|ϥ|ϯ
ⲙⲡⲉϥⲟⲩⲱⲓⲛⲓ	ⲙ|ⲡⲉϥ|ⲟⲩⲱⲓⲛⲓ
ⲛⲓⲥⲓⲟⲩ	ⲛⲓ|ⲥⲓⲟⲩ
ⲉⲩϩⲓⲱⲟⲩⲧ	ⲉ|ⲩ|ϩⲓⲱⲟⲩⲧ
ⲛⲧⲉⲛⲓⲫⲏⲟⲩⲓ	ⲛⲧⲉ|ⲛⲓ|ⲫⲏⲟⲩⲓ
ⲉⲩⲉⲕⲓⲙ	ⲉⲩⲉ|ⲕⲓⲙ
ϧⲉⲛϩⲁⲛϭⲏⲡⲓ	ϧⲉⲛ|ϩⲁⲛ|ϭⲏⲡⲓ
ϥⲛⲁⲟⲩⲱⲣⲡ	ϥ|ⲛⲁ|ⲟⲩⲱⲣⲡ
ⲛⲛⲉϥⲁⲅⲅⲉⲗⲟⲥ	ⲛ|ⲛⲉϥ|ⲁⲅⲅⲉⲗⲟⲥ
ϥⲛⲁⲑⲱⲟⲩϯ	ϥ|ⲛⲁ|ⲑⲱⲟⲩϯ
ⲛⲛⲉϥⲥⲱⲧⲡ	ⲛ|ⲛⲉϥ|ⲥⲱⲧⲡ
ϧⲉⲛⲡⲓϥⲧⲟⲩ	ϧⲉⲛ|ⲡⲓ|ϥⲧⲟⲩ
ⲑⲏⲟⲩ	ⲑⲏⲟⲩ
ⲓⲥϫⲉⲛⲁⲩⲣⲏϫϥ	ⲓⲥϫⲉⲛ|ⲁⲩⲣⲏϫ|ϥ
ⲙⲡⲕⲁϩⲓ	ⲙ|ⲡ|ⲕⲁϩⲓ
ⲉϯⲡⲁⲣⲟⲃⲟⲗⲏ	ⲉ|ϯ|ⲡⲁⲣⲟⲃⲟⲗⲏ
ⲛⲧⲉⲛⲉⲥϫⲁⲗ	ⲛⲧⲉ|ⲛⲉⲥ|ϫⲁⲗ
ϭⲛⲟⲛ	ϭⲛⲟⲛ
ⲛⲧⲉⲥϩⲓϫⲱⲃⲓ	ⲛⲧⲉ|ⲥ|ϩⲓϫⲱⲃⲓ
ϣⲁⲣⲉⲧⲉⲛⲉⲙⲓ	ϣⲁⲣⲉ|ⲧⲉⲛ|ⲉⲙⲓ
ϫⲉϥϧⲉⲛⲧ	ϫⲉ|ϥ|ϧⲉⲛⲧ
ⲛϫⲉⲡⲓϣⲱⲙ	ⲛϫⲉ|ⲡⲓ|ϣⲱⲙ
ⲁⲣⲉⲧⲉⲛϣⲁⲛⲛⲁⲩ	ⲁⲣⲉⲧⲉⲛϣⲁⲛ|ⲛⲁⲩ
ⲉⲁⲩϣⲱⲡⲓ	ⲉ|ⲁ|ⲩ|ϣⲱⲡⲓ
ϫⲉϥϧⲱⲛⲧ	ϫⲉ|ϥ|ϧⲱⲛⲧ
ⲉⲛⲓⲣⲱⲟⲩ	ⲉ|ⲛⲓ|ⲣⲱⲟⲩ
ϫⲉⲛⲛⲉⲧⲁⲓⲅⲉⲛⲉⲁ	ϫⲉ|ⲛⲛⲉ|ⲧⲁⲓ|ⲅⲉⲛⲉⲁ
ϣⲁⲧⲉⲛⲁⲓ	ϣⲁⲧⲉ|ⲛⲁⲓ
ⲛⲉⲙⲡⲓⲕⲁϩⲓ	ⲛⲉⲙ|ⲡⲓ|ⲕⲁϩⲓ
ⲛⲁⲥⲁϫⲓ	ⲛⲁ|ⲥⲁϫⲓ
ⲛⲛⲟⲩⲥⲓⲛⲓ	ⲛⲛ|ⲟⲩ|ⲥⲓⲛⲓ
ⲉⲑⲃⲉⲡⲓⲉϩⲟⲟⲩ	ⲉⲑⲃⲉ|ⲡⲓ|ⲉϩⲟⲟⲩ
ⲛⲉⲙϯⲟⲩⲛⲟⲩ	ⲛⲉⲙ|ϯ|ⲟⲩⲛⲟⲩ
ⲁⲅⲅⲉⲗⲟⲥ	ⲁⲅⲅⲉⲗⲟⲥ
ⲉⲫⲓⲱⲧ	ⲉ|ⲫ|ⲓⲱⲧ
ϫⲉⲧⲛⲁⲩ	ϫⲉ|ⲧ|ⲛⲁⲩ
ⲡⲓⲥⲏⲟⲩ	ⲡⲓ|ⲥⲏⲟⲩ
ⲉⲁϥⲙⲟϣⲓ	ⲉ|ⲁ|ϥ|ⲙⲟϣⲓ
ⲉⲁϥⲭⲱ	ⲉ|ⲁ|ϥ|ⲭⲱ
ⲛⲛⲉϥⲉⲃⲓⲁⲓⲕ	ⲛ|ⲛⲉϥ|ⲉⲃⲓⲁⲓⲕ
ⲙⲡⲓⲉⲣϣⲓϣⲓ	ⲙ|ⲡⲓ|ⲉⲣϣⲓϣⲓ
ⲙⲡⲉϥϩⲱⲃ	ⲙ|ⲡⲉϥ|ϩⲱⲃ
ⲙⲡⲓⲉⲙⲛⲟⲩⲧ	ⲙ|ⲡⲓ|ⲉⲙⲛⲟⲩⲧ
ⲛⲧⲉϥⲣⲱⲓⲥ	ⲛⲧⲉ|ϥ|ⲣⲱⲓⲥ
ϫⲉⲁⲣⲉⲡϭⲟⲓⲥ	ϫⲉ|ⲁⲣⲉ|ⲡ|ϭⲟⲓⲥ
ⲙⲡⲓⲏⲓ	ⲙ|ⲡⲓ|ⲏⲓ
ϩⲁⲛⲁⲣⲟⲩϩⲓ	ϩⲁ|ⲛⲁ|ⲣⲟⲩϩⲓ
ⲧⲫⲁϣⲓ	ⲧ|ⲫⲁϣⲓ
ⲉⲣⲉⲡⲓⲁⲗⲉⲕⲧⲱⲣ	ⲉⲣⲉ|ⲡⲓ|ⲁⲗⲉⲕⲧⲱⲣ
ϩⲁⲛⲁⲧⲟⲟⲩⲓ	ϩⲁ|ⲛⲁ|ⲧⲟⲟⲩⲓ
ⲛⲧⲉϥϫⲉⲙⲑⲏⲛⲟⲩ	ⲛⲧⲉ|ϥ|ϫⲉⲙ|ⲑⲏⲛⲟⲩ
ⲉⲣⲉⲧⲉⲛⲛⲕⲟⲧ	ⲉⲣⲉ|ⲧⲉⲛ|ⲛⲕⲟⲧ
ⲡⲉⲧⲓϫⲱ	ⲡ|ⲉⲧ|ⲓ|ϫⲱ
