ⲙⲡⲉⲕⲥⲱⲧⲙ	ⲙⲡⲉ|ⲕ|ⲥⲱⲧⲙ	ⲙ|ⲡⲉⲕ|ⲥⲱⲧⲙ
ⲙⲙⲟⲛ	ⲙⲙⲟ|ⲛ	ⲙⲙⲟⲛ
ⲉⲧⲃⲏⲏⲧ	ⲉⲧⲃⲏⲏⲧ	ⲉⲧⲃⲏⲏ|ⲧ
ⲛⲧⲉϯⲉⲟⲟⲩ	ⲛ|ⲧⲉ|ϯⲉⲟⲟⲩ	ⲛⲧⲉ|ϯ|ⲉⲟⲟⲩ
ⲛϩⲏⲧ	ⲛ|ϩⲏⲧ	ⲛϩⲏⲧ
ⲛⲉ	ⲛⲉ	ⲛ|ⲉ
ⲉⲧⲱ	ⲉ|ⲧⲱ	ⲉⲧⲱ
ⲛⲁⲓ	ⲛⲁ|ⲓ	ⲛⲁⲓ
ⲛϩⲏⲧϥ	ⲛϩⲏⲧ|ϥ	ⲛ|ϩⲏⲧ|ϥ
ⲛⲉⲛⲧⲁⲓϫⲟⲟⲩ	ⲛ|ⲉⲛⲧ|ⲁ|ⲓ|ϫⲟⲟⲩ	ⲛ|ⲉⲛⲧ|ⲁ|ⲓ|ϫⲟⲟ|ⲩ
ⲛⲁⲩ	ⲛⲁ|ⲩ	ⲛⲁⲩ
ⲉⲣⲱⲧⲛ	ⲉⲣⲱ|ⲧⲛ	ⲉⲣⲱⲧ|ⲛ
ⲛϩⲟⲩⲛ	ⲛϩⲟⲩⲛ	ⲛ|ϩⲟⲩⲛ
ϣⲁϩⲟⲩⲛ	ϣⲁ|ϩⲟⲩⲛ	ϣⲁϩⲟⲩⲛ
ⲉⲡⲉⲕⲉⲣⲁⲥⲙⲟⲥ	ⲉ|ⲡⲉⲕ|ⲉⲣⲁⲥⲙⲟⲥ	ⲉ|ⲡ|ⲉⲕⲉⲣⲁⲥⲙⲟⲥ
ϩⲓϩⲏ	ϩⲓϩⲏ	ϩⲓ|ϩⲏ
ⲛⲧⲉⲧⲛ	ⲛⲧⲉⲧⲛ	ⲛ|ⲧⲉⲧⲛ
ⲙⲡⲧⲏⲣϥ	ⲙ|ⲡ|ⲧⲏⲣϥ	ⲙ|ⲡ|ⲧⲏⲣ|ϥ
ⲙⲡϣⲁ	ⲙⲡϣⲁ	ⲙ|ⲡ|ϣⲁ
ⲛⲥⲁⲃⲟⲗ	ⲛⲥⲁ|ⲃⲟⲗ	ⲛⲥⲁⲃⲟⲗ
ⲉⲧⲉϣϣⲉ	ⲉⲧ|ⲉϣϣⲉ	ⲉⲧⲉ|ϣϣⲉ
ⲙⲉ	ⲙⲉ	ⲙ|ⲉ
ⲁⲣⲓϩⲟⲧⲉ	ⲁⲣⲓ|ϩⲟⲧⲉ	ⲁⲣⲓϩⲟⲧⲉ
ⲛⲧⲟ	ⲛⲧⲟ	ⲛ|ⲧⲟ
ⲛⲧⲁⲛⲁⲓ	ⲛⲧⲁ|ⲛⲁⲓ	ⲛ|ⲧ|ⲁⲛⲁⲓ	ⲛⲧ|ⲁ|ⲛⲁⲓ
ⲛⲥⲁϥ	ⲛ|ⲥⲁϥ	ⲛⲥⲁ|ϥ
ⲛⲑⲁⲗⲁⲥⲥⲁ	ⲛ|ⲑⲁⲗⲁⲥⲥⲁ	ⲛⲑⲁⲗⲁⲥⲥⲁ
ⲉⲩⲟ	ⲉ|ⲩ|ⲟ	ⲉⲩ|ⲟ
ⲉⲩⲉⲓ	ⲉ|ⲩ|ⲉⲓ	ⲉ|ⲩⲉⲓ
ⲉϫⲱ	ⲉ|ϫⲱ	ⲉϫⲱ
ⲉⲧⲙⲉ	ⲉⲧ|ⲙⲉ	ⲉ|ⲧ|ⲙⲉ
ⲛⲧⲟⲟⲧⲟⲩ	ⲛⲧⲟⲟⲧ|ⲟⲩ	ⲛ|ⲧⲟⲟⲧ|ⲟⲩ
ⲛⲁⲕ	ⲛⲁ|ⲕ	ⲛⲁⲕ
ⲛϩⲟⲩⲟ	ⲛ|ϩⲟⲩⲟ	ⲛϩⲟⲩⲟ
ⲉⲡⲉⲥⲏⲧ	ⲉ|ⲡ|ⲉⲥⲏⲧ	ⲉ|ⲡⲉⲥⲏⲧ	ⲉⲡⲉⲥⲏⲧ	ⲉ|ⲡⲉ|ⲥⲏⲧ
ϫⲉϩⲛⲧⲉⲩⲛⲟⲩ	ϫⲉ|ϩⲛ|ⲧ|ⲉⲩⲛⲟⲩ	ϫⲉ|ϩⲛ|ⲧⲉ|ⲩⲛⲟⲩ
ⲛⲧϭⲟⲙ	ⲛ|ⲧ|ϭⲟⲙ	ⲛ|ⲧϭⲟⲙ
ⲛⲕⲉⲥⲟⲡ	ⲛ|ⲕⲉ|ⲥⲟⲡ	ⲛ|ⲕⲉⲥⲟⲡ
ⲉⲩϣⲟⲟⲡ	ⲉ|ⲩ|ϣⲟⲟⲡ	ⲉ|ⲩϣⲟⲟⲡ
ⲉⲙⲙⲟⲛ	ⲉⲙⲙⲟⲛ	ⲉ|ⲙⲙⲟⲛ	ⲉⲙⲙⲟ|ⲛ
ⲛⲧⲉⲛⲁⲣⲭⲱⲛ	ⲛⲧⲉ|ⲛ|ⲁⲣⲭⲱⲛ	ⲛ|ⲧⲉⲛ|ⲁⲣⲭⲱⲛ
ⲛⲧⲛⲃⲱⲕ	ⲛ|ⲧⲛ|ⲃⲱⲕ	ⲛ|ⲧⲛⲃⲱⲕ
ϣⲁⲥⲃⲱⲕ	ϣⲁ|ⲥ|ⲃⲱⲕ	ϣⲁ|ⲥⲃⲱⲕ
ϫⲉⲉⲧⲉⲧⲛϣⲁⲛⲃⲱⲕ	ϫⲉ|ⲉⲧⲉⲧⲛϣⲁⲛ|ⲃⲱⲕ	ϫⲉ|ⲉⲧⲉⲧⲛϣⲁⲛⲃⲱⲕ
ⲛϥⲃⲱⲕ	ⲛ|ϥ|ⲃⲱⲕ	ⲛ|ϥⲃⲱⲕ
ⲙⲡⲧⲟⲩⲛⲉⲥⲣⲉϥⲙⲟⲟⲩⲧ	ⲙ|ⲡⲧⲟⲩⲛⲉⲥ|ⲣⲉϥⲙⲟⲟⲩⲧ	ⲙ|ⲡ|ⲧⲟⲩⲛⲉⲥⲣⲉϥⲙⲟⲟⲩⲧ
ⲛⲕⲁ	ⲛⲕⲁ	ⲛ|ⲕⲁ
ⲧⲁϩⲉ	ⲧⲁϩⲉ	ⲧⲁ|ϩⲉ
ⲉⲃⲱⲗ	ⲉ|ⲃⲱⲗ	ⲉⲃⲱⲗ
ⲁⲓⲟ	ⲁ|ⲓ|ⲟ	ⲁⲓⲟ
ⲛⲧⲙⲡⲁϫⲟⲉⲓⲥ	ⲛ|ⲧⲙ|ⲡⲁ|ϫⲟⲉⲓⲥ	ⲛⲧⲙ|ⲡⲁ|ϫⲟⲉⲓⲥ
ⲛⲧⲁⲕⲁⲁⲕ	ⲛⲧ|ⲁ|ⲕ|ⲁⲁ|ⲕ	ⲛⲧ|ⲁ|ⲕⲁⲁ|ⲕ
ⲉϣⲱⲡⲉ	ⲉϣⲱⲡⲉ	ⲉ|ϣⲱⲡⲉ
ⲕⲁⲧⲁⲕⲣⲓⲛⲉ	ⲕⲁⲧⲁⲕⲣⲓⲛⲉ	ⲕⲁⲧⲁ|ⲕⲣⲓⲛⲉ
ⲉⲧϩⲟⲗϭ	ⲉⲧ|ϩⲟⲗϭ	ⲉ|ⲧ|ϩⲟⲗϭ
ⲙⲙⲟⲟⲩ	ⲙⲙⲟ|ⲟⲩ	ⲙ|ⲙⲟⲟⲩ
ⲙⲡⲣⲧⲣⲉⲗⲁⲁⲩ	ⲙⲡⲣⲧⲣⲉ|ⲗⲁⲁⲩ	ⲙⲡⲣ|ⲧⲣⲉ|ⲗⲁⲁⲩ
ϩⲁⲡⲁⲝ	ϩⲁⲡⲁⲝ	ϩⲁ|ⲡⲁⲝ
ⲛⲛϭⲓⲛⲟⲩⲟⲟⲙ	ⲛ|ⲛ|ϭⲓⲛⲟⲩⲟⲟⲙ	ⲛ|ⲛϭⲓ|ⲛ|ⲟⲩⲟⲟⲙ
ⲛⲁⲛⲟⲩ	ⲛⲁ|ⲛⲟⲩ	ⲛⲁⲛⲟⲩ
ⲉⲥⲏⲡ	ⲉⲥⲏⲡ	ⲉ|ⲥ|ⲏⲡ
ⲉⲡⲉⲧⲏⲣϥ	ⲉ|ⲡ|ⲉ|ⲧⲏⲣ|ϥ	ⲉ|ⲡⲉ|ⲧⲏⲣ|ϥ
ⲉⲁⲩⲧⲁⲁϥ	ⲉ|ⲁⲩ|ⲧⲁⲁ|ϥ	ⲉ|ⲁ|ⲩ|ⲧⲁⲁ|ϥ
ⲛⲥⲱⲣⲙ	ⲛ|ⲥⲱⲣⲙ	ⲛ|ⲥ|ⲱⲣⲙ
ϣⲁϩⲣⲁⲓ	ϣⲁϩⲣⲁⲓ	ϣⲁ|ϩⲣⲁⲓ
ⲛϩⲧⲏϥ	ⲛ|ϩⲧⲏ|ϥ	ⲛϩⲧⲏ|ϥ
ⲟⲩⲉⲓⲛⲉ	ⲟⲩⲉⲓⲛⲉ	ⲟⲩ|ⲉⲓⲛⲉ
ϣⲁⲃⲟⲗ	ϣⲁⲃⲟⲗ	ϣⲁ|ⲃⲟⲗ
ⲛⲉⲧⲛⲙⲉⲉⲩⲉ	ⲛ|ⲉⲧ|ⲛ|ⲙⲉⲉⲩⲉ	ⲛⲉⲧⲛ|ⲙⲉⲉⲩⲉ
ⲙⲙⲏⲛⲉ	ⲙ|ⲙⲏⲛⲉ	ⲙⲙⲏⲛⲉ
ⲛⲧⲕⲁⲥ	ⲛ|ⲧ|ⲕⲁⲥ	ⲛ|ⲧⲕⲁⲥ
ⲁⲩⲉⲓⲥ	ⲁⲩⲉⲓ|ⲥ	ⲁ|ⲩ|ⲉⲓⲥ	ⲁⲩⲉⲓⲥ
ⲛⲧⲁϥ	ⲛⲧⲁ|ϥ	ⲛⲧ|ⲁ|ϥ
ⲡⲉⲧⲛⲁϣⲛϩⲧⲏϥ	ⲡ|ⲉⲧ|ⲛⲁ|ϣⲛ|ϩⲧⲏ|ϥ	ⲡ|ⲉⲧ|ⲛⲁ|ϣ|ⲛ|ϩⲧⲏϥ
ϫⲉⲁⲙⲏⲓⲧⲛ	ϫⲉ|ⲁⲙⲏⲓⲧⲛ	ϫⲉ|ⲁⲙⲏⲓ|ⲧⲛ
ⲙⲛⲡⲉⲧⲛⲁⲛⲟⲩϥ	ⲙ|ⲛ|ⲡⲉⲧⲛⲁⲛⲟⲩϥ	ⲙⲛ|ⲡⲉⲧⲛⲁⲛⲟⲩϥ
ⲛⲥⲱϣ	ⲛ|ⲥⲱϣ	ⲛ|ⲥ|ⲱϣ
ϫⲉⲛϯⲥⲟⲟⲩⲛ	ϫⲉ|ⲛ|ϯ|ⲥⲟⲟⲩⲛ	ϫⲉ|ⲛ|ϯⲥⲟⲟⲩⲛ
ⲉⲧⲏⲡ	ⲉⲧ|ⲏⲡ	ⲉⲧⲏⲡ
ⲛⲧⲉⲣⲉϥϫⲟⲟⲩ	ⲛⲧⲉⲣⲉ|ϥ|ϫⲟⲟⲩ	ⲛⲧⲉⲣⲉ|ϥ|ϫⲟⲟ|ⲩ	ⲛ|ⲧⲉ|ⲣⲉϥϫⲟⲟⲩ
ⲕⲁⲧⲁⲧⲟⲡⲟⲥ	ⲕⲁⲧⲁ|ⲧⲟⲡⲟⲥ	ⲕⲁ|ⲧⲁ|ⲧⲟⲡⲟⲥ
ⲉϥⲛⲁⲣⲇⲓⲕⲁⲓⲟⲥ	ⲉ|ϥ|ⲛⲁⲣⲇⲓⲕⲁⲓⲟⲥ	ⲉ|ϥ|ⲛⲁ|ⲣⲇⲓⲕⲁⲓⲟⲥ
ϯⲛⲁϫⲟⲟⲩ	ϯ|ⲛⲁ|ϫⲟⲟⲩ	ϯ|ⲛⲁ|ϫⲟⲟ|ⲩ
ⲙⲩⲥⲧⲏⲣⲓⲟⲛ	ⲙ|ⲩⲥⲧⲏⲣⲓⲟⲛ	ⲙⲩⲥⲧⲏⲣⲓⲟⲛ
ⲛⲧⲉ	ⲛⲧⲉ	ⲛ|ⲧ|ⲉ
ⲟⲩⲱϣϥ	ⲟⲩⲱϣ|ϥ	ⲟⲩⲱϣϥ
ⲛⲧⲙⲛⲧⲣⲉϥϣⲙϣⲉⲉⲓⲇⲱⲗⲟⲛ	ⲛ|ⲧ|ⲙⲛⲧⲣⲉϥϣⲙϣⲉ|ⲉⲓⲇⲱⲗⲟⲛ	ⲛ|ⲧ|ⲙⲛⲧⲣⲉϥϣⲙϣⲉⲉⲓⲇⲱⲗⲟⲛ
ⲁϩⲉⲣⲁⲧⲟⲩ	ⲁϩⲉ|ⲣⲁⲧ|ⲟⲩ	ⲁϩⲉⲣⲁⲧ|ⲟⲩ
ⲛⲉⲧⲛϫⲱ	ⲛⲉⲧⲛ|ϫⲱ	ⲛ|ⲉⲧ|ⲛ|ϫⲱ
ⲉⲣϩⲱⲃ	ⲉ|ⲣϩⲱⲃ	ⲉ|ⲣ|ϩⲱⲃ
ϫⲉⲙⲡⲟⲩⲥⲱⲧⲙ	ϫⲉ|ⲙ|ⲡⲟⲩ|ⲥⲱⲧⲙ	ϫⲉ|ⲙ|ⲡ|ⲟⲩ|ⲥⲱⲧⲙ
ⲛⲟⲩⲱⲛϩ	ⲛ|ⲟⲩ|ⲱⲛϩ	ⲛ|ⲟⲩⲱⲛϩ
ⲛⲧⲁϥⲣⲛⲁⲓ	ⲛⲧ|ⲁ|ϥ|ⲣⲛⲁⲓ	ⲛⲧ|ⲁ|ϥ|ⲣ|ⲛⲁⲓ
ⲙⲡⲉϥⲛⲟⲉⲓ	ⲙ|ⲡⲉϥ|ⲛⲟⲉⲓ	ⲙⲡⲉ|ϥ|ⲛⲟⲉⲓ
ⲙⲡⲣⲙⲉⲉⲩⲉ	ⲙⲡⲣ|ⲙⲉⲉⲩⲉ	ⲙ|ⲡ|ⲣⲙⲉⲉⲩⲉ
ⲛⲟⲉⲓⲛ	ⲛⲟⲉⲓⲛ	ⲛⲟⲉⲓ|ⲛ
ⲛϫⲡⲯⲓⲧⲉ	ⲛ|ϫⲡ|ⲯⲓⲧⲉ	ⲛ|ϫⲡⲯⲓⲧⲉ
ⲉⲧⲉⲛⲟⲩ	ⲉ|ⲧⲉⲛⲟⲩ	ⲉⲧⲉⲛⲟⲩ
ⲁⲙⲏⲓⲧⲛ	ⲁⲙⲏⲓⲧⲛ	ⲁⲙⲏⲓ|ⲧⲛ
.........	.........	...|...|...
ⲛⲛⲉⲣⲣⲱⲟⲩ	ⲛ|ⲛⲉ|ⲣⲣⲱⲟⲩ	ⲛ|ⲛ|ⲉⲣⲣⲱⲟⲩ
ⲙⲡⲉϥⲟⲩⲱϣ	ⲙⲡⲉ|ϥ|ⲟⲩⲱϣ	ⲙ|ⲡⲉϥ|ⲟⲩⲱϣ
ⲛⲛⲉⲩⲉⲣⲏⲩ	ⲛ|ⲛⲉⲩ|ⲉⲣⲏⲩ	ⲛ|ⲛⲉ|ⲩ|ⲉⲣⲏⲩ
ⲉⲧϩⲟⲟⲩ	ⲉⲧ|ϩⲟⲟⲩ	ⲉ|ⲧ|ϩⲟⲟⲩ
ⲙⲡⲉϥⲥⲱⲧⲙ	ⲙⲡⲉ|ϥ|ⲥⲱⲧⲙ	ⲙ|ⲡⲉϥ|ⲥⲱⲧⲙ
ⲛⲉⲓⲙⲉⲉⲩⲉ	ⲛⲉ|ⲓ|ⲙⲉⲉⲩⲉ	ⲛⲉⲓ|ⲙⲉⲉⲩⲉ
ⲛⲥⲟⲩⲟⲩⲁ	ⲛ|ⲥⲟⲩ|ⲟⲩⲁ	ⲛ|ⲥⲟⲩⲟⲩⲁ
ⲛⲁⲥ	ⲛⲁ|ⲥ	ⲛ|ⲁⲥ
ⲛⲁϩⲉ	ⲛⲁ|ϩⲉ	ⲛ|ⲁϩⲉ
ⲙⲡⲉⲧϩⲟⲟⲩ	ⲙ|ⲡ|ⲉⲧ|ϩⲟⲟⲩ	ⲙ|ⲡⲉ|ⲧ|ϩⲟⲟⲩ
ⲡⲉⲧⲛⲁϣⲡⲟⲣϫⲛ	ⲡ|ⲉⲧ|ⲛⲁ|ϣ|ⲡⲟⲣϫⲛ	ⲡ|ⲉⲧ|ⲛⲁ|ϣⲡⲟⲣϫ|ⲛ
ⲙⲡⲣⲥⲱⲧⲙ	ⲙⲡⲣ|ⲥⲱⲧⲙ	ⲙⲡ|ⲣ|ⲥⲱⲧⲙ
ⲉⲧⲟⲟⲧⲕ	ⲉⲧⲟⲟⲧ|ⲕ	ⲉ|ⲧⲟⲟⲧ|ⲕ
ϩⲟⲟⲩ	ϩⲟⲟⲩ	ϩⲟ|ⲟⲩ
ⲉⲥⲱϣ	ⲉ|ⲥ|ⲱϣ	ⲉ|ⲥⲱϣ
ϫⲉⲛⲧⲟⲟⲩ	ϫⲉ|ⲛⲧⲟⲟⲩ	ϫⲉ|ⲛ|ⲧⲟⲟⲩ
ⲟⲩⲱⲛϩ	ⲟⲩⲱⲛϩ	ⲟⲩ|ⲱⲛϩ
ⲉⲧⲉⲛⲧⲟⲟⲩ	ⲉⲧⲉ|ⲛⲧⲟⲟⲩ	ⲉⲧⲉ|ⲛ|ⲧⲟⲟⲩ
ⲉⲛⲉⲙⲛⲗⲁⲁⲩ	ⲉⲛⲉ|ⲙⲛ|ⲗⲁⲁⲩ	ⲉ|ⲛⲉ|ⲙⲛ|ⲗⲁⲁⲩ
ⲛⲧⲉⲧⲛⲃⲱⲕ'	ⲛ|ⲧⲉⲧⲛ|ⲃⲱⲕ'	ⲛⲧⲉⲧⲛ|ⲃⲱⲕ'
ⲉⲧⲙⲟⲥⲧⲉ	ⲉ|ⲧ|ⲙⲟⲥⲧⲉ	ⲉⲧ|ⲙⲟⲥⲧⲉ
ϩⲓⲡⲁϩⲟⲩ	ϩⲓ|ⲡⲁϩⲟⲩ	ϩⲓⲡⲁϩⲟⲩ
ⲛⲧⲁⲧⲁⲙⲟⲕ	ⲛ|ⲧⲁ|ⲧⲁⲙⲟ|ⲕ	ⲛⲧ|ⲁ|ⲧⲁⲙⲟ|ⲕ	ⲛⲧⲁ|ⲧⲁⲙⲟ|ⲕ
ⲛⲧⲁϯ	ⲛⲧⲁ|ϯ	ⲛⲧ|ⲁ|ϯ	ⲛ|ⲧⲁ|ϯ
ⲛⲧⲉⲣⲉⲥϫⲉⲛⲁⲓ	ⲛⲧⲉⲣⲉ|ⲥ|ϫⲉⲛⲁ|ⲓ	ⲛⲧⲉⲣⲉ|ⲥ|ϫⲉ|ⲛⲁⲓ
ⲉⲧⲥⲟⲟⲩⲛ	ⲉⲧ|ⲥⲟⲟⲩⲛ	ⲉ|ⲧ|ⲥⲟⲟⲩⲛ
ϫⲉⲛⲧⲁⲟⲩϣⲱⲡⲉ	ϫⲉ|ⲛⲧ|ⲁ|ⲟⲩ|ϣⲱⲡⲉ	ϫⲉ|ⲛ|ⲧⲁ|ⲟⲩ|ϣⲱⲡⲉ
ⲉⲡⲁϩⲟⲩ	ⲉ|ⲡⲁϩⲟⲩ	ⲉⲡⲁϩⲟⲩ	ⲉ|ⲡⲁϩ|ⲟⲩ
ⲉⲧⲡⲉ	ⲉ|ⲧ|ⲡⲉ	ⲉ|ⲧⲡⲉ
ⲛⲛⲉⲧⲉⲙⲉϣϣⲉ	ⲛ|ⲛ|ⲉⲧⲉ|ⲙⲉ|ϣϣⲉ	ⲛ|ⲛ|ⲉⲧⲉ|ⲙⲉϣϣⲉ
ⲉⲧϩⲁⲉⲟⲟⲩ	ⲉⲧ|ϩⲁ|ⲉⲟⲟⲩ	ⲉⲧ|ϩⲁⲉⲟⲟⲩ
ⲛⲛⲁϩⲣⲛⲛⲣⲱⲙⲉ	ⲛⲛⲁϩⲣⲛ|ⲛ|ⲣⲱⲙⲉ	ⲛ|ⲛⲁϩⲣⲛ|ⲛ|ⲣⲱⲙⲉ
ⲙⲛⲛⲉⲧⲟⲩⲁⲁⲃ	ⲙⲛ|ⲛ|ⲉⲧ|ⲟⲩⲁⲁⲃ	ⲙ|ⲛ|ⲛⲉⲧⲟⲩⲁⲁⲃ
ⲉⲧϣⲱⲱⲧ	ⲉⲧ|ϣⲱⲱⲧ	ⲉ|ⲧ|ϣⲱⲱⲧ
ⲉⲧⲙⲏⲏⲧⲉ	ⲉ|ⲧ|ⲙⲏⲏⲧⲉ	ⲉⲧ|ⲙⲏⲏⲧⲉ
ⲉⲕ	ⲉⲕ	ⲉ|ⲕ
ⲛⲧⲑⲁⲗⲁⲥⲥⲁ	ⲛ|ⲧ|ⲑⲁⲗⲁⲥⲥⲁ	ⲛ|ⲧⲑⲁⲗⲁⲥⲥⲁ	ⲛⲧⲑⲁⲗⲁⲥⲥⲁ
ⲉⲧⲣⲟⲉⲓⲥ	ⲉⲧ|ⲣⲟⲉⲓⲥ	ⲉ|ⲧ|ⲣⲟⲉⲓⲥ
ⲙⲡⲉ	ⲙ|ⲡⲉ	ⲙⲡⲉ
ϩⲛⲛⲉⲧⲉⲛⲟⲩⲕ	ϩⲛ|ⲛ|ⲉⲧⲉ|ⲛⲟⲩⲕ	ϩⲛ|ⲛ|ⲉⲧⲉ|ⲛⲟⲩ|ⲕ
ⲉϫⲟⲟⲩ	ⲉ|ϫⲟ|ⲟⲩ	ⲉ|ϫⲟⲟ|ⲩ	ⲉ|ϫⲟⲟⲩ
ⲛⲧⲉϩⲓⲏ	ⲛ|ⲧⲉ|ϩⲓⲏ	ⲛⲧⲉ|ϩⲓⲏ
ⲛⲛⲉϩⲟⲟⲩ	ⲛ|ⲛⲉ|ϩⲟⲟⲩ	ⲛ|ⲛ|ⲉϩⲟⲟⲩ
ⲉⲕϩⲙⲙⲙⲁ	ⲉ|ⲕ|ϩⲙ|ⲙ|ⲙⲁ	ⲉ|ⲕ|ϩⲙ|ⲙⲙⲁ
ϩⲛⲟⲩϣⲡⲛϣⲱⲡ	ϩⲛ|ⲟⲩ|ϣⲡⲛϣⲱⲡ	ϩⲛ|ⲟⲩ|ϣⲡ|ⲛ|ϣⲱⲡ
ϩⲛⲟⲩⲙⲛⲧϣⲁⲛϩⲧⲏϥ	ϩⲛ|ⲟⲩ|ⲙⲛⲧϣⲁⲛϩⲧⲏϥ	ϩⲛ|ⲟⲩ|ⲙⲛⲧϣⲁⲛϩⲧⲏ|ϥ
ⲛϫⲟⲟⲩ	ⲛ|ϫⲟ|ⲟⲩ	ⲛ|ϫⲟⲟ|ⲩ
ⲉⲩⲣⲡⲙⲉⲉⲩⲉ	ⲉ|ⲩ|ⲣ|ⲡ|ⲙⲉⲉⲩⲉ	ⲉ|ⲩ|ⲣⲡⲙⲉⲉⲩⲉ
ⲛⲧⲉϩⲟⲩⲉⲓⲧⲉ	ⲛ|ⲧⲉ|ϩⲟⲩⲉⲓⲧⲉ	ⲛⲧⲉ|ϩⲟⲩⲉⲓⲧⲉ
ⲡⲉⲧⲛⲁⲛⲟⲩϥ	ⲡ|ⲉⲧ|ⲛⲁⲛⲟⲩ|ϥ	ⲡⲉⲧⲛⲁⲛⲟⲩϥ
ⲉⲧⲉⲕⲛⲁⲃⲱⲕ	ⲉ|ⲧⲉⲕ|ⲛⲁ|ⲃⲱⲕ	ⲉⲧⲉ|ⲕ|ⲛⲁ|ⲃⲱⲕ
ⲁⲛⲁⲩ	ⲁⲛⲁⲩ	ⲁ|ⲛⲁⲩ
ⲧⲁⲉⲓⲟⲩ	ⲧⲁⲉⲓⲟⲩ	ⲧⲁⲉⲓⲟ|ⲩ
ⲛⲉⲩϫⲱ	ⲛⲉ|ⲩ|ϫⲱ	ⲛⲉⲩ|ϫⲱ
ⲙⲡⲓⲛⲁⲩ	ⲙⲡ|ⲓ|ⲛⲁⲩ	ⲙ|ⲡⲓ|ⲛⲁⲩ
ⲉⲧⲣⲁϭⲱ	ⲉ|ⲧⲣ|ⲁ|ϭⲱ	ⲉ|ⲧⲣⲁ|ϭⲱ
ⲙⲡⲓⲟⲩⲱⲙ	ⲙⲡ|ⲓ|ⲟⲩⲱⲙ	ⲙ|ⲡⲓ|ⲟⲩⲱⲙ
ⲙⲡⲉⲓϩⲉ	ⲙ|ⲡⲉⲓ|ϩⲉ	ⲙⲡ|ⲉⲓ|ϩⲉ	ⲙ|ⲡⲉⲓϩⲉ
ⲁⲩⲣⲧϩⲉ	ⲁ|ⲩ|ⲣⲧϩⲉ	ⲁ|ⲩ|ⲣ|ⲧ|ϩⲉ
ⲉⲡⲉϥⲧⲟⲟⲩ	ⲉ|ⲡⲉϥ|ⲧⲟⲟⲩ	ⲉ|ⲡ|ⲉϥⲧⲟⲟⲩ	ⲉ|ⲡⲉ|ϥⲧⲟⲟⲩ
ⲥⲃⲟⲕ	ⲥⲃⲟⲕ	ⲥⲃⲟ|ⲕ
ⲙⲙⲟⲩ	ⲙⲙⲟ|ⲩ	ⲙ|ⲙⲟⲩ	ⲙⲙⲟⲩ
......	......	...|...
ϩⲁⲧⲉⲛϩⲏ	ϩⲁ|ⲧⲉⲛ|ϩⲏ	ϩⲁⲧⲉⲛ|ϩⲏ
ⲉⲣⲱϥ	ⲉⲣⲱ|ϥ	ⲉ|ⲣⲱ|ϥ
ⲡⲙⲁⲓⲣⲱⲙⲉ	ⲡ|ⲙⲁⲓⲣⲱⲙⲉ	ⲡ|ⲙⲁⲓ|ⲣⲱⲙⲉ
ⲙⲡⲉⲧⲡⲉ	ⲙⲡⲉ|ⲧ|ⲡⲉ	ⲙ|ⲡⲉ|ⲧⲡⲉ
ϫⲟⲟⲩ	ϫⲟⲟ|ⲩ	ϫⲟⲟⲩ
ⲛⲧⲁⲕⲱ	ⲛ|ⲧⲁ|ⲕⲱ	ⲛⲧ|ⲁ|ⲕⲱ
ⲛⲁϫⲟⲩⲱⲧ	ⲛ|ⲁ|ϫⲟⲩⲱⲧ	ⲛⲁ|ϫⲟⲩⲱⲧ
ⲉⲧⲉⲧⲛⲥⲱⲧⲙ	ⲉ|ⲧⲉⲧⲛ|ⲥⲱⲧⲙ	ⲉⲧⲉ|ⲧⲛ|ⲥⲱⲧⲙ
ⲥⲁⲥⲁ	ⲥⲁⲥⲁ	ⲥⲁ|ⲥⲁ
ϩⲙⲡⲙⲉϩϣⲟⲙⲛⲧ	ϩⲙ|ⲡ|ⲙⲉϩϣⲟⲙⲛⲧ	ϩⲙ|ⲡ|ⲙⲉϩ|ϣⲟⲙⲛⲧ
ⲉϥⲁϩⲉⲣⲁⲧϥ	ⲉ|ϥ|ⲁϩⲉ|ⲣⲁⲧ|ϥ	ⲉ|ϥ|ⲁϩⲉⲣⲁⲧ|ϥ
ⲁⲕⲕⲁⲁⲧ	ⲁ|ⲕ|ⲕⲁⲁⲧ	ⲁ|ⲕ|ⲕⲁⲁ|ⲧ
ϯⲙⲧⲟⲛ	ϯⲙⲧⲟⲛ	ϯ|ⲙⲧⲟⲛ
ⲛⲥⲁⲥⲁ	ⲛⲥⲁ|ⲥⲁ	ⲛ|ⲥⲁⲥⲁ	ⲛ|ⲥⲁ|ⲥⲁ
ⲛⲧⲉϥⲙⲛⲧϣⲁⲛϩⲧⲏϥ	ⲛ|ⲧⲉϥ|ⲙⲛⲧϣⲁⲛϩⲧⲏ|ϥ	ⲛ|ⲧⲉϥ|ⲙⲛⲧϣⲁⲛϩⲧⲏϥ
ⲛⲧⲁⲡⲥⲱⲧⲏⲣ	ⲛⲧ|ⲁ|ⲡ|ⲥⲱⲧⲏⲣ	ⲛ|ⲧⲁ|ⲡ|ⲥⲱⲧⲏⲣ
ⲕⲱⲧⲉ	ⲕⲱⲧⲉ	ⲕⲱⲧ|ⲉ
ⲛⲛⲟⲉⲓⲕ	ⲛ|ⲛⲟⲉⲓⲕ	ⲛ|ⲛ|ⲟⲉⲓⲕ
ϩⲓⲱⲱⲧⲉ	ϩⲓⲱⲱ|ⲧⲉ	ϩⲓⲱⲱⲧ|ⲉ
ⲙⲡⲣⲕⲁⲁϥ	ⲙⲡⲣ|ⲕⲁⲁ|ϥ	ⲙⲡ|ⲣ|ⲕⲁⲁ|ϥ
ⲛⲟⲩ	ⲛ|ⲟⲩ	ⲛⲟⲩ
ⲛⲧⲉⲧⲛϣⲗⲏⲗ	ⲛ|ⲧⲉⲧⲛ|ϣⲗⲏⲗ	ⲛⲧⲉⲧⲛ|ϣⲗⲏⲗ
ⲛⲧⲉⲩⲛⲟⲩ	ⲛ|ⲧⲉ|ⲩⲛⲟⲩ	ⲛⲧⲉⲩⲛⲟⲩ
ϩⲱⲱⲥ	ϩⲱⲱ|ⲥ	ϩⲱⲱⲥ
ⲉⲧⲃⲏⲧ	ⲉⲧⲃⲏ|ⲧ	ⲉⲧ|ⲃⲏⲧ
ⲧⲉϩⲉ	ⲧⲉ|ϩⲉ	ⲧ|ⲉϩⲉ
ⲉϣϣⲉ	ⲉϣϣⲉ	ⲉ|ϣϣⲉ
ⲉⲡⲧⲏⲣϥ	ⲉ|ⲡ|ⲧⲏⲣϥ	ⲉ|ⲡ|ⲧⲏⲣ|ϥ
ⲛⲉⲓϣⲁϫⲉ	ⲛⲉⲓ|ϣⲁϫⲉ	ⲛⲉ|ⲓ|ϣⲁϫⲉ
ⲙⲡⲏⲩⲉ	ⲙ|ⲡⲏⲩⲉ	ⲙ|ⲡ|ⲏⲩⲉ
ⲛⲧⲃⲱ	ⲛ|ⲧⲃⲱ	ⲛ|ⲧ|ⲃⲱ
ⲡⲁⲡⲛⲟⲩⲧⲉ	ⲡⲁ|ⲡ|ⲛⲟⲩⲧⲉ	ⲡⲁⲡⲛⲟⲩⲧⲉ
ⲙⲡⲉⲓⲛⲁⲩ	ⲙ|ⲡⲉⲓ|ⲛⲁⲩ	ⲙⲡ|ⲉⲓ|ⲛⲁⲩ
ⲛⲉⲥϣⲟⲟⲡ	ⲛ|ⲉ|ⲥ|ϣⲟⲟⲡ	ⲛⲉ|ⲥ|ϣⲟⲟⲡ
ϥⲛⲁⲁⲁⲩ	ϥ|ⲛⲁ|ⲁⲁ|ⲩ	ϥ|ⲛⲁ|ⲁ|ⲁⲩ
ⲛⲥⲱⲧⲡ	ⲛ|ⲥⲱⲧⲡ	ⲛ|ⲥ|ⲱⲧⲡ
ⲛⲁⲡⲣⲏⲧⲉ	ⲛ|ⲁⲡⲣⲏⲧⲉ	ⲛⲁ|ⲡ|ⲣⲏⲧⲉ
ⲛⲧⲁⲡⲉⲛⲥⲱⲧⲏⲣ	ⲛⲧ|ⲁ|ⲡⲉⲛ|ⲥⲱⲧⲏⲣ	ⲛ|ⲧⲁ|ⲡⲉⲛ|ⲥⲱⲧⲏⲣ
ⲡⲉⲛⲛⲟⲩⲧⲉ	ⲡⲉⲛ|ⲛⲟⲩⲧⲉ	ⲡⲉ|ⲛ|ⲛⲟⲩⲧⲉ
ϯⲧⲕⲁⲥ	ϯⲧⲕⲁⲥ	ϯ|ⲧⲕⲁⲥ
ⲙⲡⲟⲩⲣⲡⲙⲉⲉⲩⲉ	ⲙⲡ|ⲟⲩ|ⲣ|ⲡ|ⲙⲉⲉⲩⲉ	ⲙⲡ|ⲟⲩ|ⲣⲡⲙⲉⲉⲩⲉ
ⲉⲩⲛⲟϭ	ⲉ|ⲩ|ⲛⲟϭ	ⲉⲩ|ⲛⲟϭ
ⲛⲥϯⲛⲟⲩϥⲉ	ⲛ|ⲥϯⲛⲟⲩϥⲉ	ⲛ|ⲥ|ϯⲛⲟⲩϥⲉ
ⲡⲣⲟⲥⲟⲩⲟⲉⲓϣ	ⲡⲣⲟⲥ|ⲟⲩⲟⲉⲓϣ	ⲡⲣⲟⲥⲟⲩⲟⲉⲓϣ
ⲛⲅⲣϩⲧⲏⲕ	ⲛ|ⲅ|ⲣϩⲧⲏⲕ	ⲛ|ⲅ|ⲣϩⲧⲏ|ⲕ
ⲉⲧⲣ	ⲉ|ⲧⲣ	ⲉ|ⲧ|ⲣ
ϫⲉϯϩⲧⲏⲕ	ϫⲉ|ϯϩⲧⲏ|ⲕ	ϫⲉ|ϯ|ϩⲧⲏ|ⲕ
ⲁϥϫⲓϣⲕⲁⲕ	ⲁ|ϥ|ϫⲓϣⲕⲁⲕ	ⲁ|ϥ|ϫⲓ|ϣⲕⲁⲕ
ⲙⲡⲉϥⲣⲡⲙⲉⲉⲩⲉ	ⲙⲡⲉ|ϥ|ⲣ|ⲡ|ⲙⲉⲉⲩⲉ	ⲙ|ⲡⲉϥ|ⲣ|ⲡ|ⲙⲉⲉⲩⲉ	ⲙ|ⲡⲉϥ|ⲣⲡⲙⲉⲉⲩⲉ
ⲛⲁϥ	ⲛⲁ|ϥ	ⲛ|ⲁϥ
ⲉⲧⲟⲟⲧⲟⲩ	ⲉⲧⲟⲟⲧ|ⲟⲩ	ⲉ|ⲧⲟⲟⲧ|ⲟⲩ
ⲉϫⲱⲟⲩ	ⲉϫⲱ|ⲟⲩ	ⲉ|ϫⲱ|ⲟⲩ
ⲉⲣⲁⲧϥ	ⲉⲣⲁⲧ|ϥ	ⲉ|ⲣⲁⲧ|ϥ
ⲛϫⲱⲕ	ⲛ|ϫⲱⲕ	ⲛ|ϫⲱ|ⲕ
ϫⲉⲛ	ϫⲉ|ⲛ	ϫⲉⲛ
ⲛⲧⲁⲩϫⲟⲟⲩ	ⲛⲧ|ⲁ|ⲩ|ϫⲟⲟ|ⲩ	ⲛⲧ|ⲁ|ⲩ|ϫⲟ|ⲟⲩ
ⲛⲕⲱϩⲧ	ⲛ|ⲕⲱϩⲧ	ⲛ|ⲕ|ⲱϩⲧ
ⲛⲥⲉⲣϩⲟⲧⲉ	ⲛ|ⲥ|ⲉⲣϩⲟⲧⲉ	ⲛ|ⲥⲉ|ⲣϩⲟⲧⲉ
ⲛⲙⲡϣⲁ	ⲛ|ⲙⲡϣⲁ	ⲛⲙ|ⲡ|ϣⲁ
ⲙⲡⲣⲡⲙⲉⲉⲩⲉ	ⲙ|ⲡ|ⲣⲡⲙⲉⲉⲩⲉ	ⲙⲡⲣ|ⲡ|ⲙⲉⲉⲩⲉ
ϯϩⲁⲡ	ϯϩⲁⲡ	ϯ|ϩⲁⲡ
ⲛⲥⲙⲟⲩ	ⲛ|ⲥⲙⲟⲩ	ⲛ|ⲥ|ⲙⲟⲩ
ⲛⲧⲁⲛⲉⲛⲉⲓⲟⲟⲧⲉ	ⲛⲧ|ⲁ|ⲛⲉⲛ|ⲉⲓⲟⲟⲧⲉ	ⲛ|ⲧⲁ|ⲛⲉⲛ|ⲉⲓⲟⲟⲧⲉ
ⲙⲡⲁⲣⲡⲙⲉⲉⲩⲉ	ⲙ|ⲡⲁ|ⲣⲡⲙⲉⲉⲩⲉ	ⲙ|ⲡⲁ|ⲣ|ⲡ|ⲙⲉⲉⲩⲉ
ϩⲓⲧⲟⲟⲧ	ϩⲓⲧⲟⲟⲧ	ϩⲓ|ⲧⲟⲟⲧ
ⲛⲛⲁϩⲣⲛ	ⲛⲛⲁϩⲣⲛ	ⲛ|ⲛⲁϩⲣⲛ
ⲟⲩϭⲁⲥ	ⲟⲩ|ϭⲁⲥ	ⲟⲩϭⲁⲥ
ⲉⲧⲉⲥⲟⲩⲙⲛⲧϣⲟⲙⲧⲉ	ⲉⲧⲉ|ⲥⲟⲩ|ⲙⲛⲧϣⲟⲙⲧⲉ	ⲉⲧⲉ|ⲥ|ⲟⲩ|ⲙⲛⲧϣⲟⲙⲧⲉ
ϩⲁⲣⲁⲧϥ	ϩⲁⲣⲁⲧ|ϥ	ϩⲁ|ⲣⲁⲧ|ϥ
ⲉⲡⲛⲁⲩ	ⲉⲡ|ⲛⲁ|ⲩ	ⲉ|ⲡ|ⲛⲁⲩ
ϯⲟⲥⲉ	ϯⲟⲥⲉ	ϯ|ⲟⲥⲉ
ⲛϫⲡϣⲟⲙⲧⲉ	ⲛ|ϫⲡ|ϣⲟⲙⲧⲉ	ⲛ|ϫⲡϣⲟⲙⲧⲉ
ⲉⲉⲓ	ⲉ|ⲉⲓ	ⲉⲉⲓ
ⲛⲕⲟ	ⲛ|ⲕ|ⲟ	ⲛ|ⲕⲟ
ⲛⲉⲓ	ⲛ|ⲉⲓ	ⲛⲉⲓ
ⲉⲧⲉⲕⲕⲗⲏⲣⲟⲛⲟⲙⲓⲁ	ⲉ|ⲧⲉⲕ|ⲕⲗⲏⲣⲟⲛⲟⲙⲓⲁ	ⲉ|ⲧ|ⲉⲕⲕⲗⲏⲣⲟⲛⲟⲙⲓⲁ
ⲛϫⲡⲥⲟ	ⲛ|ϫⲡ|ⲥⲟ	ⲛ|ϫⲡⲥⲟ
ⲉⲛⲁϣⲱⲥ	ⲉ|ⲛⲁϣⲱ|ⲥ	ⲉ|ⲛⲁ|ϣⲱⲥ
ⲕⲁⲁⲧ	ⲕⲁⲁ|ⲧ	ⲕⲁⲁⲧ
ⲛⲁⲛⲁϣ	ⲛ|ⲁⲛⲁϣ	ⲛⲁ|ⲛ|ⲁϣ
ⲛⲟⲩϣⲏ	ⲛ|ⲟⲩϣⲏ	ⲛ|ⲟⲩ|ϣⲏ
ⲉⲛⲉϥⲟⲩⲱϣ	ⲉ|ⲛⲉϥ|ⲟⲩⲱϣ	ⲉ|ⲛⲉ|ϥ|ⲟⲩⲱϣ
ⲉⲛⲧϥ	ⲉ|ⲛⲧ|ϥ	ⲉⲛⲧ|ϥ
ⲛⲥⲟⲩⲛⲡⲡⲉⲧⲛⲁⲛⲟⲩϥ	ⲛ|ⲥⲟⲩⲛ|ⲡ|ⲡⲉⲧⲛⲁⲛⲟⲩ|ϥ	ⲛ|ⲥⲟⲩⲛ|ⲡ|ⲡⲉⲧⲛⲁⲛⲟⲩϥ
ⲙⲛⲛⲉⲧ	ⲙⲛ|ⲛⲉⲧ	ⲙⲛ|ⲛ|ⲉⲧ
ϩⲛⲟⲩϯϩⲧⲏϥ	ϩⲛ|ⲟⲩ|ϯϩⲧⲏ|ϥ	ϩⲛ|ⲟⲩ|ϯϩⲧⲏϥ
ⲉⲧϥⲱϭⲉ	ⲉⲧ|ϥⲱϭⲉ	ⲉ|ⲧ|ϥⲱϭⲉ
ⲛϯⲁⲏⲥ	ⲛ|ϯ|ⲁⲏⲥ	ⲛ|ϯⲁⲏⲥ
ⲛⲛⲉⲛⲧⲁϥϫⲟⲟⲩ	ⲛ|ⲛ|ⲉⲛⲧ|ⲁ|ϥ|ϫⲟ|ⲟⲩ	ⲛ|ⲛⲉ|ⲛⲧ|ⲁ|ϥ|ϫⲟ|ⲟⲩ	ⲛ|ⲛ|ⲉⲛⲧ|ⲁ|ϥ|ϫⲟⲟ|ⲩ
ⲛⲕⲁⲧⲁⲗⲁⲗⲓⲁ	ⲛ|ⲕⲁⲧⲁⲗⲁⲗⲓⲁ	ⲛ|ⲕⲁ|ⲧ|ⲁⲗⲁⲗⲓⲁ
ⲉⲣⲟⲓ	ⲉⲣⲟ|ⲓ	ⲉⲣⲟⲓ
ⲧⲛⲛⲟⲟⲩⲥⲟⲩ	ⲧⲛⲛⲟⲟⲩⲥ|ⲟⲩ	ⲧⲛⲛⲟⲟⲩ|ⲥⲟⲩ	ⲧⲛⲛⲟⲟⲩ|ⲥⲟ|ⲩ
ⲉⲧⲉⲧⲛϣⲁⲛⲃⲱⲕ	ⲉ|ⲧⲉⲧⲛ|ϣⲁⲛⲃⲱⲕ	ⲉⲧⲉⲧⲛϣⲁⲛ|ⲃⲱⲕ
ϯϩⲧⲏⲧⲛ	ϯ|ϩⲧⲏ|ⲧⲛ	ϯϩⲧⲏ|ⲧⲛ
ⲛⲧⲟⲟⲩ	ⲛⲧⲟⲟⲩ	ⲛ|ⲧⲟⲟⲩ
ⲉⲧⲣⲉϥⲕⲁⲁⲧ	ⲉ|ⲧⲣⲉ|ϥ|ⲕⲁⲁ|ⲧ	ⲉ|ⲧⲣⲉϥ|ⲕⲁⲁ|ⲧ
ⲛⲧⲁⲩ	ⲛⲧⲁ|ⲩ	ⲛ|ⲧⲁ|ⲩ
ⲛⲣⲉϥϣⲙϣⲉⲉⲓⲇⲱⲗⲟⲛ	ⲛ|ⲣⲉϥϣⲙϣⲉⲉⲓⲇⲱⲗⲟⲛ	ⲛ|ⲣⲉϥϣⲙϣⲉ|ⲉⲓⲇⲱⲗⲟⲛ
ⲉⲛⲛⲁⲉⲓⲙⲉ	ⲉ|ⲛ|ⲛⲁ|ⲉⲓⲙⲉ	ⲉⲛⲛⲁ|ⲉⲓⲙⲉ	ⲉⲛⲛ|ⲁ|ⲉⲓⲙⲉ
ⲛⲛⲁϩⲏⲧ	ⲛ|ⲛⲁϩⲏⲧ	ⲛ|ⲛ|ⲁϩⲏⲧ
ϫⲟⲟⲥ	ϫⲟⲟ|ⲥ	ϫⲟⲟⲥ
ⲛⲅϫⲟⲟⲥ	ⲛ|ⲅ|ϫⲟⲟ|ⲥ	ⲛ|ⲅ|ϫⲟⲟⲥ
ⲙⲡⲣϫⲟⲟⲥ	ⲙⲡⲣ|ϫⲟⲟ|ⲥ	ⲙⲡⲣ|ϫⲟⲟⲥ
ϩⲱⲟⲩ	ϩⲱ|ⲟⲩ	ϩⲱⲟⲩ
ⲉϯ	ⲉ|ϯ	ⲉϯ
ϫⲉⲧⲉⲓⲣⲏⲛⲏ	ϫⲉ|ⲧ|ⲉⲓⲣⲏⲛⲏ	ϫⲉ|ⲧⲉⲓⲣⲏⲛⲏ
ⲛⲉⲕⲃⲁⲗ	ⲛⲉⲕ|ⲃⲁⲗ	ⲛⲉ|ⲕ|ⲃⲁⲗ
ⲛⲁϣⲥⲉⲧⲟⲩⲥⲟⲛ	ⲛⲁ|ϣ|ⲥⲉⲧ|ⲟⲩ|ⲥⲟⲛ	ⲛⲁ|ϣⲥⲉⲧ|ⲟⲩ|ⲥⲟⲛ
ⲛⲧⲛϩⲁⲣⲉϩ	ⲛ|ⲧⲛ|ϩⲁⲣⲉϩ	ⲛⲧⲛ|ϩⲁⲣⲉϩ
ⲛⲟⲩⲟⲓ	ⲛ|ⲟⲩⲟⲓ	ⲛ|ⲟⲩ|ⲟⲓ
ϫⲓⲛϫⲱϥ	ϫⲓⲛ|ϫⲱ|ϥ	ϫⲓⲛ|ϫⲱϥ
ⲛⲧⲁϫⲣⲟ	ⲛ|ⲧⲁϫⲣⲟ	ⲛ|ⲧⲁ|ϫⲣⲟ
ⲉⲥⲣⲁⲛⲁϥ	ⲉ|ⲥ|ⲣⲁⲛⲁ|ϥ	ⲉ|ⲥ|ⲣ|ⲁⲛⲁ|ϥ
ϣⲁϫⲱϥ	ϣⲁ|ϫⲱϥ	ϣⲁ|ϫⲱ|ϥ
ϯⲕⲁⲣⲡⲟⲥ	ϯⲕⲁⲣⲡⲟⲥ	ϯ|ⲕⲁⲣⲡⲟⲥ
ⲛⲉϣϣⲉ	ⲛ|ⲉϣϣⲉ	ⲛⲉ|ϣϣⲉ
ϩⲙⲡⲉϩⲟⲟⲩ	ϩⲙ|ⲡⲉ|ϩⲟⲟⲩ	ϩⲙ|ⲡ|ⲉϩⲟⲟⲩ
⁛—	⁛—	⁛|—
··	·|·	··
ϫⲉⲁⲩⲉⲓⲥ	ϫⲉ|ⲁⲩⲉⲓⲥ	ϫⲉ|ⲁⲩⲉⲓ|ⲥ
ⲛⲧⲉⲓⲣⲏⲛⲏ	ⲛ|ⲧⲉⲓⲣⲏⲛⲏ	ⲛ|ⲧ|ⲉⲓⲣⲏⲛⲏ
ⲛⲛⲉⲩⲛⲟⲃⲉ	ⲛ|ⲛⲉⲩ|ⲛⲟⲃⲉ	ⲛⲛⲉ|ⲩ|ⲛⲟⲃⲉ
ⲉⲕⲟ	ⲉ|ⲕ|ⲟ	ⲉ|ⲕⲟ
ⲉⲛⲉⲩ	ⲉ|ⲛ|ⲉⲩ	ⲉ|ⲛⲉⲩ
ⲛⲛⲉⲕϣⲛϩⲧⲏⲕ	ⲛ|ⲛⲉⲕ|ϣⲛϩⲧⲏ|ⲕ	ⲛⲛⲉ|ⲕ|ϣⲛ|ϩⲧⲏ|ⲕ
ⲙⲡⲉϥⲣⲁⲥⲧⲉ	ⲙ|ⲡⲉϥ|ⲣⲁⲥⲧⲉ	ⲙⲡⲉ|ϥ|ⲣⲁⲥⲧⲉ
ⲁⲩⲕⲁⲁϥ	ⲁ|ⲩ|ⲕⲁⲁ|ϥ	ⲁⲩ|ⲕⲁⲁ|ϥ
ⲉⲧⲟⲩϩⲁⲣⲉϩ	ⲉ|ⲧⲟⲩ|ϩⲁⲣⲉϩ	ⲉⲧ|ⲟⲩ|ϩⲁⲣⲉϩ
ⲫⲁⲅⲓⲟⲥ	ⲫⲁⲅⲓⲟⲥ	ⲫ|ⲁⲅⲓⲟⲥ
ⲁϥϫⲓⲧ	ⲁ|ϥ|ϫⲓⲧ	ⲁ|ϥ|ϫⲓ|ⲧ
ⲙⲡⲉⲩⲣⲡⲙⲉⲉⲩⲉ	ⲙⲡⲉ|ⲩ|ⲣ|ⲡ|ⲙⲉⲉⲩⲉ	ⲙ|ⲡⲉⲩ|ⲣ|ⲡ|ⲙⲉⲉⲩⲉ
ⲁⲩϯⲡⲏ	ⲁⲩ|ϯⲡⲏ	ⲁ|ⲩ|ϯⲡⲏ
ⲉϥⲧⲁⲩⲉⲥϩⲃⲏⲏⲧⲉ	ⲉ|ϥ|ⲧⲁⲩⲉⲥϩⲃⲏⲏⲧⲉ	ⲉ|ϥ|ⲧⲁⲩⲉ|ⲥϩⲃⲏⲏⲧⲉ
ⲉϩⲟⲩ	ⲉϩⲟⲩ	ⲉ|ϩⲟ|ⲩ
ⲛⲟⲩⲟⲉⲓϣ	ⲛ|ⲟⲩⲟⲉⲓϣ	ⲛ|ⲟⲩ|ⲟⲉⲓϣ
ⲛⲥⲉⲣⲙⲛⲧⲣⲉ	ⲛⲥⲉ|ⲣⲙⲛⲧⲣⲉ	ⲛ|ⲥⲉ|ⲣⲙⲛⲧⲣⲉ
ⲙⲡⲃⲱⲗ	ⲙ|ⲡ|ⲃⲱⲗ	ⲙ|ⲡⲃⲱⲗ
ⲛⲟϫⲕ	ⲛⲟϫ|ⲕ	ⲛⲟϫⲕ
ⲉⲕⲃⲏⲗ	ⲉ|ⲕ|ⲃⲏⲗ	ⲉ|ⲕⲃⲏⲗ
ⲛϥⲧⲁⲁⲕ	ⲛ|ϥ|ⲧⲁⲁⲕ	ⲛ|ϥ|ⲧⲁⲁ|ⲕ
ⲙⲡⲉⲣϩⲟⲧⲉ	ⲙⲡⲉ|ⲣϩⲟⲧⲉ	ⲙⲡ|ⲉ|ⲣϩⲟⲧⲉ
ⲛⲛⲉⲧⲉⲧⲛⲛⲁϭⲛⲟⲩⲛⲁ	ⲛ|ⲛ|ⲉ|ⲧⲉⲧⲛ|ⲛⲁ|ϭⲛ|ⲟⲩ|ⲛⲁ	ⲛⲛⲉ|ⲧⲉⲧⲛ|ⲛⲁ|ϭⲛ|ⲟⲩ|ⲛⲁ
ⲛⲕⲉⲡⲉⲧⲟⲩⲁⲁⲃ	ⲛ|ⲕⲉ|ⲡⲉⲧⲟⲩⲁⲁⲃ	ⲛ|ⲕⲉ|ⲡ|ⲉⲧ|ⲟⲩⲁⲁⲃ
ⲙⲛⲛⲉϥⲡⲉⲧⲟⲩⲁⲁⲃ	ⲙⲛ|ⲛⲉϥ|ⲡⲉⲧⲟⲩⲁⲁⲃ	ⲙⲛ|ⲛⲉϥ|ⲡ|ⲉⲧ|ⲟⲩⲁⲁⲃ
ⲛⲛⲉⲕϭⲓϫ	ⲛ|ⲛⲉⲕ|ϭⲓϫ	ⲛ|ⲛⲉ|ⲕ|ϭⲓϫ
ⲉⲡⲉϣⲧⲉⲕⲟ	ⲉ|ⲡⲉ|ϣⲧⲉⲕⲟ	ⲉ|ⲡ|ⲉϣⲧⲉⲕⲟ
ϫⲉⲛⲧⲁⲛⲁⲓ	ϫⲉ|ⲛⲧ|ⲁ|ⲛⲁⲓ	ϫⲉ|ⲛⲧⲁ|ⲛⲁⲓ	ϫⲉ|ⲛ|ⲧ|ⲁⲛⲁⲓ
ϣⲛϩⲧⲏϥ	ϣⲛ|ϩⲧⲏ|ϥ	ϣⲛϩⲧⲏ|ϥ
ⲉⲧⲃⲉⲧⲁϣⲉ	ⲉⲧⲃⲉ|ⲧ|ⲁϣⲉ	ⲉⲧⲃⲉ|ⲧⲁϣⲉ
ⲉⲧⲉϣⲁⲓⲧⲱⲟⲩⲛ	ⲉ|ⲧⲉ|ϣⲁ|ⲓ|ⲧⲱⲟⲩⲛ	ⲉⲧⲉ|ϣⲁ|ⲓ|ⲧⲱⲟⲩⲛ
ⲛⲉⲧⲛϣⲁϫⲉ	ⲛⲉⲧⲛ|ϣⲁϫⲉ	ⲛ|ⲉⲧ|ⲛ|ϣⲁϫⲉ
ⲛⲛⲉⲧⲙⲉ	ⲛ|ⲛ|ⲉⲧ|ⲙⲉ	ⲛ|ⲛⲉ|ⲧ|ⲙⲉ
ⲉϫⲱϥ	ⲉϫⲱ|ϥ	ⲉ|ϫⲱ|ϥ
ⲉⲛⲁⲛⲟⲩϥ	ⲉ|ⲛⲁⲛⲟⲩ|ϥ	ⲉ|ⲛⲁ|ⲛⲟⲩϥ
ϫⲓⲛⲙⲡⲟⲟⲩ	ϫⲓⲛ|ⲙ|ⲡ|ⲟⲟⲩ	ϫⲓⲛ|ⲙ|ⲡⲟⲟⲩ
ϫⲓⲛϫⲡϣⲟⲙⲧⲉ	ϫⲓⲛ|ϫⲡϣⲟⲙⲧⲉ	ϫⲓ|ⲛ|ϫⲡ|ϣⲟⲙⲧⲉ
ⲛⲧⲉⲧⲛϯⲉⲟⲟⲩ	ⲛ|ⲧⲉⲧⲛ|ϯⲉⲟⲟⲩ	ⲛⲧⲉⲧⲛ|ϯⲉⲟⲟⲩ
ϯϩⲓⲥⲉ	ϯϩⲓⲥⲉ	ϯ|ϩⲓⲥⲉ
ⲛⲉⲧⲉⲣⲉⲡⲉⲩϩⲏⲧ	ⲛ|ⲉⲧⲉⲣⲉ|ⲡⲉⲩ|ϩⲏⲧ	ⲛ|ⲉⲧ|ⲉⲣⲉ|ⲡⲉⲩ|ϩⲏⲧ
ⲛⲧⲁⲡⲥⲟⲫⲟⲥ	ⲛⲧ|ⲁ|ⲡ|ⲥⲟⲫⲟⲥ	ⲛ|ⲧⲁ|ⲡ|ⲥⲟⲫⲟⲥ
ⲙⲡⲉⲓϣⲁϫⲉ	ⲙ|ⲡⲉⲓ|ϣⲁϫⲉ	ⲙⲡⲉ|ⲓ|ϣⲁϫⲉ
ⲛⲥⲛⲏⲩ	ⲛ|ⲥⲛⲏⲩ	ⲛ|ⲥ|ⲛⲏⲩ
ⲛⲥⲉⲙⲛⲟⲛ	ⲛ|ⲥⲉⲙⲛⲟⲛ	ⲛⲥⲉ|ⲙⲛⲟⲛ
ⲛⲁⲁⲥ	ⲛ|ⲁⲁⲥ	ⲛⲁⲁ|ⲥ
ⲁⲟⲩⲏⲣ	ⲁ|ⲟⲩⲏⲣ	ⲁⲟⲩⲏⲣ
ⲛⲧⲁⲧⲉⲕⲙⲛⲧⲉⲓⲱⲧ	ⲛⲧⲁ|ⲧⲉⲕ|ⲙⲛⲧⲉⲓⲱⲧ	ⲛ|ⲧⲁ|ⲧⲉⲕ|ⲙⲛⲧ|ⲉⲓⲱⲧ
ⲙⲡⲉϥϣⲁϫⲉ	ⲙ|ⲡⲉϥ|ϣⲁϫⲉ	ⲙⲡⲉ|ϥ|ϣⲁϫⲉ
ϫⲉⲛⲛⲁϫⲟⲟⲥ	ϫⲉ|ⲛⲛ|ⲁ|ϫⲟⲟ|ⲥ	ϫⲉ|ⲛ|ⲛⲁ|ϫⲟⲟ|ⲥ
ⲉⲧⲣⲁϫⲟⲟⲥ	ⲉ|ⲧⲣ|ⲁ|ϫⲟⲟ|ⲥ	ⲉ|ⲧⲣⲁ|ϫⲟⲟ|ⲥ
ⲁⲓϫⲟⲟⲩ	ⲁ|ⲓ|ϫⲟⲟⲩ	ⲁ|ⲓ|ϫⲟⲟ|ⲩ
ⲉⲧⲙⲙⲁⲁⲩ	ⲉⲧ|ⲙⲙⲁⲁⲩ	ⲉ|ⲧ|ⲙⲙⲁⲁⲩ
ⲧⲁⲡⲁⲣⲭⲏ	ⲧ|ⲁⲡⲁⲣⲭⲏ	ⲧⲁ|ⲡ|ⲁⲣⲭⲏ
ⲉⲁϥⲣⲟⲩⲙⲕⲁϩ	ⲉ|ⲁ|ϥ|ⲣ|ⲟⲩ|ⲙⲕⲁϩ	ⲉ|ⲁ|ϥ|ⲣⲟⲩ|ⲙⲕⲁϩ
ⲛⲉⲓⲛⲁⲁⲛⲉⲭⲉ	ⲛ|ⲉⲓ|ⲛⲁ|ⲁⲛⲉⲭⲉ	ⲛⲉ|ⲓ|ⲛⲁ|ⲁⲛⲉⲭⲉ
ⲉⲝⲱⲣⲓⲍⲉ	ⲉ|ⲝⲱⲣⲓⲍⲉ	ⲉⲝⲱⲣⲓⲍⲉ
ⲙⲁⲧⲁⲙⲟⲓ	ⲙⲁ|ⲧⲁⲙⲟ|ⲓ	ⲙⲁⲧⲁⲙⲟ|ⲓ
ϫⲉⲁϫⲉⲟⲩϣⲁϫⲉ	ϫⲉ|ⲁϫⲉ|ⲟⲩ|ϣⲁϫⲉ	ϫⲉ|ⲁ|ϫⲉ|ⲟⲩ|ϣⲁϫⲉ
ϯⲧⲟⲟⲧ	ϯ|ⲧⲟⲟⲧ	ϯⲧⲟⲟⲧ
ⲛⲉⲩⲧⲩⲭⲓⲁⲛⲟⲥ	ⲛ|ⲉⲩⲧⲩⲭⲓⲁⲛⲟⲥ	ⲛⲉ|ⲩ|ⲧⲩⲭⲓⲁⲛⲟⲥ
ⲙⲙⲁⲩ	ⲙⲙⲁⲩ	ⲙⲙⲁ|ⲩ
ⲛϩⲏⲧⲟⲩ	ⲛϩⲏⲧ|ⲟⲩ	ⲛ|ϩⲏⲧ|ⲟⲩ
ⲙⲛⲛⲟⲃⲉ	ⲙⲛ|ⲛⲟⲃⲉ	ⲙ|ⲛ|ⲛⲟⲃⲉ
ⲉⲧⲟⲟⲧϥ	ⲉⲧⲟⲟⲧ|ϥ	ⲉ|ⲧⲟⲟⲧ|ϥ
ⲛⲏⲩ	ⲛⲏⲩ	ⲛⲏ|ⲩ
ⲉⲧⲥⲟⲟϥ	ⲉⲧ|ⲥⲟⲟ|ϥ	ⲉⲧ|ⲥⲟⲟϥ
ⲥⲱⲱϥ	ⲥⲱⲱϥ	ⲥⲱⲱ|ϥ
ϩⲁⲧⲛ	ϩⲁⲧⲛ	ϩⲁ|ⲧⲛ
ⲛⲣⲙ	ⲛ|ⲣⲙ	ⲛⲣⲙ
ⲉⲡⲟⲟⲩ	ⲉ|ⲡ|ⲟⲟⲩ	ⲉ|ⲡⲟⲟⲩ
ϩⲓⲥⲉ	ϩⲓⲥⲉ	ϩⲓ|ⲥⲉ
ⲛⲧⲁⲛϣⲣⲡϫⲟⲟⲥ	ⲛⲧ|ⲁ|ⲛ|ϣⲣⲡ|ϫⲟⲟ|ⲥ	ⲛⲧ|ⲁ|ⲛ|ϣⲣⲡϫⲟⲟ|ⲥ
ⲕⲁⲧⲁⲡⲉⲛⲧⲁⲡϫⲟⲉⲓⲥ	ⲕⲁⲧⲁ|ⲡ|ⲉⲛⲧ|ⲁ|ⲡ|ϫⲟⲉⲓⲥ	ⲕⲁⲧⲁ|ⲡⲉ|ⲛⲧ|ⲁ|ⲡ|ϫⲟⲉⲓⲥ
ⲛⲟⲩⲟⲉⲓⲉ	ⲛ|ⲟⲩⲟⲉⲓⲉ	ⲛ|ⲟⲩ|ⲟⲉⲓⲉ
ⲡⲉϫⲁⲥ	ⲡⲉϫⲁ|ⲥ	ⲡⲉϫⲁⲥ
ⲁⲥϣⲱⲡⲉ	ⲁ|ⲥ|ϣⲱⲡⲉ	ⲁ|ⲥϣⲱⲡⲉ
ⲙⲡⲟⲩⲟⲉⲓⲛ	ⲙ|ⲡ|ⲟⲩⲟⲉⲓⲛ	ⲙ|ⲡⲟⲩⲟⲉⲓⲛ
ⲙⲛⲛⲉⲩⲭⲱⲣⲓⲥⲥⲩⲛⲍⲩⲅⲟⲥ	ⲙⲛ|ⲛⲉⲩ|ⲭⲱⲣⲓⲥ|ⲥⲩⲛⲍⲩⲅⲟⲥ	ⲙⲛ|ⲛⲉⲩ|ⲭⲱⲣⲓⲥⲥⲩⲛⲍⲩⲅⲟⲥ
ⲛϩⲁⲧⲣⲉⲉⲩ	ⲛ|ϩⲁ|ⲧ|ⲣⲉⲉⲩ	ⲛ|ϩⲁⲧⲣⲉ|ⲉⲩ
ⲉⲧϣⲟⲣⲡ	ⲉ|ⲧ|ϣⲟⲣⲡ	ⲉⲧ|ϣⲟⲣⲡ
ⲛϩⲙⲉⲯⲓⲧ	ⲛ|ϩⲙⲉ|ⲯⲓⲧ	ⲛ|ϩⲙⲉⲯⲓⲧ
ⲉⲙⲡⲁⲧⲕϣⲁϫⲉ	ⲉ|ⲙⲡⲁⲧ|ⲕ|ϣⲁϫⲉ	ⲉⲙⲡⲁⲧ|ⲕ|ϣⲁϫⲉ
ⲙⲛⲧϩⲩⲗⲏ	ⲙⲛ|ⲧ|ϩⲩⲗⲏ	ⲙⲛ|ⲧϩⲩⲗⲏ
ⲛⲉⲣⲓⲛⲁⲓⲟⲥ	ⲛ|ⲉⲣⲓⲛⲁⲓⲟⲥ	ⲛⲉⲣⲓⲛⲁⲓⲟⲥ
ⲉⲧⲛⲁⲥⲉⲧϥ	ⲉⲧ|ⲛⲁ|ⲥⲉⲧϥ	ⲉⲧ|ⲛⲁⲥⲉⲧ|ϥ
ⲛⲛⲓϩⲁⲛⲉⲇⲣⲁⲕⲱⲛ	ⲛ|ⲛⲓϩⲁⲛⲉ|ⲇⲣⲁⲕⲱⲛ	ⲛⲛⲓϩⲁⲛⲉ|ⲇⲣⲁⲕⲱⲛ
ⲙⲛⲡⲙⲁϩϣⲟⲙⲛⲧ	ⲙⲛ|ⲡ|ⲙⲁϩϣⲟⲙⲛⲧ	ⲙⲛ|ⲡⲙⲁϩϣⲟⲙⲛⲧ
ⲛⲁϣ	ⲛ|ⲁϣ	ⲛⲁ|ϣ
ⲡⲛⲉⲩⲙⲁ	ⲡ|ⲛⲉⲩⲙⲁ	ⲡⲛⲉⲩⲙⲁ
ⲉⲣⲉⲡϩⲟϥ	ⲉⲣⲉ|ⲡϩⲟϥ	ⲉⲣⲉ|ⲡ|ϩⲟϥ
ⲥⲟⲟⲩϩⲥ	ⲥⲟⲟⲩϩ|ⲥ	ⲥⲟⲟⲩϩⲥ
ⲉⲣⲁⲧⲟⲩ	ⲉⲣⲁⲧ|ⲟⲩ	ⲉ|ⲣⲁⲧ|ⲟⲩ
ⲉⲧⲉⲧⲛⲥⲟⲟⲩⲛ	ⲉ|ⲧⲉⲧⲛ|ⲥⲟⲟⲩⲛ	ⲉⲧ|ⲉⲧⲛ|ⲥⲟⲟⲩⲛ
ⲛⲟⲉⲓⲕ	ⲛ|ⲟⲉⲓⲕ	ⲛⲟⲉⲓⲕ
ⲁϥϯⲡⲉϥⲟⲩⲟⲓ	ⲁ|ϥ|ϯ|ⲡⲉϥ|ⲟⲩⲟⲓ	ⲁ|ϥ|ϯ|ⲡⲉϥⲟⲩⲟⲓ
ⲛⲧⲁⲡⲛⲟⲩⲧⲉ	ⲛⲧ|ⲁ|ⲡ|ⲛⲟⲩⲧⲉ	ⲛⲧⲁ|ⲡ|ⲛⲟⲩⲧⲉ
ⲙⲡⲛⲉⲩⲙⲁ	ⲙ|ⲡⲛⲉⲩⲙⲁ	ⲙ|ⲡ|ⲛⲉⲩⲙⲁ
ⲉⲩⲙⲏϩ	ⲉ|ⲩ|ⲙⲏϩ	ⲉⲩ|ⲙⲏϩ
ⲛⲥⲱ	ⲛⲥⲱ	ⲛ|ⲥⲱ
ϩⲛⲟⲩⲱⲛϩ	ϩⲛ|ⲟⲩⲱⲛϩ	ϩⲛ|ⲟⲩ|ⲱⲛϩ
ϫⲉⲛⲁ	ϫⲉ|ⲛⲁ	ϫⲉⲛⲁ
ϯϭⲟⲙ	ϯϭⲟⲙ	ϯ|ϭⲟⲙ
ϫⲉϯⲙⲉⲉⲩⲉ	ϫⲉ|ϯ|ⲙⲉⲉⲩⲉ	ϫⲉ|ϯⲙⲉⲉⲩⲉ
ⲉⲧⲉⲛⲭⲣⲉⲓⲁ	ⲉⲧⲉⲛ|ⲭⲣⲉⲓⲁ	ⲉ|ⲧⲉⲛ|ⲭⲣⲉⲓⲁ
ⲉⲛⲉϩⲓⲟⲟⲩⲉ	ⲉ|ⲛⲉ|ϩⲓⲟⲟⲩⲉ	ⲉⲛⲉ|ϩⲓⲟⲟⲩⲉ
ϫⲉϫⲓⲧ	ϫⲉ|ϫⲓ|ⲧ	ϫⲉ|ϫⲓⲧ
ⲡⲉⲧⲉⲣⲉⲡⲇⲓⲁⲃⲟⲗⲟⲥ	ⲡ|ⲉⲧ|ⲉⲣⲉ|ⲡ|ⲇⲓⲁⲃⲟⲗⲟⲥ	ⲡ|ⲉⲧⲉⲣⲉ|ⲡ|ⲇⲓⲁⲃⲟⲗⲟⲥ
ⲙⲁⲣⲁⲛⲁⲑⲁ	ⲙⲁⲣⲁⲛ|ⲁⲑⲁ	ⲙⲁⲣⲁⲛⲁ|ⲑⲁ
ⲛϥⲧⲙⲣϩⲏⲧ	ⲛ|ϥ|ⲧⲙ|ⲣ|ϩⲏⲧ	ⲛ|ϥ|ⲧⲙ|ⲣϩⲏⲧ
ⲡⲉⲧⲣⲉⲩⲛⲁⲩ	ⲡⲉ|ⲧⲣⲉ|ⲩ|ⲛⲁⲩ	ⲡ|ⲉ|ⲧⲣⲉ|ⲩ|ⲛⲁⲩ
ⲙⲕⲁϩ	ⲙⲕⲁϩ	ⲙ|ⲕⲁϩ
ⲙⲛⲛⲉⲣⲱⲟⲩ	ⲙⲛ|ⲛ|ⲉⲣⲱⲟⲩ	ⲙⲛ|ⲛⲉ|ⲣⲱⲟⲩ
ⲙⲛⲛⲉⲧⲙⲉ	ⲙⲛ|ⲛⲉ|ⲧⲙⲉ	ⲙⲛ|ⲛ|ⲉⲧ|ⲙⲉ
ⲛϣⲁⲛϩⲧⲏϥ	ⲛ|ϣⲁⲛϩⲧⲏϥ	ⲛ|ϣⲁ|ⲛ|ϩⲧⲏ|ϥ
ϯϫⲟⲟⲩ	ϯ|ϫⲟⲟ|ⲩ	ϯ|ϫⲟⲟⲩ
ⲙⲛⲛⲉⲥⲟⲟⲩ	ⲙⲛ|ⲛⲉ|ⲥⲟⲟⲩ	ⲙⲛ|ⲛ|ⲉⲥⲟⲟⲩ
ⲉⲡⲉⲕⲣⲟ	ⲉ|ⲡⲉ|ⲕⲣⲟ	ⲉ|ⲡⲉⲕ|ⲣⲟ
ⲉⲧⲱϭⲉ	ⲉ|ⲧⲱϭⲉ	ⲉⲧ|ⲱϭⲉ
ϥⲓⲣⲟⲟⲩϣ	ϥⲓⲣⲟⲟⲩϣ	ϥⲓ|ⲣⲟⲟⲩϣ
ϥϥⲓⲣⲟⲟⲩϣ	ϥ|ϥⲓⲣⲟⲟⲩϣ	ϥ|ϥⲓ|ⲣⲟⲟⲩϣ
ⲡⲉⲥϩⲁⲓ	ⲡⲉⲥ|ϩⲁⲓ	ⲡⲉ|ⲥϩⲁⲓ
ⲧⲱⲙⲛⲧ	ⲧⲱⲙⲛⲧ	ⲧⲱⲙⲛ|ⲧ
ϯϩⲧⲏϥ	ϯϩⲧⲏ|ϥ	ϯ|ϩⲧⲏ|ϥ
ⲉⲩⲣϩⲱⲃ	ⲉ|ⲩ|ⲣϩⲱⲃ	ⲉ|ⲩ|ⲣ|ϩⲱⲃ
ⲛⲙⲡⲏⲩⲉ	ⲛ|ⲙ|ⲡⲏⲩⲉ	ⲛ|ⲙ|ⲡ|ⲏⲩⲉ
ⲟⲩⲁϣ	ⲟⲩ|ⲁϣ	ⲟⲩⲁϣ
ⲧⲉⲥϭⲓ	ⲧⲉⲥ|ϭⲓ	ⲧⲉⲥϭⲓ
ⲁϥⲣϩⲛⲁϥ	ⲁ|ϥ|ⲣϩⲛⲁ|ϥ	ⲁ|ϥ|ⲣ|ϩⲛⲁ|ϥ
ⲛⲟⲩϩⲉ	ⲛⲟⲩϩⲉ	ⲛ|ⲟⲩ|ϩⲉ
ⲉⲧⲉⲧⲛⲁⲛⲁⲩ	ⲉ|ⲧⲉⲧⲛ|ⲁ|ⲛⲁⲩ	ⲉⲧ|ⲉⲧⲛ|ⲁ|ⲛⲁⲩ	ⲉⲧⲉ|ⲧⲛ|ⲁ|ⲛⲁⲩ
ⲥⲉⲟϣ	ⲥⲉ|ⲟϣ	ⲥ|ⲉ|ⲟϣ
ⲛⲉⲩⲛⲁϫⲟⲟⲥ	ⲛ|ⲉ|ⲩ|ⲛⲁ|ϫⲟⲟ|ⲥ	ⲛⲉ|ⲩ|ⲛⲁ|ϫⲟⲟ|ⲥ
ⲉⲛⲉⲥⲟⲟⲩ	ⲉ|ⲛ|ⲉⲥⲟⲟⲩ	ⲉ|ⲛⲉⲥⲟ|ⲟⲩ
ⲉⲧⲉⲧⲛⲛⲁⲉⲓⲙⲉ	ⲉ|ⲧⲉⲧⲛ|ⲛⲁ|ⲉⲓⲙⲉ	ⲉⲧⲉ|ⲧⲛ|ⲛⲁ|ⲉⲓⲙⲉ
ⲕⲁⲧⲁⲡⲉⲛⲧⲁⲛϣⲣⲡϫⲟⲟϥ	ⲕⲁⲧⲁ|ⲡ|ⲉⲛⲧ|ⲁ|ⲛ|ϣⲣⲡ|ϫⲟⲟ|ϥ	ⲕⲁⲧⲁ|ⲡ|ⲉⲛⲧ|ⲁ|ⲛ|ϣⲣⲡϫⲟⲟ|ϥ
ϫⲉϫⲓϣⲓ	ϫⲉ|ϫⲓ|ϣⲓ	ϫⲉ|ϫⲓϣⲓ
ⲁϥϣⲡϩⲙⲟⲧ	ⲁ|ϥ|ϣⲡϩⲙⲟⲧ	ⲁ|ϥ|ϣⲡ|ϩⲙⲟⲧ
ⲙⲡⲟⲟⲩ	ⲙ|ⲡ|ⲟⲟⲩ	ⲙ|ⲡⲟⲟⲩ
ⲛⲟⲩⲟⲉⲓⲕ	ⲛ|ⲟⲩ|ⲟⲉⲓⲕ	ⲛ|ⲟⲩⲟⲉⲓⲕ
ϫⲉⲁⲗⲱⲧⲛ	ϫⲉ|ⲁⲗⲱⲧⲛ	ϫⲉ|ⲁⲗⲱ|ⲧⲛ
ⲛⲁϫⲟⲟⲩ	ⲛⲁ|ϫⲟⲟ|ⲩ	ⲛⲁ|ϫⲟ|ⲟⲩ
ⲉⲣⲉⲣⲟⲩ	ⲉ|ⲣⲉ|ⲣ|ⲟⲩ	ⲉⲣⲉ|ⲣ|ⲟⲩ
ⲛⲧⲁⲉⲗⲓⲥⲥⲁⲓⲟⲥ	ⲛ|ⲧⲁ|ⲉⲗⲓⲥⲥⲁⲓⲟⲥ	ⲛⲧ|ⲁ|ⲉⲗⲓⲥⲥⲁⲓⲟⲥ
ⲛϭⲉ	ⲛ|ϭⲉ	ⲛϭⲉ
ⲉⲡⲉⲧϩⲓⲧⲟⲩⲱϥ	ⲉ|ⲡ|ⲉⲧ|ϩⲓⲧⲟⲩⲱ|ϥ	ⲉ|ⲡ|ⲉⲧ|ϩⲓ|ⲧⲟⲩⲱ|ϥ
ⲉⲛⲉⲛϣⲏⲣⲉ	ⲉ|ⲛⲉⲛ|ϣⲏⲣⲉ	ⲉⲛⲉ|ⲛ|ϣⲏⲣⲉ
ⲛⲧⲁⲧⲉⲧⲛϫⲟⲟⲥ	ⲛⲧⲁ|ⲧⲉⲧⲛ|ϫⲟⲟ|ⲥ	ⲛⲧ|ⲁ|ⲧⲉⲧⲛ|ϫⲟⲟ|ⲥ
ⲉⲣⲟⲩϩⲉ	ⲉ|ⲣⲟⲩϩⲉ	ⲉ|ⲣ|ⲟⲩ|ϩⲉ
ⲉⲣⲡⲉⲧϩⲟⲟⲩ	ⲉ|ⲣ|ⲡⲉⲧϩⲟⲟⲩ	ⲉ|ⲣ|ⲡ|ⲉⲧ|ϩⲟⲟⲩ
ⲛⲛⲟⲩϥ	ⲛ|ⲛⲟⲩϥ	ⲛ|ⲛⲟⲩ|ϥ
ⲛⲧⲉⲧⲛϯ	ⲛ|ⲧⲉⲧⲛ|ϯ	ⲛⲧⲉⲧⲛ|ϯ
ⲧⲛⲁⲙⲉⲗⲉⲓ	ⲧⲛ|ⲁⲙⲉⲗⲉⲓ	ⲧ|ⲛ|ⲁⲙⲉⲗⲉⲓ
ⲛⲙⲡⲉⲧϩⲟⲟⲩ	ⲛ|ⲙ|ⲡⲉⲧϩⲟⲟⲩ	ⲛⲙ|ⲡⲉⲧϩⲟⲟⲩ
ⲉⲛⲉⲩⲛϣϭⲟⲙ	ⲉ|ⲛⲉ|ⲩ|ⲛ|ϣϭⲟⲙ	ⲉⲛⲉ|ⲩⲛ|ϣϭⲟⲙ
ⲉⲧⲉⲛⲇⲁⲓⲙⲱⲛ	ⲉ|ⲧⲉⲛ|ⲇⲁⲓⲙⲱⲛ	ⲉⲧⲉ|ⲛ|ⲇⲁⲓⲙⲱⲛ
ⲙⲛⲧϩⲉ	ⲙⲛ|ⲧ|ϩⲉ	ⲙⲛⲧ|ϩⲉ
ⲉⲕⲉⲕⲉⲣⲟⲥ	ⲉ|ⲕⲉⲕⲉⲣⲟⲥ	ⲉ|ⲕⲉ|ⲕⲉⲣⲟⲥ
ϩⲛϩⲉⲛϭⲓⲛⲟⲩⲱⲙ	ϩⲛ|ϩⲉⲛ|ϭⲓⲛⲟⲩⲱⲙ	ϩⲛ|ϩⲉⲛ|ϭⲓⲛ|ⲟⲩⲱⲙ
ϩⲛⲟⲩⲙⲛⲧⲁⲧϯϩⲧⲏϥ	ϩⲛ|ⲟⲩ|ⲙⲛⲧ|ⲁⲧϯϩⲧⲏ|ϥ	ϩⲛ|ⲟⲩ|ⲙⲛⲧⲁⲧϯ|ϩⲧⲏ|ϥ
ⲛⲙⲙⲛⲧϣⲁⲛⲁϩⲧⲏϥ	ⲛ|ⲙ|ⲙⲛⲧϣⲁⲛⲁϩⲧⲏ|ϥ	ⲛ|ⲙ|ⲙⲛⲧϣⲁⲛⲁ|ϩⲧⲏ|ϥ
ⲛⲁϣⲃⲟⲏⲑⲉⲓ	ⲛⲁ|ϣ|ⲃⲟⲏⲑⲉⲓ	ⲛⲁ|ϣⲃⲟⲏⲑⲉⲓ
ⲉⲛⲁϣⲱⲡⲉ	ⲉ|ⲛ|ⲁ|ϣⲱⲡⲉ	ⲉ|ⲛⲁ|ϣⲱⲡⲉ
ⲣⲟⲩ	ⲣ|ⲟⲩ	ⲣⲟⲩ
ⲉⲛⲁ	ⲉ|ⲛⲁ	ⲉⲛⲁ
ⲛⲟⲩⲛⲏⲥⲧⲉⲓⲁ	ⲛⲟⲩ|ⲛⲏⲥⲧⲉⲓⲁ	ⲛ|ⲟⲩ|ⲛⲏⲥⲧⲉⲓⲁ
ⲧⲉⲭⲣⲉⲓⲁ	ⲧⲉ|ⲭⲣⲉⲓⲁ	ⲧⲉⲭⲣⲉⲓⲁ
ⲛⲛⲉⲛⲧⲁⲕⲁⲁⲩ	ⲛ|ⲛ|ⲉⲛⲧ|ⲁ|ⲕ|ⲁⲁ|ⲩ	ⲛ|ⲛ|ⲉⲛⲧ|ⲁ|ⲕⲁⲁ|ⲩ
ⲉⲡⲏⲑⲩⲙⲉⲓ	ⲉⲡⲏⲑⲩⲙⲉⲓ	ⲉ|ⲡⲏⲑⲩⲙⲉⲓ
ⲛⲧⲁⲕϯϩⲏⲩ	ⲛⲧ|ⲁ|ⲕ|ϯϩⲏⲩ	ⲛⲧ|ⲁ|ⲕ|ϯ|ϩⲏⲩ
ⲛⲧⲉⲧⲛⲣⲧϩⲉ	ⲛ|ⲧⲉⲧⲛ|ⲣ|ⲧ|ϩⲉ	ⲛ|ⲧⲉⲧⲛ|ⲣⲧϩⲉ
ⲙⲁⲣⲛϯϩⲧⲏⲛ	ⲙⲁⲣ|ⲛ|ϯϩⲧⲏ|ⲛ	ⲙⲁⲣ|ⲛ|ϯ|ϩⲧⲏ|ⲛ
ϫⲓⲧ	ϫⲓ|ⲧ	ϫⲓⲧ
ⲉⲣⲙⲛⲧⲛⲁ	ⲉⲣ|ⲙⲛⲧⲛⲁ	ⲉ|ⲣⲙⲛⲧⲛⲁ
ⲙⲡⲣⲧⲣⲉⲛⲙⲉⲉⲩⲉ	ⲙⲡⲣ|ⲧⲣⲉ|ⲛ|ⲙⲉⲉⲩⲉ	ⲙⲡⲣⲧⲣⲉ|ⲛ|ⲙⲉⲉⲩⲉ
ⲉⲓⲱ	ⲉ|ⲓ|ⲱ	ⲉⲓⲱ
ⲉⲛⲁⲣⲟⲩ	ⲉ|ⲛ|ⲁ|ⲣⲟⲩ	ⲉ|ⲛⲁ|ⲣ|ⲟⲩ
[..]	[..]	..
ⲧϩⲉ	ⲧ|ϩⲉ	ⲧϩⲉ
ⲛⲥⲁ	ⲛ|ⲥⲁ	ⲛⲥⲁ
ⲉⲓⲥϩⲏⲏⲧⲉ	ⲉⲓⲥ|ϩⲏⲏⲧⲉ	ⲉⲓⲥϩⲏⲏⲧⲉ
ⲛⲁϣϭⲙϭⲟⲙ	ⲛⲁ|ϣϭⲙϭⲟⲙ	ⲛⲁ|ϣ|ϭⲙϭⲟⲙ
ⲙⲡⲓⲙⲟⲩ	ⲙⲡ|ⲓ|ⲙⲟⲩ	ⲙ|ⲡⲓ|ⲙⲟⲩ
ⲉⲧⲉⲧⲛϭⲱϣⲧ	ⲉ|ⲧⲉⲧⲛ|ϭⲱϣⲧ	ⲉⲧⲉ|ⲧⲛ|ϭⲱϣⲧ
ⲙⲛⲛⲉⲧⲛϩⲏⲧϥ	ⲙⲛ|ⲛⲉⲧⲛ|ϩⲏⲧϥ	ⲙⲛ|ⲛ|ⲉⲧ|ⲛϩⲏⲧ|ϥ
ⲉⲛⲧⲟⲟⲩ	ⲉ|ⲛⲧⲟⲟⲩ	ⲉ|ⲛ|ⲧⲟⲟⲩ
ⲉⲓⲛⲁⲣⲟⲩ	ⲉ|ⲓ|ⲛⲁ|ⲣⲟⲩ	ⲉ|ⲓ|ⲛⲁ|ⲣ|ⲟⲩ
ⲛⲧⲁⲡⲉⲭⲣⲓⲥⲧⲟⲥ	ⲛⲧ|ⲁ|ⲡⲉ|ⲭⲣⲓⲥⲧⲟⲥ	ⲛⲧⲁ|ⲡⲉ|ⲭⲣⲓⲥⲧⲟⲥ
ⲛⲁϣⲉ	ⲛⲁϣⲉ	ⲛⲁ|ϣⲉ
ⲛⲧⲁⲙⲓⲛⲉ	ⲛ|ⲧⲁ|ⲙⲓⲛⲉ	ⲛⲧⲁ|ⲙⲓⲛⲉ
ⲛⲟⲩⲁⲧⲟ	ⲛ|ⲟⲩ|ⲁⲧⲟ	ⲛⲟⲩ|ⲁⲧⲟ
ⲛⲛⲉⲧⲉⲛⲟⲩⲕ	ⲛ|ⲛ|ⲉⲧⲉ|ⲛⲟⲩⲕ	ⲛ|ⲛ|ⲉⲧⲉ|ⲛⲟⲩ|ⲕ
ⲛⲙⲡⲉⲣⲥⲟⲥ	ⲛ|ⲙ|ⲡⲉⲣⲥⲟⲥ	ⲛⲙ|ⲡⲉⲣⲥⲟⲥ
ⲛⲧⲁⲓⲏⲥⲟⲩⲥ	ⲛⲧⲁ|ⲓⲏⲥⲟⲩⲥ	ⲛⲧ|ⲁ|ⲓⲏⲥⲟⲩⲥ
ⲉⲧⲙⲛⲧⲥⲁⲃⲏ	ⲉ|ⲧⲙ|ⲛ|ⲧ|ⲥⲁⲃⲏ	ⲉ|ⲧ|ⲙⲛⲧⲥⲁⲃⲏ
ⲛⲧⲁⲡⲁⲡⲟⲥⲧⲟⲗⲟⲥ	ⲛⲧⲁ|ⲡ|ⲁⲡⲟⲥⲧⲟⲗⲟⲥ	ⲛⲧ|ⲁ|ⲡ|ⲁⲡⲟⲥⲧⲟⲗⲟⲥ
ⲛⲉϥϣⲗⲏⲗ	ⲛⲉ|ϥ|ϣⲗⲏⲗ	ⲛⲉϥ|ϣⲗⲏⲗ
ⲉⲧⲣⲉⲕϫⲓⲧ	ⲉ|ⲧⲣⲉ|ⲕ|ϫⲓⲧ	ⲉ|ⲧⲣⲉ|ⲕ|ϫⲓ|ⲧ
ⲛⲛⲁϩⲣⲛⲟⲩⲟⲛ	ⲛⲛⲁϩⲣⲛ|ⲟⲩⲟⲛ	ⲛ|ⲛⲁϩⲣⲛ|ⲟⲩⲟⲛ
ⲙⲡⲉϥⲕⲁⲧⲟⲟⲧϥ	ⲙⲡⲉ|ϥ|ⲕⲁⲧⲟⲟⲧ|ϥ	ⲙⲡⲉ|ϥ|ⲕⲁ|ⲧⲟⲟⲧ|ϥ
ⲙⲡⲉⲕⲟⲩⲱϣ	ⲙⲡⲉ|ⲕ|ⲟⲩⲱϣ	ⲙ|ⲡⲉⲕ|ⲟⲩⲱϣ
ⲙⲡⲱⲣϫ	ⲙ|ⲡ|ⲱⲣϫ	ⲙ|ⲡⲱⲣϫ
ⲛⲛⲉⲧⲉⲙⲉⲩⲛⲕⲟⲧⲕ	ⲛ|ⲛ|ⲉⲧⲉ|ⲙⲉ|ⲩ|ⲛⲕⲟⲧⲕ	ⲛ|ⲛ|ⲉⲧⲉ|ⲙⲉⲩ|ⲛⲕⲟⲧⲕ
ⲡⲡⲉⲧϩⲟⲟⲩ	ⲡ|ⲡ|ⲉⲧ|ϩⲟⲟⲩ	ⲡ|ⲡⲉⲧϩⲟⲟⲩ
ⲡⲡⲉⲧⲛⲁⲛⲟⲩϥ	ⲡ|ⲡⲉⲧⲛⲁⲛⲟⲩ|ϥ	ⲡ|ⲡⲉⲧⲛⲁⲛⲟⲩϥ
ⲉϩⲣⲁϥ	ⲉϩⲣⲁ|ϥ	ⲉ|ϩⲣⲁ|ϥ
ⲉⲧⲣⲉⲗⲁⲁⲩ	ⲉ|ⲧⲣⲉ|ⲗⲁⲁⲩ	ⲉⲧⲣⲉ|ⲗⲁⲁⲩ
ⲛⲙⲡⲁⲣⲁⲇⲟⲥⲓⲥ	ⲛ|ⲙ|ⲡⲁⲣⲁⲇⲟⲥⲓⲥ	ⲛⲙ|ⲡⲁⲣⲁⲇⲟⲥⲓⲥ
ⲁϥϫⲟⲟⲩⲥⲟⲩ	ⲁ|ϥ|ϫⲟ|ⲟⲩ|ⲥⲟⲩ	ⲁ|ϥ|ϫⲟⲟⲩ|ⲥⲟⲩ
ϫⲉϩⲁⲧϩⲏ	ϫⲉ|ϩⲁ|ⲧ|ϩⲏ	ϫⲉ|ϩⲁ|ⲧϩⲏ
ⲉⲥⲉⲓⲣⲉ	ⲉ|ⲥ|ⲉⲓⲣⲉ	ⲉⲥⲉ|ⲓⲣⲉ
ⲉⲣⲯⲩⲭⲏ	ⲉ|ⲣ|ⲯⲩⲭⲏ	ⲉ|ⲣⲯⲩⲭⲏ
ⲙⲛⲛⲉⲧⲙⲡⲉⲩϩⲟⲧ	ⲙⲛ|ⲛ|ⲉⲧ|ⲙ|ⲡⲉⲩ|ϩⲟⲧ	ⲙⲛ|ⲛ|ⲉⲧ|ⲙⲡⲉ|ⲩ|ϩⲟⲧ
ⲉⲁⲛⲅⲟⲩⲉⲛⲛⲟⲙⲟⲥ	ⲉ|ⲁⲛⲅ|ⲟⲩ|ⲉⲛⲛⲟⲙⲟⲥ	ⲉ|ⲁⲛⲅ|ⲟⲩ|ⲉ|ⲛ|ⲛⲟⲙⲟⲥ
ⲛⲧⲁϫⲱ	ⲛ|ⲧⲁ|ϫⲱ	ⲛⲧⲁ|ϫⲱ
ⲛⲁⲅⲁⲑⲱⲥ	ⲛ|ⲁⲅⲁⲑⲱⲥ	ⲛⲁⲅⲁⲑⲱⲥ
ⲛⲧⲁⲧⲁⲙⲱⲧⲛ	ⲛ|ⲧⲁ|ⲧⲁⲙⲱ|ⲧⲛ	ⲛⲧ|ⲁ|ⲧⲁⲙⲱ|ⲧⲛ
ϩⲛⲥⲟⲩϫⲟⲩⲧⲏ	ϩⲛ|ⲥⲟⲩϫⲟⲩⲧⲏ	ϩⲛ|ⲥⲟⲩ|ϫⲟⲩⲧⲏ
ⲉⲣⲱⲟⲩ	ⲉⲣⲱ|ⲟⲩ	ⲉ|ⲣⲱ|ⲟⲩ
ⲛⲧⲁϥϫⲟⲟⲩ	ⲛⲧ|ⲁ|ϥ|ϫⲟⲟ|ⲩ	ⲛⲧ|ⲁ|ϥ|ϫⲟ|ⲟⲩ
ⲛⲧⲁϫⲓⲧⲕ	ⲛ|ⲧⲁ|ϫⲓⲧ|ⲕ	ⲛⲧⲁ|ϫⲓⲧ|ⲕ
ϩⲟⲡⲟⲩ	ϩⲟⲡ|ⲟⲩ	ϩⲟⲡⲟⲩ
ⲛⲥⲱⲕ	ⲛⲥⲱ|ⲕ	ⲛ|ⲥⲱⲕ
ⲛⲣⲱⲟⲩ	ⲛ|ⲣⲱ|ⲟⲩ	ⲛ|ⲣⲱⲟⲩ
ⲉⲧϩⲛⲙⲡⲏⲩⲉ	ⲉⲧ|ϩⲛ|ⲙ|ⲡⲏⲩⲉ	ⲉⲧ|ϩⲛ|ⲙ|ⲡ|ⲏⲩⲉ
ⲉϩⲟⲩⲉ	ⲉϩⲟⲩⲉ	ⲉ|ϩⲟⲩⲉ
ϫⲉⲉⲓⲉⲛⲁⲩ	ϫⲉ|ⲉⲓⲉ|ⲛⲁⲩ	ϫⲉ|ⲉ|ⲓ|ⲉ|ⲛⲁⲩ
ⲥⲉϫⲓⲟⲩⲁ	ⲥⲉ|ϫⲓⲟⲩⲁ	ⲥⲉϫⲓⲟⲩⲁ
ϫⲉⲛⲉϣϣⲉ	ϫⲉⲛ|ⲉϣϣⲉ	ϫⲉ|ⲛ|ⲉϣϣⲉ
ⲥϩⲁⲓⲥⲟⲩ	ⲥϩⲁⲓⲥ|ⲟⲩ	ⲥϩⲁⲓ|ⲥⲟⲩ
ⲉⲧϭⲏⲛ	ⲉⲧ|ϭⲏⲛ	ⲉ|ⲧ|ϭⲏⲛ
ⲛⲧⲉϯⲱⲧⲉ	ⲛⲧⲉ|ϯ|ⲱⲧⲉ	ⲛⲧⲉ|ϯⲱⲧⲉ
ⲛϥϫⲟⲟⲩ	ⲛ|ϥ|ϫⲟⲟⲩ	ⲛ|ϥ|ϫⲟⲟ|ⲩ
ⲉⲧⲙⲉϩⲙⲛⲧⲥⲛⲟⲟⲩⲥ	ⲉⲧ|ⲙⲉϩⲙⲛⲧⲥⲛⲟⲟⲩⲥ	ⲉ|ⲧ|ⲙⲉϩⲙⲛⲧⲥⲛⲟⲟⲩⲥ
ⲡⲉϯⲛⲁⲁⲁϥ	ⲡⲉ|ϯ|ⲛⲁ|ⲁⲁ|ϥ	ⲡ|ⲉ|ϯ|ⲛⲁ|ⲁⲁ|ϥ
ⲡⲱϣⲥ	ⲡⲱϣ|ⲥ	ⲡⲱϣⲥ
ⲉⲥⲛⲏⲩ	ⲉ|ⲥ|ⲛⲏⲩ	ⲉ|ⲥⲛⲏⲩ
ⲉⲥⲁϩⲟⲩ	ⲉ|ⲥⲁϩⲟⲩ	ⲉ|ⲥⲁϩ|ⲟⲩ
ⲉϣⲡϩⲓⲥⲉ	ⲉ|ϣⲡϩⲓⲥⲉ	ⲉ|ϣⲡ|ϩⲓⲥⲉ
ⲛⲧⲉⲣⲟⲩⲣϩⲛⲁⲩ	ⲛⲧⲉⲣ|ⲟⲩ|ⲣ|ϩⲛⲁ|ⲩ	ⲛⲧⲉⲣ|ⲟⲩ|ⲣϩⲛⲁ|ⲩ
ϫⲉⲙⲡⲟⲩⲱϣ	ϫⲉ|ⲙ|ⲡ|ⲟⲩⲱϣ	ϫⲉ|ⲙⲡ|ⲟⲩ|ⲱϣ
ⲛⲛⲉⲛⲧⲁⲩϭⲁⲗⲱⲟⲩ	ⲛ|ⲛ|ⲉⲛⲧ|ⲁ|ⲩ|ϭⲁⲗⲱ|ⲟⲩ	ⲛ|ⲛⲉ|ⲛⲧ|ⲁ|ⲩ|ϭⲁⲗⲱ|ⲟⲩ
ⲙⲡⲉⲛⲣⲟⲟⲩϣ	ⲙ|ⲡⲉ|ⲛ|ⲣⲟⲟⲩϣ	ⲙ|ⲡⲉⲛ|ⲣⲟⲟⲩϣ
ⲙⲙⲁⲁⲩ	ⲙ|ⲙⲁⲁⲩ	ⲙⲙⲁⲁⲩ
ⲟⲩⲟⲉⲓⲕ	ⲟⲩ|ⲟⲉⲓⲕ	ⲟⲩⲟⲉⲓⲕ
ⲩⲩ	ⲩⲩ	ⲩ|ⲩ
ⲙⲡⲉⲧⲛⲁⲛⲟⲩϥ	ⲙ|ⲡ|ⲉⲧ|ⲛⲁⲛⲟⲩ|ϥ	ⲙ|ⲡⲉⲧⲛⲁⲛⲟⲩϥ
ⲉⲧⲟⲩⲧ	ⲉⲧⲟⲩⲧ	ⲉⲧ|ⲟⲩⲧ
ⲙⲡⲙⲉϩⲥⲡⲥⲛⲁⲩ	ⲙ|ⲡ|ⲙⲉϩⲥⲡⲥⲛⲁⲩ	ⲙ|ⲡ|ⲙⲉϩ|ⲥⲡ|ⲥⲛⲁⲩ
ⲁⲩⲥⲁⲛⲟⲩϣⲧ	ⲁ|ⲩ|ⲥⲁⲛⲟⲩϣⲧ	ⲁ|ⲩ|ⲥⲁⲛⲟⲩϣ|ⲧ
ⲉⲡⲱⲛⲩⲭⲟⲥ	ⲉ|ⲡⲱⲛⲩⲭⲟⲥ	ⲉⲡⲱⲛⲩⲭⲟⲥ
ⲉⲡⲉⲥϩⲁⲓ	ⲉ|ⲡⲉⲥ|ϩⲁⲓ	ⲉ|ⲡⲉ|ⲥϩⲁⲓ
ⲉⲧⲉⲧⲛⲟ	ⲉ|ⲧⲉⲧⲛ|ⲟ	ⲉⲧⲉⲧⲛ|ⲟ
ⲛⲧⲉⲧⲛⲥⲟⲟⲩⲛ	ⲛ|ⲧⲉⲧⲛ|ⲥⲟⲟⲩⲛ	ⲛⲧⲉⲧⲛ|ⲥⲟⲟⲩⲛ
ⲛⲛⲁϩⲣⲙⲡϩⲟ	ⲛⲛⲁϩⲣⲙ|ⲡ|ϩⲟ	ⲛ|ⲛⲁϩⲣⲙ|ⲡ|ϩⲟ
ⲉⲛⲉⲥⲱⲟⲩ	ⲉ|ⲛⲉⲥⲱ|ⲟⲩ	ⲉⲛⲉ|ⲥⲱ|ⲟⲩ
ⲛⲁⲡϣⲁⲩ	ⲛ|ⲁ|ⲡϣⲁⲩ	ⲛⲁ|ⲡ|ϣⲁⲩ	ⲛⲁⲡϣⲁⲩ	ⲛ|ⲁ|ⲡ|ϣⲁⲩ
ⲉⲡⲉⲓⲧⲏⲙⲁ	ⲉ|ⲡⲉⲓⲧⲏⲙⲁ	ⲉⲡⲉⲓⲧⲏⲙⲁ
ⲁⲧⲉⲩⲛⲟⲩ	ⲁ|ⲧⲉ|ⲩⲛⲟⲩ	ⲁ|ⲧⲉⲩⲛⲟⲩ
ⲁⲩⲥⲟϣϥ	ⲁ|ⲩ|ⲥⲟϣ|ϥ	ⲁ|ⲩ|ⲥⲟϣϥ
ⲉϣϥⲓ	ⲉϣ|ϥⲓ	ⲉ|ϣ|ϥⲓ	ⲉ|ϣϥⲓ
ⲉⲣⲱⲛ	ⲉⲣⲱ|ⲛ	ⲉ|ⲣⲱⲛ
ⲙⲡⲉϥⲣⲗⲁⲁⲩ	ⲙ|ⲡⲉϥ|ⲣⲗⲁⲁⲩ	ⲙⲡⲉ|ϥ|ⲣⲗⲁⲁⲩ	ⲙⲡⲉ|ϥ|ⲣ|ⲗⲁⲁⲩ
ⲙⲡⲕⲁⲧⲁⲡⲉⲧⲁⲥⲙⲁ	ⲙ|ⲡ|ⲕⲁⲧⲁⲡⲉⲧⲁⲥⲙⲁ	ⲙ|ⲡ|ⲕⲁⲧⲁ|ⲡⲉⲧⲁⲥⲙⲁ
ⲙⲛⲡⲛⲟⲩⲧⲉ	ⲙⲛ|ⲡ|ⲛⲟⲩⲧⲉ	ⲙ|ⲛ|ⲡ|ⲛⲟⲩⲧⲉ
ⲛⲧⲉⲛⲫⲩⲥⲓⲥ	ⲛ|ⲧⲉⲛ|ⲫⲩⲥⲓⲥ	ⲛⲧⲉ|ⲛ|ⲫⲩⲥⲓⲥ
ⲉⲧⲛⲁϣⲱϥ	ⲉⲧ|ⲛⲁϣⲱ|ϥ	ⲉⲧ|ⲛⲁ|ϣⲱϥ
ⲉϥⲣⲡⲉⲧⲛⲁⲛⲟⲩϥ	ⲉ|ϥ|ⲣ|ⲡ|ⲉⲧ|ⲛⲁⲛⲟⲩ|ϥ	ⲉ|ϥ|ⲣ|ⲡⲉⲧⲛⲁⲛⲟⲩ|ϥ
ⲧⲃⲱ	ⲧⲃⲱ	ⲧ|ⲃⲱ
ϩⲛⲛⲉⲛⲧⲁⲛϫⲟⲟⲩ	ϩⲛ|ⲛ|ⲉⲛⲧ|ⲁ|ⲛ|ϫⲟⲟ|ⲩ	ϩⲛ|ⲛ|ⲉⲛⲧ|ⲁ|ⲛ|ϫⲟ|ⲟⲩ
ⲙⲡⲁϩⲟ	ⲙ|ⲡ|ⲁϩⲟ	ⲙ|ⲡⲁ|ϩⲟ
ϫⲉϯⲛⲏⲩ	ϫⲉ|ϯ|ⲛⲏⲩ	ϫⲉ|ϯⲛⲏⲩ
ⲙⲙⲟⲥ	ⲙⲙⲟ|ⲥ	ⲙⲙⲟⲥ
ⲉⲧⲉϩⲛⲁⲓ	ⲉ|ⲧⲉ|ϩⲛⲁⲓ	ⲉⲧⲉ|ϩⲛⲁ|ⲓ
ⲥⲟϣϥ	ⲥⲟϣ|ϥ	ⲥⲟϣϥ
ⲉⲧⲣⲉϫⲡⲟ	ⲉ|ⲧⲣ|ⲉ|ϫⲡⲟ	ⲉ|ⲧⲣⲉ|ϫⲡⲟ
ⲛⲧⲁⲣⲣⲁⲧⲥⲟⲟⲩⲛ	ⲛⲧ|ⲁⲣ|ⲣⲁⲧⲥⲟⲟⲩⲛ	ⲛⲧ|ⲁ|ⲣ|ⲣⲁⲧⲥⲟⲟⲩⲛ
ⲉⲛⲉϩⲉⲛⲣⲉϥϫⲓⲟⲩⲉ	ⲉⲛⲉ|ϩⲉ|ⲛ|ⲣⲉϥϫⲓⲟⲩⲉ	ⲉ|ⲛⲉ|ϩⲉⲛ|ⲣⲉϥϫⲓⲟⲩⲉ
ⲛⲧⲟⲟⲧⲉ	ⲛⲧⲟⲟⲧ|ⲉ	ⲛ|ⲧⲟⲟⲧ|ⲉ
ⲉⲧⲃⲉϫⲉⲁⲣⲙⲉⲣⲉϩⲉⲛϣⲙⲙⲟ	ⲉⲧⲃⲉ|ϫⲉ|ⲁⲣ|ⲙⲉⲣⲉ|ϩⲉⲛ|ϣⲙⲙⲟ	ⲉⲧⲃⲉ|ϫⲉ|ⲁ|ⲣ|ⲙⲉⲣⲉ|ϩⲉⲛ|ϣⲙⲙⲟ
ⲁⲣⲧⲁϣⲟ	ⲁⲣ|ⲧⲁϣⲟ	ⲁ|ⲣ|ⲧⲁϣⲟ
[...]	[...]	...
ⲟⲩⲕⲟⲩⲛ	ⲟⲩⲕ|ⲟⲩⲛ	ⲟⲩⲕⲟⲩⲛ
ⲛ...	ⲛ|...	ⲛ...
ⲥⲛⲏⲩ	ⲥ|ⲛⲏⲩ	ⲥⲛⲏⲩ
ⲁϥϫⲟⲟⲩ	ⲁ|ϥ|ϫⲟⲟⲩ	ⲁ|ϥ|ϫⲟ|ⲟⲩ
ϫⲉⲙⲛⲧⲁⲓϩⲱⲃ	ϫⲉ|ⲙⲛ|ⲧⲁⲓ|ϩⲱⲃ	ϫⲉ|ⲙⲛⲧⲁ|ⲓ|ϩⲱⲃ
ⲟⲩⲱⲛ	ⲟⲩⲱⲛ	ⲟⲩⲱ|ⲛ
ϩⲛⲛⲉⲩϣⲟⲟⲩⲉ	ϩⲛ|ⲛⲉ|ⲩϣⲟⲟⲩⲉ	ϩⲛ|ⲛⲉⲩ|ϣⲟⲟⲩⲉ
ⲙⲛⲟⲩϩⲓⲥⲉ	ⲙⲛ|ⲟⲩ|ϩⲓⲥⲉ	ⲙ|ⲛⲟⲩ|ϩⲓⲥⲉ
ⲉⲡⲉⲥⲧⲁⲩⲣⲟⲥ	ⲉ|ⲡⲉ|ⲥⲧⲁⲩⲣⲟⲥ	ⲉⲡⲉ|ⲥⲧⲁⲩⲣⲟⲥ
ϫⲉⲙⲛϣϭⲟⲙ	ϫⲉ|ⲙⲛ|ϣϭⲟⲙ	ϫⲉ|ⲙⲛ|ϣ|ϭⲟⲙ
ϩⲛⲟⲩ	ϩⲛ|ⲟⲩ	ϩⲛⲟⲩ
ϩⲓⲧϩⲏ	ϩⲓ|ⲧ|ϩⲏ	ϩⲓⲧϩⲏ
ϫⲉⲕⲁⲁⲧ	ϫⲉ|ⲕⲁⲁ|ⲧ	ϫⲉ|ⲕⲁⲁⲧ
ϯⲧϩⲉ	ϯ|ⲧ|ϩⲉ	ϯⲧϩⲉ
ⲡⲡⲉⲧⲟⲩⲁⲁⲃ	ⲡ|ⲡⲉⲧⲟⲩⲁⲁⲃ	ⲡ|ⲡ|ⲉⲧ|ⲟⲩⲁⲁⲃ
ⲙⲡϩⲏⲧ	ⲙ|ⲡ|ϩⲏⲧ	ⲙ|ⲡϩⲏⲧ
ⲉⲩϯⲉⲟⲟⲩ	ⲉ|ⲩ|ϯⲉⲟⲟⲩ	ⲉ|ⲩ|ϯ|ⲉⲟⲟⲩ
ⲡⲟⲥⲟ	ⲡⲟⲥⲟ	ⲡ|ⲟⲥⲟ
ⲛⲅϣⲛϩⲧⲏⲕ	ⲛ|ⲅ|ϣⲛϩⲧⲏ|ⲕ	ⲛ|ⲅ|ϣⲛ|ϩⲧⲏ|ⲕ
ⲧⲉⲛⲧⲁⲥⲛⲁϩⲙⲉ	ⲧ|ⲉⲛⲧ|ⲁ|ⲥ|ⲛⲁϩⲙ|ⲉ	ⲧⲉ|ⲛⲧ|ⲁ|ⲥ|ⲛⲁϩⲙⲉ
ⲉⲧϩⲓϩⲏ	ⲉ|ⲧ|ϩⲓϩⲏ	ⲉⲧ|ϩⲓϩⲏ
ϫⲉⲙⲁⲧⲁⲙⲟⲓ	ϫⲉ|ⲙⲁ|ⲧⲁⲙⲟ|ⲓ	ϫⲉ|ⲙⲁⲧⲁⲙⲟ|ⲓ
ⲛⲧⲛϫⲱ	ⲛ|ⲧⲛ|ϫⲱ	ⲛⲧ|ⲛ|ϫⲱ
ⲁϥⲛⲟϫⲧ	ⲁ|ϥ|ⲛⲟϫⲧ	ⲁ|ϥ|ⲛⲟϫ|ⲧ
ϣⲁⲉϩⲣⲁⲓ	ϣⲁ|ⲉϩⲣⲁⲓ	ϣⲁⲉϩⲣⲁⲓ
ⲙⲡⲓϩⲉ	ⲙⲡ|ⲓ|ϩⲉ	ⲙ|ⲡⲓ|ϩⲉ
ⲙⲙⲛⲧⲁϥⲧⲉ	ⲙ|ⲙⲛⲧⲁ|ϥⲧⲉ	ⲙ|ⲙⲛⲧⲁϥⲧⲉ
ϫⲉⲛⲧⲉⲩⲛⲟⲩ	ϫⲉ|ⲛ|ⲧⲉ|ⲩⲛⲟⲩ	ϫⲉ|ⲛ|ⲧ|ⲉⲩⲛⲟⲩ
ⲛⲉⲧⲁⲣⲭⲏ	ⲛⲉ|ⲧ|ⲁⲣⲭⲏ	ⲛ|ⲉⲧ|ⲁⲣⲭⲏ
ⲛⲧⲁⲛϫⲟⲟⲩ	ⲛⲧ|ⲁ|ⲛ|ϫⲟ|ⲟⲩ	ⲛⲧ|ⲁ|ⲛ|ϫⲟⲟ|ⲩ
ⲡⲁⲡⲉⲗⲉⲩⲑⲉⲣⲟⲥ	ⲡⲁ|ⲡ|ⲉⲗⲉⲩⲑⲉⲣⲟⲥ	ⲡ|ⲁⲡⲉⲗⲉⲩⲑⲉⲣⲟⲥ
ⲧⲉⲛⲧⲁⲥϫⲓϩⲁⲓ	ⲧ|ⲉⲛⲧ|ⲁ|ⲥ|ϫⲓ|ϩⲁⲓ	ⲧ|ⲉⲛⲧ|ⲁ|ⲥ|ϫⲓϩⲁⲓ
ⲙⲛⲧϭⲓⲛⲁϩⲉⲣⲁⲧⲕ	ⲙⲛ|ⲧ|ϭⲓⲛⲁϩⲉⲣⲁⲧ|ⲕ	ⲙⲛ|ⲧ|ϭⲓⲛⲁϩⲉⲣⲁⲧⲕ
ⲉⲧⲉϩⲛⲁϥ	ⲉⲧⲉ|ϩⲛⲁ|ϥ	ⲉ|ⲧⲉ|ϩⲛⲁϥ	ⲉⲧⲉ|ϩⲛⲁϥ
ⲙⲡⲛⲟⲩⲧⲉ	ⲙ|ⲡ|ⲛⲟⲩⲧⲉ	ⲙ|ⲡⲛⲟⲩⲧⲉ
ⲉϫⲱⲕ	ⲉϫⲱ|ⲕ	ⲉ|ϫⲱⲕ
ⲛⲉϥϣⲁϫⲉ	ⲛⲉ|ϥ|ϣⲁϫⲉ	ⲛⲉϥ|ϣⲁϫⲉ
ⲙⲡⲉⲩϭⲙⲡϣⲓⲛⲉ	ⲙⲡⲉ|ⲩ|ϭⲙ|ⲡ|ϣⲓⲛⲉ	ⲙ|ⲡⲉⲩ|ϭⲙⲡϣⲓⲛⲉ
ⲉⲧⲱϥ	ⲉ|ⲧⲱϥ	ⲉ|ⲧⲱ|ϥ
ϯϩⲧⲏⲕ	ϯ|ϩⲧⲏ|ⲕ	ϯϩⲧⲏ|ⲕ
ⲛϩⲏⲩ	ⲛ|ϩⲏⲩ	ⲛϩⲏ|ⲩ
ⲙⲛⲛϣⲏⲣⲉ	ⲙⲛ|ⲛ|ϣⲏⲣⲉ	ⲙⲛ|ⲛϣⲏⲣⲉ
ϯⲛⲁⲁⲁⲩ	ϯ|ⲛⲁ|ⲁⲁ|ⲩ	ϯ|ⲛⲁ|ⲁ|ⲁⲩ
ⲙⲛⲧϭⲓⲛⲱⲛϩ	ⲙⲛ|ⲧ|ϭⲓⲛ|ⲱⲛϩ	ⲙⲛ|ⲧ|ϭⲓⲛⲱⲛϩ
ϫⲉⲙⲡⲉⲓⲥⲱⲧⲙ	ϫⲉ|ⲙⲡ|ⲉⲓ|ⲥⲱⲧⲙ	ϫⲉ|ⲙ|ⲡⲉⲓ|ⲥⲱⲧⲙ
ⲡⲟⲩⲣⲟⲧ	ⲡ|ⲟⲩⲣⲟⲧ	ⲡⲟⲩⲣⲟⲧ
ⲉⲧⲉⲕⲉⲓⲣⲉ	ⲉⲧⲉ|ⲕ|ⲉⲓⲣⲉ	ⲉⲧ|ⲉ|ⲕ|ⲉⲓⲣⲉ
ⲙⲛⲧⲣⲙⲙⲁⲟ	ⲙⲛ|ⲧ|ⲣⲙⲙⲁⲟ	ⲙⲛⲧ|ⲣⲙⲙⲁⲟ
ⲙⲁⲣⲛϫⲟⲟⲩ	ⲙⲁⲣ|ⲛ|ϫⲟⲟ|ⲩ	ⲙⲁⲣ|ⲛ|ϫⲟⲟⲩ
ⲛⲧⲉⲧⲛⲣⲟⲉⲓⲥ	ⲛ|ⲧⲉⲧⲛ|ⲣⲟⲉⲓⲥ	ⲛⲧⲉⲧⲛ|ⲣⲟⲉⲓⲥ
ϫⲉⲛⲧⲉⲧⲛⲥⲟⲟⲩⲛ	ϫⲉ|ⲛ|ⲧⲉⲧⲛ|ⲥⲟⲟⲩⲛ	ϫⲉ|ⲛⲧⲉⲧⲛ|ⲥⲟⲟⲩⲛ
ⲁⲓⲣⲧϩⲉ	ⲁ|ⲓ|ⲣ|ⲧ|ϩⲉ	ⲁ|ⲓ|ⲣⲧϩⲉ
ⲛϩⲣⲁϥ	ⲛ|ϩⲣⲁ|ϥ	ⲛ|ϩⲣⲁϥ
ϫⲓⲛⲧⲉⲩⲛⲟⲩ	ϫⲓⲛ|ⲧⲉ|ⲩⲛⲟⲩ	ϫⲓⲛ|ⲧ|ⲉⲩⲛⲟⲩ
ⲛϣⲁⲃⲉϩⲟ	ⲛ|ϣⲁⲃⲉ|ϩⲟ	ⲛ|ϣⲁⲃⲉϩⲟ
ⲉⲕϫⲓⲙⲏⲥⲉ	ⲉ|ⲕ|ϫⲓ|ⲙⲏⲥⲉ	ⲉ|ⲕ|ϫⲓⲙⲏⲥⲉ
ϫⲉⲛⲉϥⲟⲩⲱϣ	ϫⲉ|ⲛⲉ|ϥ|ⲟⲩⲱϣ	ϫⲉ|ⲛⲉϥ|ⲟⲩⲱϣ
ⲙⲛⲟⲩⲙⲛⲧϣⲁⲛϩⲧⲏϥ	ⲙⲛ|ⲟⲩ|ⲙⲛⲧϣⲁⲛϩⲧⲏϥ	ⲙⲛ|ⲟⲩ|ⲙⲛⲧϣⲁⲛϩⲧⲏ|ϥ
ⲛⲉϣⲱⲧ	ⲛ|ⲉϣⲱⲧ	ⲛⲉ|ϣⲱⲧ
ⲛⲛⲉⲛⲧⲁⲩⲉⲓ	ⲛ|ⲛ|ⲉⲛⲧ|ⲁ|ⲩ|ⲉⲓ	ⲛⲛⲉ|ⲛ|ⲧⲁⲩⲉ|ⲓ
ⲉⲛⲉⲛⲧⲁϥϫⲟⲟⲩ	ⲉ|ⲛ|ⲉⲛⲧ|ⲁ|ϥ|ϫⲟⲟ|ⲩ	ⲉ|ⲛ|ⲉⲛⲧ|ⲁ|ϥ|ϫⲟⲟⲩ
ⲙⲡⲁϭⲙⲡϣⲓⲛⲉ	ⲙ|ⲡⲁ|ϭⲙⲡϣⲓⲛⲉ	ⲙ|ⲡⲁ|ϭⲙ|ⲡ|ϣⲓⲛⲉ
ⲉⲡⲉϩⲟⲟⲩ	ⲉ|ⲡⲉ|ϩⲟⲟⲩ	ⲉ|ⲡ|ⲉϩⲟⲟⲩ
ⲉϩⲏⲧϥ	ⲉ|ϩⲏⲧ|ϥ	ⲉ|ϩⲏⲧϥ
ϩⲙⲡⲉⲧϩⲟⲟⲩ	ϩⲙ|ⲡ|ⲉⲧ|ϩⲟⲟⲩ	ϩⲙ|ⲡⲉⲧϩⲟⲟⲩ
ⲥⲱⲣⲙ	ⲥ|ⲱⲣⲙ	ⲥⲱⲣⲙ
ϩⲓⲡⲉⲥⲧⲁⲩⲣⲟⲥ	ϩⲓ|ⲡⲉ|ⲥⲧⲁⲩⲣⲟⲥ	ϩⲓ|ⲡⲉⲥⲧⲁⲩⲣⲟⲥ
ⲛⲟⲩϫⲁⲓ	ⲛ|ⲟⲩϫⲁⲓ	ⲛ|ⲟⲩ|ϫⲁⲓ
ⲉⲛⲧⲟϥ	ⲉⲛⲧⲟϥ	ⲉ|ⲛⲧⲟϥ
ⲛⲟⲩⲡⲛⲟⲏ	ⲛ|ⲟⲩ|ⲡⲛⲟⲏ	ⲛ|ⲟⲩ|ⲡ|ⲛⲟⲏ
ⲙⲡⲟⲩⲡⲓⲥⲧⲉⲩⲉ	ⲙⲡ|ⲟⲩ|ⲡⲓⲥⲧⲉⲩⲉ	ⲙ|ⲡ|ⲟⲩ|ⲡⲓⲥⲧⲉⲩⲉ
ⲉⲛⲉⲓⲟ	ⲉ|ⲛⲉ|ⲓ|ⲟ	ⲉ|ⲛ|ⲉⲓ|ⲟ
ⲛϣⲃⲣⲣϩⲱⲃ	ⲛ|ϣⲃⲣⲣϩⲱⲃ	ⲛ|ϣⲃⲣ|ⲣϩⲱⲃ
ⲉⲛⲉⲙⲡⲉⲡϫⲟⲉⲓⲥ	ⲉⲛⲉ|ⲙⲡⲉ|ⲡ|ϫⲟⲉⲓⲥ	ⲉ|ⲛⲉ|ⲙⲡⲉ|ⲡ|ϫⲟⲉⲓⲥ
ⲉⲥⲛⲁⲩ	ⲉ|ⲥ|ⲛⲁⲩ	ⲉ|ⲥⲛⲁⲩ
ⲛⲁⲧⲃⲱⲗ	ⲛⲁ|ⲧ|ⲃⲱⲗ	ⲛ|ⲁⲧⲃⲱⲗ
ϫⲓⲛⲛⲧⲉϩⲟⲩⲉⲓⲧⲉ	ϫⲓⲛ|ⲛ|ⲧⲉ|ϩⲟⲩⲉⲓⲧⲉ	ϫⲓⲛⲛ|ⲧⲉ|ϩⲟⲩⲉⲓⲧⲉ
ⲁⲩⲙⲟⲣⲥ	ⲁ|ⲩ|ⲙⲟⲣⲥ	ⲁ|ⲩ|ⲙⲟⲣ|ⲥ
ⲙⲛϯⲱⲧⲉ	ⲙⲛ|ϯ|ⲱⲧⲉ	ⲙⲛ|ϯⲱⲧⲉ
ⲛⲧⲁⲛ	ⲛⲧⲁ|ⲛ	ⲛ|ⲧⲁ|ⲛ
ⲉⲧⲁϩⲉⲣⲁⲧⲟⲩ	ⲉⲧ|ⲁϩⲉ|ⲣⲁⲧ|ⲟⲩ	ⲉ|ⲧⲁϩⲉ|ⲣⲁⲧ|ⲟⲩ
ⲙⲡⲉⲛϭⲙⲡϣⲓⲛⲉ	ⲙⲡⲉ|ⲛ|ϭⲙ|ⲡ|ϣⲓⲛⲉ	ⲙ|ⲡⲉⲛ|ϭⲙⲡϣⲓⲛⲉ
ⲁⲣⲓⲡⲙⲉⲉⲩⲉ	ⲁⲣⲓ|ⲡ|ⲙⲉⲉⲩⲉ	ⲁⲣ|ⲓ|ⲡ|ⲙⲉⲉⲩⲉ
ⲛⲁⲣϣⲓⲃⲉ	ⲛⲁ|ⲣϣⲓⲃⲉ	ⲛⲁ|ⲣ|ϣⲓⲃⲉ
ⲛⲟⲩϭⲥ	ⲛ|ⲟⲩϭⲥ	ⲛⲟⲩϭⲥ
ϩⲛⲛⲉⲧⲉⲛⲟⲩϥ	ϩⲛ|ⲛ|ⲉⲧⲉ|ⲛⲟⲩϥ	ϩⲛ|ⲛ|ⲉⲧⲉ|ⲛⲟⲩ|ϥ
ⲉⲧⲉⲧⲛⲧⲁϣⲉⲟⲉⲓϣ	ⲉ|ⲧⲉⲧⲛ|ⲧⲁϣⲉ|ⲟⲉⲓϣ	ⲉ|ⲧⲉⲧⲛ|ⲧⲁϣⲉⲟⲉⲓϣ
ϫⲓⲟⲩⲟⲉⲓⲛ	ϫⲓⲟⲩⲟⲉⲓⲛ	ϫⲓ|ⲟⲩⲟⲉⲓⲛ
ⲉⲛⲁⲥⲟⲟⲩ	ⲉ|ⲛⲁ|ⲥⲟⲟⲩ	ⲉ|ⲛ|ⲁ|ⲥⲟⲟⲩ
ⲙⲡⲁⲧⲉⲧⲛⲁⲓⲧⲉⲓ	ⲙⲡⲁⲧⲉⲧⲛ|ⲁⲓⲧⲉⲓ	ⲙⲡⲁⲧⲉ|ⲧⲛ|ⲁⲓⲧⲉⲓ
ⲛⲱϩⲉ	ⲛⲱϩⲉ	ⲛ|ⲱϩⲉ
ⲉⲛⲱϩⲉ	ⲉ|ⲛⲱϩⲉ	ⲉ|ⲛ|ⲱϩⲉ
ⲛⲣⲡⲙⲉⲉⲩⲉ	ⲛ|ⲣⲡⲙⲉⲉⲩⲉ	ⲛ|ⲣ|ⲡ|ⲙⲉⲉⲩⲉ
ⲛⲛⲉⲧⲛⲁⲛⲟⲩⲟⲩ	ⲛ|ⲛ|ⲉⲧ|ⲛⲁ|ⲛⲟⲩ|ⲟⲩ	ⲛ|ⲛ|ⲉⲧ|ⲛⲁⲛⲟⲩ|ⲟⲩ
