·ⲻ	PUNCT	·ⲻ
·	PUNCT	·
·	UNKNOWN	·
Φαμενωθ	FM	Φαμενωθ
β	FM	β
γ	FM	γ
θἰνδικτίονος	FM	θἰνδικτίονος
ο	FM	ο
ϣϣⲉ	N	ϣϣⲉ
ϣϣⲉ	V	ϣϣⲉ
ϣϥⲉ	N	ϣϥⲉ
ϣϥⲉ	NUM	ϣϥⲉ
ϣϥ	V	ϣϥ
ϣϫⲁϩⲙ	V	ϣϫⲁϩⲙ
ϣϫⲉ	N	ϣϫⲉ
ϣϫⲏⲩ	N	ϣϫⲉ
ϣϭⲁ	V	ϣⲱⲱϭⲉ
ϣϭⲙϭⲟⲙ	N	ϣϭⲙϭⲟⲙ
ϣϭⲙϭⲟⲙ	V	ϣϭⲙϭⲟⲙ
ϣϭⲟⲙ	N	ϣϭⲟⲙ
ϣϭⲟⲙ	V	ϣϭⲟⲙ
ϣⲁϣ	N	ϣⲁϣ
ϣⲁϥⲉ	V	ϣⲁϥⲉ
ϣⲁϥⲧⲉ	N	ϣⲁϥⲧⲉ
ϣⲁϩⲉ	V	ϣⲁϩⲉ
ϣⲁϩⲛⲕⲱϩⲧ	N	ϣⲁϩⲛⲕⲱϩⲧ
ϣⲁϩⲛⲥⲁⲧⲉ	N	ϣⲁϩⲛⲥⲁⲧⲉ
ϣⲁϩⲟⲩⲛ	ADV	ϣⲁϩⲟⲩⲛ
ϣⲁϩⲟⲩⲛ	PREP	ϣⲁϩⲟⲩⲛ
ϣⲁϩⲣⲁⲓⲉⲡⲟⲟⲩⲛϩⲟⲟⲩ	ADV	ϣⲁϩⲣⲁⲓⲉⲡⲟⲟⲩⲛϩⲟⲟⲩ
ϣⲁϩⲣⲁⲓ	ADV	ϣⲁϩⲣⲁⲓ
ϣⲁϩ	N	ϣⲁϩ
ϣⲁϩ	V	ϣⲁϩ
ϣⲁϫⲉ	N	ϣⲁϫⲉ
ϣⲁϫⲉ	V	ϣⲁϫⲉ
ϣⲁⲁϥ	N	ϣⲁⲁϥ
ϣⲁⲁⲛⲧ	N	ϣⲁ
ϣⲁⲁⲣ	N	ϣⲁⲁⲣ
ϣⲁⲁⲧ	V	ϣⲓⲧⲉ
ϣⲁⲁⲧ	VSTAT	ϣⲓⲧⲉ
ϣⲁⲁ	V	ϣⲁⲁ
ϣⲁⲃⲟⲗ	ADV	ϣⲁⲃⲟⲗ
ϣⲁⲉϩⲣⲁⲓ	ADV	ϣⲁⲉϩⲣⲁⲓ
ϣⲁⲉⲓ	N	ϣⲁⲉⲓ
ϣⲁⲓⲣⲉ	N	ϣⲁⲓⲣⲉ
ϣⲁⲓ	N	ϣⲁⲓ
ϣⲁⲕⲧ	V	ϣⲁⲕⲧ
ϣⲁⲗⲛⲃⲏⲧ	N	ϣⲁⲗⲛⲃⲏⲧ
ϣⲁⲗ	N	ϣⲁⲗ
ϣⲁⲛϩⲏⲧ	N	ϣⲁⲛϩⲏⲧ
ϣⲁⲛⲁϩⲧⲏϥ	N	ϣⲁⲛⲁϩⲧⲏϥ
ϣⲁⲛⲧⲉⲟⲩϣⲱⲡⲉ	ADV	ϣⲁⲛⲧⲉⲟⲩϣⲱⲡⲉ
ϣⲁⲛⲧⲉ	ALIM	ϣⲁⲛⲧⲉ
ϣⲁⲛⲧ	ALIM	ϣⲁⲛⲧⲉ
ϣⲁⲛⲧ	N	ϣⲁⲛⲧ
ϣⲁⲛ	ACOND	ϣⲁⲛ
ϣⲁⲛ	CCOND	ϣⲁⲛ
ϣⲁⲛ	N	ϣⲁⲛ
ϣⲁⲛ	V	ϣⲁⲛ
ϣⲁⲡⲉⲓⲙⲁ	ADV	ϣⲁⲡⲉⲓⲙⲁ
ϣⲁⲣⲉ	AAOR	ϣⲁⲣⲉ
ϣⲁⲣⲉ	V	ϣⲁⲁⲣⲉ
ϣⲁⲣⲟ	PREP	ϣⲁ
ϣⲁⲣⲡ	N	ϣⲁⲣⲡ
ϣⲁⲣⲱ	PREP	ϣⲁ
ϣⲁⲣⲱ	V	ϣⲁⲁⲣⲉ
ϣⲁⲥⲱⲛⲧ	N	ϣⲁⲥⲱⲛⲧ
ϣⲁⲧⲛⲁⲩ	ADV	ϣⲁⲧⲛⲁⲩ
ϣⲁⲧⲛ	PREP	ϣⲁⲧⲛ
ϣⲁⲧⲟⲩ	V	ϣⲁⲧⲟⲩ
ϣⲁⲧ	V	ϣⲓⲧⲉ
ϣⲁⲩ	N	ϣⲁⲩ
ϣⲁ	AAOR	ϣⲁⲣⲉ
ϣⲁ	N	ϣⲁ
ϣⲁ	PREP	ϣⲁ
ϣⲁ	V	ϣⲁ
ϣⲃⲃⲓⲱ	N	ϣⲃⲃⲓⲱ
ϣⲃⲃ	V	ϣⲓⲃⲉ
ϣⲃⲉⲉⲣ	N	ϣⲃⲉⲉⲣ
ϣⲃⲉⲓⲱ	N	ϣⲃⲉⲓⲱ
ϣⲃⲉ	N	ϣⲃⲉ
ϣⲃⲏⲣⲕⲗⲏⲣⲟⲛⲟⲙⲟⲥ	N	ϣⲃⲏⲣⲕⲗⲏⲣⲟⲛⲟⲙⲟⲥ
ϣⲃⲏⲣ	N	ϣⲃⲏⲣ
ϣⲃⲛⲛⲉ	N	ϣⲃⲛⲛⲉ
ϣⲃⲣⲙⲉⲗⲟⲥ	N	ϣⲃⲣⲙⲉⲗⲟⲥ
ϣⲃⲣⲣϩⲱⲃ	N	ϣⲃⲣⲣϩⲱⲃ
ϣⲃⲣ	N	ϣⲃⲣ
ϣⲃⲧ	V	ϣⲓⲃⲉ
ϣⲃⲱ	N	ϣⲃⲱ
ϣⲃ	V	ϣⲃ
ϣⲃv	V	ϣⲃv
ϣⲉϥ	V	ϣⲱϥ
ϣⲉⲉⲣⲉ	N	ϣⲉⲉⲣⲉ
ϣⲉⲗⲉⲉⲧ	N	ϣⲉⲗⲉⲉⲧ
ϣⲉⲙϣⲉ	V	ϣⲉⲙϣⲉ
ϣⲉⲙⲁⲃⲧⲁⲥⲉⲛϣⲉ	N	ϣⲉⲙⲁⲃⲧⲁⲥⲉⲛϣⲉ
ϣⲉⲙⲛⲧϣⲉ	N	ϣⲉⲙⲛⲧϣⲉ
ϣⲉⲛⲉϩⲧⲏ	V	ϣⲉⲛⲉϩⲧⲏ
ϣⲉⲛⲉⲗⲟⲟⲗⲉ	N	ϣⲉⲛⲉⲗⲟⲟⲗⲉ
ϣⲉⲛⲉ	V	ϣⲱⲱⲛⲉ
ϣⲉⲛⲟⲩⲧⲉ	NPROP	ϣⲉⲛⲟⲩⲧⲉ
ϣⲉⲟⲉⲓϣ	N	ϣⲉⲟⲉⲓϣ
ϣⲉⲡϣⲡ	V	ϣⲟⲡϣⲡ
ϣⲉⲡϩⲓⲥⲉ	V	ϣⲉⲡϩⲓⲥⲉ
ϣⲉⲡϩⲙⲟⲧ	V	ϣⲉⲡϩⲙⲟⲧ
ϣⲉⲡⲟⲩϫⲁⲓ	PREP	ϣⲉⲡⲟⲩϫⲁⲓ
ϣⲉⲡ	V	ϣⲱⲡ
ϣⲉⲣϣⲱⲣ	V	ϣⲟⲣϣⲣ
ϣⲉⲥ	V	ⲥⲱϣ
ϣⲉⲧϣⲱⲧ	VSTAT	ϣⲟⲧϣⲧ
ϣⲉⲧⲁⲓⲟⲩ	N	ϣⲉⲧⲁⲓⲟⲩ
ϣⲉ	N	ϣⲉ
ϣⲉ	NUM	ϣⲉ
ϣⲉ	V	ϣⲉ
ϣⲏϣ	VSTAT	ϣⲱϣ
ϣⲏϥ	VSTAT	ϣⲱϥ
ϣⲏⲓ	N	ϣⲏⲓ
ϣⲏⲕ	VSTAT	ϣⲓⲕⲉ
ϣⲏⲙ	N	ϣⲏⲙ
ϣⲏⲛ	N	ϣⲏⲛ
ϣⲏⲡ	VSTAT	ϣⲱⲡ
ϣⲏⲣⲉϣⲏⲙ	N	ϣⲏⲣⲉϣⲏⲙ
ϣⲏⲣⲉⲕⲟⲩⲓ	N	ϣⲏⲣⲉⲕⲟⲩⲓ
ϣⲏⲣⲉ	N	ϣⲏⲣⲉ
ϣⲏⲣⲉ	NPROP	ϣⲏⲣⲉ
ϣⲏⲣⲡⲥϩⲁⲓ	V	ϣⲏⲣⲡⲥϩⲁⲓ
ϣⲏⲧ	N	ϣⲏⲧ
ϣⲏ	N	ϣⲏ
ϣⲓⲃⲉ	V	ϣⲓⲃⲉ
ϣⲓⲏⲧ	NPROP	ϣⲓⲏⲧ
ϣⲓⲏ	N	ϣⲓⲏ
ϣⲓⲕⲉ	V	ϣⲓⲕⲉ
ϣⲓⲛⲉⲛⲥⲁ	V	ϣⲓⲛⲉⲛⲥⲁ
ϣⲓⲛⲉ	N	ϣⲓⲛⲉ
ϣⲓⲛⲉ	V	ϣⲓⲛⲉ
ϣⲓⲡⲉ	N	ϣⲓⲡⲉ
ϣⲓⲡⲉ	V	ϣⲓⲡⲉ
ϣⲓⲧⲉ	V	ϣⲓⲧⲉ
ϣⲓ	N	ϣⲓ
ϣⲕⲁⲕ	N	ϣⲕⲁⲕ
ϣⲕⲉⲗⲕⲉⲗ	V	ϣⲕⲉⲗⲕⲉⲗ
ϣⲕⲟⲗ	N	ϣⲕⲟⲗ
ϣⲗⲏⲗ	N	ϣⲗⲏⲗ
ϣⲗⲏⲗ	V	ϣⲗⲏⲗ
ϣⲗⲗ	V	ϣⲗⲗ
ϣⲗⲟϥ	N	ϣⲗⲟϥ
ϣⲗⲧⲙ	N	ϣⲗⲧⲙ
ϣⲙϣⲉⲉⲓⲇⲱⲗⲟⲛ	V	ϣⲙϣⲉⲉⲓⲇⲱⲗⲟⲛ
ϣⲙϣⲉ	V	ϣⲙϣⲉ
ϣⲙⲁ	V	ϣⲙⲁ
ϣⲙⲙⲟ	N	ϣⲙⲙⲟ
ϣⲙⲟⲩⲛⲉ	NUM	ϣⲙⲟⲩⲛⲉ
ϣⲙⲟⲩⲛⲛϣⲟ	N	ϣⲙⲟⲩⲛⲛϣⲟ
ϣⲙⲟⲩⲛ	N	ϣⲙⲟⲩⲛ
ϣⲙⲟⲩⲛ	NUM	ϣⲙⲟⲩⲛ
ϣⲙⲧ	NUM	ϣⲙⲧ
ϣⲛⲉ	N	ϣⲛⲉ
ϣⲛⲏⲩ	N	ϣⲛⲉ
ϣⲛⲥ	N	ϣⲛⲥ
ϣⲛⲧ	V	ϣⲛⲧ
ϣⲛ	V	ϣⲛ
ϣⲟϣⲟⲩ	N	ϣⲟϣⲟⲩ
ϣⲟϣⲧ	N	ϣⲟϣⲧ
ϣⲟϣ	N	ϣⲟϣ
ϣⲟϫⲛⲉ	N	ϣⲟϫⲛⲉ
ϣⲟϫⲧ	N	ϣⲟϫⲧ
ϣⲟⲃⲉ	VSTAT	ϣⲓⲃⲉ
ϣⲟⲉⲓϣ	N	ϣⲟⲉⲓϣ
ϣⲟⲉⲓϫ	N	ϣⲟⲉⲓϫ
ϣⲟⲕϩ	V	ϣⲱⲕϩ
ϣⲟⲗϥ	V	ϣⲟⲗϥ
ϣⲟⲗϩ	VSTAT	ϣⲱⲗϩ
ϣⲟⲗⲉⲥ	N	ϣⲟⲗⲉⲥ
ϣⲟⲗⲉ	V	ϣⲱⲗ
ϣⲟⲗⲕ	V	ϣⲟⲗⲕ
ϣⲟⲗⲛ	V	ϣⲟⲗⲛ
ϣⲟⲗⲟⲩ	V	ϣⲟⲗⲟⲩ
ϣⲟⲗⲥ	V	ϣⲟⲗⲥ
ϣⲟⲙⲉⲛⲧ	N	ϣⲟⲙⲉⲛⲧ
ϣⲟⲙⲉⲧ	N	ϣⲟⲙⲉⲧ
ϣⲟⲙⲛⲧ	N	ϣⲟⲙⲛⲧ
ϣⲟⲙⲛⲧ	NUM	ϣⲟⲙⲛⲧ
ϣⲟⲙⲧⲉ	N	ϣⲟⲙⲧⲉ
ϣⲟⲙⲧⲉ	NUM	ϣⲟⲙⲧⲉ
ϣⲟⲙⲧ	N	ϣⲟⲙⲧ
ϣⲟⲙⲧ	NUM	ϣⲟⲙⲧ
ϣⲟⲛϣ	N	ϣⲟⲛϣ
ϣⲟⲛϥ	V	ϣⲱⲛϥ
ϣⲟⲛⲧⲉ	N	ϣⲟⲛⲧⲉ
ϣⲟⲟⲛ	V	ϣⲱⲱⲛⲉ
ϣⲟⲟⲡ	VSTAT	ϣⲱⲡⲉ
ϣⲟⲟⲥⲉ	N	ϣⲟⲟⲥⲉ
ϣⲟⲟⲥ	N	ϣⲟⲟⲥ
ϣⲟⲟⲩⲉ	V	ϣⲟⲟⲩⲉ
ϣⲟⲟⲩ	N	ϣⲟⲟⲩ
ϣⲟⲡ	V	ϣⲱⲡ
ϣⲟⲣϣⲣ	V	ϣⲟⲣϣⲣ
ϣⲟⲣⲡⲉ	N	ϣⲟⲣⲡⲉ
ϣⲟⲣⲡ	N	ϣⲟⲣⲡ
ϣⲟⲧⲙ	VSTAT	ϣⲱⲧⲙ
ϣⲟⲧ	N	ϣⲟⲧ
ϣⲟⲩϣⲟⲩ	N	ϣⲟⲩϣⲟⲩ
ϣⲟⲩϣⲟⲩ	V	ϣⲟⲩϣⲟⲩ
ϣⲟⲩϣⲧ	N	ϣⲟⲩϣⲧ
ϣⲟⲩϩⲏⲛⲉ	N	ϣⲟⲩϩⲏⲛⲉ
ϣⲟⲩⲉⲓⲧ	VSTAT	ϣⲟⲩⲟ
ϣⲟⲩⲉ	V	ϣⲟⲩⲟ
ϣⲟⲩⲙⲉⲣⲓⲧ	N	ϣⲟⲩⲙⲉⲣⲓⲧ
ϣⲟⲩⲙⲟⲩⲧⲉ	N	ϣⲟⲩⲙⲟⲩⲧⲉ
ϣⲟⲩⲟⲉⲓⲧ	VSTAT	ϣⲟⲩⲟ
ϣⲟⲩⲟ	V	ϣⲟⲩⲟ
ϣⲟⲩⲣⲡⲉⲥⲙⲉⲉⲩⲉ	N	ϣⲟⲩⲣⲡⲉⲥⲙⲉⲉⲩⲉ
ϣⲟⲩⲧⲙⲧⲁⲩⲉ	N	ϣⲟⲩⲧⲙⲧⲁⲩⲉ
ϣⲟⲩⲱϩ	V	ϣⲟⲩⲱϩ
ϣⲟⲩⲱⲟⲩ	VSTAT	ϣⲟⲩⲱⲟⲩ
ϣⲟⲩⲱ	V	ϣⲟⲩⲱ
ϣⲟⲩ	N	ϣⲟⲟⲩ
ϣⲟ	N	ϣⲟ
ϣⲟ	NUM	ϣⲟ
ϣⲡϩⲓⲥⲉ	V	ϣⲡϩⲓⲥⲉ
ϣⲡϩⲙⲟⲧ	V	ϣⲡϩⲙⲟⲧ
ϣⲡⲉⲛϣⲱⲡ	N	ϣⲡⲉⲛϣⲱⲡ
ϣⲡⲏⲣⲉ	N	ϣⲡⲏⲣⲉ
ϣⲡⲟⲛ	V	ϣⲡⲟⲛ
ϣⲡⲧⲱⲣⲉ	V	ϣⲡⲧⲱⲣⲉ
ϣⲡ	V	ϣⲱⲡ
ϣⲣϣⲱⲣ	V	ϣⲟⲣϣⲣ
ϣⲣϣⲱⲣ	VSTAT	ϣⲟⲣϣⲣ
ϣⲣⲡϣⲁϫⲉ	V	ϣⲣⲡϣⲁϫⲉ
ϣⲣⲡⲙⲓⲥⲉ	N	ϣⲣⲡⲙⲓⲥⲉ
ϣⲣⲡⲙⲙⲓⲥⲉ	N	ϣⲣⲡⲙⲙⲓⲥⲉ
ϣⲣⲡⲛ	N	ϣⲣⲡⲛ
ϣⲣⲡⲧⲁⲙⲟ	V	ϣⲣⲡⲧⲁⲙⲟ
ϣⲣⲡ	V	ϣⲱⲣⲡ
ϣⲥⲛⲉ	N	ϣⲥⲛⲉ
ϣⲥⲛⲕⲱⲣⲁⲝ	N	ϣⲥⲛⲕⲱⲣⲁⲝ
ϣⲥⲛⲟⲩⲟϭⲉ	N	ϣⲥⲛⲟⲩⲟϭⲉ
ϣⲥ	N	ϣⲥ
ϣⲧⲁⲙ	V	ϣⲧⲁⲙ
ϣⲧⲉⲕⲟ	N	ϣⲧⲉⲕⲟ
ϣⲧⲉⲣⲧⲱⲣ	V	ϣⲧⲟⲣⲧⲣ
ϣⲧⲏⲛ	N	ϣⲧⲏⲛ
ϣⲧⲙⲟⲩⲱⲛ	N	ϣⲧⲙⲟⲩⲱⲛ
ϣⲧⲙ	VIMP	ϣⲧⲙ
ϣⲧⲟⲙ	V	ϣⲧⲟⲙ
ϣⲧⲟⲣⲧⲉⲣ	V	ϣⲧⲟⲣⲧⲉⲣ
ϣⲧⲟⲣⲧⲣ	N	ϣⲧⲟⲣⲧⲣ
ϣⲧⲟⲣⲧⲣ	V	ϣⲧⲟⲣⲧⲣ
ϣⲧⲟⲩϫⲉ	V	ϣⲧⲟⲩϫⲉ
ϣⲧⲣⲧⲣ	V	ϣⲧⲟⲣⲧⲣ
ϣⲧⲣⲧⲱⲣ	V	ϣⲧⲟⲣⲧⲣ
ϣⲧⲣⲧⲱⲣ	VSTAT	ϣⲧⲟⲣⲧⲣ
ϣⲱϣ	V	ϣⲱϣ
ϣⲱϥⲧ	V	ϣⲱϥⲧ
ϣⲱϥ	V	ϣⲱϥ
ϣⲱϫⲡ	V	ϣⲱϫⲡ
ϣⲱⲗϩ	V	ϣⲱⲗϩ
ϣⲱⲗⲙ	V	ϣⲱⲗⲙ
ϣⲱⲗ	V	ϣⲱⲗ
ϣⲱⲙⲉ	N	ϣⲱⲙⲉ
ϣⲱⲙ	N	ϣⲱⲙ
ϣⲱⲛⲃ	N	ϣⲱⲛⲃ
ϣⲱⲛⲉ	N	ϣⲱⲛⲉ
ϣⲱⲛⲉ	V	ϣⲱⲛⲉ
ϣⲱⲛⲧ	V	ϣⲱⲛⲧ
ϣⲱⲡⲉ	V	ϣⲱⲡⲉ
ϣⲱⲡⲉ`	V	ϣⲱⲡⲉ`
ϣⲱⲡ	V	ϣⲱⲡ
ϣⲱⲣⲡ	V	ϣⲱⲣⲡ
ϣⲱⲥⲙ	N	ϣⲱⲥⲙ
ϣⲱⲥ	N	ϣⲱⲥ
ϣⲱⲱⲡⲉ	N	ϣⲱⲱⲡⲉ
ϣⲱⲱⲡⲉ	V	ϣⲱⲱⲡⲉ
ϣⲱⲱⲧⲛⲉⲓⲇⲱⲗⲟⲛ	N	ϣⲱⲱⲧⲛⲉⲓⲇⲱⲗⲟⲛ
ϣⲱⲱⲧ	N	ϣⲱⲱⲧ
ϣⲱⲱⲧ	V	ϣⲱⲱⲧ
ϣⲱ	N	ϣⲱ
ϣ	V	ϣ
ϣoⲙⲛⲧ	NUM	ϣoⲙⲛⲧ
ϥⲁⲓϣⲓⲛⲉ	N	ϥⲁⲓϣⲓⲛⲉ
ϥⲁⲓⲉⲧⲡⲱ	N	ϥⲁⲓⲉⲧⲡⲱ
ϥⲁⲓⲕⲗⲟⲙ	N	ϥⲁⲓⲕⲗⲟⲙ
ϥⲉϭ	V	ϥⲱϭⲉ
ϥⲉⲓⲣⲟⲟⲩϣ	V	ϥⲉⲓⲣⲟⲟⲩϣ
ϥⲓϩⲣⲁⲩ	V	ϥⲓϩⲣⲁⲩ
ϥⲓⲉⲓⲁⲧ	V	ϥⲓⲉⲓⲁⲧ
ϥⲓⲡⲣⲟⲟⲩϣ	V	ϥⲓⲡⲣⲟⲟⲩϣ
ϥⲓⲣⲟⲟⲩϣ	V	ϥⲓⲣⲟⲟⲩϣ
ϥⲓⲧ	V	ϥⲓ
ϥⲓ	V	ϥⲓ
ϥⲛⲧ	N	ϥⲛⲧ
ϥⲟϭ	V	ϥⲱϭⲉ
ϥⲟⲗ	V	ϥⲟⲗ
ϥⲟⲧ	V	ϥⲱⲧⲉ
ϥⲟ	V	ϥⲟ
ϥⲧⲟⲟⲩ	N	ϥⲧⲟⲟⲩ
ϥⲧⲟⲩ	NUM	ϥⲧⲟⲩ
ϥⲧⲟ	N	ϥⲧⲟ
ϥⲱϭⲉ	V	ϥⲱϭⲉ
ϥⲱⲧⲉ	V	ϥⲱⲧⲉ
ϥⲱⲱⲣⲉ	V	ϥⲱⲱⲣⲉ
ϥⲱ	N	ϥⲱ
ϥ	N	ϥ
ϥ	PPERO	ⲛⲧⲟϥ
ϥ	PPERS	ⲛⲧⲟϥ
ϥ	PPOS	ϥ
ϩⲁϩⲛⲥⲟⲡ	ADV	ϩⲁϩⲛⲥⲟⲡ
ϩⲁϩⲧⲉ	PREP	ϩⲁϩⲧⲉ
ϩⲁϩⲧⲉ	V	ϩⲁϩⲧⲉ
ϩⲁϩⲧⲏ	PREP	ϩⲁϩⲧⲛ
ϩⲁϩⲧⲙ	PREP	ϩⲁϩⲧⲛ
ϩⲁϩⲧⲛ	PREP	ϩⲁϩⲧⲛ
ϩⲁϩ	N	ϩⲁϩ
ϩⲁϭⲉ	NPROP	ϩⲁϭⲉ
ϩⲁⲁⲩ	N	ϩⲁⲁⲩ
ϩⲁⲃⲟⲗ	ADV	ϩⲁⲃⲟⲗ
ϩⲁⲅⲓⲁⲍⲉ	V	ϩⲁⲅⲓⲁⲍⲉ
ϩⲁⲅⲓⲁⲥⲙⲟⲥ	N	ϩⲁⲅⲓⲁⲥⲙⲟⲥ
ϩⲁⲅⲓⲟⲥⲩⲛⲏ	N	ϩⲁⲅⲓⲟⲥⲩⲛⲏ
ϩⲁⲅⲓⲟⲥ	N	ϩⲁⲅⲓⲟⲥ
ϩⲁⲅⲓⲟⲧⲁⲧⲟⲥ	N	ϩⲁⲅⲓⲟⲧⲁⲧⲟⲥ
ϩⲁⲅⲓⲱⲥⲩⲛⲏ	N	ϩⲁⲅⲓⲱⲥⲩⲛⲏ
ϩⲁⲅⲓⲱⲧⲁⲧⲟⲥ	N	ϩⲁⲅⲓⲱⲧⲁⲧⲟⲥ
ϩⲁⲅⲛⲟⲛ	N	ϩⲁⲅⲛⲟⲛ
ϩⲁⲉⲓⲁⲧ	PREP	ϩⲁⲉⲓⲁⲧ
ϩⲁⲉⲓⲃⲉⲥ	N	ϩⲁⲉⲓⲃⲉⲥ
ϩⲁⲉⲓⲃⲥ	N	ϩⲁⲉⲓⲃⲥ
ϩⲁⲉⲓⲙ	N	ϩⲁⲉⲓⲙ
ϩⲁⲉ	N	ϩⲁⲉ
ϩⲁⲏ	N	ϩⲁⲏ
ϩⲁⲑⲏ	ADV	ϩⲁⲑⲏ
ϩⲁⲓⲃⲉⲥ	N	ϩⲁⲓⲃⲉⲥ
ϩⲁⲓⲃⲥ	N	ϩⲁⲓⲃⲥ
ϩⲁⲓⲣⲁⲓⲧⲓⲕⲟⲥ	N	ϩⲁⲓⲣⲁⲓⲧⲓⲕⲟⲥ
ϩⲁⲓⲣⲉⲥⲓⲥ	N	ϩⲁⲓⲣⲉⲥⲓⲥ
ϩⲁⲓⲣⲉⲧⲓⲕⲟⲥ	N	ϩⲁⲓⲣⲉⲧⲓⲕⲟⲥ
ϩⲁⲓⲣⲏⲥⲓⲥ	N	ϩⲁⲓⲣⲏⲥⲓⲥ
ϩⲁⲓⲣⲏⲧⲓⲕⲟⲥ	N	ϩⲁⲓⲣⲏⲧⲓⲕⲟⲥ
ϩⲁⲓ	N	ϩⲁⲓ
ϩⲁⲕ	N	ϩⲁⲕ
ϩⲁⲗⲁⲁⲧⲉ	N	ϩⲁⲗⲏⲧ
ϩⲁⲗⲁⲥⲥⲁ	N	ϩⲁⲗⲁⲥⲥⲁ
ϩⲁⲗⲁⲧⲉ	N	ϩⲁⲗⲏⲧ
ϩⲁⲗⲉ	N	ϩⲁⲗⲉ
ϩⲁⲗⲏⲧ	N	ϩⲁⲗⲏⲧ
ϩⲁⲗⲓⲉⲩⲥ	N	ϩⲁⲗⲓⲉⲩⲥ
ϩⲁⲗⲩⲥⲓⲥ	N	ϩⲁⲗⲩⲥⲓⲥ
ϩⲁⲗⲱⲙⲁ	N	ϩⲁⲗⲱⲙⲁ
ϩⲁⲗⲱⲙ	N	ϩⲁⲗⲱⲙ
ϩⲁⲗ	N	ϩⲁⲗ
ϩⲁⲙϣⲉ	N	ϩⲁⲙϣⲉ
ϩⲁⲙⲁ	CONJ	ϩⲁⲙⲁ
ϩⲁⲙⲏⲛ	PTC	ϩⲁⲙⲏⲛ
ϩⲁⲙⲕⲉⲗⲗⲉ	N	ϩⲁⲙⲕⲉⲗⲗⲉ
ϩⲁⲙⲕⲗⲗⲉ	N	ϩⲁⲙⲕⲗⲗⲉ
ϩⲁⲙⲟⲓ	CONJ	ϩⲁⲙⲟⲓ
ϩⲁⲙⲱⲥ	NPROP	ϩⲁⲙⲱⲥ
ϩⲁⲡⲉⲥⲏⲧ	ADV	ϩⲁⲡⲉⲥⲏⲧ
ϩⲁⲡⲗⲟⲩⲛ	N	ϩⲁⲡⲗⲟⲩⲛ
ϩⲁⲡⲗⲟⲩⲥ	N	ϩⲁⲡⲗⲟⲩⲥ
ϩⲁⲡⲗⲱⲥ	ADV	ϩⲁⲡⲗⲱⲥ
ϩⲁⲡⲥ	N	ϩⲁⲡⲥ
ϩⲁⲡⲥ	VBD	ϩⲁⲡⲥ
ϩⲁⲡ	N	ϩⲁⲡ
ϩⲁⲣϣϩⲏⲧ	N	ϩⲁⲣϣϩⲏⲧ
ϩⲁⲣⲁⲧ	PREP	ϩⲁⲣⲁⲧ
ϩⲁⲣⲉϣϩⲏⲧ	N	ϩⲁⲣⲉϣϩⲏⲧ
ϩⲁⲣⲉϩ	N	ϩⲁⲣⲉϩ
ϩⲁⲣⲉϩ	V	ϩⲁⲣⲉϩ
ϩⲁⲣⲓϩⲁⲣⲟ	PREP	ϩⲁⲣⲓϩⲁⲣⲟ
ϩⲁⲣⲙⲁ	N	ϩⲁⲣⲙⲁ
ϩⲁⲣⲙⲉⲛⲓⲟⲥ	N	ϩⲁⲣⲙⲉⲛⲓⲟⲥ
ϩⲁⲣⲙⲏⲛⲓⲟⲥ	N	ϩⲁⲣⲙⲏⲛⲓⲟⲥ
ϩⲁⲣⲙⲟⲍⲉ	V	ϩⲁⲣⲙⲟⲍⲉ
ϩⲁⲣⲙⲟⲛⲓⲁ	N	ϩⲁⲣⲙⲟⲛⲓⲁ
ϩⲁⲣⲟ	PREP	ϩⲁ
ϩⲁⲣⲡⲁⲍⲉ	V	ϩⲁⲣⲡⲁⲍⲉ
ϩⲁⲣⲱ	PREP	ϩⲁ
ϩⲁⲥⲉ	N	ϩⲁⲥⲉ
ϩⲁⲥⲓⲉ	N	ϩⲁⲥⲓⲉ
ϩⲁⲧⲃⲉⲥ	N	ϩⲁⲧⲃⲉⲥ
ϩⲁⲧⲉ	PREP	ϩⲁⲧⲉ
ϩⲁⲧⲉ	V	ϩⲁⲧⲉ
ϩⲁⲧⲏⲣ	N	ϩⲁⲧⲏⲣ
ϩⲁⲧⲏⲩ	N	ϩⲁⲧⲏⲩ
ϩⲁⲧⲏ	PREP	ϩⲁⲧⲏ
ϩⲁⲧⲏ	PREP_PPERO	ϩⲁϩⲧⲛ
ϩⲁⲧⲙ	PREP	ϩⲁⲧⲛ
ϩⲁⲧⲛ	PREP	ϩⲁⲧⲛ
ϩⲁⲧⲟⲟⲧ	PREP	ϩⲁⲧⲛ
ϩⲁⲧ	N	ϩⲁⲧ
ϩⲁ	PREP	ϩⲁ
ϩⲃⲁ	N	ϩⲃⲁ
ϩⲃⲃⲉ	N	ϩⲃⲃⲉ
ϩⲃⲏⲟⲩⲉ	N	ϩⲱⲃ
ϩⲃⲏⲩⲉ	N	ϩⲱⲃ
ϩⲃⲟⲩⲣ	N	ϩⲃⲟⲩⲣ
ϩⲃⲥⲱ	N	ϩⲃⲥⲱ
ϩⲃⲥ	N	ϩⲃⲥ
ϩⲃⲥ	V	ϩⲃⲥ
ϩⲉϫϩⲱϫ	V	ϩⲟϫϩϫ
ϩⲉⲃⲇⲟⲙⲁⲥ	N	ϩⲉⲃⲇⲟⲙⲁⲥ
ϩⲉⲃⲣⲁⲓⲁ	N	ϩⲉⲃⲣⲁⲓⲁ
ϩⲉⲃⲣⲁⲓⲟⲥ	N	ϩⲉⲃⲣⲁⲓⲟⲥ
ϩⲉⲃⲥⲱ	N	ϩⲉⲃⲥⲱ
ϩⲉⲃⲥ	V	ϩⲱⲃⲥ
ϩⲉⲃⲱⲱⲛ	N	ϩⲉⲃⲱⲱⲛ
ϩⲉⲅⲉⲙⲱⲛ	N	ϩⲉⲅⲉⲙⲱⲛ
ϩⲉⲅⲏⲙⲱⲛ	N	ϩⲉⲅⲏⲙⲱⲛ
ϩⲉⲉϩⲣⲁⲓ	V	ϩⲉⲉϩⲣⲁⲓ
ϩⲉⲑⲛⲓⲕⲟⲥ	N	ϩⲉⲑⲛⲓⲕⲟⲥ
ϩⲉⲑⲛⲟⲥ	N	ϩⲉⲑⲛⲟⲥ
ϩⲉⲑⲟⲥ	N	ϩⲉⲑⲟⲥ
ϩⲉⲓⲉⲓⲃ	N	ϩⲉⲓⲉⲓⲃ
ϩⲉⲓⲙⲁⲣⲙⲉⲛⲏ	N	ϩⲉⲓⲙⲁⲣⲙⲉⲛⲏ
ϩⲉⲓⲣⲉⲥⲓⲥ	N	ϩⲉⲓⲣⲉⲥⲓⲥ
ϩⲉⲓⲣⲉⲧⲓⲕⲟⲥ	N	ϩⲉⲓⲣⲉⲧⲓⲕⲟⲥ
ϩⲉⲓⲣⲏⲥⲓⲥ	N	ϩⲉⲓⲣⲏⲥⲓⲥ
ϩⲉⲓⲣⲏⲧⲓⲕⲟⲥ	N	ϩⲉⲓⲣⲏⲧⲓⲕⲟⲥ
ϩⲉⲕⲁⲧⲟⲛⲧⲁⲣⲭⲟⲥ	N	ϩⲉⲕⲁⲧⲟⲛⲧⲁⲣⲭⲟⲥ
ϩⲉⲕⲉ	V	ϩⲉⲕⲉ
ϩⲉⲗⲗⲏⲛⲟⲥ	N	ϩⲉⲗⲗⲏⲛⲟⲥ
ϩⲉⲗⲗⲏⲛ	N	ϩⲉⲗⲗⲏⲛ
ϩⲉⲗⲟⲥ	N	ϩⲉⲗⲟⲥ
ϩⲉⲗⲡⲓⲍⲉ	V	ϩⲉⲗⲡⲓⲍⲉ
ϩⲉⲗⲡⲓⲥ	N	ϩⲉⲗⲡⲓⲥ
ϩⲉⲙϩⲁⲗ	N	ϩⲉⲙϩⲁⲗ
ϩⲉⲙⲏⲣⲁ	N	ϩⲉⲙⲏⲣⲁ
ϩⲉⲛϯⲙⲓⲛⲉ	none	ϩⲉⲛϯⲙⲓⲛⲉ
ϩⲉⲛϯⲥⲃⲱ	N	ϩⲉⲛϯⲥⲃⲱ
ϩⲉⲛⲉⲉⲧⲉ	N	ϩⲉⲛⲉⲉⲧⲉ
ϩⲉⲛⲉⲉⲧⲏ	N	ϩⲉⲛⲉⲉⲧⲏ
ϩⲉⲛⲛⲁⲥ	N	ϩⲉⲛⲛⲁⲥ
ϩⲉⲛⲟⲩϣⲉⲡϩⲙⲟⲧ	ADV	ϩⲉⲛⲟⲩϣⲉⲡϩⲙⲟⲧ
ϩⲉⲛⲟⲩϣⲡϩⲙⲟⲧ	ADV	ϩⲉⲛⲟⲩϣⲡϩⲙⲟⲧ
ϩⲉⲛⲟⲩϩⲙⲟⲧ	ADV	ϩⲉⲛⲟⲩϩⲙⲟⲧ
ϩⲉⲛⲟⲩϩⲱⲡ	ADV	ϩⲉⲛⲟⲩϩⲱⲡ
ϩⲉⲛⲟⲩϫⲱⲕ	ADV	ϩⲉⲛⲟⲩϫⲱⲕ
ϩⲉⲛⲟⲩϭⲉⲡⲏ	ADV	ϩⲉⲛⲟⲩϭⲉⲡⲏ
ϩⲉⲛⲟⲩⲡⲉⲑⲏⲡ	ADV	ϩⲉⲛⲟⲩⲡⲉⲑⲏⲡ
ϩⲉⲛⲥⲟⲡ	ADV	ϩⲉⲛⲥⲟⲡ
ϩⲉⲛ	ART	ⲟⲩ
ϩⲉⲛ	PREP	ϩⲉⲛ
ϩⲉⲝⲓⲥ	N	ϩⲉⲝⲓⲥ
ϩⲉⲡ	V	ϩⲱⲡ
ϩⲉⲣⲙⲁⲛ	N	ϩⲉⲣⲙⲁⲛ
ϩⲉⲣⲙⲉⲛⲉⲩⲉ	V	ϩⲉⲣⲙⲉⲛⲉⲩⲉ
ϩⲉⲣⲙⲉⲛⲉⲩⲧⲏⲥ	N	ϩⲉⲣⲙⲉⲛⲉⲩⲧⲏⲥ
ϩⲉⲣⲙⲏⲛⲉⲓⲁ	N	ϩⲉⲣⲙⲏⲛⲉⲓⲁ
ϩⲉⲣⲙⲏⲛⲉⲩⲉ	V	ϩⲉⲣⲙⲏⲛⲉⲩⲉ
ϩⲉⲣⲙⲏⲛⲉⲩⲧⲏⲥ	N	ϩⲉⲣⲙⲏⲛⲉⲩⲧⲏⲥ
ϩⲉⲣⲙⲏⲛⲓⲁ	N	ϩⲉⲣⲙⲏⲛⲓⲁ
ϩⲉⲣⲙⲏⲥ	NPROP	ϩⲉⲣⲙⲏⲥ
ϩⲉⲣⲙⲟⲅⲉⲛⲏⲥ	NPROP	ϩⲉⲣⲙⲟⲅⲉⲛⲏⲥ
ϩⲉⲧϩⲱⲧ	V	ϩⲟⲧϩⲧ
ϩⲉⲧⲁⲍⲉ	V	ϩⲉⲧⲁⲍⲉ
ϩⲉⲧⲁⲓⲣⲁ	N	ϩⲉⲧⲁⲓⲣⲁ
ϩⲉⲧⲃ	V	ϩⲱⲧⲃ
ϩⲉⲧⲟⲓⲙⲟⲥ	N	ϩⲉⲧⲟⲓⲙⲟⲥ
ϩⲉⲩⲣⲉⲙⲁ	N	ϩⲉⲩⲣⲉⲙⲁ
ϩⲉⲱⲥ	CONJ	ϩⲉⲱⲥ
ϩⲉ	N	ϩⲉ
ϩⲉ	V	ϩⲉ
ϩⲏϣ	VSTAT	ϩⲱϣ
ϩⲏϭⲉ	N	ϩⲏϭⲉ
ϩⲏⲃⲉ	N	ϩⲏⲃⲉ
ϩⲏⲃⲥ	N	ϩⲏⲃⲥ
ϩⲏⲅⲉⲙⲟⲛⲓⲁ	N	ϩⲏⲅⲉⲙⲟⲛⲓⲁ
ϩⲏⲅⲉⲙⲱⲛⲓⲕⲟⲛ	N	ϩⲏⲅⲉⲙⲱⲛⲓⲕⲟⲛ
ϩⲏⲅⲉⲙⲱⲛ	N	ϩⲏⲅⲉⲙⲱⲛ
ϩⲏⲅⲏⲙⲱⲛ	N	ϩⲏⲅⲏⲙⲱⲛ
ϩⲏⲅⲟⲩⲙⲉⲛⲟⲥ	N	ϩⲏⲅⲟⲩⲙⲉⲛⲟⲥ
ϩⲏⲇⲁⲛⲏ	V	ϩⲏⲇⲁⲛⲏ
ϩⲏⲇⲟⲛⲏ	N	ϩⲏⲇⲟⲛⲏ
ϩⲏⲏⲛⲉ	N	ϩⲏⲏⲛⲉ
ϩⲏⲏⲧⲉ	N	ϩⲏⲏⲧⲉ
ϩⲏⲏⲧⲉ	PTC	ϩⲏⲏⲧⲉ
ϩⲏⲕⲉ	N	ϩⲏⲕⲉ
ϩⲏⲗⲉⲓⲁⲥ	NPROP	ϩⲏⲗⲉⲓⲁⲥ
ϩⲏⲗⲉⲓ	NPROP	ϩⲏⲗⲉⲓ
ϩⲏⲗⲏⲕⲓⲁ	N	ϩⲏⲗⲏⲕⲓⲁ
ϩⲏⲗⲓϭⲓⲁ	N	ϩⲏⲗⲓϭⲓⲁ
ϩⲏⲗⲓⲁⲥ	NPROP	ϩⲏⲗⲓⲁⲥ
ϩⲏⲗⲓⲕⲓⲁ	N	ϩⲏⲗⲓⲕⲓⲁ
ϩⲏⲗⲓⲟⲇⲱⲣⲟⲥ	NPROP	ϩⲏⲗⲓⲟⲇⲱⲣⲟⲥ
ϩⲏⲗⲓⲟⲥ	N	ϩⲏⲗⲓⲟⲥ
ϩⲏⲗⲓ	NPROP	ϩⲏⲗⲓ
ϩⲏⲗⲗⲏⲛ	NPROP	ϩⲏⲗⲗⲏⲛ
ϩⲏⲙⲉⲛⲁⲓⲟⲥ	NPROP	ϩⲏⲙⲉⲛⲁⲓⲟⲥ
ϩⲏⲙ	VSTAT	ϩⲙⲟⲙ
ϩⲏⲛⲉ	N	ϩⲏⲛⲉ
ϩⲏⲛⲧ	VSTAT	ϩⲱⲛⲧ
ϩⲏⲛ	VSTAT	ϩⲱⲛ
ϩⲏⲡⲁⲣ	N	ϩⲏⲡⲁⲣ
ϩⲏⲡ	VSTAT	ϩⲱⲡ
ϩⲏⲣⲟⲇⲏⲥ	NPROP	ϩⲏⲣⲟⲇⲏⲥ
ϩⲏⲣⲱⲇⲏⲥ	NPROP	ϩⲏⲣⲱⲇⲏⲥ
ϩⲏⲣⲱⲇⲓⲁⲛⲟⲥ	N	ϩⲏⲣⲱⲇⲓⲁⲛⲟⲥ
ϩⲏⲣⲱⲇⲓⲁⲥ	N	ϩⲏⲣⲱⲇⲓⲁⲥ
ϩⲏⲣⲱⲇⲓⲁⲥ	NPROP	ϩⲏⲣⲱⲇⲓⲁⲥ
ϩⲏⲧϥⲙ	PREP	ϩⲏⲧϥⲙ
ϩⲏⲧⲛⲟⲩⲱⲧ	N	ϩⲏⲧⲛⲟⲩⲱⲧ
ϩⲏⲧⲛ	N	ϩⲏⲧⲛ
ϩⲏⲧ	N	ϩⲏⲧ
ϩⲏⲩ	N	ϩⲏⲩ
ϩⲏⲩ	VSTAT	ϩⲏⲩ
ϩⲏ	N	ϩⲏ
ϩⲓϩⲏ	ADV	ϩⲓϩⲏ
ϩⲓϩⲏ	N	ϩⲓϩⲏ
ϩⲓϩⲟⲩⲛ	ADV	ϩⲓϩⲟⲩⲛ
ϩⲓϫⲉⲛ	PREP	ϩⲓϫⲛ
ϩⲓϫⲙ	PREP	ϩⲓϫⲛ
ϩⲓϫⲛ	PREP	ϩⲓϫⲛ
ϩⲓϫⲱ	PREP	ϩⲓϫⲛ
ϩⲓⲁⲧⲣⲟⲥ	N	ϩⲓⲁⲧⲣⲟⲥ
ϩⲓⲃⲟⲗ	ADV	ϩⲓⲃⲟⲗ
ϩⲓⲇⲓⲟⲛ	N	ϩⲓⲇⲓⲟⲛ
ϩⲓⲇⲓⲱⲧⲏⲥ	N	ϩⲓⲇⲓⲱⲧⲏⲥ
ϩⲓⲉⲓⲃ	N	ϩⲓⲉⲓⲃ
ϩⲓⲉⲓⲧ	N	ϩⲓⲉⲓⲧ
ϩⲓⲉⲣⲁϯⲟⲛ	N	ϩⲓⲉⲣⲁϯⲟⲛ
ϩⲓⲉⲣⲁ	N	ϩⲓⲉⲣⲁ
ϩⲓⲉⲣⲉⲩⲥ	N	ϩⲓⲉⲣⲉⲩⲥ
ϩⲓⲉⲣⲟⲛ	N	ϩⲓⲉⲣⲟⲛ
ϩⲓⲉⲣⲟⲥⲟⲗⲩⲙⲁ	NPROP	ϩⲓⲉⲣⲟⲥⲟⲗⲩⲙⲁ
ϩⲓⲉⲣⲟⲩⲥⲁⲗⲏⲙ	NPROP	ϩⲓⲉⲣⲟⲩⲥⲁⲗⲏⲙ
ϩⲓⲉⲣⲟⲫⲁⲛⲧⲏⲥ	N	ϩⲓⲉⲣⲟⲫⲁⲛⲧⲏⲥ
ϩⲓⲏ	N	ϩⲓⲏ
ϩⲓⲑⲏ	ADV	ϩⲓⲑⲏ
ϩⲓⲕⲁⲛⲟⲥ	N	ϩⲓⲕⲁⲛⲟⲥ
ϩⲓⲕⲱⲛ	N	ϩⲓⲕⲱⲛ
ϩⲓⲗⲁ	V	ϩⲓⲗⲁ
ϩⲓⲗⲓⲕⲣⲓⲛⲏⲥ	N	ϩⲓⲗⲓⲕⲣⲓⲛⲏⲥ
ϩⲓⲙⲁⲣⲙⲉⲛⲏ	N	ϩⲓⲙⲁⲣⲙⲉⲛⲏ
ϩⲓⲙⲉⲣⲟⲥ	N	ϩⲓⲙⲉⲣⲟⲥ
ϩⲓⲙⲉ	N	ϩⲓⲙⲉ
ϩⲓⲛⲁⲓ	ADV	ϩⲓⲛⲁⲓ
ϩⲓⲛⲁ	CONJ	ϩⲓⲛⲁ
ϩⲓⲛⲏⲃ	N	ϩⲓⲛⲏⲃ
ϩⲓⲛⲏⲃ	V	ϩⲓⲛⲏⲃ
ϩⲓⲟⲙⲉ	N	ⲥϩⲓⲙⲉ
ϩⲓⲟⲛⲉ	N	ϩⲓⲟⲛⲉ
ϩⲓⲟⲟⲩⲉ	N	ϩⲓⲟⲟⲩⲉ
ϩⲓⲟⲩⲉ	V	ϩⲓⲟⲩⲉ
ϩⲓⲟⲩⲥⲟⲡ	ADV	ϩⲓⲟⲩⲥⲟⲡ
ϩⲓⲡⲉⲥⲏⲧ	ADV	ϩⲓⲡⲉⲥⲏⲧ
ϩⲓⲡⲡⲉⲩⲥ	N	ϩⲓⲡⲡⲉⲩⲥ
ϩⲓⲡⲡⲓⲕⲟⲥ	N	ϩⲓⲡⲡⲓⲕⲟⲥ
ϩⲓⲣⲏⲛⲉ	N	ϩⲓⲣⲏⲛⲉ
ϩⲓⲣⲏⲛⲏ	N	ϩⲓⲣⲏⲛⲏ
ϩⲓⲣⲙ	PREP	ϩⲓⲣⲛ
ϩⲓⲣⲛ	PREP	ϩⲓⲣⲛ
ϩⲓⲣⲱ	PREP	ϩⲓⲣⲛ
ϩⲓⲣ	N	ϩⲓⲣ
ϩⲓⲥⲁⲅⲅⲉⲗⲟⲥ	V	ϩⲓⲥⲁⲅⲅⲉⲗⲟⲥ
ϩⲓⲥⲁⲩⲣⲟⲥ	N	ϩⲓⲥⲁⲩⲣⲟⲥ
ϩⲓⲥⲇⲟⲣⲓⲍⲉ	V	ϩⲓⲥⲇⲟⲣⲓⲍⲉ
ϩⲓⲥⲇⲱⲣⲓⲍⲉ	V	ϩⲓⲥⲇⲱⲣⲓⲍⲉ
ϩⲓⲥⲉ	N	ϩⲓⲥⲉ
ϩⲓⲥⲓⲟⲛ	N	ϩⲓⲥⲓⲟⲛ
ϩⲓⲥⲟⲛ	N	ϩⲓⲥⲟⲛ
ϩⲓⲥⲟⲥ	N	ϩⲓⲥⲟⲥ
ϩⲓⲥⲧⲟⲣⲓⲁ	N	ϩⲓⲥⲧⲟⲣⲓⲁ
ϩⲓⲥⲧⲟⲣⲓⲍⲉ	V	ϩⲓⲥⲧⲟⲣⲓⲍⲉ
ϩⲓⲥⲧⲱⲣⲓⲁ	N	ϩⲓⲥⲧⲱⲣⲓⲁ
ϩⲓⲥⲧⲱⲣⲓⲍⲉ	V	ϩⲓⲥⲧⲱⲣⲓⲍⲉ
ϩⲓⲧⲁⲗⲓⲕⲏ	N	ϩⲓⲧⲁⲗⲓⲕⲏ
ϩⲓⲧⲉⲙ	PREP	ϩⲓⲧⲛ
ϩⲓⲧⲉ	PREP	ϩⲓⲧⲛ
ϩⲓⲧⲉ	V	ϩⲓⲧⲉ
ϩⲓⲧⲙ	PREP	ϩⲓⲧⲛ
ϩⲓⲧⲛ	PREP	ϩⲓⲧⲛ
ϩⲓⲧⲟⲟⲧ	PREP	ϩⲓⲧⲛ
ϩⲓⲧⲟⲟⲧ	V	ϩⲓⲧⲟⲟⲧ
ϩⲓⲧⲟⲟ	PREP	ϩⲓⲧⲛ
ϩⲓⲧⲟⲩⲱ	PREP	ϩⲓⲧⲟⲩⲛ
ϩⲓⲱⲛⲉ	V	ϩⲓⲱⲛⲉ
ϩⲓⲱⲧ	PREP	ϩⲓⲱⲧ
ϩⲓⲱⲱ	PREP	ϩⲓ
ϩⲓⲱ	PREP	ϩⲓ
ϩⲓ	PREP	ϩⲓ
ϩⲓ	V	ϩⲓ
ϩⲕⲁⲉⲓⲧ	VSTAT	ϩⲕⲟ
ϩⲕⲟ	V	ϩⲕⲟ
ϩⲗⲗⲏⲛ	N	ϩⲗⲗⲏⲛ
ϩⲗⲗⲟⲓ	N	ϩⲗⲗⲟ
ϩⲗⲗⲟ	N	ϩⲗⲗⲟ
ϩⲗⲗⲱ	N	ϩⲗⲗⲱ
ϩⲗⲟϭ	V	ϩⲗⲟϭ
ϩⲗⲟⲟⲗⲉ	N	ϩⲗⲟⲟⲗⲉ
ϩⲗⲟⲡⲗⲡ	V	ϩⲗⲟⲡⲗⲡ
ϩⲗⲟⲥⲧⲛ	VSTAT	ϩⲗⲟⲥⲧⲛ
ϩⲗⲡⲗⲱⲡ	VSTAT	ϩⲗⲡⲗⲱⲡ
ϩⲙϩⲁⲗ	N	ϩⲙϩⲁⲗ
ϩⲙϩⲙ	V	ϩⲙϩⲙ
ϩⲙϫ	N	ϩⲙϫ
ϩⲙⲉ	N	ϩⲙⲉ
ϩⲙⲉ	NUM	ϩⲙⲉ
ϩⲙⲏ	N	ϩⲙⲏ
ϩⲙⲙⲁⲛⲓⲙ	ADV	ϩⲙⲙⲁⲛⲓⲙ
ϩⲙⲙⲉ	V	ϩⲙⲙⲉ
ϩⲙⲟⲙ	N	ϩⲙⲟⲙ
ϩⲙⲟⲙ	VSTAT	ϩⲙⲟⲙ
ϩⲙⲟⲟⲥ	V	ϩⲙⲟⲟⲥ
ϩⲙⲟⲟⲥ	VSTAT	ϩⲙⲟⲟⲥ
ϩⲙⲟⲟ	V	ϩⲙⲟⲟ
ϩⲙⲟⲧ	N	ϩⲙⲟⲧ
ϩⲙⲟⲩ	N	ϩⲙⲟⲩ
ϩⲙⲡⲉϩⲟⲟⲩⲙⲛⲧⲉⲩϣⲏ	ADV	ϩⲙⲡⲉϩⲟⲟⲩⲙⲛⲧⲉⲩϣⲏ
ϩⲙⲡⲉⲓⲙⲁ	ADV	ϩⲙⲡⲉⲓⲙⲁ
ϩⲙⲡⲉⲓⲟⲩⲟⲉⲓϣ	ADV	ϩⲙⲡⲉⲓⲟⲩⲟⲉⲓϣ
ϩⲙⲡⲉⲟⲩⲟⲉⲓϣⲉⲧⲙⲙⲁⲩ	ADV	ϩⲙⲡⲉⲟⲩⲟⲉⲓϣⲉⲧⲙⲙⲁⲩ
ϩⲙⲡⲓⲟⲩⲟⲉⲓϣ	ADV	ϩⲙⲡⲓⲟⲩⲟⲉⲓϣ
ϩⲙⲡⲙⲁⲉⲧⲙⲙⲁⲩ	ADV	ϩⲙⲡⲙⲁⲉⲧⲙⲙⲁⲩ
ϩⲙⲡⲥⲁⲥⲛⲁⲩ	ADV	ϩⲙⲡⲥⲁⲥⲛⲁⲩ
ϩⲙⲥ	V	ϩⲙⲥ
ϩⲙ	N	ϩⲙ
ϩⲙ	PREP	ϩⲛ
ϩⲛⲁⲁⲩⲛⲕⲁⲥⲟⲧⲉ	N	ϩⲛⲁⲁⲩⲛⲕⲁⲥⲟⲧⲉ
ϩⲛⲁⲁⲩ	N	ϩⲛⲁⲁⲩ
ϩⲛⲁⲟⲩ	N	ϩⲛⲁⲟⲩ
ϩⲛⲁⲩⲛⲕⲁⲥⲟⲧⲉ	N	ϩⲛⲁⲩⲛⲕⲁⲥⲟⲧⲉ
ϩⲛⲁⲩ	ADV	ϩⲛⲁⲩ
ϩⲛⲁⲩ	N	ϩⲛⲁⲩ
ϩⲛⲁ	N	ϩⲛⲉ
ϩⲛⲁ	VBD	ϩⲛⲉ
ϩⲛⲉ	VBD	ϩⲛⲉ
ϩⲛⲏ	N	ϩⲛⲏ
ϩⲛⲕⲉⲙⲁ	ADV	ϩⲛⲕⲉⲙⲁ
ϩⲛⲛⲉϩⲟⲟⲩⲛ	PREP	ϩⲛⲛⲉϩⲟⲟⲩⲛ
ϩⲛⲟⲩϣⲉⲡϩⲙⲟⲧ	ADV	ϩⲛⲟⲩϣⲉⲡϩⲙⲟⲧ
ϩⲛⲟⲩϣⲡϩⲙⲟⲧ	ADV	ϩⲛⲟⲩϣⲡϩⲙⲟⲧ
ϩⲛⲟⲩϣⲡⲉⲛϣⲱⲡ	ADV	ϩⲛⲟⲩϣⲡⲉⲛϣⲱⲡ
ϩⲛⲟⲩϣⲡⲛϣⲱⲡ	ADV	ϩⲛⲟⲩϣⲡⲛϣⲱⲡ
ϩⲛⲟⲩϩⲙⲟⲧ	ADV	ϩⲛⲟⲩϩⲙⲟⲧ
ϩⲛⲟⲩϩⲱⲡ	ADV	ϩⲛⲟⲩϩⲱⲡ
ϩⲛⲟⲩϫⲱⲕ	ADV	ϩⲛⲟⲩϫⲱⲕ
ϩⲛⲟⲩϭⲉⲡⲏ	ADV	ϩⲛⲟⲩϭⲉⲡⲏ
ϩⲛⲟⲩⲙⲉ	ADV	ϩⲛⲟⲩⲙⲉ
ϩⲛⲟⲩⲟⲩⲱⲛϩⲉⲃⲟⲗ	ADV	ϩⲛⲟⲩⲟⲩⲱⲛϩⲉⲃⲟⲗ
ϩⲛⲟⲩⲡⲉⲑⲏⲡ	ADV	ϩⲛⲟⲩⲡⲉⲑⲏⲡ
ϩⲛⲟ	N	ϩⲛⲁⲩ
ϩⲛⲧⲉⲩϣⲏ	ADV	ϩⲛⲧⲉⲩϣⲏ
ϩⲛⲧⲉⲩⲛⲟⲩⲉⲧⲙⲙⲁⲩ	ADV	ϩⲛⲧⲉⲩⲛⲟⲩⲉⲧⲙⲙⲁⲩ
ϩⲛⲧⲉⲩⲛⲟⲩ	ADV	ϩⲛⲧⲉⲩⲛⲟⲩ
ϩⲛⲧⲙⲏⲧⲉⲙ	PREP	ϩⲛⲧⲙⲏⲧⲉⲛ
ϩⲛⲧⲙⲏⲧⲉⲛ	PREP	ϩⲛⲧⲙⲏⲧⲉⲛ
ϩⲛⲧⲟⲩ	N	ϩⲛⲧⲟⲩ
ϩⲛ	ART	ϩⲛ
ϩⲛ	PREP	ϩⲛ
ϩⲟϥ	N	ϩⲟϥ
ϩⲟϫϩϫ	V	ϩⲟϫϩϫ
ϩⲟϫϩⲉϫ	V	ϩⲟϫϩⲉϫ
ϩⲟⲃⲟⲗⲟⲥ	N	ϩⲟⲃⲟⲗⲟⲥ
ϩⲟⲃⲥ	V	ϩⲱⲃⲥ
ϩⲟⲇⲟⲥ	N	ϩⲟⲇⲟⲥ
ϩⲟⲉⲓⲙ	N	ϩⲟⲉⲓⲙ
ϩⲟⲉⲓⲛⲉ	N	ϩⲟⲓⲛⲉ
ϩⲟⲉⲓⲧⲉ	N	ϩⲟⲉⲓⲧⲉ
ϩⲟⲓⲛⲉ	N	ϩⲟⲓⲛⲉ
ϩⲟⲓⲟⲛ	N	ϩⲟⲓⲟⲛ
ϩⲟⲓⲧⲉ	N	ϩⲟⲓⲧⲉ
ϩⲟⲓ	N	ϩⲟⲓ
ϩⲟⲕ	V	ϩⲱⲱⲕ
ϩⲟⲗϭ	VSTAT	ϩⲗⲟϭ
ϩⲟⲗⲓⲅⲟⲛ	N	ϩⲟⲗⲓⲅⲟⲛ
ϩⲟⲗⲟⲕⲁⲩⲧⲱⲙⲁ	N	ϩⲟⲗⲟⲕⲁⲩⲧⲱⲙⲁ
ϩⲟⲗⲟⲕⲟⲧϯⲛⲟⲥ	N	ϩⲟⲗⲟⲕⲟⲧϯⲛⲟⲥ
ϩⲟⲗⲟⲕⲟⲧⲧⲓⲛⲟⲥ	N	ϩⲟⲗⲟⲕⲟⲧⲧⲓⲛⲟⲥ
ϩⲟⲗⲟⲛ	N	ϩⲟⲗⲟⲛ
ϩⲟⲗⲟⲥⲉⲣⲓⲕⲟⲛ	N	ϩⲟⲗⲟⲥⲉⲣⲓⲕⲟⲛ
ϩⲟⲗⲟⲥⲏⲣⲓⲕⲕⲟⲛ	N	ϩⲟⲗⲟⲥⲏⲣⲓⲕⲕⲟⲛ
ϩⲟⲗⲟⲥ	ADV	ϩⲟⲗⲟⲥ
ϩⲟⲗⲱⲥ	ADV	ϩⲟⲗⲱⲥ
ϩⲟⲙⲉⲗⲓⲁ	N	ϩⲟⲙⲉⲗⲓⲁ
ϩⲟⲙⲏⲗⲉⲓ	V	ϩⲟⲙⲏⲗⲉⲓ
ϩⲟⲙⲏⲗⲓⲁ	N	ϩⲟⲙⲏⲗⲓⲁ
ϩⲟⲙⲏⲣⲟⲥ	N	ϩⲟⲙⲏⲣⲟⲥ
ϩⲟⲙⲓⲗⲓⲁ	N	ϩⲟⲙⲓⲗⲓⲁ
ϩⲟⲙⲛⲧ	N	ϩⲟⲙⲛⲧ
ϩⲟⲙⲟⲓⲱⲥ	ADV	ϩⲟⲙⲟⲓⲱⲥ
ϩⲟⲙⲟⲗⲓⲁ	N	ϩⲟⲙⲟⲗⲓⲁ
ϩⲟⲙⲟⲗⲟⲅⲉⲓⲁ	N	ϩⲟⲙⲟⲗⲟⲅⲉⲓⲁ
ϩⲟⲙⲟⲗⲟⲅⲉⲓ	V	ϩⲟⲙⲟⲗⲟⲅⲉⲓ
ϩⲟⲙⲟⲗⲟⲅⲏⲧⲏⲥ	N	ϩⲟⲙⲟⲗⲟⲅⲏⲧⲏⲥ
ϩⲟⲙⲟⲗⲟⲅⲓⲁ	N	ϩⲟⲙⲟⲗⲟⲅⲓⲁ
ϩⲟⲙⲟⲛⲟⲓⲁ	N	ϩⲟⲙⲟⲛⲟⲓⲁ
ϩⲟⲙⲟⲛⲟⲓ	V	ϩⲟⲙⲟⲛⲟⲓ
ϩⲟⲙⲟⲟⲩⲥⲓⲟⲛ	N	ϩⲟⲙⲟⲟⲩⲥⲓⲟⲛ
ϩⲟⲙⲟⲟⲩⲥⲓⲟⲥ	N	ϩⲟⲙⲟⲟⲩⲥⲓⲟⲥ
ϩⲟⲙⲧ	N	ϩⲟⲙⲧ
ϩⲟⲙⲱⲥ	ADV	ϩⲟⲙⲱⲥ
ϩⲟⲛ	V	ϩⲱⲛ
ϩⲟⲟⲕⲉ	VSTAT	ϩⲟⲟⲕⲉ
ϩⲟⲟⲗⲉ	N	ϩⲟⲟⲗⲉ
ϩⲟⲟⲩϣ	V	ϩⲟⲟⲩϣ
ϩⲟⲟⲩⲧ	N	ϩⲟⲟⲩⲧ
ϩⲟⲟⲩ	N	ϩⲟⲟⲩ
ϩⲟⲟⲩ	V	ϩⲟⲟⲩ
ϩⲟⲟⲩ	VSTAT	ϩⲟⲟⲩ
ϩⲟⲡⲗⲟⲛ	N	ϩⲟⲡⲗⲟⲛ
ϩⲟⲡⲟⲧⲉ	CONJ	ϩⲟⲡⲟⲧⲉ
ϩⲟⲡⲟⲩ	ADV	ϩⲟⲡⲟⲩ
ϩⲟⲡⲱⲥ	ADV	ϩⲟⲡⲱⲥ
ϩⲟⲡ	V	ϩⲱⲡ
ϩⲟⲣϣ	VSTAT	ϩⲣⲟϣ
ϩⲟⲣⲁⲙⲁ	N	ϩⲟⲣⲁⲙⲁ
ϩⲟⲣⲁⲥⲓⲥ	N	ϩⲟⲣⲁⲥⲓⲥ
ϩⲟⲣⲓⲍⲉ	V	ϩⲟⲣⲓⲍⲉ
ϩⲟⲣⲙⲁⲕⲏ	N	ϩⲟⲣⲙⲁⲕⲏ
ϩⲟⲣⲙⲏ	N	ϩⲟⲣⲙⲏ
ϩⲟⲣⲙⲓⲥⲕⲟⲥ	N	ϩⲟⲣⲙⲓⲥⲕⲟⲥ
ϩⲟⲣⲟⲙⲁ	N	ϩⲟⲣⲟⲙⲁ
ϩⲟⲣⲟⲥ	N	ϩⲟⲣⲟⲥ
ϩⲟⲣⲡ	V	ϩⲟⲣⲡ
ϩⲟⲣ	V	ϩⲱⲣ
ϩⲟⲥⲉⲙ	NPROP	ϩⲟⲥⲉⲙ
ϩⲟⲥⲉ	VSTAT	ϩⲓⲥⲉ
ϩⲟⲥⲓⲱⲧⲁⲧⲟⲥ	N	ϩⲟⲥⲓⲱⲧⲁⲧⲟⲥ
ϩⲟⲥⲟⲛ	ADV	ϩⲟⲥⲟⲛ
ϩⲟⲥⲟⲛ	N	ϩⲟⲥⲟⲛ
ϩⲟⲧϩⲉⲧ	V	ϩⲟⲧϩⲉⲧ
ϩⲟⲧϩⲧ	V	ϩⲟⲧϩⲧ
ϩⲟⲧⲁⲛ	CONJ	ϩⲟⲧⲁⲛ
ϩⲟⲧⲃⲉ	V	ϩⲱⲧⲃ
ϩⲟⲧⲃ	V	ϩⲱⲧⲃ
ϩⲟⲧⲉ	N	ϩⲟⲧⲉ
ϩⲟⲧⲓ	CONJ	ϩⲟⲧⲓ
ϩⲟⲧⲡ	V	ϩⲟⲧⲡ
ϩⲟⲧⲣ	VSTAT	ϩⲱⲧⲣ
ϩⲟⲧ	N	ϩⲟⲧ
ϩⲟⲩⲉⲓⲧⲉ	N	ϩⲟⲩⲉⲓⲧⲉ
ϩⲟⲩⲉ	ADV	ϩⲟⲩⲉ
ϩⲟⲩⲉ	N	ϩⲟⲩⲉ
ϩⲟⲩⲙⲓⲥⲉ	N	ϩⲟⲩⲙⲓⲥⲉ
ϩⲟⲩⲙⲡⲉ	N	ϩⲟⲩⲙⲡⲉ
ϩⲟⲩⲛ	ADV	ϩⲟⲩⲛ
ϩⲟⲩⲛ	N	ϩⲟⲩⲛ
ϩⲟⲩⲟ	N	ϩⲟⲩⲟ
ϩⲟⲩo	N	ϩⲟⲩo
ϩⲟ	N	ϩⲟ
ϩⲣϣⲓⲣⲉ	N	ϩⲣϣⲓⲣⲉ
ϩⲣⲁϫⲣⲉϫ	V	ϩⲣⲁϫⲣⲉϫ
ϩⲣⲁⲃⲃⲉⲓ	N	ϩⲣⲁⲃⲃⲉⲓ
ϩⲣⲁⲃⲃⲓ	N	ϩⲣⲁⲃⲃⲓ
ϩⲣⲁⲃⲇⲟⲥ	N	ϩⲣⲁⲃⲇⲟⲥ
ϩⲣⲁⲉⲓ	ADV	ϩⲣⲁⲉⲓ
ϩⲣⲁⲓϩⲙ	PREP	ϩⲣⲁⲓϩⲛ
ϩⲣⲁⲓϩⲛ	PREP	ϩⲣⲁⲓϩⲛ
ϩⲣⲁⲓ	ADV	ϩⲣⲁⲓ
ϩⲣⲁⲓ	PREP	ϩⲣⲁⲓ
ϩⲣⲁⲙⲛⲟⲥ	N	ϩⲣⲁⲙⲛⲟⲥ
ϩⲣⲁⲭⲁ	N	ϩⲣⲁⲭⲁ
ϩⲣⲁⲭⲏⲗ	NPROP	ϩⲣⲁⲭⲏⲗ
ϩⲣⲁ	V	ϩⲣⲁ
ϩⲣⲃ	N	ϩⲣⲃ
ϩⲣⲉⲃⲉⲕⲕⲁ	NPROP	ϩⲣⲉⲃⲉⲕⲕⲁ
ϩⲣⲉⲙⲙⲁ	N	ϩⲣⲉⲙⲙⲁ
ϩⲣⲉⲡⲓⲍⲉ	V	ϩⲣⲉⲡⲓⲍⲉ
ϩⲣⲉ	N	ϩⲣⲉ
ϩⲣⲏϭ	N	ϩⲣⲏϭ
ϩⲣⲏⲣⲉ	N	ϩⲣⲏⲣⲉ
ϩⲣⲏⲥⲓⲥ	N	ϩⲣⲏⲥⲓⲥ
ϩⲣⲏⲧⲟⲛ	N	ϩⲣⲏⲧⲟⲛ
ϩⲣⲏⲧⲱⲣ	N	ϩⲣⲏⲧⲱⲣ
ϩⲣⲟϣ	V	ϩⲣⲟϣ
ϩⲣⲟⲃⲟⲁⲙ	NPROP	ϩⲣⲟⲃⲟⲁⲙ
ϩⲣⲟⲕⲛϩⲏⲧ	N	ϩⲣⲟⲕⲛϩⲏⲧ
ϩⲣⲟⲕ	V	ϩⲣⲟⲕ
ϩⲣⲟⲟⲩ	N	ϩⲣⲟⲟⲩ
ϩⲣⲟⲩⲃⲃⲁⲉⲓ	N	ϩⲣⲟⲩⲃⲃⲁⲉⲓ
ϩⲣⲟⲩⲃⲃⲁⲓ	N	ϩⲣⲟⲩⲃⲃⲁⲓ
ϩⲣⲟⲩⲫⲟⲥ	NPROP	ϩⲣⲟⲩⲫⲟⲥ
ϩⲣⲟⲩ	N	ϩⲣⲟⲩ
ϩⲣⲱⲙⲁⲓⲕⲟⲛ	N	ϩⲣⲱⲙⲁⲓⲕⲟⲛ
ϩⲣⲱⲙⲁⲓⲟⲥ	N	ϩⲣⲱⲙⲁⲓⲟⲥ
ϩⲣⲱⲙⲁⲓⲱⲥ	N	ϩⲣⲱⲙⲁⲓⲱⲥ
ϩⲣⲱⲙⲁⲛⲟⲥ	NPROP	ϩⲣⲱⲙⲁⲛⲟⲥ
ϩⲣⲱⲙⲏ	NPROP	ϩⲣⲱⲙⲏ
ϩⲣⲱ	N	ϩⲣⲱ
ϩⲧⲉⲙⲧⲟⲙⲧ	VSTAT	ϩⲧⲟⲙⲧⲙ
ϩⲧⲉⲙⲧⲱⲙ	VSTAT	ϩⲧⲟⲙⲧⲙ
ϩⲧⲏ	N	ϩⲏⲧ
ϩⲧⲙⲧⲟⲙⲧ	VSTAT	ϩⲧⲟⲙⲧⲙ
ϩⲧⲙⲧⲱⲙ	VSTAT	ϩⲧⲟⲙⲧⲙ
ϩⲧⲟⲙⲧⲉⲙ	V	ϩⲧⲟⲙⲧⲉⲙ
ϩⲧⲟⲙⲧⲙ	V	ϩⲧⲟⲙⲧⲙ
ϩⲧⲟⲟⲩⲉ	N	ϩⲧⲟⲟⲩⲉ
ϩⲧⲟⲟⲩ	N	ϩⲧⲟⲟⲩ
ϩⲧⲟⲟⲩ	V	ϩⲧⲟⲟⲩ
ϩⲧⲟⲡ	N	ϩⲧⲟⲡ
ϩⲧⲟⲣ	N	ϩⲧⲟⲣ
ϩⲧⲟ	N	ϩⲧⲟ
ϩⲧⲱⲱⲣ	N	ϩⲧⲟ
ϩⲩⲁⲕⲓⲛⲑⲓⲛⲟⲛ	N	ϩⲩⲁⲕⲓⲛⲑⲓⲛⲟⲛ
ϩⲩⲁⲕⲓⲛⲑⲟⲥ	N	ϩⲩⲁⲕⲓⲛⲑⲟⲥ
ϩⲩⲃⲣⲓⲍⲉ	V	ϩⲩⲃⲣⲓⲍⲉ
ϩⲩⲇⲁⲛⲉ	V	ϩⲩⲇⲁⲛⲉ
ϩⲩⲇⲣⲓⲁ	N	ϩⲩⲇⲣⲓⲁ
ϩⲩⲇⲣⲟⲡⲓⲕⲟⲥ	N	ϩⲩⲇⲣⲟⲡⲓⲕⲟⲥ
ϩⲩⲗⲏ	N	ϩⲩⲗⲏ
ϩⲩⲗⲓⲕⲏ	N	ϩⲩⲗⲓⲕⲏ
ϩⲩⲗⲓⲕⲟⲛ	N	ϩⲩⲗⲓⲕⲟⲛ
ϩⲩⲗⲓⲕⲟⲥ	N	ϩⲩⲗⲓⲕⲟⲥ
ϩⲩⲙⲉⲛⲁⲓⲟⲥ	NPROP	ϩⲩⲙⲉⲛⲁⲓⲟⲥ
ϩⲩⲙⲏⲛ	N	ϩⲩⲙⲏⲛ
ϩⲩⲙⲛⲉⲩⲉ	V	ϩⲩⲙⲛⲉⲩⲉ
ϩⲩⲙⲛⲓ	V	ϩⲩⲙⲛⲓ
ϩⲩⲙⲛⲟⲗⲟⲅⲉⲓ	V	ϩⲩⲙⲛⲟⲗⲟⲅⲉⲓ
ϩⲩⲙⲛⲟⲗⲟⲅⲓⲁ	N	ϩⲩⲙⲛⲟⲗⲟⲅⲓⲁ
ϩⲩⲙⲛⲟⲥ	N	ϩⲩⲙⲛⲟⲥ
ϩⲩⲙⲛⲱⲧⲟⲥ	N	ϩⲩⲙⲛⲱⲧⲟⲥ
ϩⲩⲡⲁⲣⲏⲥ	N	ϩⲩⲡⲁⲣⲏⲥ
ϩⲩⲡⲁⲣⲝⲓⲥ	N	ϩⲩⲡⲁⲣⲝⲓⲥ
ϩⲩⲡⲁⲣⲭⲟⲛⲧⲁ	N	ϩⲩⲡⲁⲣⲭⲟⲛⲧⲁ
ϩⲩⲡⲁⲣ	N	ϩⲩⲡⲁⲣ
ϩⲩⲡⲉⲣⲉⲓⲧⲉⲓ	V	ϩⲩⲡⲉⲣⲉⲓⲧⲉⲓ
ϩⲩⲡⲉⲣⲉⲧⲉⲓ	V	ϩⲩⲡⲉⲣⲉⲧⲉⲓ
ϩⲩⲡⲉⲣⲏⲧⲉⲓ	V	ϩⲩⲡⲉⲣⲏⲧⲉⲓ
ϩⲩⲡⲉⲣⲏⲧⲏⲥ	N	ϩⲩⲡⲉⲣⲏⲧⲏⲥ
ϩⲩⲡⲉⲣⲓⲭⲟⲥ	NPROP	ϩⲩⲡⲉⲣⲓⲭⲟⲥ
ϩⲩⲡⲏⲣⲉⲥⲓⲁ	N	ϩⲩⲡⲏⲣⲉⲥⲓⲁ
ϩⲩⲡⲏⲣⲉⲧⲉⲓ	V	ϩⲩⲡⲏⲣⲉⲧⲉⲓ
ϩⲩⲡⲏⲣⲉⲧⲏⲥ	N	ϩⲩⲡⲏⲣⲉⲧⲏⲥ
ϩⲩⲡⲟⲅⲟⲣⲉⲩⲉ	V	ϩⲩⲡⲟⲅⲟⲣⲉⲩⲉ
ϩⲩⲡⲟⲅⲣⲁⲫⲉⲩⲥ	N	ϩⲩⲡⲟⲅⲣⲁⲫⲉⲩⲥ
ϩⲩⲡⲟⲅⲣⲁⲫⲉ	V	ϩⲩⲡⲟⲅⲣⲁⲫⲉ
ϩⲩⲡⲟⲅⲣⲁⲫⲏ	V	ϩⲩⲡⲟⲅⲣⲁⲫⲏ
ϩⲩⲡⲟⲇⲓⲁⲕⲟⲛⲟⲥ	N	ϩⲩⲡⲟⲇⲓⲁⲕⲟⲛⲟⲥ
ϩⲩⲡⲟⲇⲓⲁⲕⲱⲛ	N	ϩⲩⲡⲟⲇⲓⲁⲕⲱⲛ
ϩⲩⲡⲟⲕⲉⲓⲥⲑⲁⲓ	V	ϩⲩⲡⲟⲕⲉⲓⲥⲑⲁⲓ
ϩⲩⲡⲟⲕⲓⲥⲑⲁⲓ	V	ϩⲩⲡⲟⲕⲓⲥⲑⲁⲓ
ϩⲩⲡⲟⲕⲓⲥⲑⲉ	V	ϩⲩⲡⲟⲕⲓⲥⲑⲉ
ϩⲩⲡⲟⲕⲟⲣⲉⲩⲉ	V	ϩⲩⲡⲟⲕⲟⲣⲉⲩⲉ
ϩⲩⲡⲟⲕⲣⲓⲛⲉ	V	ϩⲩⲡⲟⲕⲣⲓⲛⲉ
ϩⲩⲡⲟⲕⲣⲓⲥⲓⲥ	N	ϩⲩⲡⲟⲕⲣⲓⲥⲓⲥ
ϩⲩⲡⲟⲕⲣⲓⲧⲏⲥ	N	ϩⲩⲡⲟⲕⲣⲓⲧⲏⲥ
ϩⲩⲡⲟⲗⲩⲙⲯⲓⲥ	N	ϩⲩⲡⲟⲗⲩⲙⲯⲓⲥ
ϩⲩⲡⲟⲙⲉⲓⲛⲉ	V	ϩⲩⲡⲟⲙⲉⲓⲛⲉ
ϩⲩⲡⲟⲙⲓⲛⲉ	V	ϩⲩⲡⲟⲙⲓⲛⲉ
ϩⲩⲡⲟⲙⲛⲏⲙⲁ	N	ϩⲩⲡⲟⲙⲛⲏⲙⲁ
ϩⲩⲡⲟⲙⲛⲏⲥⲓⲥ	N	ϩⲩⲡⲟⲙⲛⲏⲥⲓⲥ
ϩⲩⲡⲟⲙⲛⲏⲥⲕⲉ	V	ϩⲩⲡⲟⲙⲛⲏⲥⲕⲉ
ϩⲩⲡⲟⲙⲟⲛⲏ	N	ϩⲩⲡⲟⲙⲟⲛⲏ
ϩⲩⲡⲟⲡⲟⲇⲓⲟⲛ	N	ϩⲩⲡⲟⲡⲟⲇⲓⲟⲛ
ϩⲩⲡⲟⲥⲧⲁⲥⲓⲥ	N	ϩⲩⲡⲟⲥⲧⲁⲥⲓⲥ
ϩⲩⲡⲟⲧⲁⲅⲏ	N	ϩⲩⲡⲟⲧⲁⲅⲏ
ϩⲩⲡⲟⲧⲁⲥⲥⲉ	V	ϩⲩⲡⲟⲧⲁⲥⲥⲉ
ϩⲩⲡⲟⲩⲣⲅⲉⲓ	V	ϩⲩⲡⲟⲩⲣⲅⲉⲓ
ϩⲩⲡⲟⲩⲣⲅⲓⲥⲑⲉ	V	ϩⲩⲡⲟⲩⲣⲅⲓⲥⲑⲉ
ϩⲩⲡⲟⲭⲟⲣⲉⲓ	V	ϩⲩⲡⲟⲭⲟⲣⲉⲓ
ϩⲩⲡⲱⲣⲁⲟⲛ	N	ϩⲩⲡⲱⲣⲁⲟⲛ
ϩⲩⲥⲥⲱⲡⲟⲥ	N	ϩⲩⲥⲥⲱⲡⲟⲥ
ϩⲱϣ	V	ϩⲱϣ
ϩⲱϥⲧ	V	ϩⲱϥⲧ
ϩⲱϭⲃ	V	ϩⲱϭⲃ
ϩⲱⲃⲛⲓⲙ	N	ϩⲱⲃⲛⲓⲙ
ϩⲱⲃⲥ	V	ϩⲱⲃⲥ
ϩⲱⲃ	N	ϩⲱⲃ
ϩⲱⲕ	V	ϩⲱⲕ
ϩⲱⲗⲟⲥ	ADV	ϩⲱⲗⲟⲥ
ϩⲱⲗⲱⲥ	ADV	ϩⲱⲗⲱⲥ
ϩⲱⲗ	V	ϩⲱⲗ
ϩⲱⲙⲟⲓⲱⲥ	ADV	ϩⲱⲙⲟⲓⲱⲥ
ϩⲱⲙ	V	ϩⲱⲙ
ϩⲱⲛⲧ	V	ϩⲱⲛⲧ
ϩⲱⲛ	V	ϩⲱⲛ
ϩⲱⲟⲩ	V	ϩⲱⲟⲩ
ϩⲱⲡ	N	ϩⲱⲡ
ϩⲱⲡ	V	ϩⲱⲡ
ϩⲱⲣϭ	V	ϩⲱⲣϭ
ϩⲱⲣⲃ	V	ϩⲱⲣⲃ
ϩⲱⲣⲓⲅⲉⲛⲏⲥ	NPROP	ϩⲱⲣⲓⲅⲉⲛⲏⲥ
ϩⲱⲣⲓⲍⲉ	V	ϩⲱⲣⲓⲍⲉ
ϩⲱⲣⲡ	V	ϩⲱⲣⲡ
ϩⲱⲣⲥⲓⲉⲥⲓⲟⲥ	NPROP	ϩⲱⲣⲥⲓⲉⲥⲓⲟⲥ
ϩⲱⲣⲥⲓⲏⲥⲓⲟⲥ	NPROP	ϩⲱⲣⲥⲓⲏⲥⲓⲟⲥ
ϩⲱⲥⲇⲉ	CONJ	ϩⲱⲥⲇⲉ
ϩⲱⲥⲧⲉ	CONJ	ϩⲱⲥⲧⲉ
ϩⲱⲥ	CONJ	ϩⲱⲥ
ϩⲱⲥ	N	ϩⲱⲥ
ϩⲱⲧⲃ	V	ϩⲱⲧⲃ
ϩⲱⲧⲡ	N	ϩⲱⲧⲡ
ϩⲱⲧⲡ	V	ϩⲱⲧⲡ
ϩⲱⲧ	IMOD	ϩⲱⲧ
ϩⲱⲧ	N	ϩⲱⲧ
ϩⲱⲱ	ADV	ϩⲱⲱ
ϩⲱⲱ	IMOD	ϩⲱⲱ
ϩⲱ	IMOD	ϩⲱⲱ
ϩⲱ	IMOD_PPERO	ϩⲱ
ϩⲱ	V	ϩⲱ
ϫⲁϩⲙ	V	ϫⲱϩⲙ
ϫⲁϩⲙ	VSTAT	ϫⲱϩⲙ
ϫⲁϫⲉⲉⲩ	N	ϫⲁϫⲉⲉⲩ
ϫⲁϫⲉ	N	ϫⲁϫⲉ
ϫⲁϫⲱ	VSTAT	ϫⲁϫⲉ
ϫⲁϫ	N	ϫⲁϫ
ϫⲁⲉⲓⲉ	N	ϫⲁⲉⲓⲉ
ϫⲁⲓⲃⲉⲕⲉ	N	ϫⲁⲓⲃⲉⲕⲉ
ϫⲁⲓⲉ	N	ϫⲁⲓⲉ
ϫⲁⲓⲏ	N	ϫⲁⲓⲏ
ϫⲁⲙⲏ	N	ϫⲁⲙⲏ
ϫⲁⲥⲓϩⲏⲧ	N	ϫⲁⲥⲓϩⲏⲧ
ϫⲁⲥⲧⲉ	V	ϫⲓⲥⲉ
ϫⲁⲥⲧ	V	ϫⲓⲥⲉ
ϫⲁⲧϥⲉ	N	ϫⲁⲧϥⲉ
ϫⲁⲧⲃⲉ	N	ϫⲁⲧⲃⲉ
ϫⲁⲩⲙⲟⲉⲓⲧ	N	ϫⲁⲩⲙⲟⲉⲓⲧ
ϫⲁⲩⲙⲟⲓⲧ	N	ϫⲁⲩⲙⲟⲓⲧ
ϫⲃⲃⲉⲥ	N	ϫⲃⲃⲉⲥ
ϫⲉϭⲟⲗ	V	ϫⲉϭⲟⲗ
ϫⲉⲕϫⲓⲕ	V	ϫⲉⲕϫⲓⲕ
ϫⲉⲕⲁⲁⲥ	CONJ	ϫⲉⲕⲁⲁⲥ
ϫⲉⲕⲁⲥ	CONJ	ϫⲉⲕⲁⲥ
ϫⲉⲕⲙ	V	ϫⲉⲕⲙ
ϫⲉⲕ	V	ϫⲱⲱⲕⲉ
ϫⲉⲛⲁ	V	ϫⲉⲛⲁ
ϫⲉⲛⲉⲡⲱⲣ	N	ϫⲉⲛⲉⲡⲱⲣ
ϫⲉⲛⲙⲙⲟⲛ	CONJ	ϫⲉⲛⲙⲙⲟⲛ
ϫⲉⲛⲟⲩ	N	ϫⲉⲛⲟⲩ
ϫⲉⲟⲩⲁ	V	ϫⲉⲟⲩⲁ
ϫⲉⲡ	N	ϫⲡ
ϫⲉⲣⲟ	V	ϫⲉⲣⲟ
ϫⲉⲣⲱϥ	V	ϫⲉⲣⲱϥ
ϫⲉⲣⲱ	V	ϫⲉⲣⲱ
ϫⲉⲩ	V	ϫⲓ
ϫⲉ	CONJ	ϫⲉ
ϫⲉ	V	ϫⲱ
ϫⲏϩ	VSTAT	ϫⲱϩ
ϫⲏϭⲉ	N	ϫⲏϭⲉ
ϫⲏⲏⲥ	N	ϫⲏⲏⲥ
ϫⲏⲕ	VSTAT	ϫⲱⲕ
ϫⲏⲣ	VSTAT	ϫⲱⲣ
ϫⲏⲩⲛϭⲟⲛⲥ	VSTAT	ϫⲓⲛϭⲟⲛⲥ
ϫⲓϣⲁϫⲉ	V	ϫⲓϣⲁϫⲉ
ϫⲓϣⲓⲡⲉ	V	ϫⲓϣⲓⲡⲉ
ϫⲓϣⲕⲁⲕⲉⲃⲟⲗ	V	ϫⲓϣⲕⲁⲕⲉⲃⲟⲗ
ϫⲓϣⲕⲁⲕ	V	ϫⲓϣⲕⲁⲕ
ϫⲓϩⲁⲓ	V	ϫⲓϩⲁⲓ
ϫⲓϩⲁⲡ	V	ϫⲓϩⲁⲡ
ϫⲓϩⲓⲕⲱⲛ	V	ϫⲓϩⲓⲕⲱⲛ
ϫⲓϩⲓⲙⲉ	V	ϫⲓϩⲓⲙⲉ
ϫⲓϩⲟ	V	ϫⲓϩⲟ
ϫⲓϩⲣⲁϥ	N	ϫⲓϩⲣⲁϥ
ϫⲓϩⲣⲃ	V	ϫⲓϩⲣⲃ
ϫⲓϩ	N	ϫⲓϩ
ϫⲓϫⲉⲉⲩⲉ	N	ϫⲁϫⲉ
ϫⲓϫⲉⲩⲉ	N	ϫⲁϫⲉ
ϫⲓϫⲱⲓ	NPROP	ϫⲓϫⲱⲓ
ϫⲓϭⲟⲗ	V	ϫⲓϭⲟⲗ
ϫⲓϯⲡⲉ	V	ϫⲓϯⲡⲉ
ϫⲓϯ	N	ϫⲓϯ
ϫⲓⲁⲅⲁⲡⲏ	V	ϫⲓⲁⲅⲁⲡⲏ
ϫⲓⲁⲉⲓⲕ	N	ϫⲓⲁⲉⲓⲕ
ϫⲓⲁⲛⲁⲡⲁⲩⲥⲓⲥ	V	ϫⲓⲁⲛⲁⲡⲁⲩⲥⲓⲥ
ϫⲓⲁⲝⲓⲱⲙⲁ	V	ϫⲓⲁⲝⲓⲱⲙⲁ
ϫⲓⲁⲣⲭⲏ	V	ϫⲓⲁⲣⲭⲏ
ϫⲓⲃⲁⲡⲧⲓⲥⲙⲁ	V	ϫⲓⲃⲁⲡⲧⲓⲥⲙⲁ
ϫⲓⲉⲝⲟⲩⲥⲓⲁ	V	ϫⲓⲉⲝⲟⲩⲥⲓⲁ
ϫⲓⲉⲟⲟⲩ	V	ϫⲓⲉⲟⲟⲩ
ϫⲓⲉⲡⲓⲧⲓⲙⲓⲁ	V	ϫⲓⲉⲡⲓⲧⲓⲙⲓⲁ
ϫⲓⲕⲁⲧⲏⲅⲟⲣⲓⲁ	V	ϫⲓⲕⲁⲧⲏⲅⲟⲣⲓⲁ
ϫⲓⲕⲃⲁ	N	ϫⲓⲕⲃⲁ
ϫⲓⲕⲗⲏⲣⲟⲛⲟⲙⲓⲁ	V	ϫⲓⲕⲗⲏⲣⲟⲛⲟⲙⲓⲁ
ϫⲓⲕⲗⲏⲣⲟⲥ	V	ϫⲓⲕⲗⲏⲣⲟⲥ
ϫⲓⲗⲩⲡⲏ	V	ϫⲓⲗⲩⲡⲏ
ϫⲓⲙⲟⲉⲓⲧ	V	ϫⲓⲙⲟⲉⲓⲧ
ϫⲓⲙⲟⲣⲫⲏ	V	ϫⲓⲙⲟⲣⲫⲏ
ϫⲓⲛϣⲟⲣⲡ	ADV	ϫⲓⲛϣⲟⲣⲡ
ϫⲓⲛϫⲏ	N	ϫⲓⲛϫⲏ
ϫⲓⲛϭⲟⲛⲥ	N	ϫⲓⲛϭⲟⲛⲥ
ϫⲓⲛⲉⲡⲉⲩⲟⲉⲓϣⲉⲧⲙⲙⲁⲩ	ADV	ϫⲓⲛⲉⲡⲉⲩⲟⲉⲓϣⲉⲧⲙⲙⲁⲩ
ϫⲓⲛⲉⲡⲉⲩⲟⲉⲓϣ	ADV	ϫⲓⲛⲉⲡⲉⲩⲟⲉⲓϣ
ϫⲓⲛⲉ	PREP	ϫⲓⲛⲉ
ϫⲓⲛⲙⲙⲟⲛ	CONJ	ϫⲓⲛⲙⲙⲟⲛ
ϫⲓⲛⲙ	PREP	ϫⲓⲛⲛ
ϫⲓⲛⲛϣⲟⲣⲡ	ADV	ϫⲓⲛⲛϣⲟⲣⲡ
ϫⲓⲛⲛ	PREP	ϫⲓⲛⲛ
ϫⲓⲛⲧⲁ	CONJ	ϫⲓⲛⲧⲁ
ϫⲓⲛⲧⲉⲛⲟⲩ	ADV	ϫⲓⲛⲧⲉⲛⲟⲩ
ϫⲓⲛ	ADV	ϫⲓⲛ
ϫⲓⲛ	CONJ	ϫⲓⲛ
ϫⲓⲛ	PREP	ϫⲓⲛ
ϫⲓⲟⲟⲣ	V	ϫⲓⲟⲟⲣ
ϫⲓⲟⲩⲁ	V	ϫⲓⲟⲩⲁ
ϫⲓⲟⲩⲉ	N	ϫⲓⲟⲩⲉ
ϫⲓⲟⲩⲉ	V	ϫⲓⲟⲩⲉ
ϫⲓⲡⲉⲓⲣⲁ	V	ϫⲓⲡⲉⲓⲣⲁ
ϫⲓⲡⲏⲣⲁ	V	ϫⲓⲡⲏⲣⲁ
ϫⲓⲡⲓⲣⲁ	V	ϫⲓⲡⲓⲣⲁ
ϫⲓⲡⲟⲩⲱ	V	ϫⲓⲡⲟⲩⲱ
ϫⲓⲥϩⲓⲙⲉ	V	ϫⲓⲥϩⲓⲙⲉ
ϫⲓⲥⲁⲣⲝ	V	ϫⲓⲥⲁⲣⲝ
ϫⲓⲥⲃⲱ	V	ϫⲓⲥⲃⲱ
ϫⲓⲥⲉⲛϩⲏⲧ	V	ϫⲓⲥⲉⲛϩⲏⲧ
ϫⲓⲥⲉ	N	ϫⲓⲥⲉ
ϫⲓⲥⲉ	V	ϫⲓⲥⲉ
ϫⲓⲥⲙⲟⲩ	V	ϫⲓⲥⲙⲟⲩ
ϫⲓⲥⲧⲟⲗⲏ	V	ϫⲓⲥⲧⲟⲗⲏ
ϫⲓⲥⲩⲙⲃⲟⲩⲗⲓⲟⲛ	V	ϫⲓⲥⲩⲙⲃⲟⲩⲗⲓⲟⲛ
ϫⲓⲥⲭⲏⲙⲁ	V	ϫⲓⲥⲭⲏⲙⲁ
ϫⲓⲥⲱϣ	V	ϫⲓⲥⲱϣ
ϫⲓⲥⲱⲙⲁ	V	ϫⲓⲥⲱⲙⲁ
ϫⲓⲧⲉⲭⲟⲗⲗⲏ	V	ϫⲓⲧⲉⲭⲟⲗⲗⲏ
ϫⲓⲧⲉ	V	ϫⲓ
ϫⲓⲧⲓⲡⲉ	V	ϫⲓⲧⲓⲡⲉ
ϫⲓⲧⲣⲟⲫⲏ	V	ϫⲓⲧⲣⲟⲫⲏ
ϫⲓⲧⲩⲡⲟⲥ	V	ϫⲓⲧⲩⲡⲟⲥ
ϫⲓⲧ	V	ϫⲓ
ϫⲓ	ADV	ϫⲓ
ϫⲓ	CONJ	ϫⲓ
ϫⲓ	N	ϫⲓ
ϫⲓ	PREP	ϫⲓ
ϫⲓ	V	ϫⲓ
ϫⲕ	V	ϫⲕ
ϫⲛⲁϩ	N	ϫⲛⲁϩ
ϫⲛⲁⲁⲩ	N	ϫⲛⲁⲁⲩ
ϫⲛⲉ	CONJ	ϫⲛⲉ
ϫⲛⲉ	V	ϫⲛⲟⲩ
ϫⲛⲙⲙⲟⲛ	CONJ	ϫⲛⲙⲙⲟⲛ
ϫⲛⲟⲩ	V	ϫⲛⲟⲩ
ϫⲛ	CONJ	ϫⲛ
ϫⲛ	PREP	ϫⲛ
ϫⲟⲉⲓⲥ	N	ϫⲟⲉⲓⲥ
ϫⲟⲉⲓⲧ	N	ϫⲟⲉⲓⲧ
ϫⲟⲉⲓ	N	ϫⲟⲉⲓ
ϫⲟⲉⲓ	V	ϫⲟⲉⲓ
ϫⲟⲓ	N	ϫⲟⲓ
ϫⲟⲕⲉⲣ	V	ϫⲟⲕⲉⲣ
ϫⲟⲕⲣ	V	ϫⲟⲕⲣ
ϫⲟⲕ	V	ϫⲱⲕ
ϫⲟⲛⲧ	VSTAT	ϫⲱⲛⲧ
ϫⲟⲟⲃⲉ	V	ϫⲱⲱⲃⲉ
ϫⲟⲟⲗⲉⲥ	N	ϫⲟⲟⲗⲉⲥ
ϫⲟⲟⲣⲉ	V	ϫⲱⲱⲣⲉ
ϫⲟⲟⲣⲉ	VSTAT	ϫⲱⲱⲣⲉ
ϫⲟⲟⲣ	V	ϫⲱⲱⲣⲉ
ϫⲟⲟⲣ	VSTAT	ϫⲣⲟ
ϫⲟⲟⲩⲉⲣⲁⲧ	V	ϫⲟⲟⲩⲉⲣⲁⲧ
ϫⲟⲟⲩⲥⲉ	V	ϫⲟⲟⲩⲥⲉ
ϫⲟⲟⲩⲧ	N	ϫⲟⲟⲩⲧ
ϫⲟⲟⲩ	V	ϫⲟⲟⲩ
ϫⲟⲟ	V	ϫⲱ
ϫⲟⲡϫⲡ	V	ϩϫⲟⲡϫⲡ
ϫⲟⲥⲉ	VSTAT	ϫⲓⲥⲉ
ϫⲟⲥ	N	ϫⲟⲥ
ϫⲟⲩϩⲉ	V	ϫⲟⲩϩⲉ
ϫⲟⲩⲥⲛⲟⲟⲩⲥ	N	ϫⲟⲩⲥⲛⲟⲟⲩⲥ
ϫⲟⲩⲧⲁϥⲧⲉ	N	ϫⲟⲩⲧⲁϥⲧⲉ
ϫⲟⲩⲧⲏ	N	ϫⲟⲩⲧⲏ
ϫⲟⲩⲧⲏ	NUM	ϫⲟⲩⲧⲏ
ϫⲟⲩⲧⲥⲛⲟⲟⲩⲥ	N	ϫⲟⲩⲧⲥⲛⲟⲟⲩⲥ
ϫⲟⲩⲧ	N	ϫⲟⲩⲧ
ϫⲟⲩⲧ	NUM	ϫⲟⲩⲧ
ϫⲟⲩⲱⲧⲉ	N	ϫⲟⲩⲱⲧⲉ
ϫⲟⲩⲱⲧⲛϣⲉ	N	ϫⲟⲩⲱⲧⲛϣⲉ
ϫⲟ	N	ϫⲟ
ϫⲟ	V	ϫⲟ
ϫⲡⲉ	V	ϫⲡⲟ
ϫⲡⲓⲉ	V	ϫⲡⲓⲟ
ϫⲡⲓⲟ	V	ϫⲡⲓⲟ
ϫⲡⲓ	V	ϫⲡⲓ
ϫⲡⲟ	N	ϫⲡⲟ
ϫⲡⲟ	V	ϫⲡⲟ
ϫⲡ	N	ϫⲡ
ϫⲣⲁⲉⲓⲧ	VSTAT	ϫⲣⲟ
ϫⲣⲟⲉⲓⲧ	VSTAT	ϫⲣⲟ
ϫⲣⲟⲡ	N	ϫⲣⲟⲡ
ϫⲣⲟ	V	ϫⲣⲟ
ϫⲧⲟ	V	ϫⲧⲟ
ϫⲱϥ	V	ϫⲱϥ
ϫⲱϩⲙ	N	ϫⲱϩⲙ
ϫⲱϩⲙ	V	ϫⲱϩⲙ
ϫⲱϩ	V	ϫⲱϩ
ϫⲱϭⲉ	V	ϫⲱϭⲉ
ϫⲱⲕⲉⲃⲟⲗ	V	ϫⲱⲕⲉⲃⲟⲗ
ϫⲱⲕⲙ	N	ϫⲱⲕⲙ
ϫⲱⲕⲙ	V	ϫⲱⲕⲙ
ϫⲱⲕⲣ	V	ϫⲱⲕⲣ
ϫⲱⲕ	V	ϫⲱⲕ
ϫⲱⲗϫ	V	ϫⲱⲗϫ
ϫⲱⲙⲙⲟⲟⲩ	V	ϫⲱⲙⲙⲟⲟⲩ
ϫⲱⲛⲧ	V	ϫⲱⲛⲧ
ϫⲱⲣⲉⲙ	V	ϫⲱⲣⲉⲙ
ϫⲱⲣⲙ	V	ϫⲱⲣⲙ
ϫⲱⲣ	V	ϫⲱⲣ
ϫⲱⲧⲉ	V	ϫⲱⲧⲉ
ϫⲱⲱⲙⲉ	N	ϫⲱⲱⲙⲉ
ϫⲱⲱⲣⲉ	V	ϫⲱⲱⲣⲉ
ϫⲱⲱⲣ	N	ϫⲱⲱⲣ
ϫⲱ	N	ϫⲱϫ
ϫⲱ	V	ϫⲱ
ϭⲁⲃ	N	ϭⲁⲃ
ϭⲁⲗⲉ	V	ϭⲟⲉⲓⲗⲉ
ϭⲁⲗⲱⲟⲩ	VSTAT	ϭⲟⲉⲓⲗⲉ
ϭⲁⲗⲱⲱ	V	ϭⲟⲉⲓⲗⲉ
ϭⲁⲗⲱ	V	ϭⲁⲗⲱ
ϭⲁⲙⲟⲩⲗ	N	ϭⲁⲙⲟⲩⲗ
ϭⲁⲛⲁϩ	N	ϭⲁⲛⲁϩ
ϭⲃϣⲁ	N	ϭⲃϣⲁ
ϭⲃⲃⲉ	V	ϭⲃⲃⲉ
ϭⲃⲟⲉⲓ	N	ϭⲃⲟⲉⲓ
ϭⲃⲟⲓ	N	ϭⲃⲟⲓ
ϭⲉϣϭⲱϣ	V	ϭⲉϣϭⲱϣ
ϭⲉⲃⲃⲉ	V	ϭⲉⲃⲃⲉ
ϭⲉⲃ	V	ϭⲉⲃ
ϭⲉⲉⲧ	VSTAT	ϭⲱ
ϭⲉⲗⲉ	V	ϭⲱⲱⲗⲉ
ϭⲉⲗⲙⲁⲓ	N	ϭⲉⲗⲙⲁⲓ
ϭⲉⲗⲡ	V	ϭⲱⲗⲡ
ϭⲉⲛⲑⲉⲛ	V	ϭⲓⲛⲉ
ϭⲉⲛⲧ	V	ϭⲓⲛⲉ
ϭⲉⲛ	V	ϭⲓⲛⲉ
ϭⲉⲡⲏ	N	ϭⲉⲡⲏ
ϭⲉⲡⲏ	V	ϭⲉⲡⲏ
ϭⲉⲡ	V	ϭⲱⲡⲉ
ϭⲉⲣⲁϭⲉ	N	ϭⲉⲣⲏϭ
ϭⲉⲣⲟⲟⲃ	N	ϭⲉⲣⲟⲟⲃ
ϭⲉⲣⲱϥ	N	ϭⲉⲣⲱϥ
ϭⲉⲣⲱⲃ	N	ϭⲉⲣⲱⲃ
ϭⲉ	ADV	ϭⲉ
ϭⲉ	ART	ϭⲉ
ϭⲉ	CONJ	ϭⲉ
ϭⲉ	PTC	ϭⲉ
ϭⲏⲡ	VSTAT	ϭⲱⲡⲉ
ϭⲏⲩ	VSTAT	ϭⲱⲟⲩ
ϭⲓϫ	N	ϭⲓϫ
ϭⲓⲃⲱⲧⲟⲥ	N	ϭⲓⲃⲱⲧⲟⲥ
ϭⲓⲏⲛⲃⲁⲁⲙⲡⲉ	N	ϭⲓⲏⲛⲃⲁⲁⲙⲡⲉ
ϭⲓⲙⲙⲟⲟϣⲉ	N	ϭⲓⲙⲙⲟⲟϣⲉ
ϭⲓⲛϣⲁϫⲉ	N	ϭⲓⲛϣⲁϫⲉ
ϭⲓⲛϣⲙϣⲉ	N	ϭⲓⲛϣⲙϣⲉ
ϭⲓⲛϣⲱⲗⲙ	N	ϭⲓⲛϣⲱⲗⲙ
ϭⲓⲛϩⲉ	N	ϭⲓⲛϩⲉ
ϭⲓⲛϩⲩⲙⲛⲉⲩⲉ	V	ϭⲓⲛϩⲩⲙⲛⲉⲩⲉ
ϭⲓⲛϭⲗⲱ	N	ϭⲓⲛϭⲗⲱ
ϭⲓⲛϭⲱⲣ	N	ϭⲓⲛϭⲱⲣ
ϭⲓⲛⲁϩⲉⲣⲁⲧ	V	ϭⲓⲛⲁϩⲉⲣⲁⲧ
ϭⲓⲛⲃⲱⲕ	N	ϭⲓⲛⲃⲱⲕ
ϭⲓⲛⲉⲓ	N	ϭⲓⲛⲉⲓ
ϭⲓⲛⲉⲙⲡϣⲓⲛⲉ	V	ϭⲓⲛⲉⲙⲡϣⲓⲛⲉ
ϭⲓⲛⲉⲣϩⲱⲃ	N	ϭⲓⲛⲉⲣϩⲱⲃ
ϭⲓⲛⲉ	V	ϭⲓⲛⲉ
ϭⲓⲛⲗⲩⲡⲏ	V	ϭⲓⲛⲗⲩⲡⲏ
ϭⲓⲛⲙⲓϣⲉ	N	ϭⲓⲛⲙⲓϣⲉ
ϭⲓⲛⲛⲁⲩ	N	ϭⲓⲛⲛⲁⲩ
ϭⲓⲛⲟⲩⲟⲟⲙ	N	ϭⲓⲛⲟⲩⲟⲟⲙ
ϭⲓⲛⲟⲩⲱⲙ	N	ϭⲓⲛⲟⲩⲱⲙ
ϭⲓⲛⲟⲩⲱⲱⲙ	N	ϭⲓⲛⲟⲩⲱⲱⲙ
ϭⲓⲛⲡⲣⲟⲥϩⲩⲇⲣⲉⲩⲉ	V	ϭⲓⲛⲡⲣⲟⲥϩⲩⲇⲣⲉⲩⲉ
ϭⲓⲛⲣϩⲱⲃ	N	ϭⲓⲛⲣϩⲱⲃ
ϭⲓⲛⲥϩⲁⲓ	N	ϭⲓⲛⲥϩⲁⲓ
ϭⲓⲛⲥⲁⲁⲛϣ	N	ϭⲓⲛⲥⲁⲁⲛϣ
ϭⲓⲛⲥⲩⲛⲁⲅⲉ	N	ϭⲓⲛⲥⲩⲛⲁⲅⲉ
ϭⲓⲛⲥⲱⲧⲙ	N	ϭⲓⲛⲥⲱⲧⲙ
ϭⲓⲛⲥⲱ	N	ϭⲓⲛⲥⲱ
ϭⲓⲛⲱϣ	N	ϭⲓⲛⲱϣ
ϭⲓⲛⲱⲛϩ	N	ϭⲓⲛⲱⲛϩ
ϭⲓⲛⲱ	N	ϭⲓⲛⲱ
ϭⲓⲛ	N	ϭⲓⲛ
ϭⲓⲛ	V	ϭⲓⲛⲉ
ϭⲓⲥ	NUM	ϭⲓⲥ
ϭⲗⲙⲁⲓ	N	ϭⲗⲙⲁⲓ
ϭⲗⲙⲗⲱⲙ	V	ϭⲗⲙⲗⲱⲙ
ϭⲗⲟϭ	N	ϭⲗⲟϭ
ϭⲗⲟⲙⲗⲉⲙ	N	ϭⲗⲟⲙⲗⲉⲙ
ϭⲗⲟⲙⲗⲙ	N	ϭⲗⲟⲙⲗⲙ
ϭⲗⲟⲟϭⲉ	N	ϭⲗⲟⲟϭⲉ
ϭⲗⲟⲟⲧⲉ	N	ϭⲗⲱⲧ
ϭⲗⲟⲧⲉ	N	ϭⲗⲱⲧ
ϭⲗⲡ	V	ϭⲱⲗⲡ
ϭⲗⲱϭ	V	ϭⲗⲱϭ
ϭⲗⲱⲡⲉ	N	ϭⲗⲱⲡⲉ
ϭⲗⲱⲱⲧ	N	ϭⲗⲱⲱⲧ
ϭⲙϭⲟⲙ	V	ϭⲙϭⲟⲙ
ϭⲙⲏⲟⲩ	N	ϭⲙⲏⲟⲩ
ϭⲙⲏⲩ	N	ϭⲙⲏⲩ
ϭⲙⲡϣⲓⲛⲉ	V	ϭⲙⲡϣⲓⲛⲉ
ϭⲙ	V	ϭⲓⲛⲉ
ϭⲛⲁⲣⲓⲕⲉ	V	ϭⲛⲁⲣⲓⲕⲉ
ϭⲛⲁⲧ	V	ϭⲛⲁⲧ
ϭⲛⲁⲫⲟⲣⲙⲏ	V	ϭⲛⲁⲫⲟⲣⲙⲏ
ϭⲛⲑⲉⲙ	V	ϭⲛⲑⲉ
ϭⲛⲑⲉⲛ	V	ϭⲛⲑⲉ
ϭⲛⲟⲛ	V	ϭⲛⲟⲛ
ϭⲛⲣⲁⲧ	V	ϭⲛⲣⲁⲧ
ϭⲛⲧ	V	ϭⲓⲛⲉ
ϭⲛⲭⲁⲣⲓⲥ	V	ϭⲛⲭⲁⲣⲓⲥ
ϭⲛ	V	ϭⲓⲛⲉ
ϭⲟϫϥ	VSTAT	ϭⲱϫⲃ
ϭⲟϫϭⲉϫ	V	ϭⲟϫϭⲉϫ
ϭⲟϫⲃ	VSTAT	ϭⲱϫⲃ
ϭⲟⲉⲓⲗⲉ	V	ϭⲟⲉⲓⲗⲉ
ϭⲟⲓⲗⲉ	N	ϭⲟⲓⲗⲉ
ϭⲟⲓⲗⲉ	V	ϭⲟⲓⲗⲉ
ϭⲟⲗϫ	V	ϭⲟⲗϫ
ϭⲟⲗⲗⲉ	N	ϭⲟⲗⲗⲉ
ϭⲟⲗⲡ	V	ϭⲱⲗⲡ
ϭⲟⲗⲡ	VSTAT	ϭⲱⲗⲡ
ϭⲟⲗ	N	ϭⲟⲗ
ϭⲟⲙϭⲉⲙ	V	ϭⲟⲙϭⲉⲙ
ϭⲟⲙϭⲙ	V	ϭⲟⲙϭⲙ
ϭⲟⲙ	N	ϭⲟⲙ
ϭⲟⲛⲥ	N	ϭⲟⲛⲥ
ϭⲟⲛⲧ	VSTAT	ϭⲱⲛⲧ
ϭⲟⲟⲃ	V	ϭⲟⲟⲃ
ϭⲟⲟⲃ	VSTAT	ϭⲟⲟⲃ
ϭⲟⲟⲗⲉ	V	ϭⲱⲱⲗⲉ
ϭⲟⲟⲗⲉ	VSTAT	ϭⲱⲱⲗⲉ
ϭⲟⲟⲙⲉ	N	ϭⲟⲟⲙⲉ
ϭⲟⲟⲙ	N	ϭⲱⲙ
ϭⲟⲟⲩⲛⲉ	N	ϭⲟⲟⲩⲛⲉ
ϭⲟⲡⲧ	V	ϭⲟⲡⲧ
ϭⲟⲡ	V	ϭⲱⲡⲉ
ϭⲟⲣϣ	V	ⲕⲱⲣϣ
ϭⲟⲣϭⲥ	N	ϭⲟⲣϭⲥ
ϭⲟⲥⲙ	VSTAT	ϭⲟⲥⲙ
ϭⲟⲧⲡ	V	ϭⲟⲧⲡ
ϭⲟⲧ	N	ϭⲟⲧ
ϭⲣⲏⲡⲉ	N	ϭⲣⲏⲡⲉ
ϭⲣⲟϭ	N	ϭⲣⲟϭ
ϭⲣⲟⲙⲡⲉ	N	ϭⲣⲟⲙⲡⲉ
ϭⲣⲟⲛⲟⲥ	N	ϭⲣⲟⲛⲟⲥ
ϭⲣⲟⲟϭ	N	ϭⲣⲟⲟϭ
ϭⲣⲟⲟⲙⲡⲉ	N	ϭⲣⲟⲟⲙⲡⲉ
ϭⲣⲱϩ	N	ϭⲣⲱϩ
ϭⲣⲱϭ	N	ϭⲣⲱϭ
ϭⲱϣⲧ	V	ϭⲱϣⲧ
ϭⲱϫⲃ	V	ϭⲱϫⲃ
ϭⲱⲃⲉ	N	ϭⲱⲃⲉ
ϭⲱⲃ	N	ϭⲱⲃ
ϭⲱⲗⲡ	N	ϭⲱⲗⲡ
ϭⲱⲗⲡ	V	ϭⲱⲗⲡ
ϭⲱⲙ	V	ϭⲱⲙ
ϭⲱⲛⲧ	N	ϭⲱⲛⲧ
ϭⲱⲟⲩ	V	ϭⲱⲟⲩ
ϭⲱⲡⲉ	V	ϭⲱⲡⲉ
ϭⲱⲡⲧ	V	ϭⲱⲡⲧ
ϭⲱⲣϣ	V	ϭⲱⲣϣ
ϭⲱⲣϭ	V	ϭⲱⲣϭ
ϭⲱⲧϩ	V	ϭⲱⲧϩ
ϭⲱⲧⲡ	V	ϭⲱⲧⲡ
ϭⲱⲧⲣ	V	ϭⲱⲧⲣ
ϭⲱⲱⲃⲉ	V	ϭⲱⲱⲃⲉ
ϭⲱⲱⲙⲉ	V	ϭⲱⲱⲙⲉ
ϭⲱ	V	ϭⲱ
ϭⲱ	VIMP	ϭⲱ
ϯϣⲓⲡⲉ	V	ϯϣⲓⲡⲉ
ϯϩⲁⲡ	V	ϯϩⲁⲡ
ϯϩⲉ	V	ϯϩⲉ
ϯϩⲏⲩ	N	ϯϩⲏⲩ
ϯϩⲏⲩ	V	ϯϩⲏⲩ
ϯϩⲓⲕⲱⲛ	V	ϯϩⲓⲕⲱⲛ
ϯϩⲓⲥⲉ	V	ϯϩⲓⲥⲉ
ϯϩⲧⲏ	V	ϯϩⲧⲏ
ϯϭⲟⲙ	V	ϯϭⲟⲙ
ϯⲁⲁⲥ	V	ϯⲁⲁⲥ
ϯⲁⲅⲁⲡⲏ	V	ϯⲁⲅⲁⲡⲏ
ϯⲁⲅⲱⲛ	V	ϯⲁⲅⲱⲛ
ϯⲁⲓⲱⲛ	V	ϯⲁⲓⲱⲛ
ϯⲁⲕⲱⲛⲉⲓ	V	ϯⲁⲕⲱⲛⲉⲓ
ϯⲁⲙⲁⲣⲧⲉⲣⲉ	V	ϯⲁⲙⲁⲣⲧⲉⲣⲉ
ϯⲁⲛⲁⲅⲕⲏ	V	ϯⲁⲛⲁⲅⲕⲏ
ϯⲁⲛⲁⲡⲁⲩⲥⲓⲥ	V	ϯⲁⲛⲁⲡⲁⲩⲥⲓⲥ
ϯⲁⲡⲟⲕⲣⲓⲥⲓⲥ	V	ϯⲁⲡⲟⲕⲣⲓⲥⲓⲥ
ϯⲁⲡⲟⲫⲁⲥⲓⲥ	V	ϯⲁⲡⲟⲫⲁⲥⲓⲥ
ϯⲁⲫⲟⲣⲙⲏ	V	ϯⲁⲫⲟⲣⲙⲏ
ϯⲃⲁⲡⲧⲓⲥⲙⲁ	V	ϯⲃⲁⲡⲧⲓⲥⲙⲁ
ϯⲇⲱⲣⲟⲛ	V	ϯⲇⲱⲣⲟⲛ
ϯⲉⲅⲅⲩⲏⲧⲏⲥ	V	ϯⲉⲅⲅⲩⲏⲧⲏⲥ
ϯⲉⲓϥⲧ	V	ϯⲉⲓϥⲧ
ϯⲉⲓⲣⲏⲛⲏ	V	ϯⲉⲓⲣⲏⲛⲏ
ϯⲉⲛⲧⲟⲗⲏ	V	ϯⲉⲛⲧⲟⲗⲏ
ϯⲉⲝⲟⲩⲥⲓⲁ	V	ϯⲉⲝⲟⲩⲥⲓⲁ
ϯⲉⲟⲟⲩ	V	ϯⲉⲟⲟⲩ
ϯⲉ	N	ϯⲉ
ϯⲑⲉ	V	ϯⲑⲉ
ϯⲑⲣⲟⲛⲟⲥ	V	ϯⲑⲣⲟⲛⲟⲥ
ϯⲕⲁⲡⲛⲟⲥ	V	ϯⲕⲁⲡⲛⲟⲥ
ϯⲕⲁⲣⲡⲟⲥ	V	ϯⲕⲁⲣⲡⲟⲥ
ϯⲕⲁⲧⲁⲥⲧⲁⲥⲓⲥ	V	ϯⲕⲁⲧⲁⲥⲧⲁⲥⲓⲥ
ϯⲕⲗⲏⲣⲟⲥ	V	ϯⲕⲗⲏⲣⲟⲥ
ϯⲕⲗⲯ	N	ϯⲕⲗⲯ
ϯⲕⲗⲯ	V	ϯⲕⲗⲯ
ϯⲕⲛⲉⲩⲉ	V	ϯⲕⲛⲉⲩⲉ
ϯⲕⲣⲁⲩⲕⲏ	V	ϯⲕⲣⲁⲩⲕⲏ
ϯⲗⲉⲝⲓⲥ	V	ϯⲗⲉⲝⲓⲥ
ϯⲗⲓⲃⲉⲗⲗⲟⲥ	V	ϯⲗⲓⲃⲉⲗⲗⲟⲥ
ϯⲗⲟⲅⲟⲥ	V	ϯⲗⲟⲅⲟⲥ
ϯⲗⲩⲡⲏ	V	ϯⲗⲩⲡⲏ
ϯⲙⲉⲧⲁⲛⲓⲁ	V	ϯⲙⲉⲧⲁⲛⲓⲁ
ϯⲙⲉ	N	ϯⲙⲉ
ϯⲙⲏ	N	ϯⲙⲏ
ϯⲙⲟⲣⲫⲏ	V	ϯⲙⲟⲣⲫⲏ
ϯⲙⲡⲉϥⲟⲩⲟⲉⲓ	V	ϯⲙⲡⲉϥⲟⲩⲟⲉⲓ
ϯⲙⲡⲉϥⲟⲩⲟⲓ	V	ϯⲙⲡⲉϥⲟⲩⲟⲓ
ϯⲙⲡⲉⲕⲟⲩⲟⲉⲓ	V	ϯⲙⲡⲉⲕⲟⲩⲟⲉⲓ
ϯⲙⲡⲉⲕⲟⲩⲟⲓ	V	ϯⲙⲡⲉⲕⲟⲩⲟⲓ
ϯⲙⲡⲉⲛⲟⲩⲟⲉⲓ	V	ϯⲙⲡⲉⲛⲟⲩⲟⲉⲓ
ϯⲙⲡⲉⲛⲟⲩⲟⲓ	V	ϯⲙⲡⲉⲛⲟⲩⲟⲓ
ϯⲙⲡⲉⲥⲟⲩⲟⲉⲓ	V	ϯⲙⲡⲉⲥⲟⲩⲟⲉⲓ
ϯⲙⲡⲉⲥⲟⲩⲟⲓ	V	ϯⲙⲡⲉⲥⲟⲩⲟⲓ
ϯⲙⲡⲉⲩⲟⲩⲟⲉⲓ	V	ϯⲙⲡⲉⲩⲟⲩⲟⲉⲓ
ϯⲙⲡⲉⲩⲟⲩⲟⲓ	V	ϯⲙⲡⲉⲩⲟⲩⲟⲓ
ϯⲙⲧⲟⲛ	V	ϯⲙⲧⲟⲛ
ϯⲛⲁⲁⲕⲉ	V	ϯⲛⲁⲁⲕⲉ
ϯⲛⲟⲙⲟⲥ	V	ϯⲛⲟⲙⲟⲥ
ϯⲛⲟⲩϭⲥ	V	ϯⲛⲟⲩϭⲥ
ϯⲛⲧⲟⲗⲏ	V	ϯⲛⲧⲟⲗⲏ
ϯⲟⲥⲉ	V	ϯⲟⲥⲉ
ϯⲟⲩⲃⲉ	V	ϯⲟⲩⲃⲉ
ϯⲟⲩⲛϣⲉ	N	ϯⲟⲩⲛϣⲉ
ϯⲟⲩⲛϣⲟ	N	ϯⲟⲩⲛϣⲟ
ϯⲟⲩⲟⲉⲓ	V	ϯⲟⲩⲟⲉⲓ
ϯⲟⲩⲟⲓ	V	ϯⲟⲩⲟⲓ
ϯⲟⲩⲱ	V	ϯⲟⲩⲱ
ϯⲟⲩ	N	ϯⲟⲩ
ϯⲡⲁⲟⲩⲟⲓ	V	ϯⲡⲁⲟⲩⲟⲓ
ϯⲡⲉⲩⲟⲓ	V	ϯⲡⲉⲩⲟⲓ
ϯⲡⲉ	N	ϯⲡⲉ
ϯⲡⲓ	V	ϯⲡⲓ
ϯⲡⲣⲟⲥⲫⲟⲣⲁ	V	ϯⲡⲣⲟⲥⲫⲟⲣⲁ
ϯⲣⲁⲛ	V	ϯⲣⲁⲛ
ϯⲣⲏⲛⲏ	N	ϯⲣⲏⲛⲏ
ϯⲥⲃⲱ	N	ϯⲥⲃⲱ
ϯⲥⲃⲱ	V	ϯⲥⲃⲱ
ϯⲥⲙⲏ	N	ϯⲥⲙⲏ
ϯⲥⲟ	V	ϯⲥⲟ
ϯⲥⲧⲟⲗⲏ	V	ϯⲥⲧⲟⲗⲏ
ϯⲥⲩⲙⲃⲟⲗⲏ	V	ϯⲥⲩⲙⲃⲟⲗⲏ
ϯⲧⲁⲝⲓⲥ	V	ϯⲧⲁⲝⲓⲥ
ϯⲧⲟⲟⲧⲟⲩ	V	ϯⲧⲟⲟⲧ
ϯⲧⲟⲟⲧ	V	ϯⲧⲟⲟⲧ
ϯⲧⲣⲟⲫⲏ	V	ϯⲧⲣⲟⲫⲏ
ϯⲧⲱⲛ	N	ϯⲧⲱⲛ
ϯⲧⲱⲛ	V	ϯⲧⲱⲛ
ϯⲭⲁⲣⲁⲕⲧⲏⲣ	V	ϯⲭⲁⲣⲁⲕⲧⲏⲣ
ϯⲭⲁⲣⲓⲥ	V	ϯⲭⲁⲣⲓⲥ
ϯⲱⲛϩ	V	ϯⲱⲛϩ
ϯⲱⲧⲉ	N	ϯⲱⲧⲉ
ϯ	N	ϯ
ϯ	PDEM	ⲡⲓ
ϯ	PPERS	ⲁⲛⲟⲕ
ϯ	V	ϯ
ϯ-ⲁⲅⲁⲑⲟⲛ	N	ϯ-ⲁⲅⲁⲑⲟⲛ
—	PUNCT	—
†	PUNCT	†
…ⲛ	UNKNOWN	…ⲛ
ⲁϣⲁϩⲟⲙ	N	ⲁϣⲁϩⲟⲙ
ⲁϣⲁⲓ	N	ⲁϣⲁⲓ
ⲁϣⲉ	VSTAT	ⲉⲓϣⲉ
ⲁϣⲏ	N	ⲁϣⲏ
ⲁϣⲟⲉⲓϣ	N	ⲁϣⲟⲉⲓϣ
ⲁϣⲧ	V	ⲉⲓϣⲉ
ⲁϣⲱ	N	ⲁϣⲱ
ⲁϣ	N	ⲁϣ
ⲁϣ	PINT	ⲁϣ
ⲁϣ	V	ⲁϣ
ⲁϥ	N	ⲁϥ
ⲁϩⲉⲣⲁⲧ	V	ⲱϩⲉ
ⲁϩⲉⲣⲁⲧ	V_PPERO	ⲁϩⲉⲣⲁⲧ
ⲁϩⲉⲣ	V	ⲁϩⲉⲣ
ⲁϩⲉ	V	ⲁϩⲉ
ⲁϩⲏⲩ	ADV	ⲁϩⲏⲩ
ⲁϩⲏⲩ	N	ⲁϩⲏⲩ
ⲁϩⲟⲣⲁⲧⲟⲛ	N	ⲁϩⲟⲣⲁⲧⲟⲛ
ⲁϩⲟⲣⲁⲧⲟⲥ	N	ⲁϩⲟⲣⲁⲧⲟⲥ
ⲁϩⲟⲩ	V	ⲁϩⲟⲩ
ⲁϩⲟ	N	ⲁϩⲟ
ⲁϩⲣⲟ	VBD	ⲁϩⲣⲟ
ⲁϩⲣⲱ	VBD	ⲁϩⲣⲟ
ⲁϩⲱⲙ	N	ⲁϩⲱⲙ
ⲁϩⲱⲱⲣ	N	ⲁϩⲟ
ⲁϫⲓ	APST	ⲁϫⲓ
ⲁϫⲓ	VIMP	ϫⲱ
ⲁϫⲙ	PREP	ⲁϫⲛ
ⲁϫⲛⲧ	PREP	ⲁϫⲛ
ⲁϫⲛⲱϫⲛ	ADV	ⲁϫⲛⲱϫⲛ
ⲁϫⲛ	PREP	ⲁϫⲛ
ⲁϭⲃⲉⲥ	N	ⲁϭⲃⲉⲥ
ⲁϭⲃⲥ	N	ⲁϭⲃⲥ
ⲁϭⲟⲗⲧⲉ	N	ⲁϭⲟⲗⲧⲉ
ⲁϭⲣⲏⲛ	N	ⲁϭⲣⲏⲛ
ⲁⲁⲣⲱⲛ	NPROP	ⲁⲁⲣⲱⲛ
ⲁⲁ	V	ⲉⲓⲣⲉ
ⲁⲃⲁⲅⲟⲩⲙ	NPROP	ⲁⲃⲁⲅⲟⲩⲙ
ⲁⲃⲁⲕⲟⲩⲙ	NPROP	ⲁⲃⲁⲕⲟⲩⲙ
ⲁⲃⲁⲥⲓⲗⲉⲩⲧⲟⲥ	N	ⲁⲃⲁⲥⲓⲗⲉⲩⲧⲟⲥ
ⲁⲃⲃⲁ	N	ⲁⲃⲃⲁ
ⲁⲃⲉⲗⲧⲓⲟⲛ	N	ⲁⲃⲉⲗⲧⲓⲟⲛ
ⲁⲃⲉⲛⲛⲏⲣ	NPROP	ⲁⲃⲉⲛⲛⲏⲣ
ⲁⲃⲓⲁⲑⲁⲣ	NPROP	ⲁⲃⲓⲁⲑⲁⲣ
ⲁⲃⲓⲁⲥ	NPROP	ⲁⲃⲓⲁⲥ
ⲁⲃⲓⲁ	NPROP	ⲁⲃⲓⲁ
ⲁⲃⲓⲙⲉⲗⲉⲭ	NPROP	ⲁⲃⲓⲙⲉⲗⲉⲭ
ⲁⲃⲓⲟⲩⲇ	NPROP	ⲁⲃⲓⲟⲩⲇ
ⲁⲃⲓⲣⲱⲛ	NPROP	ⲁⲃⲓⲣⲱⲛ
ⲁⲃⲓⲥⲁⲗⲱⲙ	NPROP	ⲁⲃⲓⲥⲁⲗⲱⲙ
ⲁⲃⲟⲟⲩⲉ	N	ⲁⲃⲱ
ⲁⲃⲣⲁϩⲁⲙ	NPROP	ⲁⲃⲣⲁϩⲁⲙ
ⲁⲃⲱⲕ	N	ⲁⲃⲱⲕ
ⲁⲃⲱ	N	ⲁⲃⲱ
ⲁⲃ	N	ⲁⲃ
ⲁⲅⲁⲅⲓⲟⲥ	NPROP	ⲁⲅⲁⲅⲓⲟⲥ
ⲁⲅⲁⲑⲟⲛⲓⲕⲟⲥ	NPROP	ⲁⲅⲁⲑⲟⲛⲓⲕⲟⲥ
ⲁⲅⲁⲑⲟⲛ	N	ⲁⲅⲁⲑⲟⲛ
ⲁⲅⲁⲑⲟⲥ	N	ⲁⲅⲁⲑⲟⲥ
ⲁⲅⲁⲑⲱⲛⲓⲕⲟⲥ	NPROP	ⲁⲅⲁⲑⲱⲛⲓⲕⲟⲥ
ⲁⲅⲁⲕⲓⲟⲥ	NPROP	ⲁⲅⲁⲕⲓⲟⲥ
ⲁⲅⲁⲗⲗⲓⲱⲛ	V	ⲁⲅⲁⲗⲗⲓⲱⲛ
ⲁⲅⲁⲗⲙⲁ	N	ⲁⲅⲁⲗⲙⲁ
ⲁⲅⲁⲛⲁⲕⲧⲉⲓ	V	ⲁⲅⲁⲛⲁⲕⲧⲉⲓ
ⲁⲅⲁⲡⲁ	V	ⲁⲅⲁⲡⲁ
ⲁⲅⲁⲡⲏⲧⲟⲥ	N	ⲁⲅⲁⲡⲏⲧⲟⲥ
ⲁⲅⲁⲡⲏ	N	ⲁⲅⲁⲡⲏ
ⲁⲅⲁⲣⲓⲛⲛⲉⲟⲥ	N	ⲁⲅⲁⲣⲓⲛⲛⲉⲟⲥ
ⲁⲅⲅⲉⲗⲓⲕⲏ	N	ⲁⲅⲅⲉⲗⲓⲕⲏ
ⲁⲅⲅⲉⲗⲓⲕⲟⲛ	N	ⲁⲅⲅⲉⲗⲓⲕⲟⲛ
ⲁⲅⲅⲉⲗⲓⲕⲟⲥ	N	ⲁⲅⲅⲉⲗⲓⲕⲟⲥ
ⲁⲅⲅⲉⲗⲟⲥ	N	ⲁⲅⲅⲉⲗⲟⲥ
ⲁⲅⲅⲏⲛ	N	ⲁⲅⲅⲏⲛ
ⲁⲅⲅⲓⲟⲛ	N	ⲁⲅⲅⲓⲟⲛ
ⲁⲅⲉⲗⲏ	N	ⲁⲅⲉⲗⲏ
ⲁⲅⲉⲛⲛⲏⲧⲟⲛ	N	ⲁⲅⲉⲛⲛⲏⲧⲟⲛ
ⲁⲅⲉⲛⲛⲏⲧⲟⲥ	N	ⲁⲅⲉⲛⲛⲏⲧⲟⲥ
ⲁⲅⲓⲁ	N	ⲁⲅⲓⲁ
ⲁⲅⲓⲟⲛ	N	ⲁⲅⲓⲟⲛ
ⲁⲅⲓⲟⲥ	N	ⲁⲅⲓⲟⲥ
ⲁⲅⲕⲩⲣⲁ	NPROP	ⲁⲅⲕⲩⲣⲁ
ⲁⲅⲙⲏ	N	ⲁⲅⲙⲏ
ⲁⲅⲛⲱⲙⲏⲥⲩⲛⲏ	N	ⲁⲅⲛⲱⲙⲏⲥⲩⲛⲏ
ⲁⲅⲛⲱⲙⲟⲛ	N	ⲁⲅⲛⲱⲙⲟⲛ
ⲁⲅⲛⲱⲥⲧⲟⲥ	N	ⲁⲅⲛⲱⲥⲧⲟⲥ
ⲁⲅⲟⲛⲓⲁ	N	ⲁⲅⲟⲛⲓⲁ
ⲁⲅⲟⲣⲁⲓⲟⲥ	N	ⲁⲅⲟⲣⲁⲓⲟⲥ
ⲁⲅⲟⲣⲁⲥⲓⲁ	N	ⲁⲅⲟⲣⲁⲥⲓⲁ
ⲁⲅⲟⲣⲁ	N	ⲁⲅⲟⲣⲁ
ⲁⲅⲣⲁⲫⲟⲥ	ADV	ⲁⲅⲣⲁⲫⲟⲥ
ⲁⲅⲣⲓⲟⲛ	N	ⲁⲅⲣⲓⲟⲛ
ⲁⲅⲣⲓⲟⲥ	N	ⲁⲅⲣⲓⲟⲥ
ⲁⲅⲣⲓⲡⲡⲁⲥ	NPROP	ⲁⲅⲣⲓⲡⲡⲁⲥ
ⲁⲅⲱⲅⲏ	N	ⲁⲅⲱⲅⲏ
ⲁⲅⲱⲛⲓⲁ	N	ⲁⲅⲱⲛⲓⲁ
ⲁⲅⲱⲛⲓⲍⲉⲥⲑⲉ	V	ⲁⲅⲱⲛⲓⲍⲉⲥⲑⲉ
ⲁⲅⲱⲛⲓⲍⲉ	V	ⲁⲅⲱⲛⲓⲍⲉ
ⲁⲅⲱⲛⲓⲥⲧⲏⲥ	N	ⲁⲅⲱⲛⲓⲥⲧⲏⲥ
ⲁⲅⲱⲛⲟⲑⲉⲧⲏⲥ	N	ⲁⲅⲱⲛⲟⲑⲉⲧⲏⲥ
ⲁⲅⲱⲛ	N	ⲁⲅⲱⲛ
ⲁⲇⲁⲙⲁⲛⲧⲓⲛⲏ	N	ⲁⲇⲁⲙⲁⲛⲧⲓⲛⲏ
ⲁⲇⲁⲙⲁⲛⲧⲟⲥ	N	ⲁⲇⲁⲙⲁⲛⲧⲟⲥ
ⲁⲇⲁⲙ	NPROP	ⲁⲇⲁⲙ
ⲁⲇⲏⲗⲟⲥ	N	ⲁⲇⲏⲗⲟⲥ
ⲁⲇⲓϭⲓ	V	ⲁⲇⲓϭⲓ
ⲁⲇⲓⲕⲁⲓⲟⲥ	N	ⲁⲇⲓⲕⲁⲓⲟⲥ
ⲁⲇⲓⲕⲉⲓ	V	ⲁⲇⲓⲕⲉⲓ
ⲁⲇⲓⲕⲓⲁ	N	ⲁⲇⲓⲕⲓⲁ
ⲁⲇⲓⲕⲟⲛ	N	ⲁⲇⲓⲕⲟⲛ
ⲁⲇⲓⲕⲟⲥ	N	ⲁⲇⲓⲕⲟⲥ
ⲁⲇⲓⲕⲱⲥ	ADV	ⲁⲇⲓⲕⲱⲥ
ⲁⲉⲓⲕ	N	ⲁⲉⲓⲕ
ⲁⲉⲓⲧ	N	ⲁⲉⲓⲧ
ⲁⲉⲣⲟⲇⲓⲟⲥ	N	ⲁⲉⲣⲟⲇⲓⲟⲥ
ⲁⲉⲧⲟⲥ	N	ⲁⲉⲧⲟⲥ
ⲁⲍⲱⲣⲁⲥ	NPROP	ⲁⲍⲱⲣⲁⲥ
ⲁⲍⲱⲣⲁ	NPROP	ⲁⲍⲱⲣⲁ
ⲁⲏⲣ	N	ⲁⲏⲣ
ⲁⲑⲁⲛⲁⲥⲓⲁ	N	ⲁⲑⲁⲛⲁⲥⲓⲁ
ⲁⲑⲁⲛⲁⲥⲓⲟⲥ	NPROP	ⲁⲑⲁⲛⲁⲥⲓⲟⲥ
ⲁⲑⲁⲛⲁⲧⲟⲛ	N	ⲁⲑⲁⲛⲁⲧⲟⲛ
ⲁⲑⲁⲛⲁⲧⲟⲥ	N	ⲁⲑⲁⲛⲁⲧⲟⲥ
ⲁⲑⲉⲣⲙⲏⲛⲉⲩⲉ	V	ⲁⲑⲉⲣⲙⲏⲛⲉⲩⲉ
ⲁⲑⲉⲧⲉⲓ	V	ⲁⲑⲉⲧⲉⲓ
ⲁⲑⲉⲧⲓ	V	ⲁⲑⲉⲧⲓ
ⲁⲑⲏⲛⲁⲓⲟⲥ	N	ⲁⲑⲏⲛⲁⲓⲟⲥ
ⲁⲑⲏⲧ	N	ⲁⲑⲏⲧ
ⲁⲑⲗⲏⲥⲓⲥ	N	ⲁⲑⲗⲏⲥⲓⲥ
ⲁⲑⲗⲏⲧⲏⲥ	N	ⲁⲑⲗⲏⲧⲏⲥ
ⲁⲑⲗⲟⲛ	N	ⲁⲑⲗⲟⲛ
ⲁⲑⲗⲟⲫⲟⲣⲟⲥ	N	ⲁⲑⲗⲟⲫⲟⲣⲟⲥ
ⲁⲑⲩⲛⲁ	N	ⲁⲑⲩⲛⲁ
ⲁⲑⲩⲣⲁⲥ	N	ⲁⲑⲩⲣⲁⲥ
ⲁⲑⲱⲣ	NPROP	ⲁⲑⲱⲣ
ⲁⲓⲇⲓⲟⲥ	N	ⲁⲓⲇⲓⲟⲥ
ⲁⲓⲇⲟⲓⲟⲛ	N	ⲁⲓⲇⲟⲓⲟⲛ
ⲁⲓⲛⲓⲅⲙⲁ	N	ⲁⲓⲛⲓⲅⲙⲁ
ⲁⲓⲡⲉⲛⲟⲥ	N	ⲁⲓⲡⲉⲛⲟⲥ
ⲁⲓⲥⲑⲁⲛⲉ	V	ⲁⲓⲥⲑⲁⲛⲉ
ⲁⲓⲥⲑⲏⲥⲓⲥ	N	ⲁⲓⲥⲑⲏⲥⲓⲥ
ⲁⲓⲥⲑⲏⲧⲏⲣⲓⲟⲛ	N	ⲁⲓⲥⲑⲏⲧⲏⲣⲓⲟⲛ
ⲁⲓⲥⲑⲏⲧⲟⲛ	N	ⲁⲓⲥⲑⲏⲧⲟⲛ
ⲁⲓⲥⲑⲏⲧⲟⲥ	N	ⲁⲓⲥⲑⲏⲧⲟⲥ
ⲁⲓⲧⲉⲓ	N	ⲁⲓⲧⲉⲓ
ⲁⲓⲧⲉⲓ	V	ⲁⲓⲧⲉⲓ
ⲁⲓⲧⲏⲙⲁ	N	ⲁⲓⲧⲏⲙⲁ
ⲁⲓⲧⲏⲥⲓⲥ	N	ⲁⲓⲧⲏⲥⲓⲥ
ⲁⲓⲧⲓⲁ	N	ⲁⲓⲧⲓⲁ
ⲁⲓⲧⲓⲟⲛ	N	ⲁⲓⲧⲓⲟⲛ
ⲁⲓⲧⲓⲟⲥ	N	ⲁⲓⲧⲓⲟⲥ
ⲁⲓⲧⲓ	V	ⲁⲓⲧⲓ
ⲁⲓⲭⲙⲁⲗⲟⲧⲓⲍⲉ	V	ⲁⲓⲭⲙⲁⲗⲟⲧⲓⲍⲉ
ⲁⲓⲭⲙⲁⲗⲟⲧⲟⲥ	N	ⲁⲓⲭⲙⲁⲗⲟⲧⲟⲥ
ⲁⲓⲭⲙⲁⲗⲱⲥⲓⲁ	N	ⲁⲓⲭⲙⲁⲗⲱⲥⲓⲁ
ⲁⲓⲭⲙⲁⲗⲱⲧⲉⲩⲉ	V	ⲁⲓⲭⲙⲁⲗⲱⲧⲉⲩⲉ
ⲁⲓⲭⲙⲁⲗⲱⲧⲓⲍⲉ	V	ⲁⲓⲭⲙⲁⲗⲱⲧⲓⲍⲉ
ⲁⲓⲭⲙⲁⲗⲱⲧⲟⲥ	N	ⲁⲓⲭⲙⲁⲗⲱⲧⲟⲥ
ⲁⲓⲱⲛⲓⲟⲛ	N	ⲁⲓⲱⲛⲓⲟⲛ
ⲁⲓⲱⲛⲓⲟⲥ	N	ⲁⲓⲱⲛⲓⲟⲥ
ⲁⲓⲱⲛ	N	ⲁⲓⲱⲛ
ⲁⲕⲁⲅⲓⲟⲥ	NPROP	ⲁⲕⲁⲅⲓⲟⲥ
ⲁⲕⲁⲑⲁⲣⲥⲓⲁ	N	ⲁⲕⲁⲑⲁⲣⲥⲓⲁ
ⲁⲕⲁⲑⲁⲣⲧⲟⲛ	N	ⲁⲕⲁⲑⲁⲣⲧⲟⲛ
ⲁⲕⲁⲑⲁⲣⲧⲟⲥ	N	ⲁⲕⲁⲑⲁⲣⲧⲟⲥ
ⲁⲕⲁⲓⲣⲟⲛ	N	ⲁⲕⲁⲓⲣⲟⲛ
ⲁⲕⲁⲕⲓⲟⲥ	NPROP	ⲁⲕⲁⲕⲓⲟⲥ
ⲁⲕⲁⲕⲟⲥ	N	ⲁⲕⲁⲕⲟⲥ
ⲁⲕⲁⲛⲁⲕⲧⲓ	V	ⲁⲕⲁⲛⲁⲕⲧⲓ
ⲁⲕⲁⲧⲁⲅⲛⲱⲥⲧⲟⲥ	N	ⲁⲕⲁⲧⲁⲅⲛⲱⲥⲧⲟⲥ
ⲁⲕⲉⲗⲇⲁⲙⲁⲭ	NPROP	ⲁⲕⲉⲗⲇⲁⲙⲁⲭ
ⲁⲕⲉⲗⲧⲁⲙⲁⲭ	NPROP	ⲁⲕⲉⲗⲧⲁⲙⲁⲭ
ⲁⲕⲉⲣⲁⲓⲟⲛ	N	ⲁⲕⲉⲣⲁⲓⲟⲛ
ⲁⲕⲉⲣⲁⲓⲟⲥ	N	ⲁⲕⲉⲣⲁⲓⲟⲥ
ⲁⲕⲓⲛⲏⲧⲟⲛ	N	ⲁⲕⲓⲛⲏⲧⲟⲛ
ⲁⲕⲙⲏⲛ	ADV	ⲁⲕⲙⲏⲛ
ⲁⲕⲙⲏ	N	ⲁⲕⲙⲏ
ⲁⲕⲟⲗⲗⲟⲩⲑⲓⲁ	N	ⲁⲕⲟⲗⲗⲟⲩⲑⲓⲁ
ⲁⲕⲟⲗⲟⲩⲑⲓⲁ	N	ⲁⲕⲟⲗⲟⲩⲑⲓⲁ
ⲁⲕⲣⲁⲧⲟⲛ	N	ⲁⲕⲣⲁⲧⲟⲛ
ⲁⲕⲣⲓⲃⲁⲍⲉ	V	ⲁⲕⲣⲓⲃⲁⲍⲉ
ⲁⲕⲣⲓⲃⲓⲁ	N	ⲁⲕⲣⲓⲃⲓⲁ
ⲁⲕⲣⲓⲃⲱⲥ	ADV	ⲁⲕⲣⲓⲃⲱⲥ
ⲁⲕⲣⲓⲟⲛ	N	ⲁⲕⲣⲓⲟⲛ
ⲁⲕⲣⲓⲥ	N	ⲁⲕⲣⲓⲥ
ⲁⲕⲣⲟⲁⲧⲏⲥ	N	ⲁⲕⲣⲟⲁⲧⲏⲥ
ⲁⲕⲣⲱⲁⲧⲏⲥ	N	ⲁⲕⲣⲱⲁⲧⲏⲥ
ⲁⲕⲧⲓⲛ	N	ⲁⲕⲧⲓⲛ
ⲁⲕⲩⲣⲟⲛ	N	ⲁⲕⲩⲣⲟⲛ
ⲁⲕⲩⲣⲟⲩ	V	ⲁⲕⲩⲣⲟⲩ
ⲁⲗⲁⲃⲁⲥⲧⲣⲟⲛ	N	ⲁⲗⲁⲃⲁⲥⲧⲣⲟⲛ
ⲁⲗⲉⲕⲧⲟⲥ	N	ⲁⲗⲉⲕⲧⲟⲥ
ⲁⲗⲉⲕⲧⲱⲣ	N	ⲁⲗⲉⲕⲧⲱⲣ
ⲁⲗⲉⲝⲁⲛⲇⲣⲉⲩⲥ	N	ⲁⲗⲉⲝⲁⲛⲇⲣⲉⲩⲥ
ⲁⲗⲉⲝⲁⲛⲇⲣⲟⲥ	NPROP	ⲁⲗⲉⲝⲁⲛⲇⲣⲟⲥ
ⲁⲗⲉ	V	ⲁⲗⲉ
ⲁⲗⲏⲑⲉⲓⲁ	N	ⲁⲗⲏⲑⲉⲓⲁ
ⲁⲗⲏⲑⲓⲛⲏ	N	ⲁⲗⲏⲑⲓⲛⲏ
ⲁⲗⲏⲑⲓⲛⲟⲛ	N	ⲁⲗⲏⲑⲓⲛⲟⲛ
ⲁⲗⲏⲑⲓⲛⲟⲥ	N	ⲁⲗⲏⲑⲓⲛⲟⲥ
ⲁⲗⲏⲑⲱⲥ	ADV	ⲁⲗⲏⲑⲱⲥ
ⲁⲗⲏⲩ	VSTAT	ⲁⲗⲉ
ⲁⲗⲓⲑⲓⲛⲏ	N	ⲁⲗⲓⲑⲓⲛⲏ
ⲁⲗⲕⲥ	N	ⲁⲗⲕⲥ
ⲁⲗⲗⲁⲅⲏ	N	ⲁⲗⲗⲁⲅⲏ
ⲁⲗⲗⲁⲥⲥⲉ	V	ⲁⲗⲗⲁⲥⲥⲉ
ⲁⲗⲗⲁ	CONJ	ⲁⲗⲗⲁ
ⲁⲗⲗⲏⲅⲟⲣⲉⲓ	V	ⲁⲗⲗⲏⲅⲟⲣⲉⲓ
ⲁⲗⲗⲏⲗⲟⲩⲓⲓⲁ	PTC	ⲁⲗⲗⲏⲗⲟⲩⲓⲓⲁ
ⲁⲗⲗⲟⲅⲉⲛⲏⲥ	N	ⲁⲗⲗⲟⲅⲉⲛⲏⲥ
ⲁⲗⲗⲟⲅⲉⲛⲓⲟⲥ	N	ⲁⲗⲗⲟⲅⲉⲛⲓⲟⲥ
ⲁⲗⲗⲟⲧⲣⲓⲟⲛ	N	ⲁⲗⲗⲟⲧⲣⲓⲟⲛ
ⲁⲗⲗⲟⲧⲣⲓⲟⲥ	N	ⲁⲗⲗⲟⲧⲣⲓⲟⲥ
ⲁⲗⲗⲟⲫⲩⲗⲟⲥ	N	ⲁⲗⲗⲟⲫⲩⲗⲟⲥ
ⲁⲗⲗⲱⲏ	N	ⲁⲗⲗⲱⲏ
ⲁⲗⲟⲅⲟⲛ	N	ⲁⲗⲟⲅⲟⲛ
ⲁⲗⲟⲅⲟⲥ	N	ⲁⲗⲟⲅⲟⲥ
ⲁⲗⲟⲟⲩⲉ	N	ⲁⲗⲱ
ⲁⲗⲟⲩ	N	ⲁⲗⲟⲩ
ⲁⲗⲥⲟⲥ	N	ⲁⲗⲥⲟⲥ
ⲁⲗⲫⲁⲃⲁⲧⲱⲛ	N	ⲁⲗⲫⲁⲃⲁⲧⲱⲛ
ⲁⲗⲫⲁⲓⲟⲥ	N	ⲁⲗⲫⲁⲓⲟⲥ
ⲁⲗⲫⲁ	N	ⲁⲗⲫⲁ
ⲁⲗⲱⲧ	VIMP	ⲁⲗⲱⲧ
ⲁⲗⲱ	VIMP	ⲁⲗⲱ
ⲁⲗ	N	ⲁⲗ
ⲁⲙⲁϩⲧⲉ	V	ⲁⲙⲁϩⲧⲉ
ⲁⲙⲁⲣⲁⲛⲧⲟⲥ	N	ⲁⲙⲁⲣⲁⲛⲧⲟⲥ
ⲁⲙⲉⲗⲉⲓⲁ	N	ⲁⲙⲉⲗⲉⲓⲁ
ⲁⲙⲉⲗⲉⲓ	V	ⲁⲙⲉⲗⲉⲓ
ⲁⲙⲉⲗⲏⲥ	N	ⲁⲙⲉⲗⲏⲥ
ⲁⲙⲉⲗⲓⲁ	N	ⲁⲙⲉⲗⲓⲁ
ⲁⲙⲉⲗⲓ	V	ⲁⲙⲉⲗⲓ
ⲁⲙⲉⲣⲓⲙⲛⲟⲥ	N	ⲁⲙⲉⲣⲓⲙⲛⲟⲥ
ⲁⲙⲉⲣⲓ	N	ⲁⲙⲉⲣⲓ
ⲁⲙⲉⲧⲣⲏⲧⲟⲛ	N	ⲁⲙⲉⲧⲣⲏⲧⲟⲛ
ⲁⲙⲏⲉⲓⲛ	VIMP	ⲉⲓ
ⲁⲙⲏⲉⲓⲧⲛ	VIMP	ⲉⲓ
ⲁⲙⲏⲉⲓ	VIMP	ⲉⲓ
ⲁⲙⲏⲑⲓⲥⲧⲱⲥ	N	ⲁⲙⲏⲑⲓⲥⲧⲱⲥ
ⲁⲙⲏⲓⲛ	VIMP	ⲁⲙⲏⲓⲛ
ⲁⲙⲏⲓⲧⲛ	VIMP	ⲉⲓ
ⲁⲙⲏⲓ	VIMP	ⲉⲓ
ⲁⲙⲏⲧⲣⲓⲧⲟⲥ	N	ⲁⲙⲏⲧⲣⲓⲧⲟⲥ
ⲁⲙⲓⲁⲛⲧⲟⲥ	N	ⲁⲙⲓⲁⲛⲧⲟⲥ
ⲁⲙⲓⲛⲁⲇⲁⲃ	NPROP	ⲁⲙⲓⲛⲁⲇⲁⲃ
ⲁⲙⲓⲣⲁ	N	ⲁⲙⲓⲣⲁ
ⲁⲙⲙⲟⲣⲁⲓⲟⲥ	N	ⲁⲙⲙⲟⲣⲁⲓⲟⲥ
ⲁⲙⲙⲱⲛⲓⲧⲏⲥ	N	ⲁⲙⲙⲱⲛⲓⲧⲏⲥ
ⲁⲙⲙⲱⲧⲓⲟⲛ	NPROP	ⲁⲙⲙⲱⲧⲓⲟⲛ
ⲁⲙⲛⲧⲉ	N	ⲁⲙⲛⲧⲉ
ⲁⲙⲟⲩⲧⲉ	VIMP	ⲉⲓ
ⲁⲙⲟⲩ	VIMP	ⲉⲓ
ⲁⲙⲡⲟⲩⲗⲉ	N	ⲁⲙⲡⲟⲩⲗⲉ
ⲁⲙⲩⲅⲇⲁⲗⲟⲛ	N	ⲁⲙⲩⲅⲇⲁⲗⲟⲛ
ⲁⲙⲫⲓⲁⲍⲉ	V	ⲁⲙⲫⲓⲁⲍⲉ
ⲁⲙⲫⲓⲃⲁⲗⲉ	V	ⲁⲙⲫⲓⲃⲁⲗⲉ
ⲁⲙⲫⲓⲃⲟⲗⲓⲁ	N	ⲁⲙⲫⲓⲃⲟⲗⲓⲁ
ⲁⲙⲫⲓⲧⲁⲡⲟⲥ	N	ⲁⲙⲫⲓⲧⲁⲡⲟⲥ
ⲁⲙⲱⲙⲟⲙ	N	ⲁⲙⲱⲙⲟⲙ
ⲁⲙⲱⲛⲁ	NPROP	ⲁⲙⲱⲛⲁ
ⲁⲙ	N	ⲁⲙ
ⲁⲛϩⲁⲗⲓⲥⲕⲉ	V	ⲁⲛϩⲁⲗⲓⲥⲕⲉ
ⲁⲛϩⲁⲗⲱⲙⲁ	N	ⲁⲛϩⲁⲗⲱⲙⲁ
ⲁⲛϩⲉⲥⲓⲥ	N	ⲁⲛϩⲉⲥⲓⲥ
ⲁⲛϩⲏⲕⲉⲓⲥⲑⲁⲓ	V	ⲁⲛϩⲏⲕⲉⲓⲥⲑⲁⲓ
ⲁⲛϩⲟⲗⲟⲙⲁ	N	ⲁⲛϩⲟⲗⲟⲙⲁ
ⲁⲛϩⲟⲙⲟⲓⲟⲛ	N	ⲁⲛϩⲟⲙⲟⲓⲟⲛ
ⲁⲛϩⲟⲥⲓⲟⲥ	N	ⲁⲛϩⲟⲥⲓⲟⲥ
ⲁⲛϩⲱⲙⲁⲗⲓⲁ	N	ⲁⲛϩⲱⲙⲁⲗⲓⲁ
ⲁⲛϫⲱϫ	N	ⲁⲛϫⲱϫ
ⲁⲛϯⲛⲱⲟⲩ	NPROP	ⲁⲛϯⲛⲱⲟⲩ
ⲁⲛⲁϣ	N	ⲁⲛⲁϣ
ⲁⲛⲁϥ	N	ⲁⲛⲁϥ
ⲁⲛⲁⲃⲁⲑⲙⲟⲥ	N	ⲁⲛⲁⲃⲁⲑⲙⲟⲥ
ⲁⲛⲁⲃⲁⲥⲓⲥ	N	ⲁⲛⲁⲃⲁⲥⲓⲥ
ⲁⲛⲁⲅⲕⲁⲍⲉ	V	ⲁⲛⲁⲅⲕⲁⲍⲉ
ⲁⲛⲁⲅⲕⲁⲓⲟⲛ	N	ⲁⲛⲁⲅⲕⲁⲓⲟⲛ
ⲁⲛⲁⲅⲕⲁⲓⲟⲥ	N	ⲁⲛⲁⲅⲕⲁⲓⲟⲥ
ⲁⲛⲁⲅⲕⲏ	N	ⲁⲛⲁⲅⲕⲏ
ⲁⲛⲁⲅⲛⲱⲥⲧⲏⲥ	N	ⲁⲛⲁⲅⲛⲱⲥⲧⲏⲥ
ⲁⲛⲁⲅⲛⲱⲥⲧⲓⲕⲟⲛ	N	ⲁⲛⲁⲅⲛⲱⲥⲧⲓⲕⲟⲛ
ⲁⲛⲁⲇⲓⲇⲟⲩ	V	ⲁⲛⲁⲇⲓⲇⲟⲩ
ⲁⲛⲁⲑⲉⲙⲁⲧⲓⲍⲉ	V	ⲁⲛⲁⲑⲉⲙⲁⲧⲓⲍⲉ
ⲁⲛⲁⲑⲉⲙⲁ	N	ⲁⲛⲁⲑⲉⲙⲁ
ⲁⲛⲁⲑⲏⲙⲁ	N	ⲁⲛⲁⲑⲏⲙⲁ
ⲁⲛⲁⲓⲥⲑⲏⲧⲟⲛ	N	ⲁⲛⲁⲓⲥⲑⲏⲧⲟⲛ
ⲁⲛⲁⲓⲥⲑⲏⲧⲟⲥ	N	ⲁⲛⲁⲓⲥⲑⲏⲧⲟⲥ
ⲁⲛⲁⲓⲧⲓⲟⲥ	N	ⲁⲛⲁⲓⲧⲓⲟⲥ
ⲁⲛⲁⲕⲁⲗⲉⲓ	V	ⲁⲛⲁⲕⲁⲗⲉⲓ
ⲁⲛⲁⲕⲣⲓⲛⲉ	V	ⲁⲛⲁⲕⲣⲓⲛⲉ
ⲁⲛⲁⲗⲁⲙⲃⲁⲛⲉ	V	ⲁⲛⲁⲗⲁⲙⲃⲁⲛⲉ
ⲁⲛⲁⲗⲏⲙⲯⲓⲥ	N	ⲁⲛⲁⲗⲏⲙⲯⲓⲥ
ⲁⲛⲁⲗⲏⲯⲓⲥ	N	ⲁⲛⲁⲗⲏⲯⲓⲥ
ⲁⲛⲁⲗⲟⲅⲓⲁ	N	ⲁⲛⲁⲗⲟⲅⲓⲁ
ⲁⲛⲁⲗⲟⲅⲓⲟⲛ	N	ⲁⲛⲁⲗⲟⲅⲓⲟⲛ
ⲁⲛⲁⲛⲉⲩⲉ	V	ⲁⲛⲁⲛⲉⲩⲉ
ⲁⲛⲁⲡⲁⲩⲉ	V	ⲁⲛⲁⲡⲁⲩⲉ
ⲁⲛⲁⲡⲁⲩⲥⲓⲥ	N	ⲁⲛⲁⲡⲁⲩⲥⲓⲥ
ⲁⲛⲁⲡⲗⲁⲥⲓⲥ	N	ⲁⲛⲁⲡⲗⲁⲥⲓⲥ
ⲁⲛⲁⲡⲛⲟⲏ	N	ⲁⲛⲁⲡⲛⲟⲏ
ⲁⲛⲁⲣⲭⲟⲥ	N	ⲁⲛⲁⲣⲭⲟⲥ
ⲁⲛⲁⲥⲕⲉⲡⲧⲉⲥⲑⲁⲓ	V	ⲁⲛⲁⲥⲕⲉⲡⲧⲉⲥⲑⲁⲓ
ⲁⲛⲁⲥⲧⲁⲥⲓⲙⲱⲛ	N	ⲁⲛⲁⲥⲧⲁⲥⲓⲙⲱⲛ
ⲁⲛⲁⲥⲧⲁⲥⲓⲥ	N	ⲁⲛⲁⲥⲧⲁⲥⲓⲥ
ⲁⲛⲁⲥⲧⲁⲥⲓ	V	ⲁⲛⲁⲥⲧⲁⲥⲓ
ⲁⲛⲁⲥⲧⲣⲉⲫⲉⲥⲑⲁⲓ	V	ⲁⲛⲁⲥⲧⲣⲉⲫⲉⲥⲑⲁⲓ
ⲁⲛⲁⲥⲧⲣⲉⲫⲩ	V	ⲁⲛⲁⲥⲧⲣⲉⲫⲩ
ⲁⲛⲁⲥⲧⲣⲟⲫⲏ	N	ⲁⲛⲁⲥⲧⲣⲟⲫⲏ
ⲁⲛⲁⲧⲟⲗⲏ	NPROP	ⲁⲛⲁⲧⲟⲗⲏ
ⲁⲛⲁⲧⲟⲗⲓⲟⲥ	NPROP	ⲁⲛⲁⲧⲟⲗⲓⲟⲥ
ⲁⲛⲁⲧⲣⲉⲡⲉ	V	ⲁⲛⲁⲧⲣⲉⲡⲉ
ⲁⲛⲁⲩϣ	N	ⲁⲛⲁⲩϣ
ⲁⲛⲁⲩ	VIMP	ⲛⲁⲩ
ⲁⲛⲁⲫⲟⲣⲁ	N	ⲁⲛⲁⲫⲟⲣⲁ
ⲁⲛⲁⲭⲟⲣⲉⲓ	V	ⲁⲛⲁⲭⲟⲣⲉⲓ
ⲁⲛⲁⲭⲱⲣⲉⲓ	V	ⲁⲛⲁⲭⲱⲣⲉⲓ
ⲁⲛⲁⲭⲱⲣⲏⲥⲓⲥ	N	ⲁⲛⲁⲭⲱⲣⲏⲥⲓⲥ
ⲁⲛⲁⲭⲱⲣⲏⲧⲏⲥ	N	ⲁⲛⲁⲭⲱⲣⲏⲧⲏⲥ
ⲁⲛⲁⲭⲱⲣⲓⲧⲏⲥ	N	ⲁⲛⲁⲭⲱⲣⲓⲧⲏⲥ
ⲁⲛⲁⲭⲱⲣⲓ	V	ⲁⲛⲁⲭⲱⲣⲓ
ⲁⲛⲅⲱⲛ	N	ⲁⲛⲅⲱⲛ
ⲁⲛⲅ	PPERI	ⲁⲛⲟⲕ
ⲁⲛⲇⲓⲕⲉⲓⲙⲉⲛⲟⲥ	N	ⲁⲛⲇⲓⲕⲉⲓⲙⲉⲛⲟⲥ
ⲁⲛⲇⲓⲕⲓⲙⲉⲛⲟⲥ	N	ⲁⲛⲇⲓⲕⲓⲙⲉⲛⲟⲥ
ⲁⲛⲇⲣⲉⲁⲥ	NPROP	ⲁⲛⲇⲣⲉⲁⲥ
ⲁⲛⲇⲣⲉⲓⲁⲥ	N	ⲁⲛⲇⲣⲉⲓⲁⲥ
ⲁⲛⲉⲡⲓⲕⲱⲗⲩⲧⲏⲥ	ADV	ⲁⲛⲉⲡⲓⲕⲱⲗⲩⲧⲏⲥ
ⲁⲛⲉⲭⲉⲥⲑⲉ	V	ⲁⲛⲉⲭⲉⲥⲑⲉ
ⲁⲛⲉⲭⲉ	V	ⲁⲛⲉⲭⲉ
ⲁⲛⲍⲏⲃⲉ	N	ⲁⲛⲍⲏⲃⲉ
ⲁⲛⲍⲏⲃ	N	ⲁⲛⲍⲏⲃ
ⲁⲛⲍⲱⲛⲏ	N	ⲁⲛⲍⲱⲛⲏ
ⲁⲛⲑⲉⲙⲓⲟⲛ	N	ⲁⲛⲑⲉⲙⲓⲟⲛ
ⲁⲛⲑⲉⲱⲛⲟⲥ	N	ⲁⲛⲑⲉⲱⲛⲟⲥ
ⲁⲛⲑⲓⲙⲟⲥ	NPROP	ⲁⲛⲑⲓⲙⲟⲥ
ⲁⲛⲑⲣⲁⲝ	N	ⲁⲛⲑⲣⲁⲝ
ⲁⲛⲑⲩⲡⲁⲧⲟⲥ	N	ⲁⲛⲑⲩⲡⲁⲧⲟⲥ
ⲁⲛⲓⲭⲉ	V	ⲁⲛⲓⲭⲉ
ⲁⲛⲓ	VIMP	ⲉⲓⲛⲉ
ⲁⲛⲛⲁ	NPROP	ⲁⲛⲛⲁ
ⲁⲛⲛⲱⲛⲁ	N	ⲁⲛⲛⲱⲛⲁ
ⲁⲛⲟⲏⲧⲟⲛ	N	ⲁⲛⲟⲏⲧⲟⲛ
ⲁⲛⲟⲏⲧⲟⲥ	N	ⲁⲛⲟⲏⲧⲟⲥ
ⲁⲛⲟⲕ	PPERI	ⲁⲛⲟⲕ
ⲁⲛⲟⲙⲉⲓ	V	ⲁⲛⲟⲙⲉⲓ
ⲁⲛⲟⲙⲓⲁ	N	ⲁⲛⲟⲙⲓⲁ
ⲁⲛⲟⲙⲟⲛ	N	ⲁⲛⲟⲙⲟⲛ
ⲁⲛⲟⲙⲟⲥ	N	ⲁⲛⲟⲙⲟⲥ
ⲁⲛⲟⲛ	PPERI	ⲁⲛⲟⲛ
ⲁⲛⲟⲩⲥⲓⲟⲥ	N	ⲁⲛⲟⲩⲥⲓⲟⲥ
ⲁⲛⲟⲭⲏ	N	ⲁⲛⲟⲭⲏ
ⲁⲛⲧⲓϩⲣⲏⲥⲓⲥ	N	ⲁⲛⲧⲓϩⲣⲏⲥⲓⲥ
ⲁⲛⲧⲓⲅⲣⲁⲫⲉ	V	ⲁⲛⲧⲓⲅⲣⲁⲫⲉ
ⲁⲛⲧⲓⲅⲣⲁⲫⲟⲛ	N	ⲁⲛⲧⲓⲅⲣⲁⲫⲟⲛ
ⲁⲛⲧⲓⲇⲓⲕⲟⲥ	N	ⲁⲛⲧⲓⲇⲓⲕⲟⲥ
ⲁⲛⲧⲓⲕⲉⲓⲙⲉⲛⲏ	N	ⲁⲛⲧⲓⲕⲉⲓⲙⲉⲛⲏ
ⲁⲛⲧⲓⲕⲉⲓⲙⲉⲛⲟⲛ	N	ⲁⲛⲧⲓⲕⲉⲓⲙⲉⲛⲟⲛ
ⲁⲛⲧⲓⲕⲉⲓⲙⲉⲛⲟⲥ	N	ⲁⲛⲧⲓⲕⲉⲓⲙⲉⲛⲟⲥ
ⲁⲛⲧⲓⲕⲓⲙⲉⲛⲟⲥ	N	ⲁⲛⲧⲓⲕⲓⲙⲉⲛⲟⲥ
ⲁⲛⲧⲓⲗⲉⲅⲉ	V	ⲁⲛⲧⲓⲗⲉⲅⲉ
ⲁⲛⲧⲓⲗⲟⲅⲓⲁ	N	ⲁⲛⲧⲓⲗⲟⲅⲓⲁ
ⲁⲛⲧⲓⲙⲓⲙⲟⲛ	N	ⲁⲛⲧⲓⲙⲓⲙⲟⲛ
ⲁⲛⲧⲓⲛⲟⲟⲩ	NPROP	ⲁⲛⲧⲓⲛⲟⲟⲩ
ⲁⲛⲧⲓⲟⲭⲓⲁ	NPROP	ⲁⲛⲧⲓⲟⲭⲓⲁ
ⲁⲛⲧⲓⲧⲩⲡⲟⲛ	N	ⲁⲛⲧⲓⲧⲩⲡⲟⲛ
ⲁⲛⲧⲓⲧⲩⲡⲟⲥ	N	ⲁⲛⲧⲓⲧⲩⲡⲟⲥ
ⲁⲛⲧⲓⲭⲣⲓⲥⲧⲟⲥ	N	ⲁⲛⲧⲓⲭⲣⲓⲥⲧⲟⲥ
ⲁⲛⲧⲓ	PREP	ⲁⲛⲧⲓ
ⲁⲛⲧⲱⲛⲓⲟⲥ	NPROP	ⲁⲛⲧⲱⲛⲓⲟⲥ
ⲁⲛⲩⲥⲧⲏⲥ	N	ⲁⲛⲩⲥⲧⲏⲥ
ⲁⲛ	NEG	ⲁⲛ
ⲁⲝⲓⲟⲛ	N	ⲁⲝⲓⲟⲛ
ⲁⲝⲓⲟⲡⲓⲥⲧⲟⲥ	N	ⲁⲝⲓⲟⲡⲓⲥⲧⲟⲥ
ⲁⲝⲓⲟⲥⲁⲝⲓⲟⲥⲁⲝⲓⲟⲥ	N	ⲁⲝⲓⲟⲥⲁⲝⲓⲟⲥⲁⲝⲓⲟⲥ
ⲁⲝⲓⲟⲥ	N	ⲁⲝⲓⲟⲥ
ⲁⲝⲓⲟⲩ	V	ⲁⲝⲓⲟⲩ
ⲁⲝⲓⲱⲙⲁⲧⲓⲕⲟⲥ	N	ⲁⲝⲓⲱⲙⲁⲧⲓⲕⲟⲥ
ⲁⲝⲓⲱⲙⲁ	N	ⲁⲝⲓⲱⲙⲁ
ⲁⲝⲟⲛ	N	ⲁⲝⲟⲛ
ⲁⲟⲩⲏⲧ	N	ⲁⲟⲩⲏⲧ
ⲁⲡϩⲟⲩ	NPROP	ⲁⲡϩⲟⲩ
ⲁⲡⲁⲅⲅⲉⲓⲗⲉ	V	ⲁⲡⲁⲅⲅⲉⲓⲗⲉ
ⲁⲡⲁⲑⲏⲥ	N	ⲁⲡⲁⲑⲏⲥ
ⲁⲡⲁⲓⲇⲉ	V	ⲁⲡⲁⲓⲇⲉ
ⲁⲡⲁⲓⲧⲉⲓ	V	ⲁⲡⲁⲓⲧⲉⲓ
ⲁⲡⲁⲛⲑⲣⲟⲡⲓⲁ	N	ⲁⲡⲁⲛⲑⲣⲟⲡⲓⲁ
ⲁⲡⲁⲛⲧⲁ	V	ⲁⲡⲁⲛⲧⲁ
ⲁⲡⲁⲛⲧⲏⲙⲁ	N	ⲁⲡⲁⲛⲧⲏⲙⲁ
ⲁⲡⲁⲛⲧⲏ	N	ⲁⲡⲁⲛⲧⲏ
ⲁⲡⲁⲛⲧⲩⲙⲁ	N	ⲁⲡⲁⲛⲧⲩⲙⲁ
ⲁⲡⲁⲣⲛⲁ	V	ⲁⲡⲁⲣⲛⲁ
ⲁⲡⲁⲣⲭⲏ	N	ⲁⲡⲁⲣⲭⲏ
ⲁⲡⲁⲧⲁ	V	ⲁⲡⲁⲧⲁ
ⲁⲡⲁⲧⲏ	N	ⲁⲡⲁⲧⲏ
ⲁⲡⲁⲩⲥⲧⲱⲥ	ADV	ⲁⲡⲁⲩⲥⲧⲱⲥ
ⲁⲡⲁ	N	ⲁⲡⲁ
ⲁⲡⲉⲓⲗⲉⲓ	V	ⲁⲡⲉⲓⲗⲉⲓ
ⲁⲡⲉⲓⲗⲉ	V	ⲁⲡⲉⲓⲗⲉ
ⲁⲡⲉⲓⲗⲏ	N	ⲁⲡⲉⲓⲗⲏ
ⲁⲡⲉⲣⲁⲛⲧⲟⲛ	N	ⲁⲡⲉⲣⲁⲛⲧⲟⲛ
ⲁⲡⲉⲣⲁⲛⲧⲟⲥ	N	ⲁⲡⲉⲣⲁⲛⲧⲟⲥ
ⲁⲡⲉ	N	ⲁⲡⲉ
ⲁⲡⲏⲩⲉ	N	ⲁⲡⲉ
ⲁⲡⲓⲥⲧⲉⲓ	V	ⲁⲡⲓⲥⲧⲉⲓ
ⲁⲡⲓⲥⲧⲓⲁ	N	ⲁⲡⲓⲥⲧⲓⲁ
ⲁⲡⲓⲥⲧⲟⲛ	N	ⲁⲡⲓⲥⲧⲟⲛ
ⲁⲡⲓⲥⲧⲟⲥ	N	ⲁⲡⲓⲥⲧⲟⲥ
ⲁⲡⲟϩⲣⲏⲧⲟⲥ	N	ⲁⲡⲟϩⲣⲏⲧⲟⲥ
ⲁⲡⲟⲅⲣⲁⲫⲏ	N	ⲁⲡⲟⲅⲣⲁⲫⲏ
ⲁⲡⲟⲅⲣⲁⲫⲟⲛ	N	ⲁⲡⲟⲅⲣⲁⲫⲟⲛ
ⲁⲡⲟⲅⲣⲩⲫⲟⲛ	N	ⲁⲡⲟⲅⲣⲩⲫⲟⲛ
ⲁⲡⲟⲇⲉⲓⲝⲓⲥ	N	ⲁⲡⲟⲇⲉⲓⲝⲓⲥ
ⲁⲡⲟⲇⲉⲝⲓⲥ	N	ⲁⲡⲟⲇⲉⲝⲓⲥ
ⲁⲡⲟⲇⲏⲅⲙⲁ	N	ⲁⲡⲟⲇⲏⲅⲙⲁ
ⲁⲡⲟⲇⲏⲙⲉⲓ	V	ⲁⲡⲟⲇⲏⲙⲉⲓ
ⲁⲡⲟⲇⲏⲙⲓⲁ	N	ⲁⲡⲟⲇⲏⲙⲓⲁ
ⲁⲡⲟⲇⲓⲕⲛⲩⲉ	V	ⲁⲡⲟⲇⲓⲕⲛⲩⲉ
ⲁⲡⲟⲇⲓⲝⲓⲥ	N	ⲁⲡⲟⲇⲓⲝⲓⲥ
ⲁⲡⲟⲑⲏⲕⲏ	N	ⲁⲡⲟⲑⲏⲕⲏ
ⲁⲡⲟⲕⲁⲑⲓⲥⲧⲁ	V	ⲁⲡⲟⲕⲁⲑⲓⲥⲧⲁ
ⲁⲡⲟⲕⲁⲗⲩⲯⲓⲥ	N	ⲁⲡⲟⲕⲁⲗⲩⲯⲓⲥ
ⲁⲡⲟⲕⲁⲧⲁⲥⲧⲁⲥⲓⲥ	N	ⲁⲡⲟⲕⲁⲧⲁⲥⲧⲁⲥⲓⲥ
ⲁⲡⲟⲕⲗⲏⲣⲟⲥ	N	ⲁⲡⲟⲕⲗⲏⲣⲟⲥ
ⲁⲡⲟⲕⲟⲗⲗⲁ	V	ⲁⲡⲟⲕⲟⲗⲗⲁ
ⲁⲡⲟⲕⲣⲁⲫⲟⲛ	N	ⲁⲡⲟⲕⲣⲁⲫⲟⲛ
ⲁⲡⲟⲕⲣⲓⲛⲉⲥⲑⲁⲓ	V	ⲁⲡⲟⲕⲣⲓⲛⲉⲥⲑⲁⲓ
ⲁⲡⲟⲕⲣⲓⲥⲓⲥ	N	ⲁⲡⲟⲕⲣⲓⲥⲓⲥ
ⲁⲡⲟⲕⲣⲓⲧⲏⲥ	N	ⲁⲡⲟⲕⲣⲓⲧⲏⲥ
ⲁⲡⲟⲕⲣⲩⲫⲟⲛ	N	ⲁⲡⲟⲕⲣⲩⲫⲟⲛ
ⲁⲡⲟⲗⲁⲩⲉ	V	ⲁⲡⲟⲗⲁⲩⲉ
ⲁⲡⲟⲗⲁⲩⲥⲓⲥ	N	ⲁⲡⲟⲗⲁⲩⲥⲓⲥ
ⲁⲡⲟⲗⲗⲟⲛ	NPROP	ⲁⲡⲟⲗⲗⲟⲛ
ⲁⲡⲟⲗⲗⲱⲛ	NPROP	ⲁⲡⲟⲗⲗⲱⲛ
ⲁⲡⲟⲗⲗⲱ	NPROP	ⲁⲡⲟⲗⲗⲱ
ⲁⲡⲟⲗⲟⲅⲓⲁ	N	ⲁⲡⲟⲗⲟⲅⲓⲁ
ⲁⲡⲟⲗⲟⲅⲓⲍⲉ	V	ⲁⲡⲟⲗⲟⲅⲓⲍⲉ
ⲁⲡⲟⲗⲩ	V	ⲁⲡⲟⲗⲩ
ⲁⲡⲟⲙⲉⲣⲟⲩⲥ	ADV	ⲁⲡⲟⲙⲉⲣⲟⲩⲥ
ⲁⲡⲟⲛⲉⲁ	N	ⲁⲡⲟⲛⲉⲁ
ⲁⲡⲟⲛⲟⲓⲁ	N	ⲁⲡⲟⲛⲟⲓⲁ
ⲁⲡⲟⲣⲉⲓ	V	ⲁⲡⲟⲣⲉⲓ
ⲁⲡⲟⲣⲓ	V	ⲁⲡⲟⲣⲓ
ⲁⲡⲟⲣⲣⲟⲓⲁ	N	ⲁⲡⲟⲣⲣⲟⲓⲁ
ⲁⲡⲟⲥⲕⲉⲩⲏ	N	ⲁⲡⲟⲥⲕⲉⲩⲏ
ⲁⲡⲟⲥⲧⲁⲗⲙⲉⲛⲟⲥ	V	ⲁⲡⲟⲥⲧⲁⲗⲙⲉⲛⲟⲥ
ⲁⲡⲟⲥⲧⲁⲥⲥⲉ	V	ⲁⲡⲟⲥⲧⲁⲥⲥⲉ
ⲁⲡⲟⲥⲧⲁⲧⲏⲥ	N	ⲁⲡⲟⲥⲧⲁⲧⲏⲥ
ⲁⲡⲟⲥⲧⲉⲣⲓ	V	ⲁⲡⲟⲥⲧⲉⲣⲓ
ⲁⲡⲟⲥⲧⲏⲑⲓⲍⲉ	V	ⲁⲡⲟⲥⲧⲏⲑⲓⲍⲉ
ⲁⲡⲟⲥⲧⲏⲑⲟⲩⲥ	ADV	ⲁⲡⲟⲥⲧⲏⲑⲟⲩⲥ
ⲁⲡⲟⲥⲧⲟⲗⲏ	N	ⲁⲡⲟⲥⲧⲟⲗⲏ
ⲁⲡⲟⲥⲧⲟⲗⲓⲕⲏ	N	ⲁⲡⲟⲥⲧⲟⲗⲓⲕⲏ
ⲁⲡⲟⲥⲧⲟⲗⲓⲕⲟⲛ	N	ⲁⲡⲟⲥⲧⲟⲗⲓⲕⲟⲛ
ⲁⲡⲟⲥⲧⲟⲗⲓⲕⲟⲥ	N	ⲁⲡⲟⲥⲧⲟⲗⲓⲕⲟⲥ
ⲁⲡⲟⲥⲧⲟⲗⲟⲥ	N	ⲁⲡⲟⲥⲧⲟⲗⲟⲥ
ⲁⲡⲟⲥⲩⲛⲁⲅⲱⲅⲟⲥ	N	ⲁⲡⲟⲥⲩⲛⲁⲅⲱⲅⲟⲥ
ⲁⲡⲟⲧⲁⲅⲏ	N	ⲁⲡⲟⲧⲁⲅⲏ
ⲁⲡⲟⲧⲁⲥⲥⲉ	V	ⲁⲡⲟⲧⲁⲥⲥⲉ
ⲁⲡⲟⲧⲉⲗⲉⲥⲙⲁ	N	ⲁⲡⲟⲧⲉⲗⲉⲥⲙⲁ
ⲁⲡⲟⲧ	N	ⲁⲡⲟⲧ
ⲁⲡⲟⲫⲁⲛⲉ	V	ⲁⲡⲟⲫⲁⲛⲉ
ⲁⲡⲟⲫⲁⲥⲓⲥ	N	ⲁⲡⲟⲫⲁⲥⲓⲥ
ⲁⲡⲟⲭⲁⲣⲓⲍⲉ	V	ⲁⲡⲟⲭⲁⲣⲓⲍⲉ
ⲁⲡⲟⲭⲏ	N	ⲁⲡⲟⲭⲏ
ⲁⲡⲣⲁⲅⲓⲁ	N	ⲁⲡⲣⲁⲅⲓⲁ
ⲁⲡⲣⲁⲕⲧⲟⲥ	N	ⲁⲡⲣⲁⲕⲧⲟⲥ
ⲁⲡⲥ	N	ⲁⲡⲥ
ⲁⲡⲱⲗⲗⲟⲛ	NPROP	ⲁⲡⲱⲗⲗⲟⲛ
ⲁⲡⲱⲗⲗⲱⲛ	NPROP	ⲁⲡⲱⲗⲗⲱⲛ
ⲁⲡⲱⲗⲗⲱ	NPROP	ⲁⲡⲱⲗⲗⲱ
ⲁⲣϣⲓⲛ	N	ⲁⲣϣⲓⲛ
ⲁⲣⲁⲃⲟⲥ	N	ⲁⲣⲁⲃⲟⲥ
ⲁⲣⲁⲙ	NPROP	ⲁⲣⲁⲙ
ⲁⲣⲁⲥⲑⲉ	V	ⲁⲣⲁⲥⲑⲉ
ⲁⲣⲁ	CONJ	ⲁⲣⲁ
ⲁⲣⲁ	PTC	ⲁⲣⲁ
ⲁⲣⲅⲟⲛ	N	ⲁⲣⲅⲟⲛ
ⲁⲣⲅⲟⲥ	N	ⲁⲣⲅⲟⲥ
ⲁⲣⲉⲥⲕⲉ	V	ⲁⲣⲉⲥⲕⲉ
ⲁⲣⲉⲧⲏ	N	ⲁⲣⲉⲧⲏ
ⲁⲣⲏϫⲥ	N	ⲁⲣⲏϫⲥ
ⲁⲣⲏϫ	V	ⲁⲣⲏϫ
ⲁⲣⲏⲃ	N	ⲁⲣⲏⲃ
ⲁⲣⲏⲩ	CONJ	ⲁⲣⲏⲩ
ⲁⲣⲓⲁⲛⲟⲥ	N	ⲁⲣⲓⲁⲛⲟⲥ
ⲁⲣⲓⲑⲙⲓⲁ	N	ⲁⲣⲓⲑⲙⲓⲁ
ⲁⲣⲓⲑⲙⲓⲟⲛ	N	ⲁⲣⲓⲑⲙⲓⲟⲛ
ⲁⲣⲓⲑⲙⲟⲥ	N	ⲁⲣⲓⲑⲙⲟⲥ
ⲁⲣⲓⲕⲉ	N	ⲁⲣⲓⲕⲉ
ⲁⲣⲓⲙⲁⲑⲁⲓⲟⲥ	NPROP	ⲁⲣⲓⲙⲁⲑⲁⲓⲟⲥ
ⲁⲣⲓⲟⲥ	NPROP	ⲁⲣⲓⲟⲥ
ⲁⲣⲓⲣⲉ	VIMP	ⲉⲓⲣⲉ
ⲁⲣⲓⲥⲧⲁ	V	ⲁⲣⲓⲥⲧⲁ
ⲁⲣⲓⲥⲧⲟⲇⲉⲗⲏⲥ	NPROP	ⲁⲣⲓⲥⲧⲟⲇⲉⲗⲏⲥ
ⲁⲣⲓⲥⲧⲟⲛ	N	ⲁⲣⲓⲥⲧⲟⲛ
ⲁⲣⲓⲥⲧⲟⲧⲉⲗⲏⲥ	NPROP	ⲁⲣⲓⲥⲧⲟⲧⲉⲗⲏⲥ
ⲁⲣⲓⲫⲟⲣⲟⲥ	NPROP	ⲁⲣⲓⲫⲟⲣⲟⲥ
ⲁⲣⲓ	VIMP	ⲉⲓⲣⲉ
ⲁⲣⲕⲁⲇⲓⲟⲥ	NPROP	ⲁⲣⲕⲁⲇⲓⲟⲥ
ⲁⲣⲕⲉⲩⲑⲟⲥ	N	ⲁⲣⲕⲉⲩⲑⲟⲥ
ⲁⲣⲕⲟⲥ	N	ⲁⲣⲕⲟⲥ
ⲁⲣⲕⲧⲟⲥ	N	ⲁⲣⲕⲧⲟⲥ
ⲁⲣⲛⲁ	V	ⲁⲣⲛⲁ
ⲁⲣⲛⲏⲥⲓⲥ	N	ⲁⲣⲛⲏⲥⲓⲥ
ⲁⲣⲛⲓⲥⲑⲉ	V	ⲁⲣⲛⲓⲥⲑⲉ
ⲁⲣⲝ	N	ⲁⲣⲝ
ⲁⲣⲟϣ	N	ⲁⲣⲟϣ
ⲁⲣⲟⲟⲩⲉ	N	ⲁⲣⲟⲟⲩⲉ
ⲁⲣⲣⲏⲧⲟⲛ	N	ⲁⲣⲣⲏⲧⲟⲛ
ⲁⲣⲣⲏⲧⲟⲥ	N	ⲁⲣⲣⲏⲧⲟⲥ
ⲁⲣⲥⲉⲛⲓⲟⲥ	NPROP	ⲁⲣⲥⲉⲛⲓⲟⲥ
ⲁⲣⲥⲉⲛⲟⲅⲉⲛⲓⲁ	N	ⲁⲣⲥⲉⲛⲟⲅⲉⲛⲓⲁ
ⲁⲣⲥⲓⲛⲓⲕⲟⲛ	N	ⲁⲣⲥⲓⲛⲓⲕⲟⲛ
ⲁⲣⲥⲩⲛⲓⲟⲥ	NPROP	ⲁⲣⲥⲩⲛⲓⲟⲥ
ⲁⲣⲧⲏⲣⲓⲁ	N	ⲁⲣⲧⲏⲣⲓⲁ
ⲁⲣⲧⲩⲙⲓⲥ	N	ⲁⲣⲧⲩⲙⲓⲥ
ⲁⲣⲭⲁⲅⲅⲉⲗⲓⲕⲏ	N	ⲁⲣⲭⲁⲅⲅⲉⲗⲓⲕⲏ
ⲁⲣⲭⲁⲅⲅⲉⲗⲟⲥ	N	ⲁⲣⲭⲁⲅⲅⲉⲗⲟⲥ
ⲁⲣⲭⲁⲓⲟⲛ	N	ⲁⲣⲭⲁⲓⲟⲛ
ⲁⲣⲭⲁⲓⲟⲥ	N	ⲁⲣⲭⲁⲓⲟⲥ
ⲁⲣⲭⲉⲓ	V	ⲁⲣⲭⲉⲓ
ⲁⲣⲭⲉⲥⲑⲁⲓ	V	ⲁⲣⲭⲉⲥⲑⲁⲓ
ⲁⲣⲭⲏⲅⲟⲥ	N	ⲁⲣⲭⲏⲅⲟⲥ
ⲁⲣⲭⲏⲇⲓⲁⲕⲟⲛⲟⲥ	N	ⲁⲣⲭⲏⲇⲓⲁⲕⲟⲛⲟⲥ
ⲁⲣⲭⲏⲇⲓⲁⲕⲱⲛ	N	ⲁⲣⲭⲏⲇⲓⲁⲕⲱⲛ
ⲁⲣⲭⲏⲉⲡⲓⲥⲕⲟⲡⲟⲥ	N	ⲁⲣⲭⲏⲉⲡⲓⲥⲕⲟⲡⲟⲥ
ⲁⲣⲭⲏⲑⲗⲓⲧⲏⲥ	N	ⲁⲣⲭⲏⲑⲗⲓⲧⲏⲥ
ⲁⲣⲭⲏⲕⲣⲓⲧⲏⲥ	N	ⲁⲣⲭⲏⲕⲣⲓⲧⲏⲥ
ⲁⲣⲭⲏⲗⲁⲟⲥ	NPROP	ⲁⲣⲭⲏⲗⲁⲟⲥ
ⲁⲣⲭⲏⲗⲏⲥⲧⲏⲥ	N	ⲁⲣⲭⲏⲗⲏⲥⲧⲏⲥ
ⲁⲣⲭⲏⲙⲁⲛⲇⲣⲓⲧⲏⲥ	N	ⲁⲣⲭⲏⲙⲁⲛⲇⲣⲓⲧⲏⲥ
ⲁⲣⲭⲏⲡⲗⲁⲥⲙⲁ	N	ⲁⲣⲭⲏⲡⲗⲁⲥⲙⲁ
ⲁⲣⲭⲏⲡⲣⲉⲥⲃⲩⲧⲉⲣⲟⲥ	N	ⲁⲣⲭⲏⲡⲣⲉⲥⲃⲩⲧⲉⲣⲟⲥ
ⲁⲣⲭⲏⲡⲣⲟⲫⲏⲧⲏⲥ	N	ⲁⲣⲭⲏⲡⲣⲟⲫⲏⲧⲏⲥ
ⲁⲣⲭⲏⲥⲧⲣⲁⲧⲩⲗⲁⲧⲏⲥ	N	ⲁⲣⲭⲏⲥⲧⲣⲁⲧⲩⲗⲁⲧⲏⲥ
ⲁⲣⲭⲏ	N	ⲁⲣⲭⲏ
ⲁⲣⲭⲓⲅⲉⲛⲉⲧⲱⲣ	N	ⲁⲣⲭⲓⲅⲉⲛⲉⲧⲱⲣ
ⲁⲣⲭⲓⲅⲉⲛⲛⲏⲧⲱⲣ	N	ⲁⲣⲭⲓⲅⲉⲛⲛⲏⲧⲱⲣ
ⲁⲣⲭⲓⲇⲁⲓⲙⲱⲛ	N	ⲁⲣⲭⲓⲇⲁⲓⲙⲱⲛ
ⲁⲣⲭⲓⲇⲓⲁⲕⲟⲛⲟⲥ	N	ⲁⲣⲭⲓⲇⲓⲁⲕⲟⲛⲟⲥ
ⲁⲣⲭⲓⲉⲡⲓⲥⲕⲟⲡⲟⲥ	N	ⲁⲣⲭⲓⲉⲡⲓⲥⲕⲟⲡⲟⲥ
ⲁⲣⲭⲓⲉⲣⲉⲩⲥ	N	ⲁⲣⲭⲓⲉⲣⲉⲩⲥ
ⲁⲣⲭⲓⲉⲣⲟⲥⲩⲛⲏ	N	ⲁⲣⲭⲓⲉⲣⲟⲥⲩⲛⲏ
ⲁⲣⲭⲓⲙⲁⲅⲉⲣⲟⲥ	N	ⲁⲣⲭⲓⲙⲁⲅⲉⲣⲟⲥ
ⲁⲣⲭⲓⲙⲁⲛⲇⲣⲓⲧⲏⲥ	N	ⲁⲣⲭⲓⲙⲁⲛⲇⲣⲓⲧⲏⲥ
ⲁⲣⲭⲓⲥⲑⲁⲓ	V	ⲁⲣⲭⲓⲥⲑⲁⲓ
ⲁⲣⲭⲓⲥⲧⲣⲁⲧⲉⲩⲙⲁ	N	ⲁⲣⲭⲓⲥⲧⲣⲁⲧⲉⲩⲙⲁ
ⲁⲣⲭⲓⲥⲧⲣⲁⲧⲏⲅⲟⲥ	N	ⲁⲣⲭⲓⲥⲧⲣⲁⲧⲏⲅⲟⲥ
ⲁⲣⲭⲓⲥⲩⲛⲁⲅⲱⲅⲟⲥ	N	ⲁⲣⲭⲓⲥⲩⲛⲁⲅⲱⲅⲟⲥ
ⲁⲣⲭⲓⲧⲉⲕⲧⲱⲛ	N	ⲁⲣⲭⲓⲧⲉⲕⲧⲱⲛ
ⲁⲣⲭⲓⲧⲗⲕ	V	ⲁⲣⲭⲓⲧⲗⲕ
ⲁⲣⲭⲟⲛⲧⲓⲕⲏ	N	ⲁⲣⲭⲟⲛⲧⲓⲕⲏ
ⲁⲣⲭⲟⲛⲧⲓⲕⲟⲛ	N	ⲁⲣⲭⲟⲛⲧⲓⲕⲟⲛ
ⲁⲣⲭⲱⲛ	N	ⲁⲣⲭⲱⲛ
ⲁⲣⲱⲙⲁⲧⲁ	N	ⲁⲣⲱⲙⲁⲧⲁ
ⲁⲣⲱⲛ	NPROP	ⲁⲣⲱⲛ
ⲁⲣ	APST_PPERS	ⲁ_ⲛⲧⲟ
ⲁⲥⲁⲗⲉⲩⲧⲟⲥ	N	ⲁⲥⲁⲗⲉⲩⲧⲟⲥ
ⲁⲥⲁⲫ	NPROP	ⲁⲥⲁⲫ
ⲁⲥⲉⲃⲏⲥ	N	ⲁⲥⲉⲃⲏⲥ
ⲁⲥⲉⲛⲛⲉⲑ	NPROP	ⲁⲥⲉⲛⲛⲉⲑ
ⲁⲥⲏⲙⲁⲛⲧⲟⲥ	N	ⲁⲥⲏⲙⲁⲛⲧⲟⲥ
ⲁⲥⲏⲙⲓⲟⲥ	N	ⲁⲥⲏⲙⲓⲟⲥ
ⲁⲥⲑⲉⲛⲉⲓⲁ	N	ⲁⲥⲑⲉⲛⲉⲓⲁ
ⲁⲥⲑⲉⲛⲏⲥ	N	ⲁⲥⲑⲉⲛⲏⲥ
ⲁⲥⲕⲉⲓ	V	ⲁⲥⲕⲉⲓ
ⲁⲥⲕⲏⲥⲓⲥ	N	ⲁⲥⲕⲏⲥⲓⲥ
ⲁⲥⲕⲏⲧⲏⲥ	N	ⲁⲥⲕⲏⲧⲏⲥ
ⲁⲥⲕⲏⲧⲓⲕⲟⲛ	N	ⲁⲥⲕⲏⲧⲓⲕⲟⲛ
ⲁⲥⲕⲟⲥ	N	ⲁⲥⲕⲟⲥ
ⲁⲥⲕⲩⲧⲏⲥ	N	ⲁⲥⲕⲩⲧⲏⲥ
ⲁⲥⲟⲩ	N	ⲁⲥⲟⲩ
ⲁⲥⲡⲁⲍⲉ	V	ⲁⲥⲡⲁⲍⲉ
ⲁⲥⲡⲁⲗⲁⲑⲟⲥ	N	ⲁⲥⲡⲁⲗⲁⲑⲟⲥ
ⲁⲥⲡⲁⲥⲙⲟⲥ	N	ⲁⲥⲡⲁⲥⲙⲟⲥ
ⲁⲥⲡⲉ	N	ⲁⲥⲡⲉ
ⲁⲥⲥⲁⲣⲓⲟⲛ	N	ⲁⲥⲥⲁⲣⲓⲟⲛ
ⲁⲥⲥⲩⲣⲓⲟⲥ	N	ⲁⲥⲥⲩⲣⲓⲟⲥ
ⲁⲥⲧⲉⲓⲟⲥ	N	ⲁⲥⲧⲉⲓⲟⲥ
ⲁⲥⲧⲏⲣ	N	ⲁⲥⲧⲏⲣ
ⲁⲥⲧⲓⲟⲥ	N	ⲁⲥⲧⲓⲟⲥ
ⲁⲥⲧⲣⲟⲗⲟⲅⲟⲥ	N	ⲁⲥⲧⲣⲟⲗⲟⲅⲟⲥ
ⲁⲥⲧⲣⲟⲛⲟⲙⲓⲁ	N	ⲁⲥⲧⲣⲟⲛⲟⲙⲓⲁ
ⲁⲥⲩⲛⲑⲉⲧⲟⲛ	N	ⲁⲥⲩⲛⲑⲉⲧⲟⲛ
ⲁⲥⲩⲛⲑⲉⲧⲟⲥ	N	ⲁⲥⲩⲛⲑⲉⲧⲟⲥ
ⲁⲥⲫⲁⲗⲏⲥ	N	ⲁⲥⲫⲁⲗⲏⲥ
ⲁⲥⲫⲁⲗⲓⲁ	N	ⲁⲥⲫⲁⲗⲓⲁ
ⲁⲥⲫⲁⲗⲓⲍⲉ	V	ⲁⲥⲫⲁⲗⲓⲍⲉ
ⲁⲥⲫⲁⲗⲱⲥ	ADV	ⲁⲥⲫⲁⲗⲱⲥ
ⲁⲥⲭⲏⲙⲟⲛⲉⲓ	V	ⲁⲥⲭⲏⲙⲟⲛⲉⲓ
ⲁⲥⲭⲏⲙⲟⲥⲩⲛⲏ	N	ⲁⲥⲭⲏⲙⲟⲥⲩⲛⲏ
ⲁⲥⲱⲙⲁⲧⲟⲛ	N	ⲁⲥⲱⲙⲁⲧⲟⲛ
ⲁⲥⲱⲙⲁⲧⲟⲥ	N	ⲁⲥⲱⲙⲁⲧⲟⲥ
ⲁⲥⲱⲟⲩ	VSTAT	ⲁⲥⲁⲓ
ⲁⲥ	N	ⲁⲥ
ⲁⲧϣⲁϫⲉ	N	ⲁⲧϣⲁϫⲉ
ⲁⲧϣⲁⲩ	N	ⲁⲧϣⲁⲩ
ⲁⲧϣⲉⲡϩⲙⲟⲧ	N	ⲁⲧϣⲉⲡϩⲙⲟⲧ
ⲁⲧϣⲓⲡⲉ	N	ⲁⲧϣⲓⲡⲉ
ⲁⲧϣⲓⲧ	N	ⲁⲧϣⲓ
ⲁⲧϣⲡϩⲓⲥⲉ	N	ⲁⲧϣⲡϩⲓⲥⲉ
ⲁⲧϣⲡϩⲙⲟⲧ	N	ⲁⲧϣⲡϩⲙⲟⲧ
ⲁⲧϩⲉⲃⲥⲱ	N	ⲁⲧϩⲉⲃⲥⲱ
ⲁⲧϩⲏⲧ	N	ⲁⲧϩⲏⲧ
ⲁⲧϩⲟⲧⲉ	N	ⲁⲧϩⲟⲧⲉ
ⲁⲧϩⲩⲗⲏ	N	ⲁⲧϩⲩⲗⲏ
ⲁⲧϫⲓⲏⲡⲉ	N	ⲁⲧϫⲓⲏⲡⲉ
ⲁⲧϫⲟ	N	ⲁⲧϫⲟ
ⲁⲧϭⲟⲙ	N	ⲁⲧϭⲟⲙ
ⲁⲧϭⲱⲛⲧ	N	ⲁⲧϭⲱⲛⲧ
ⲁⲧϯϣⲓ	N	ⲁⲧϯϣⲓ
ⲁⲧⲁⲑⲉⲧⲉⲓ	N	ⲁⲧⲁⲑⲉⲧⲉⲓ
ⲁⲧⲁⲕⲧⲟⲥ	N	ⲁⲧⲁⲕⲧⲟⲥ
ⲁⲧⲁⲕⲧⲱⲥ	N	ⲁⲧⲁⲕⲧⲱⲥ
ⲁⲧⲁⲙⲁⲛⲇⲓⲛⲟⲛ	N	ⲁⲧⲁⲙⲁⲛⲇⲓⲛⲟⲛ
ⲁⲧⲁⲝⲓⲁ	N	ⲁⲧⲁⲝⲓⲁ
ⲁⲧⲁⲣⲏϫ	N	ⲁⲧⲁⲣⲏϫ
ⲁⲧⲃⲉⲥ	N	ⲁⲧⲃⲉⲥ
ⲁⲧⲃⲥ	N	ⲁⲧⲃⲥ
ⲁⲧⲃⲱⲗⲉⲃⲟⲗ	N	ⲁⲧⲃⲱⲗⲉⲃⲟⲗ
ⲁⲧⲇⲓⲁⲕⲣⲓⲛⲉ	N	ⲁⲧⲇⲓⲁⲕⲣⲓⲛⲉ
ⲁⲧⲉⲓⲙⲉ	N	ⲁⲧⲉⲓⲙⲉ
ⲁⲧⲉⲗⲏⲥ	N	ⲁⲧⲉⲗⲏⲥ
ⲁⲧⲉⲛⲱⲭⲗⲓ	N	ⲁⲧⲉⲛⲱⲭⲗⲓ
ⲁⲧⲉⲩⲁⲅⲅⲉⲗⲉⲓ	N	ⲁⲧⲉⲩⲁⲅⲅⲉⲗⲉⲓ
ⲁⲧⲏⲡⲉ	N	ⲁⲧⲏⲡⲉ
ⲁⲧⲑⲁⲃ	N	ⲁⲧⲑⲁⲃ
ⲁⲧⲓⲙⲓⲁ	N	ⲁⲧⲓⲙⲓⲁ
ⲁⲧⲓⲙⲟⲥ	N	ⲁⲧⲓⲙⲟⲥ
ⲁⲧⲕⲁϭⲓⲁ	N	ⲁⲧⲕⲁϭⲓⲁ
ⲁⲧⲕⲁⲕⲓⲁ	N	ⲁⲧⲕⲁⲕⲓⲁ
ⲁⲧⲕⲁⲣⲡⲟⲥ	N	ⲁⲧⲕⲁⲣⲡⲟⲥ
ⲁⲧⲕⲁⲧⲁⲗⲩⲉ	N	ⲁⲧⲕⲁⲧⲁⲗⲩⲉ
ⲁⲧⲕⲓⲙ	N	ⲁⲧⲕⲓⲙ
ⲁⲧⲗⲟⲅⲟⲥ	N	ⲁⲧⲗⲟⲅⲟⲥ
ⲁⲧⲙⲟⲟⲩ	N	ⲁⲧⲙⲟⲟⲩ
ⲁⲧⲙⲟⲩⲛⲅ	N	ⲁⲧⲙⲟⲩⲛⲅ
ⲁⲧⲙⲟⲩ	N	ⲁⲧⲙⲟⲩ
ⲁⲧⲙⲡϣⲁ	N	ⲁⲧⲙⲡϣⲁ
ⲁⲧⲛⲁϩⲧⲉ	N	ⲁⲧⲛⲁϩⲧⲉ
ⲁⲧⲛⲁⲩ	N	ⲁⲧⲛⲁⲩ
ⲁⲧⲛⲁ	N	ⲁⲧⲛⲁ
ⲁⲧⲛⲟⲃⲉ	N	ⲁⲧⲛⲟⲃⲉ
ⲁⲧⲛⲟⲉⲓ	N	ⲁⲧⲛⲟⲉⲓ
ⲁⲧⲛⲟⲓ	N	ⲁⲧⲛⲟⲓ
ⲁⲧⲛⲟⲩⲥ	N	ⲁⲧⲛⲟⲩⲥ
ⲁⲧⲛⲟⲩⲧⲉ	N	ⲁⲧⲛⲟⲩⲧⲉ
ⲁⲧⲟⲛⲉⲓ	V	ⲁⲧⲟⲛⲉⲓ
ⲁⲧⲟⲡⲟⲛ	N	ⲁⲧⲟⲡⲟⲛ
ⲁⲧⲟⲩⲉⲓⲛⲉ	N	ⲁⲧⲟⲩⲉⲓⲛⲉ
ⲁⲧⲟⲩⲥⲓⲁ	N	ⲁⲧⲟⲩⲥⲓⲁ
ⲁⲧⲡⲁⲣⲁⲃⲁ	N	ⲁⲧⲡⲁⲣⲁⲃⲁ
ⲁⲧⲡⲁⲣⲁⲥⲉⲗⲉⲩⲉ	N	ⲁⲧⲡⲁⲣⲁⲥⲉⲗⲉⲩⲉ
ⲁⲧⲡⲛⲉⲩⲙⲁ	N	ⲁⲧⲡⲛⲉⲩⲙⲁ
ⲁⲧⲣⲉⲡⲧⲟⲥ	N	ⲁⲧⲣⲉⲡⲧⲟⲥ
ⲁⲧⲣⲟⲟⲩϣ	N	ⲁⲧⲣⲟⲟⲩϣ
ⲁⲧⲥⲁⲣⲁⲝ	N	ⲁⲧⲥⲁⲣⲁⲝ
ⲁⲧⲥⲃⲃⲉ	N	ⲁⲧⲥⲃⲃⲉ
ⲁⲧⲥⲃⲱ	N	ⲁⲧⲥⲃⲱ
ⲁⲧⲥⲟⲟⲩⲛ	N	ⲁⲧⲥⲟⲟⲩⲛ
ⲁⲧⲥⲭⲏⲙⲁ	N	ⲁⲧⲥⲭⲏⲙⲁ
ⲁⲧⲥⲱⲙⲁ	N	ⲁⲧⲥⲱⲙⲁ
ⲁⲧⲥⲱⲧⲙ	N	ⲁⲧⲥⲱⲧⲙ
ⲁⲧⲧⲁϩⲟ	N	ⲁⲧⲧⲁϩⲟ
ⲁⲧⲧⲁⲕⲟ	N	ⲁⲧⲧⲁⲕⲟ
ⲁⲧⲧⲁⲗϭⲟ	N	ⲁⲧⲧⲁⲗϭⲟ
ⲁⲧⲧⲁⲩⲟ	N	ⲁⲧⲧⲁⲩⲟ
ⲁⲧⲧⲛⲧⲱⲛ	N	ⲁⲧⲧⲛⲧⲱⲛ
ⲁⲧⲧⲱⲗⲙ	N	ⲁⲧⲧⲱⲗⲙ
ⲁⲧⲭⲁⲣⲁⲕⲧⲏⲣ	N	ⲁⲧⲭⲁⲣⲁⲕⲧⲏⲣ
ⲁⲧ	N	ⲁⲧ
ⲁⲩⲁⲛ	N	ⲁⲩⲁⲛ
ⲁⲩⲅⲟⲩⲥⲧⲁⲗⲓⲟⲥ	N	ⲁⲩⲅⲟⲩⲥⲧⲁⲗⲓⲟⲥ
ⲁⲩⲅⲟⲩⲥⲧⲟⲥ	N	ⲁⲩⲅⲟⲩⲥⲧⲟⲥ
ⲁⲩⲉⲓⲥ	PTC	ⲁⲩⲉⲓⲥ
ⲁⲩⲏⲧ	N	ⲁⲩⲏⲧ
ⲁⲩⲑⲁⲇⲏⲥ	N	ⲁⲩⲑⲁⲇⲏⲥ
ⲁⲩⲑⲉⲛⲧⲉⲓⲁ	N	ⲁⲩⲑⲉⲛⲧⲉⲓⲁ
ⲁⲩⲑⲉⲛⲧⲏⲥ	N	ⲁⲩⲑⲉⲛⲧⲏⲥ
ⲁⲩⲑⲉⲛⲧⲓⲕⲏ	N	ⲁⲩⲑⲉⲛⲧⲓⲕⲏ
ⲁⲩⲕⲟⲩⲥⲧⲟⲥ	V	ⲁⲩⲕⲟⲩⲥⲧⲟⲥ
ⲁⲩⲗⲏⲣⲓⲁⲛⲟⲥ	NPROP	ⲁⲩⲗⲏⲣⲓⲁⲛⲟⲥ
ⲁⲩⲗⲏ	N	ⲁⲩⲗⲏ
ⲁⲩⲝⲁⲛⲉ	V	ⲁⲩⲝⲁⲛⲉ
ⲁⲩⲝⲓⲥⲓⲥ	N	ⲁⲩⲝⲓⲥⲓⲥ
ⲁⲩⲧⲟⲅⲉⲛⲏⲥ	N	ⲁⲩⲧⲟⲅⲉⲛⲏⲥ
ⲁⲩⲧⲟⲅⲉⲛⲏⲧⲟⲥ	N	ⲁⲩⲧⲟⲅⲉⲛⲏⲧⲟⲥ
ⲁⲩⲧⲟⲅⲉⲛⲛⲓⲟⲥ	N	ⲁⲩⲧⲟⲅⲉⲛⲛⲓⲟⲥ
ⲁⲩⲧⲟⲇⲟⲝⲁⲥⲧⲟⲥ	N	ⲁⲩⲧⲟⲇⲟⲝⲁⲥⲧⲟⲥ
ⲁⲩⲧⲟⲑⲉⲗⲏⲧⲟⲥ	N	ⲁⲩⲧⲟⲑⲉⲗⲏⲧⲟⲥ
ⲁⲩⲧⲟⲕⲣⲁⲧⲱⲣ	N	ⲁⲩⲧⲟⲕⲣⲁⲧⲱⲣ
ⲁⲩⲧⲟⲡⲁⲧⲱⲣ	N	ⲁⲩⲧⲟⲡⲁⲧⲱⲣ
ⲁⲩⲧⲟⲧⲉⲗⲏⲥ	N	ⲁⲩⲧⲟⲧⲉⲗⲏⲥ
ⲁⲩⲧⲟⲩ	N	ⲁⲩⲧⲟⲩ
ⲁⲩⲧⲟⲫⲩⲏⲥ	N	ⲁⲩⲧⲟⲫⲩⲏⲥ
ⲁⲩⲧⲱⲕⲣⲁⲧⲱⲣ	N	ⲁⲩⲧⲱⲕⲣⲁⲧⲱⲣ
ⲁⲩⲱ	CONJ	ⲁⲩⲱ
ⲁⲩⲱ	N	ⲁⲩⲱ
ⲁⲩ	V	ⲁⲩ
ⲁⲫⲉⲇⲣⲱⲛ	N	ⲁⲫⲉⲇⲣⲱⲛ
ⲁⲫⲉⲗⲗⲏⲥ	N	ⲁⲫⲉⲗⲗⲏⲥ
ⲁⲫⲉⲗⲡⲓⲍⲉ	V	ⲁⲫⲉⲗⲡⲓⲍⲉ
ⲁⲫⲑⲁⲣⲥⲓⲁ	N	ⲁⲫⲑⲁⲣⲥⲓⲁ
ⲁⲫⲑⲁⲣⲧⲟⲛ	N	ⲁⲫⲑⲁⲣⲧⲟⲛ
ⲁⲫⲑⲁⲣⲧⲟⲥ	N	ⲁⲫⲑⲁⲣⲧⲟⲥ
ⲁⲫⲑⲟⲛⲓⲁ	NPROP	ⲁⲫⲑⲟⲛⲓⲁ
ⲁⲫⲑⲟⲣⲟⲥ	N	ⲁⲫⲑⲟⲣⲟⲥ
ⲁⲫⲟⲣⲓⲥⲙⲟⲥ	N	ⲁⲫⲟⲣⲓⲥⲙⲟⲥ
ⲁⲫⲟⲣⲙⲏ	N	ⲁⲫⲟⲣⲙⲏ
ⲁⲫⲟⲩ	NPROP	ⲁⲫⲟⲩ
ⲁⲫⲣⲏⲇⲱⲛⲓⲁ	N	ⲁⲫⲣⲏⲇⲱⲛⲓⲁ
ⲁⲫⲩⲗⲗⲏⲥ	N	ⲁⲫⲩⲗⲗⲏⲥ
ⲁⲫⲱⲣⲓⲥⲉ	V	ⲁⲫⲱⲣⲓⲥⲉ
ⲁⲭⲁⲁⲃ	NPROP	ⲁⲭⲁⲁⲃ
ⲁⲭⲁⲃ	NPROP	ⲁⲭⲁⲃ
ⲁⲭⲁⲧⲏⲥ	N	ⲁⲭⲁⲧⲏⲥ
ⲁⲭⲉⲓⲙ	NPROP	ⲁⲭⲉⲓⲙ
ⲁⲭⲉⲣⲟⲩⲥⲓⲁ	NPROP	ⲁⲭⲉⲣⲟⲩⲥⲓⲁ
ⲁⲭⲓⲗⲗⲁⲥ	NPROP	ⲁⲭⲓⲗⲗⲁⲥ
ⲁⲭⲓⲗⲗⲓⲟⲛ	N	ⲁⲭⲓⲗⲗⲓⲟⲛ
ⲁⲭⲓⲧⲱⲃⲉⲗ	NPROP	ⲁⲭⲓⲧⲱⲃⲉⲗ
ⲁⲭⲱⲣⲏⲧⲟⲥ	N	ⲁⲭⲱⲣⲏⲧⲟⲥ
ⲁⲯⲩⲭⲟⲛ	N	ⲁⲯⲩⲭⲟⲛ
ⲁ	ADV	ⲁ
ⲁ	APST	ⲁ
ⲁ	FUT	ⲛⲁ
ⲁ	PPERS	ⲁ
ⲁ	UNKNOWN	ⲁ
ⲃϣⲉ	N	ⲃϣⲉ
ⲃⲁϣⲟⲣ	N	ⲃⲁϣⲟⲣ
ⲃⲁϣⲟⲩⲣ	N	ⲃⲁϣⲟⲩⲣ
ⲃⲁϩⲁⲗ	NPROP	ⲃⲁϩⲁⲗ
ⲃⲁⲁⲃⲉ	V	ⲃⲁⲁⲃⲉ
ⲃⲁⲁⲙⲡⲉ	N	ⲃⲁⲁⲙⲡⲉ
ⲃⲁⲃⲉⲣⲱⲙⲉ	N	ⲃⲁⲃⲉⲣⲱⲙⲉ
ⲃⲁⲃⲉ	V	ⲃⲁⲃⲉ
ⲃⲁⲃⲩⲗⲱⲛ	NPROP	ⲃⲁⲃⲩⲗⲱⲛ
ⲃⲁⲃⲱⲱ	V	ⲃⲁⲁⲃⲉ
ⲃⲁⲑⲙⲟⲥ	N	ⲃⲁⲑⲙⲟⲥ
ⲃⲁⲑⲟⲛ	N	ⲃⲁⲑⲟⲛ
ⲃⲁⲑⲟⲥ	N	ⲃⲁⲑⲟⲥ
ⲃⲁⲓϣⲓⲛⲉ	N	ⲃⲁⲓϣⲓⲛⲉ
ⲃⲁⲕⲧⲏⲣⲓⲁ	N	ⲃⲁⲕⲧⲏⲣⲓⲁ
ⲃⲁⲗϩⲏⲧ	N	ⲃⲁⲗϩⲏⲧ
ⲃⲁⲗⲁⲧ	N	ⲃⲁⲗⲁⲧ
ⲃⲁⲗⲗⲁ	NPROP	ⲃⲁⲗⲗⲁ
ⲃⲁⲗⲟⲧ	N	ⲃⲁⲗⲟⲧ
ⲃⲁⲗ	N	ⲃⲁⲗ
ⲃⲁⲙⲡⲉ	N	ⲃⲁⲙⲡⲉ
ⲃⲁⲛⲓⲡⲉ	N	ⲃⲁⲛⲓⲡⲉ
ⲃⲁⲡϯⲥⲙⲁ	N	ⲃⲁⲡϯⲥⲙⲁ
ⲃⲁⲡϯⲥⲧⲏⲣⲓⲟⲛ	N	ⲃⲁⲡϯⲥⲧⲏⲣⲓⲟⲛ
ⲃⲁⲡⲧⲏⲥⲧⲏⲥ	N	ⲃⲁⲡⲧⲏⲥⲧⲏⲥ
ⲃⲁⲡⲧⲓⲍⲉⲛ	V	ⲃⲁⲡⲧⲓⲍⲉⲛ
ⲃⲁⲡⲧⲓⲍⲉ	V	ⲃⲁⲡⲧⲓⲍⲉ
ⲃⲁⲡⲧⲓⲥⲙⲁ	N	ⲃⲁⲡⲧⲓⲥⲙⲁ
ⲃⲁⲡⲧⲓⲥⲙⲟⲥ	N	ⲃⲁⲡⲧⲓⲥⲙⲟⲥ
ⲃⲁⲡⲧⲓⲥⲧⲏⲣⲓⲟⲛ	N	ⲃⲁⲡⲧⲓⲥⲧⲏⲣⲓⲟⲛ
ⲃⲁⲡⲧⲓⲥⲧⲏⲥ	N	ⲃⲁⲡⲧⲓⲥⲧⲏⲥ
ⲃⲁⲣⲁⲃⲃⲁⲥ	NPROP	ⲃⲁⲣⲁⲃⲃⲁⲥ
ⲃⲁⲣⲃⲁⲣⲟⲥ	N	ⲃⲁⲣⲃⲁⲣⲟⲥ
ⲃⲁⲣⲃⲁⲣⲟⲩⲥ	N	ⲃⲁⲣⲃⲁⲣⲟⲩⲥ
ⲃⲁⲣⲉⲓⲥⲑⲁⲓ	V	ⲃⲁⲣⲉⲓⲥⲑⲁⲓ
ⲃⲁⲣⲉⲓ	V	ⲃⲁⲣⲉⲓ
ⲃⲁⲣⲑⲟⲗⲟⲙⲁⲓⲟⲥ	NPROP	ⲃⲁⲣⲑⲟⲗⲟⲙⲁⲓⲟⲥ
ⲃⲁⲣⲕⲁⲃⲁⲛ	NPROP	ⲃⲁⲣⲕⲁⲃⲁⲛ
ⲃⲁⲣⲕⲱⲃ	NPROP	ⲃⲁⲣⲕⲱⲃ
ⲃⲁⲣⲛⲁⲃⲁⲥ	N	ⲃⲁⲣⲛⲁⲃⲁⲥ
ⲃⲁⲣⲟⲥ	N	ⲃⲁⲣⲟⲥ
ⲃⲁⲣⲱⲧ	N	ⲃⲁⲣⲱⲧ
ⲃⲁⲥⲁⲛⲓⲍⲉ	V	ⲃⲁⲥⲁⲛⲓⲍⲉ
ⲃⲁⲥⲁⲛⲓⲥⲧⲏⲣⲓⲟⲛ	N	ⲃⲁⲥⲁⲛⲓⲥⲧⲏⲣⲓⲟⲛ
ⲃⲁⲥⲁⲛⲓⲥⲧⲏⲥ	N	ⲃⲁⲥⲁⲛⲓⲥⲧⲏⲥ
ⲃⲁⲥⲁⲛⲟⲥ	N	ⲃⲁⲥⲁⲛⲟⲥ
ⲃⲁⲥⲓⲗⲉⲓⲟⲥ	NPROP	ⲃⲁⲥⲓⲗⲉⲓⲟⲥ
ⲃⲁⲥⲓⲗⲓⲕⲟⲥ	N	ⲃⲁⲥⲓⲗⲓⲕⲟⲥ
ⲃⲁⲥⲓⲗⲓⲟⲥ	NPROP	ⲃⲁⲥⲓⲗⲓⲟⲥ
ⲃⲁⲥⲓⲗⲓⲥⲕⲟⲥ	NPROP	ⲃⲁⲥⲓⲗⲓⲥⲕⲟⲥ
ⲃⲁⲥⲓⲗⲓⲧⲏⲥ	NPROP	ⲃⲁⲥⲓⲗⲓⲧⲏⲥ
ⲃⲁⲥⲓⲙⲟⲥ	NPROP	ⲃⲁⲥⲓⲙⲟⲥ
ⲃⲁⲥⲓⲥ	N	ⲃⲁⲥⲓⲥ
ⲃⲁⲥⲕⲁⲛⲟⲥ	N	ⲃⲁⲥⲕⲁⲛⲟⲥ
ⲃⲁⲥⲧⲉⲣⲛⲁ	N	ⲃⲁⲥⲧⲉⲣⲛⲁ
ⲃⲁⲧⲁⲛⲉ	N	ⲃⲁⲧⲁⲛⲉ
ⲃⲁⲧⲟⲥ	N	ⲃⲁⲧⲟⲥ
ⲃⲁⲧⲧⲁⲗⲟⲅⲓ	V	ⲃⲁⲧⲧⲁⲗⲟⲅⲓ
ⲃⲁⲧⲧⲟⲗⲟⲅⲓⲁ	N	ⲃⲁⲧⲧⲟⲗⲟⲅⲓⲁ
ⲃⲁⲩⲕⲁⲗⲓⲟⲛ	N	ⲃⲁⲩⲕⲁⲗⲓⲟⲛ
ⲃⲃⲗⲗⲁϥ	N	ⲃⲃⲗⲗⲁϥ
ⲃⲃⲟⲗ	V	ⲃⲃⲟⲗ
ⲃⲃⲣⲣⲉ	N	ⲃⲃⲣⲣⲉ
ⲃⲇⲉⲗⲗⲏ	N	ⲃⲇⲉⲗⲗⲏ
ⲃⲉⲃⲁⲓⲟⲩ	V	ⲃⲉⲃⲁⲓⲟⲩ
ⲃⲉⲃⲉ	V	ⲃⲉⲃⲉ
ⲃⲉⲉⲗⲍⲉⲃⲟⲩⲗ	N	ⲃⲉⲉⲗⲍⲉⲃⲟⲩⲗ
ⲃⲉⲍⲁⲛⲧⲓⲟⲛ	NPROP	ⲃⲉⲍⲁⲛⲧⲓⲟⲛ
ⲃⲉⲕⲉ	N	ⲃⲉⲕⲉ
ⲃⲉⲕⲏ	N	ⲃⲉⲕⲏ
ⲃⲉⲗϫⲉ	N	ⲃⲉⲗϫⲉ
ⲃⲉⲗⲃⲓⲗⲉ	N	ⲃⲉⲗⲃⲓⲗⲉ
ⲃⲉⲗ	V	ⲃⲱⲗ
ⲃⲉⲛⲓⲁⲙⲓⲛ	NPROP	ⲃⲉⲛⲓⲁⲙⲓⲛ
ⲃⲉⲛⲓⲡⲉ	N	ⲃⲉⲛⲓⲡⲉ
ⲃⲉⲣⲉⲇⲁⲣⲓⲟⲥ	N	ⲃⲉⲣⲉⲇⲁⲣⲓⲟⲥ
ⲃⲉⲣⲉⲧⲁⲣⲓⲟⲥ	N	ⲃⲉⲣⲉⲧⲁⲣⲓⲟⲥ
ⲃⲉⲣⲉⲧⲱⲥ	ADV	ⲃⲉⲣⲉⲧⲱⲥ
ⲃⲉⲥⲁⲛⲧⲓⲟⲛ	NPROP	ⲃⲉⲥⲁⲛⲧⲓⲟⲛ
ⲃⲉⲥⲉ	N	ⲃⲉⲥⲉ
ⲃⲉⲧ	V	ⲃⲱⲧⲉ
ⲃⲏϭ	NPROP	ⲃⲏϭ
ⲃⲏⲇⲥⲁⲓⲇⲁⲛ	N	ⲃⲏⲇⲥⲁⲓⲇⲁⲛ
ⲃⲏⲑⲁⲛⲓⲁ	NPROP	ⲃⲏⲑⲁⲛⲓⲁ
ⲃⲏⲑⲥⲁⲓⲇⲁ	N	ⲃⲏⲑⲥⲁⲓⲇⲁ
ⲃⲏⲕ	VSTAT	ⲃⲱⲕ
ⲃⲏⲗ	VSTAT	ⲃⲱⲗ
ⲃⲏⲙⲁ	N	ⲃⲏⲙⲁ
ⲃⲏⲥⲁⲣⲓⲟⲛ	NPROP	ⲃⲏⲥⲁⲣⲓⲟⲛ
ⲃⲏⲧ	VSTAT	ⲃⲱⲧⲉ
ⲃⲓⲁⲍⲉ	V	ⲃⲓⲁⲍⲉ
ⲃⲓⲁ	N	ⲃⲓⲁ
ⲃⲓⲃⲗⲓⲟⲑⲩⲕⲏ	N	ⲃⲓⲃⲗⲓⲟⲑⲩⲕⲏ
ⲃⲓⲃⲗⲟⲥ	N	ⲃⲓⲃⲗⲟⲥ
ⲃⲓⲕⲁⲣⲓⲟⲥ	N	ⲃⲓⲕⲁⲣⲓⲟⲥ
ⲃⲓⲕⲧⲱⲣⲓⲁ	N	ⲃⲓⲕⲧⲱⲣⲓⲁ
ⲃⲓⲕⲧⲱⲣ	NPROP	ⲃⲓⲕⲧⲱⲣ
ⲃⲓⲟⲥ	N	ⲃⲓⲟⲥ
ⲃⲓⲣ	N	ⲃⲓⲣ
ⲃⲓⲱⲧⲓⲕⲟⲛ	N	ⲃⲓⲱⲧⲓⲕⲟⲛ
ⲃⲓⲱⲧⲓⲕⲟⲥ	N	ⲃⲓⲱⲧⲓⲕⲟⲥ
ⲃⲗϫⲉ	N	ⲃⲗϫⲉ
ⲃⲗⲁⲃⲏ	N	ⲃⲗⲁⲃⲏ
ⲃⲗⲁⲡⲧⲉⲓ	V	ⲃⲗⲁⲡⲧⲉⲓ
ⲃⲗⲁⲥⲫⲏⲙⲓⲁ	N	ⲃⲗⲁⲥⲫⲏⲙⲓⲁ
ⲃⲗⲃⲓⲗⲉ	N	ⲃⲗⲃⲓⲗⲉ
ⲃⲗⲗⲉ	N	ⲃⲗⲗⲉ
ⲃⲗⲗⲏ	N	ⲃⲗⲗⲏ
ⲃⲗ	V	ⲃⲗ
ⲃⲛⲧ	N	ⲃⲛⲧ
ⲃⲟϣ	V	ⲃⲱϣ
ⲃⲟϭ	V	ϥⲱϭⲉ
ⲃⲟⲁⲛⲏⲣⲅⲉⲥ	N	ⲃⲟⲁⲛⲏⲣⲅⲉⲥ
ⲃⲟⲉⲥ	NPROP	ⲃⲟⲉⲥ
ⲃⲟⲏⲑⲉⲓⲁ	N	ⲃⲟⲏⲑⲉⲓⲁ
ⲃⲟⲏⲑⲉⲓ	V	ⲃⲟⲏⲑⲉⲓ
ⲃⲟⲏⲑⲓⲁ	N	ⲃⲟⲏⲑⲓⲁ
ⲃⲟⲏⲑⲟⲥ	N	ⲃⲟⲏⲑⲟⲥ
ⲃⲟⲗⲃⲗ	V	ⲃⲟⲗⲃⲗ
ⲃⲟⲗ	N	ⲃⲟⲗ
ⲃⲟⲗ	V	ⲃⲱⲗ
ⲃⲟⲛⲧⲉ	N	ⲃⲟⲛⲧⲉ
ⲃⲟⲟⲛⲉ	V	ⲃⲟⲟⲛⲉ
ⲃⲟⲟⲣ	V	ⲃⲱⲱⲣⲉ
ⲃⲟⲣⲃⲟⲣⲟⲥ	N	ⲃⲟⲣⲃⲟⲣⲟⲥ
ⲃⲟⲧⲁⲛⲏ	N	ⲃⲟⲧⲁⲛⲏ
ⲃⲟⲧⲉ	N	ⲃⲟⲧⲉ
ⲃⲟⲧ	V	ⲃⲱⲧⲉ
ⲃⲟⲩⲗⲉⲩⲧⲏⲣⲓⲟⲛ	N	ⲃⲟⲩⲗⲉⲩⲧⲏⲣⲓⲟⲛ
ⲃⲟⲩⲗⲉⲩⲧⲏⲥ	N	ⲃⲟⲩⲗⲉⲩⲧⲏⲥ
ⲃⲟⲩⲗⲏⲥⲓⲥ	N	ⲃⲟⲩⲗⲏⲥⲓⲥ
ⲃⲟⲩⲛⲉⲩⲣⲟⲛ	N	ⲃⲟⲩⲛⲉⲩⲣⲟⲛ
ⲃⲟⲩⲛⲟⲥ	N	ⲃⲟⲩⲛⲟⲥ
ⲃⲣⲁⲃⲓⲟⲛ	N	ⲃⲣⲁⲃⲓⲟⲛ
ⲃⲣⲁⲭⲙⲁⲛⲏⲥ	N	ⲃⲣⲁⲭⲙⲁⲛⲏⲥ
ⲃⲣⲃⲣ	V	ⲃⲣⲃⲣ
ⲃⲣⲟⲛⲧⲏ	N	ⲃⲣⲟⲛⲧⲏ
ⲃⲣⲟⲩⲭⲟⲥ	N	ⲃⲣⲟⲩⲭⲟⲥ
ⲃⲣⲣⲉ	N	ⲃⲣⲣⲉ
ⲃⲩⲃⲓⲟⲛ	N	ⲃⲩⲃⲓⲟⲛ
ⲃⲩⲍⲁⲛⲧⲓⲟⲛ	NPROP	ⲃⲩⲍⲁⲛⲧⲓⲟⲛ
ⲃⲩⲣⲣⲩⲗⲗⲟⲥ	N	ⲃⲩⲣⲣⲩⲗⲗⲟⲥ
ⲃⲩⲥⲁⲛⲧⲓⲟⲛ	NPROP	ⲃⲩⲥⲁⲛⲧⲓⲟⲛ
ⲃⲱϣ	V	ⲃⲱϣ
ⲃⲱⲓⲑⲓⲁ	N	ⲃⲱⲓⲑⲓⲁ
ⲃⲱⲕ	V	ⲃⲱⲕ
ⲃⲱⲕ	VIMP	ⲃⲱⲕ
ⲃⲱⲗⲟⲥ	N	ⲃⲱⲗⲟⲥ
ⲃⲱⲗ	V	ⲃⲱⲗ
ⲃⲱⲙⲟⲥ	N	ⲃⲱⲙⲟⲥ
ⲃⲱⲛⲉⲗⲟⲟⲗⲉ	N	ⲃⲱⲛⲉⲗⲟⲟⲗⲉ
ⲃⲱⲛⲕⲛⲧⲉ	N	ⲃⲱⲛⲕⲛⲧⲉ
ⲃⲱⲱⲣⲉ	V	ⲃⲱⲱⲣⲉ
ⲃⲱ	N	ⲃⲱ
ⲃ	V	ⲃ
ⲅⲁⲃⲣⲓⲏⲗ	NPROP	ⲅⲁⲃⲣⲓⲏⲗ
ⲅⲁⲅⲅⲣⲁⲓⲛⲁ	N	ⲅⲁⲅⲅⲣⲁⲓⲛⲁ
ⲅⲁⲍⲁ	N	ⲅⲁⲍⲁ
ⲅⲁⲍⲟⲫⲩⲗⲁⲅⲓⲟⲛ	N	ⲅⲁⲍⲟⲫⲩⲗⲁⲅⲓⲟⲛ
ⲅⲁⲍⲟⲫⲩⲗⲁⲕⲓⲟⲛ	N	ⲅⲁⲍⲟⲫⲩⲗⲁⲕⲓⲟⲛ
ⲅⲁⲓⲟⲥ	NPROP	ⲅⲁⲓⲟⲥ
ⲅⲁⲗⲁⲕⲧⲓⲧⲏⲥ	N	ⲅⲁⲗⲁⲕⲧⲓⲧⲏⲥ
ⲅⲁⲗⲁⲧⲓⲁ	NPROP	ⲅⲁⲗⲁⲧⲓⲁ
ⲅⲁⲗⲉⲓⲗⲁⲓⲁ	NPROP	ⲅⲁⲗⲉⲓⲗⲁⲓⲁ
ⲅⲁⲗⲉⲓⲗⲁⲓⲟⲥ	N	ⲅⲁⲗⲉⲓⲗⲁⲓⲟⲥ
ⲅⲁⲗⲓⲗⲁⲓⲁ	NPROP	ⲅⲁⲗⲓⲗⲁⲓⲁ
ⲅⲁⲗⲓⲗⲁⲓⲟⲥ	N	ⲅⲁⲗⲓⲗⲁⲓⲟⲥ
ⲅⲁⲗⲗⲓⲕⲟⲥ	N	ⲅⲁⲗⲗⲓⲕⲟⲥ
ⲅⲁⲙⲟⲥ	N	ⲅⲁⲙⲟⲥ
ⲅⲁⲛⲟⲛ	N	ⲅⲁⲛⲟⲛ
ⲅⲁⲡⲁⲣⲓ	N	ⲅⲁⲡⲁⲣⲓ
ⲅⲁⲣ	CONJ	ⲅⲁⲣ
ⲅⲁⲣ	PTC	ⲅⲁⲣ
ⲅⲉϩⲉⲛⲛⲁ	N	ⲅⲉϩⲉⲛⲛⲁ
ⲅⲉⲇⲉⲱⲛ	NPROP	ⲅⲉⲇⲉⲱⲛ
ⲅⲉⲑⲑⲁⲓⲟⲥ	N	ⲅⲉⲑⲑⲁⲓⲟⲥ
ⲅⲉⲑⲥⲏⲙⲁⲛⲉⲓ	N	ⲅⲉⲑⲥⲏⲙⲁⲛⲉⲓ
ⲅⲉⲛⲉⲁ	N	ⲅⲉⲛⲉⲁ
ⲅⲉⲛⲉⲥⲓⲥ	N	ⲅⲉⲛⲉⲥⲓⲥ
ⲅⲉⲛⲏⲙⲁ	N	ⲅⲉⲛⲏⲙⲁ
ⲅⲉⲛⲏⲧⲟⲛ	N	ⲅⲉⲛⲏⲧⲟⲛ
ⲅⲉⲛⲓⲁ	N	ⲅⲉⲛⲓⲁ
ⲅⲉⲛⲓⲕⲟⲥ	N	ⲅⲉⲛⲓⲕⲟⲥ
ⲅⲉⲛⲛⲁⲓⲟⲥ	N	ⲅⲉⲛⲛⲁⲓⲟⲥ
ⲅⲉⲛⲛⲉⲁ	N	ⲅⲉⲛⲛⲉⲁ
ⲅⲉⲛⲛⲉⲟⲥ	N	ⲅⲉⲛⲛⲉⲟⲥ
ⲅⲉⲛⲛⲏⲥⲁⲣⲉⲧ	N	ⲅⲉⲛⲛⲏⲥⲁⲣⲉⲧ
ⲅⲉⲛⲛⲏⲧⲟⲥ	N	ⲅⲉⲛⲛⲏⲧⲟⲥ
ⲅⲉⲛⲟⲓⲧⲟ	V	ⲅⲉⲛⲟⲓⲧⲟ
ⲅⲉⲛⲟⲥ	N	ⲅⲉⲛⲟⲥ
ⲅⲉⲟⲙⲏⲉⲧⲣⲓⲁ	N	ⲅⲉⲟⲙⲏⲉⲧⲣⲓⲁ
ⲅⲉⲟⲙⲏⲧⲣⲓⲁ	N	ⲅⲉⲟⲙⲏⲧⲣⲓⲁ
ⲅⲉⲣⲁⲍⲏⲛⲟⲥ	N	ⲅⲉⲣⲁⲍⲏⲛⲟⲥ
ⲅⲉⲣⲁⲥⲏⲛⲟⲥ	N	ⲅⲉⲣⲁⲥⲏⲛⲟⲥ
ⲅⲉⲣⲅⲉⲥⲁⲓⲟⲥ	N	ⲅⲉⲣⲅⲉⲥⲁⲓⲟⲥ
ⲅⲉⲱⲙⲏⲧⲣⲓⲁ	N	ⲅⲉⲱⲙⲏⲧⲣⲓⲁ
ⲅⲉⲱⲙⲓⲧⲣⲏⲥ	N	ⲅⲉⲱⲙⲓⲧⲣⲏⲥ
ⲅⲉⲱⲣⲅⲓⲟⲥ	NPROP	ⲅⲉⲱⲣⲅⲓⲟⲥ
ⲅⲉⲱⲣⲅⲟⲥ	N	ⲅⲉⲱⲣⲅⲟⲥ
ⲅⲉ	PTC	ⲅⲉ
ⲅⲓⲅⲁⲥ	N	ⲅⲓⲅⲁⲥ
ⲅⲗⲩⲡⲧⲟⲛ	N	ⲅⲗⲩⲡⲧⲟⲛ
ⲅⲗⲱⲥⲥⲟⲕⲟⲙⲟⲛ	N	ⲅⲗⲱⲥⲥⲟⲕⲟⲙⲟⲛ
ⲅⲛⲏⲥⲓⲟⲥ	N	ⲅⲛⲏⲥⲓⲟⲥ
ⲅⲛⲟⲫⲟⲥ	N	ⲅⲛⲟⲫⲟⲥ
ⲅⲛⲱⲙⲏ	N	ⲅⲛⲱⲙⲏ
ⲅⲛⲱⲥⲉⲱⲥ	N	ⲅⲛⲱⲥⲉⲱⲥ
ⲅⲛⲱⲥⲓⲥ	N	ⲅⲛⲱⲥⲓⲥ
ⲅⲛⲱⲥⲧⲓⲕⲟⲥ	N	ⲅⲛⲱⲥⲧⲓⲕⲟⲥ
ⲅⲟⲗⲅⲟⲑⲁ	NPROP	ⲅⲟⲗⲅⲟⲑⲁ
ⲅⲟⲙⲟⲣⲣⲁ	NPROP	ⲅⲟⲙⲟⲣⲣⲁ
ⲅⲣⲁⲙⲙⲁϯⲕⲟⲥ	N	ⲅⲣⲁⲙⲙⲁϯⲕⲟⲥ
ⲅⲣⲁⲙⲙⲁⲧⲉⲩⲥ	N	ⲅⲣⲁⲙⲙⲁⲧⲉⲩⲥ
ⲅⲣⲁⲙⲙⲁⲧⲏⲫⲟⲣⲟⲥ	N	ⲅⲣⲁⲙⲙⲁⲧⲏⲫⲟⲣⲟⲥ
ⲅⲣⲁⲙⲙⲁⲧⲓⲕⲟⲥ	N	ⲅⲣⲁⲙⲙⲁⲧⲓⲕⲟⲥ
ⲅⲣⲁⲙⲙⲁ	N	ⲅⲣⲁⲙⲙⲁ
ⲅⲣⲁⲙⲡⲉ	N	ⲅⲣⲁⲙⲡⲉ
ⲅⲣⲁⲫⲉⲩⲥ	N	ⲅⲣⲁⲫⲉⲩⲥ
ⲅⲣⲁⲫⲏ	N	ⲅⲣⲁⲫⲏ
ⲅⲣⲁⲫⲟⲟⲩⲉ	N	ⲅⲣⲁⲫⲟⲟⲩⲉ
ⲅⲣⲏⲅⲟⲣⲓⲟⲥ	NPROP	ⲅⲣⲏⲅⲟⲣⲓⲟⲥ
ⲅⲣⲏⲅⲟⲣⲟⲥ	N	ⲅⲣⲏⲅⲟⲣⲟⲥ
ⲅⲣⲩⲡⲁⲍⲉ	V	ⲅⲣⲩⲡⲁⲍⲉ
ⲅⲩⲙⲛⲁⲍⲉ	V	ⲅⲩⲙⲛⲁⲍⲉ
ⲅⲩⲙⲛⲁⲥⲓⲁ	N	ⲅⲩⲙⲛⲁⲥⲓⲁ
ⲅ⳿	NUM	ⲅ⳿
ⲅ	PPERO	ⲅ
ⲅ	PPERS	ⲛⲧⲟⲕ
ⲇⲁⲑⲁⲛ	NPROP	ⲇⲁⲑⲁⲛ
ⲇⲁⲓⲙⲟⲛⲓⲍⲉ	V	ⲇⲁⲓⲙⲟⲛⲓⲍⲉ
ⲇⲁⲓⲙⲟⲛⲓⲟⲛ	N	ⲇⲁⲓⲙⲟⲛⲓⲟⲛ
ⲇⲁⲓⲙⲱⲛⲓⲟⲛ	N	ⲇⲁⲓⲙⲱⲛⲓⲟⲛ
ⲇⲁⲓⲙⲱⲛ	N	ⲇⲁⲓⲙⲱⲛ
ⲇⲁⲗⲙⲁⲛⲟⲩⲑⲁ	NPROP	ⲇⲁⲗⲙⲁⲛⲟⲩⲑⲁ
ⲇⲁⲙⲁⲥⲕⲟⲥ	NPROP	ⲇⲁⲙⲁⲥⲕⲟⲥ
ⲇⲁⲛⲓⲏⲗ	NPROP	ⲇⲁⲛⲓⲏⲗ
ⲇⲁⲛⲓⲥⲧⲏⲥ	N	ⲇⲁⲛⲓⲥⲧⲏⲥ
ⲇⲁⲡⲁⲛⲏ	N	ⲇⲁⲡⲁⲛⲏ
ⲇⲁⲩⲉⲓⲇ	NPROP	ⲇⲁⲩⲉⲓⲇ
ⲇⲁⲩⲓⲇ	NPROP	ⲇⲁⲩⲓⲇ
ⲇⲉⲃⲃⲱⲣⲁ	NPROP	ⲇⲉⲃⲃⲱⲣⲁ
ⲇⲉⲓⲡⲛⲉⲩⲉ	V	ⲇⲉⲓⲡⲛⲉⲩⲉ
ⲇⲉⲓⲡⲛⲟⲛ	N	ⲇⲉⲓⲡⲛⲟⲛ
ⲇⲉⲓⲡⲛⲟⲛ	V	ⲇⲉⲓⲡⲛⲟⲛ
ⲇⲉⲕⲁⲛⲟⲥ	N	ⲇⲉⲕⲁⲛⲟⲥ
ⲇⲉⲕⲁⲡⲟⲗⲓⲥ	N	ⲇⲉⲕⲁⲡⲟⲗⲓⲥ
ⲇⲉⲕⲁⲥ	N	ⲇⲉⲕⲁⲥ
ⲇⲉⲕⲓⲟⲥ	NPROP	ⲇⲉⲕⲓⲟⲥ
ⲇⲉⲥⲡⲟⲧⲉⲓⲁ	N	ⲇⲉⲥⲡⲟⲧⲉⲓⲁ
ⲇⲉⲥⲡⲟⲧⲏⲥ	N	ⲇⲉⲥⲡⲟⲧⲏⲥ
ⲇⲉⲥⲡⲱⲧⲁ	N	ⲇⲉⲥⲡⲱⲧⲁ
ⲇⲉⲩⲧⲉⲣⲁⲥ	FM	ⲇⲉⲩⲧⲉⲣⲁⲥ
ⲇⲉⲩⲧⲉⲣⲁ	N	ⲇⲉⲩⲧⲉⲣⲁ
ⲇⲉⲩⲧⲉⲣⲟⲛⲟⲙⲓⲟⲛ	N	ⲇⲉⲩⲧⲉⲣⲟⲛⲟⲙⲓⲟⲛ
ⲇⲉⲩⲧⲉⲣⲟⲛ	ADV	ⲇⲉⲩⲧⲉⲣⲟⲛ
ⲇⲉ	PTC	ⲇⲉ
ⲇⲏⲗⲟⲩ	V	ⲇⲏⲗⲟⲩ
ⲇⲏⲙⲁⲅⲱⲅⲟⲥ	N	ⲇⲏⲙⲁⲅⲱⲅⲟⲥ
ⲇⲏⲙⲁⲥ	NPROP	ⲇⲏⲙⲁⲥ
ⲇⲏⲙⲏⲅⲟⲣⲉⲓ	V	ⲇⲏⲙⲏⲅⲟⲣⲉⲓ
ⲇⲏⲙⲏⲧⲣⲓⲟⲥ	NPROP	ⲇⲏⲙⲏⲧⲣⲓⲟⲥ
ⲇⲏⲙⲓⲟⲥ	N	ⲇⲏⲙⲓⲟⲥ
ⲇⲏⲙⲓⲟⲩⲣⲅⲓⲁ	N	ⲇⲏⲙⲓⲟⲩⲣⲅⲓⲁ
ⲇⲏⲙⲓⲟⲩⲣⲅⲟⲥ	N	ⲇⲏⲙⲓⲟⲩⲣⲅⲟⲥ
ⲇⲏⲙⲟⲥⲓⲁ	N	ⲇⲏⲙⲟⲥⲓⲁ
ⲇⲏⲙⲟⲥⲓⲟⲛ	N	ⲇⲏⲙⲟⲥⲓⲟⲛ
ⲇⲏⲙⲟⲥ	N	ⲇⲏⲙⲟⲥ
ⲇⲏⲙⲟⲧⲓⲥⲧⲏⲥ	N	ⲇⲏⲙⲟⲧⲓⲥⲧⲏⲥ
ⲇⲏⲛⲁⲣⲓⲟⲛ	N	ⲇⲏⲛⲁⲣⲓⲟⲛ
ⲇⲏ	PTC	ⲇⲏ
ⲇⲓⲁⲃⲁⲗⲗⲉ	V	ⲇⲓⲁⲃⲁⲗⲗⲉ
ⲇⲓⲁⲃⲟⲗⲏ	N	ⲇⲓⲁⲃⲟⲗⲏ
ⲇⲓⲁⲃⲟⲗⲓⲕⲟⲛ	N	ⲇⲓⲁⲃⲟⲗⲓⲕⲟⲛ
ⲇⲓⲁⲃⲟⲗⲟⲥ	N	ⲇⲓⲁⲃⲟⲗⲟⲥ
ⲇⲓⲁⲃⲟⲗⲟⲥ	NPROP	ⲇⲓⲁⲃⲟⲗⲟⲥ
ⲇⲓⲁⲅⲣⲁⲫⲟⲛ	N	ⲇⲓⲁⲅⲣⲁⲫⲟⲛ
ⲇⲓⲁⲅⲱⲅⲏ	N	ⲇⲓⲁⲅⲱⲅⲏ
ⲇⲓⲁⲇⲉⲭⲉ	V	ⲇⲓⲁⲇⲉⲭⲉ
ⲇⲓⲁⲇⲟⲭⲟⲥ	N	ⲇⲓⲁⲇⲟⲭⲟⲥ
ⲇⲓⲁⲑⲉⲥⲓⲥ	N	ⲇⲓⲁⲑⲉⲥⲓⲥ
ⲇⲓⲁⲑⲏⲕⲏ	N	ⲇⲓⲁⲑⲏⲕⲏ
ⲇⲓⲁⲑⲩⲕⲏ	N	ⲇⲓⲁⲑⲩⲕⲏ
ⲇⲓⲁⲓⲣⲉⲥⲓⲥ	N	ⲇⲓⲁⲓⲣⲉⲥⲓⲥ
ⲇⲓⲁⲕⲟⲛⲉⲓ	V	ⲇⲓⲁⲕⲟⲛⲉⲓ
ⲇⲓⲁⲕⲟⲛⲓⲁ	N	ⲇⲓⲁⲕⲟⲛⲓⲁ
ⲇⲓⲁⲕⲟⲛⲓ	V	ⲇⲓⲁⲕⲟⲛⲉⲓ
ⲇⲓⲁⲕⲟⲛⲟⲥ	N	ⲇⲓⲁⲕⲟⲛⲟⲥ
ⲇⲓⲁⲕⲣⲏⲥⲓⲥ	N	ⲇⲓⲁⲕⲣⲏⲥⲓⲥ
ⲇⲓⲁⲕⲣⲓⲛⲉ	V	ⲇⲓⲁⲕⲣⲓⲛⲉ
ⲇⲓⲁⲕⲣⲓⲥⲓⲥ	N	ⲇⲓⲁⲕⲣⲓⲥⲓⲥ
ⲇⲓⲁⲕⲣⲓⲧⲓⲕⲟⲥ	N	ⲇⲓⲁⲕⲣⲓⲧⲓⲕⲟⲥ
ⲇⲓⲁⲕⲱⲛ	N	ⲇⲓⲁⲕⲱⲛ
ⲇⲓⲁⲗⲉⲅⲉ	V	ⲇⲓⲁⲗⲉⲅⲉ
ⲇⲓⲁⲗⲟⲅⲟⲥ	N	ⲇⲓⲁⲗⲟⲅⲟⲥ
ⲇⲓⲁⲙⲟⲛⲏ	N	ⲇⲓⲁⲙⲟⲛⲏ
ⲇⲓⲁⲛⲟⲓⲁ	N	ⲇⲓⲁⲛⲟⲓⲁ
ⲇⲓⲁⲛⲟⲓⲥⲓⲥ	N	ⲇⲓⲁⲛⲟⲓⲥⲓⲥ
ⲇⲓⲁⲡⲉⲣⲁ	V	ⲇⲓⲁⲡⲉⲣⲁ
ⲇⲓⲁⲥⲡⲟⲣⲁ	N	ⲇⲓⲁⲥⲡⲟⲣⲁ
ⲇⲓⲁⲥⲧⲁⲗⲙⲟⲥ	N	ⲇⲓⲁⲥⲧⲁⲗⲙⲟⲥ
ⲇⲓⲁⲥⲧⲏⲙⲁ	N	ⲇⲓⲁⲥⲧⲏⲙⲁ
ⲇⲓⲁⲥⲧⲣⲟⲫⲏ	N	ⲇⲓⲁⲥⲧⲣⲟⲫⲏ
ⲇⲓⲁⲥⲱⲥⲟⲩ	V	ⲇⲓⲁⲥⲱⲥⲟⲩ
ⲇⲓⲁⲧⲁⲅⲏ	N	ⲇⲓⲁⲧⲁⲅⲏ
ⲇⲓⲁⲧⲁⲅⲙⲁ	N	ⲇⲓⲁⲧⲁⲅⲙⲁ
ⲇⲓⲁⲧⲁⲥⲥⲉ	V	ⲇⲓⲁⲧⲁⲥⲥⲉ
ⲇⲓⲁⲧⲉⲗⲉⲓ	V	ⲇⲓⲁⲧⲉⲗⲉⲓ
ⲇⲓⲁⲧⲟⲩⲧⲟ	CONJ	ⲇⲓⲁⲧⲟⲩⲧⲟ
ⲇⲓⲁⲧⲟⲭⲟⲥ	N	ⲇⲓⲁⲧⲟⲭⲟⲥ
ⲇⲓⲁⲧⲣⲓⲃⲉ	V	ⲇⲓⲁⲧⲣⲓⲃⲉ
ⲇⲓⲁⲫⲟⲣⲁ	N	ⲇⲓⲁⲫⲟⲣⲁ
ⲇⲓⲁⲯⲁⲗⲙⲁ	N	ⲇⲓⲁⲯⲁⲗⲙⲁ
ⲇⲓⲇⲁⲥⲕⲁⲗⲓⲁ	N	ⲇⲓⲇⲁⲥⲕⲁⲗⲓⲁ
ⲇⲓⲇⲁⲥⲕⲉⲓ	V	ⲇⲓⲇⲁⲥⲕⲉⲓ
ⲇⲓⲇⲁⲥⲕⲉ	V	ⲇⲓⲇⲁⲥⲕⲉ
ⲇⲓⲇⲓⲡⲗⲁ	N	ⲇⲓⲇⲓⲡⲗⲁ
ⲇⲓⲇⲣⲁⲭⲙⲟⲛ	N	ⲇⲓⲇⲣⲁⲭⲙⲟⲛ
ⲇⲓⲏⲅⲏⲙⲁ	N	ⲇⲓⲏⲅⲏⲙⲁ
ⲇⲓⲏⲅⲏⲥⲓⲥ	N	ⲇⲓⲏⲅⲏⲥⲓⲥ
ⲇⲓⲏⲕⲏⲥⲓⲥ	N	ⲇⲓⲏⲕⲏⲥⲓⲥ
ⲇⲓⲕⲁⲍⲉ	V	ⲇⲓⲕⲁⲍⲉ
ⲇⲓⲕⲁⲓⲟⲗⲟⲅⲓⲁ	N	ⲇⲓⲕⲁⲓⲟⲗⲟⲅⲓⲁ
ⲇⲓⲕⲁⲓⲟⲛ	N	ⲇⲓⲕⲁⲓⲟⲛ
ⲇⲓⲕⲁⲓⲟⲥⲩⲛⲏ	N	ⲇⲓⲕⲁⲓⲟⲥⲩⲛⲏ
ⲇⲓⲕⲁⲓⲟⲥ	N	ⲇⲓⲕⲁⲓⲟⲥ
ⲇⲓⲕⲁⲓⲱⲙⲁ	N	ⲇⲓⲕⲁⲓⲱⲙⲁ
ⲇⲓⲕⲁⲓⲱⲥ	ADV	ⲇⲓⲕⲁⲓⲱⲥ
ⲇⲓⲕⲁⲥⲧⲏⲣⲓⲟⲛ	N	ⲇⲓⲕⲁⲥⲧⲏⲣⲓⲟⲛ
ⲇⲓⲕⲁⲥⲧⲏⲥ	N	ⲇⲓⲕⲁⲥⲧⲏⲥ
ⲇⲓⲕⲏ	N	ⲇⲓⲕⲏ
ⲇⲓⲙⲏⲧⲣⲓⲟⲥ	NPROP	ⲇⲓⲙⲏⲧⲣⲓⲟⲥ
ⲇⲓⲙⲓⲟⲩⲣⲅⲓⲁ	N	ⲇⲓⲙⲓⲟⲩⲣⲅⲓⲁ
ⲇⲓⲙⲟⲑⲉⲟⲥ	NPROP	ⲇⲓⲙⲟⲑⲉⲟⲥ
ⲇⲓⲙⲟⲧⲓⲥⲧⲏⲥ	N	ⲇⲓⲙⲟⲧⲓⲥⲧⲏⲥ
ⲇⲓⲙⲱⲣⲓⲧⲏⲥ	N	ⲇⲓⲙⲱⲣⲓⲧⲏⲥ
ⲇⲓⲛⲁ	N	ⲇⲓⲛⲁ
ⲇⲓⲟⲅⲙⲟⲥ	N	ⲇⲓⲟⲅⲙⲟⲥ
ⲇⲓⲟⲓⲕⲉⲓ	V	ⲇⲓⲟⲓⲕⲉⲓ
ⲇⲓⲟⲓⲕⲏⲥⲓⲥ	N	ⲇⲓⲟⲓⲕⲏⲥⲓⲥ
ⲇⲓⲟⲓⲕⲏⲧⲏⲥ	N	ⲇⲓⲟⲓⲕⲏⲧⲏⲥ
ⲇⲓⲟⲓⲕⲏ	V	ⲇⲓⲟⲓⲕⲏ
ⲇⲓⲟⲕⲗⲏⲧⲓⲁⲛⲟⲥ	NPROP	ⲇⲓⲟⲕⲗⲏⲧⲓⲁⲛⲟⲥ
ⲇⲓⲟⲕⲗⲏϯⲁⲛⲟⲥ	NPROP	ⲇⲓⲟⲕⲗⲏϯⲁⲛⲟⲥ
ⲇⲓⲟⲛⲏⲥⲓⲟⲥ	NPROP	ⲇⲓⲟⲛⲏⲥⲓⲟⲥ
ⲇⲓⲟⲛⲩⲥⲓⲟⲥ	NPROP	ⲇⲓⲟⲛⲩⲥⲓⲟⲥ
ⲇⲓⲟⲣⲑⲟⲩ	V	ⲇⲓⲟⲣⲑⲟⲩ
ⲇⲓⲟⲥⲕⲟⲣⲟⲥ	NPROP	ⲇⲓⲟⲥⲕⲟⲣⲟⲥ
ⲇⲓⲟⲥⲙⲏ	N	ⲇⲓⲟⲥⲙⲏ
ⲇⲓⲡⲗⲁ	N	ⲇⲓⲡⲗⲁ
ⲇⲓⲡⲗⲟⲩⲛ	N	ⲇⲓⲡⲗⲟⲩⲛ
ⲇⲓⲡⲛⲉⲩⲉ	V	ⲇⲓⲡⲛⲉⲩⲉ
ⲇⲓⲡⲛⲟⲛ	N	ⲇⲓⲡⲛⲟⲛ
ⲇⲓⲥⲧⲁⲍⲉ	V	ⲇⲓⲥⲧⲁⲍⲉ
ⲇⲓⲥⲧⲓⲭⲟⲛ	N	ⲇⲓⲥⲧⲓⲭⲟⲛ
ⲇⲓⲧⲁⲥⲅⲁⲗⲟⲥ	N	ⲇⲓⲧⲁⲥⲅⲁⲗⲟⲥ
ⲇⲓⲱⲅⲙⲟⲥ	N	ⲇⲓⲱⲅⲙⲟⲥ
ⲇⲓⲱⲕⲉⲓ	V	ⲇⲓⲱⲕⲉⲓ
ⲇⲓⲱⲕⲉ	V	ⲇⲓⲱⲕⲉ
ⲇⲓⲱⲕⲧⲏⲥ	N	ⲇⲓⲱⲕⲧⲏⲥ
ⲇⲟϭⲓⲙⲁⲥⲧⲏⲥ	N	ⲇⲟϭⲓⲙⲁⲥⲧⲏⲥ
ⲇⲟϭⲓ	V	ⲇⲟϭⲓ
ⲇⲟⲅⲙⲁⲧⲓⲍⲉ	V	ⲇⲟⲅⲙⲁⲧⲓⲍⲉ
ⲇⲟⲅⲙⲁ	N	ⲇⲟⲅⲙⲁ
ⲇⲟⲇⲏⲥ	N	ⲇⲟⲇⲏⲥ
ⲇⲟⲕⲉⲓ	V	ⲇⲟⲕⲉⲓ
ⲇⲟⲕⲓⲙⲁⲍⲉ	V	ⲇⲟⲕⲓⲙⲁⲍⲉ
ⲇⲟⲕⲓⲙⲁⲥⲧⲏⲥ	N	ⲇⲟⲕⲓⲙⲁⲥⲧⲏⲥ
ⲇⲟⲕⲓⲙⲏ	N	ⲇⲟⲕⲓⲙⲏ
ⲇⲟⲕⲓⲙⲟⲛ	N	ⲇⲟⲕⲓⲙⲟⲛ
ⲇⲟⲕⲓⲙⲟⲥ	N	ⲇⲟⲕⲓⲙⲟⲥ
ⲇⲟⲗⲟⲥ	N	ⲇⲟⲗⲟⲥ
ⲇⲟⲙⲛⲟⲥ	NPROP	ⲇⲟⲙⲛⲟⲥ
ⲇⲟⲝⲟⲅⲉⲛⲏⲥ	N	ⲇⲟⲝⲟⲅⲉⲛⲏⲥ
ⲇⲟⲝⲟⲅⲉⲛⲓⲁ	N	ⲇⲟⲝⲟⲅⲉⲛⲓⲁ
ⲇⲟⲝⲟⲕⲣⲁⲧⲓⲁ	N	ⲇⲟⲝⲟⲕⲣⲁⲧⲓⲁ
ⲇⲟⲝⲟⲕⲣⲁⲧⲱⲣ	N	ⲇⲟⲝⲟⲕⲣⲁⲧⲱⲣ
ⲇⲟⲝⲟⲗⲟⲅⲓⲁ	N	ⲇⲟⲝⲟⲗⲟⲅⲓⲁ
ⲇⲟⲝⲟⲛ	N	ⲇⲟⲝⲟⲛ
ⲇⲟⲝⲟⲫⲁⲛⲏⲥ	N	ⲇⲟⲝⲟⲫⲁⲛⲏⲥ
ⲇⲟⲝⲟⲫⲁⲛⲓⲁ	N	ⲇⲟⲝⲟⲫⲁⲛⲓⲁ
ⲇⲟⲣⲕⲁⲥ	N	ⲇⲟⲣⲕⲁⲥ
ⲇⲟⲩⲗⲟⲥ	NPROP	ⲇⲟⲩⲗⲟⲥ
ⲇⲟⲩⲝ	N	ⲇⲟⲩⲝ
ⲇⲣⲁⲕⲱⲛ	N	ⲇⲣⲁⲕⲱⲛ
ⲇⲣⲓⲙⲙⲁ	N	ⲇⲣⲓⲙⲙⲁ
ⲇⲣⲟⲙⲉⲩⲥ	N	ⲇⲣⲟⲙⲉⲩⲥ
ⲇⲣⲟⲙⲟⲥ	N	ⲇⲣⲟⲙⲟⲥ
ⲇⲣⲩⲙⲟⲥ	N	ⲇⲣⲩⲙⲟⲥ
ⲇⲩⲁⲥ	N	ⲇⲩⲁⲥ
ⲇⲩⲙⲓⲟⲩⲣⲅⲟⲥ	N	ⲇⲩⲙⲓⲟⲩⲣⲅⲟⲥ
ⲇⲩⲙⲟⲥ	N	ⲇⲩⲙⲟⲥ
ⲇⲩⲙⲟⲧⲏⲥ	N	ⲇⲩⲙⲟⲧⲏⲥ
ⲇⲩⲛⲁⲙⲓⲥ	N	ⲇⲩⲛⲁⲙⲓⲥ
ⲇⲩⲛⲁⲥⲧⲏⲥ	N	ⲇⲩⲛⲁⲥⲧⲏⲥ
ⲇⲩⲛⲁⲧⲟⲥ	N	ⲇⲩⲛⲁⲧⲟⲥ
ⲇⲩⲣⲁⲛⲛⲉⲩⲉ	V	ⲇⲩⲣⲁⲛⲛⲉⲩⲉ
ⲇⲩⲣⲁⲛⲛⲟⲥ	N	ⲇⲩⲣⲁⲛⲛⲟⲥ
ⲇⲩⲣⲁⲛⲟⲥ	NPROP	ⲇⲩⲣⲁⲛⲟⲥ
ⲇⲩⲥⲕⲟⲗⲟⲛ	N	ⲇⲩⲥⲕⲟⲗⲟⲛ
ⲇⲱⲇⲉⲕⲁⲥ	N	ⲇⲱⲇⲉⲕⲁⲥ
ⲇⲱⲣⲉⲁⲥϯⲕⲟⲛ	N	ⲇⲱⲣⲉⲁⲥϯⲕⲟⲛ
ⲇⲱⲣⲉⲁ	N	ⲇⲱⲣⲉⲁ
ⲇⲱⲣⲓⲁ	N	ⲇⲱⲣⲓⲁ
ⲇⲱⲣⲓⲍⲉ	V	ⲇⲱⲣⲓⲍⲉ
ⲇⲱⲣⲟⲑⲉⲟⲥ	NPROP	ⲇⲱⲣⲟⲑⲉⲟⲥ
ⲇⲱⲣⲟⲛ	N	ⲇⲱⲣⲟⲛ
ⲉϣϣⲉ	V	ϣϣⲉ
ⲉϣϩⲱⲡ	N	ⲉϣϩⲱⲡ
ⲉϣϫⲉ	CONJ	ⲉϣϫⲉ
ⲉϣⲁⲩ	N	ⲉϣⲁⲩ
ⲉϣⲉⲅⲕⲣⲁⲧⲉⲩⲉ	V	ⲉϣⲉⲅⲕⲣⲁⲧⲉⲩⲉ
ⲉϣⲗⲟⲩⲗⲁⲓ	V	ⲉϣⲗⲟⲩⲗⲁⲓ
ⲉϣⲧ	V	ⲉⲓϣⲉ
ⲉϣⲱⲡⲉ	CONJ	ⲉϣⲱⲡⲉ
ⲉϣⲱ	N	ⲉϣⲱ
ⲉϣ	V	ϣ
ⲉϥϣⲁⲛ	ACOND_PPERS	ⲉⲣϣⲁⲛ_ⲛⲧⲟϥ
ⲉϥⲉ	AOPT	ⲉϥⲉ
ⲉϥⲉ	AOPT_PPERS	ⲉⲣⲉ_ⲛⲧⲟϥ
ⲉϥⲓ	N	ⲉϥⲓ
ⲉϥⲧ	V	ⲱϥⲉ
ⲉϥ	N	ⲉϥ
ⲉϥ	PPERO	ⲉϥ
ⲉϩⲉ	ADV	ⲉϩⲉ
ⲉϩⲉ	N	ⲉϩⲉ
ⲉϩⲏⲧ	PREP	ⲉϩⲏⲧ
ⲉϩⲛⲁ	VBD	ϩⲛⲁ
ⲉϩⲛⲉ	VBD	ϩⲛⲉ
ⲉϩⲟⲟⲩ	N	ⲉϩⲟⲟⲩ
ⲉϩⲟⲩⲉ	ADV	ⲉϩⲟⲩⲉ
ⲉϩⲟⲩⲉ	CONJ	ⲉϩⲟⲩⲉ
ⲉϩⲟⲩⲉ	PREP	ⲉϩⲟⲩⲉ
ⲉϩⲟⲩⲛ	ADV	ⲉϩⲟⲩⲛ
ⲉϩⲟⲩ	ADV	ⲉϩⲟⲩ
ⲉϩⲣⲁⲓⲉϫⲙ	PREP	ⲉϩⲣⲁⲓⲉϫⲛ
ⲉϩⲣⲁⲓⲉϫⲛ	PREP	ⲉϩⲣⲁⲓⲉϫⲛ
ⲉϩⲣⲁⲓⲉϫⲱ	PREP	ⲉϩⲣⲁⲓⲉϫⲱ
ⲉϩⲣⲁⲓⲉ	PREP	ⲉϩⲣⲁⲓⲉ
ⲉϩⲣⲁⲓ	ADV	ⲉϩⲣⲁⲓ
ⲉϩⲣⲁⲓ	N	ⲉϩⲣⲁⲓ
ⲉϩⲣⲁ	PREP	ϩⲟ
ⲉϩⲧⲱⲱⲣ	N	ϩⲧⲟ
ⲉϫⲏⲩ	N	ϫⲟⲉⲓ
ⲉϫⲙ	PREP	ⲉϫⲛ
ⲉϫⲛϩⲉ	PREP	ⲉϫⲛϩⲉ
ⲉϫⲛⲧⲉ	PREP	ⲁϫⲛ
ⲉϫⲛ	PREP	ⲉϫⲛ
ⲉϫⲱ	PREP	ⲉϫⲛ
ⲉϫⲱ	PREP_PPERO	ⲉϫⲛ_ⲛⲧⲟ
ⲉϭⲟⲟϣ	NPROP	ⲉϭⲟⲟϣ
ⲉϭⲱϣ	N	ⲉϭⲱϣ
ⲉϭⲱⲱϣ	N	ⲉϭⲱⲱϣ
ⲉⲃⲇⲟⲙⲏ	N	ⲉⲃⲇⲟⲙⲏ
ⲉⲃⲓⲁⲧⲉ	N	ⲉⲃⲓⲁⲧⲉ
ⲉⲃⲓⲏⲛ	N	ⲉⲃⲓⲏⲛ
ⲉⲃⲓⲟⲟⲩⲉ	N	ⲉⲃⲓⲟⲟⲩⲉ
ⲉⲃⲓⲱ	N	ⲉⲃⲓⲱ
ⲉⲃⲟⲗ	ADV	ⲉⲃⲟⲗ
ⲉⲃⲟⲗ ⲟⲩ	N	ⲉⲃⲟⲗ ⲟⲩ
ⲉⲃⲟⲧ	N	ⲉⲃⲟⲧ
ⲉⲃⲣⲁ	N	ⲉⲃⲣⲁ
ⲉⲃⲣⲏϭⲉ	N	ⲉⲃⲣⲏϭⲉ
ⲉⲅⲅⲕⲗⲩⲙⲁⲥ	N	ⲉⲅⲅⲕⲗⲩⲙⲁⲥ
ⲉⲅⲅⲟⲙⲓⲁⲍⲉ	V	ⲉⲅⲅⲟⲙⲓⲁⲍⲉ
ⲉⲅⲅⲣⲁⲫⲟⲛ	N	ⲉⲅⲅⲣⲁⲫⲟⲛ
ⲉⲅⲅⲣⲁⲫⲱⲥ	ADV	ⲉⲅⲅⲣⲁⲫⲱⲥ
ⲉⲅⲅⲩⲁ	N	ⲉⲅⲅⲩⲁ
ⲉⲅⲅⲩⲏ	N	ⲉⲅⲅⲩⲏ
ⲉⲅⲅⲩⲏ	V	ⲉⲅⲅⲩⲏ
ⲉⲅⲅⲱⲙⲓⲁⲍⲉ	V	ⲉⲅⲅⲱⲙⲓⲁⲍⲉ
ⲉⲅⲉⲧⲉ	PTC	ⲉⲅⲉⲧⲉ
ⲉⲅⲕⲁⲕⲉⲓ	V	ⲉⲅⲕⲁⲕⲉⲓ
ⲉⲅⲕⲁⲕⲓ	V	ⲉⲅⲕⲁⲕⲓ
ⲉⲅⲕⲁⲗⲉⲓ	V	ⲉⲅⲕⲁⲗⲉⲓ
ⲉⲅⲕⲉⲫⲁⲗⲟⲥ	N	ⲉⲅⲕⲉⲫⲁⲗⲟⲥ
ⲉⲅⲕⲗⲏⲥⲧⲱⲥ	N	ⲉⲅⲕⲗⲏⲥⲧⲱⲥ
ⲉⲅⲕⲟⲙⲓⲁⲍⲉ	V	ⲉⲅⲕⲟⲙⲓⲁⲍⲉ
ⲉⲅⲕⲣⲁⲧⲉⲓⲁ	N	ⲉⲅⲕⲣⲁⲧⲉⲓⲁ
ⲉⲅⲕⲣⲁⲧⲉⲩⲉ	V	ⲉⲅⲕⲣⲁⲧⲉⲩⲉ
ⲉⲅⲕⲣⲁⲧⲏⲥ	N	ⲉⲅⲕⲣⲁⲧⲏⲥ
ⲉⲅⲕⲣⲩⲫⲓⲟⲛ	N	ⲉⲅⲕⲣⲩⲫⲓⲟⲛ
ⲉⲅⲕⲱⲙⲓⲁⲍⲉ	V	ⲉⲅⲕⲱⲙⲓⲁⲍⲉ
ⲉⲅⲕⲱⲙⲓⲟⲛ	N	ⲉⲅⲕⲱⲙⲓⲟⲛ
ⲉⲇⲉⲙ	N	ⲉⲇⲉⲙ
ⲉⲉⲧ	VSTAT	ⲉⲉⲧ
ⲉⲍⲉⲅⲓⲏⲗ	NPROP	ⲉⲍⲉⲅⲓⲏⲗ
ⲉⲍⲉⲕⲉⲓⲁⲥ	NPROP	ⲉⲍⲉⲕⲉⲓⲁⲥ
ⲉⲍⲉⲕⲓⲁⲥ	NPROP	ⲉⲍⲉⲕⲓⲁⲥ
ⲉⲍⲉⲕⲓⲏⲗ	NPROP	ⲉⲍⲉⲕⲓⲏⲗ
ⲉⲑⲏⲣ	N	ⲉⲑⲏⲣ
ⲉⲑⲏ	ADV	ⲉⲑⲏ
ⲉⲑⲟⲥ	N	ⲉⲑⲟⲥ
ⲉⲓϣⲁⲛ	ACOND_PPERS	ⲉⲣϣⲁⲛ_ⲁⲛⲟⲕ
ⲉⲓϣⲉ	V	ⲉⲓϣⲉ
ⲉⲓϥⲧ	N	ⲉⲓϥⲧ
ⲉⲓⲁⲃⲉ	N	ⲉⲓⲁⲃⲉ
ⲉⲓⲁⲗ	N	ⲉⲓⲁⲗ
ⲉⲓⲁⲧⲟⲟⲧ	V	ⲉⲓⲁⲧⲟⲟⲧ
ⲉⲓⲁⲧ	N	ⲉⲓⲁⲧ
ⲉⲓⲁⲧ	V	ⲉⲓⲁ
ⲉⲓⲁ	N	ⲉⲓⲁ
ⲉⲓⲁ	V	ⲉⲓⲁ
ⲉⲓⲃⲉ	N	ⲉⲓⲃⲉ
ⲉⲓⲃⲉ	V	ⲉⲓⲃⲉ
ⲉⲓⲇⲉⲁ	N	ⲉⲓⲇⲉⲁ
ⲉⲓⲇⲟⲥ	N	ⲉⲓⲇⲟⲥ
ⲉⲓⲇⲱⲗⲟⲛ	N	ⲉⲓⲇⲱⲗⲟⲛ
ⲉⲓⲉϩⲣⲁⲓ	V	ⲉⲓⲉϩⲣⲁⲓ
ⲉⲓⲉⲃⲧ	N	ⲉⲓⲉⲃⲧ
ⲉⲓⲉⲓⲃ	N	ⲉⲓⲉⲓⲃ
ⲉⲓⲉⲡⲛⲟⲩⲃ	N	ⲉⲓⲉⲡⲛⲟⲩⲃ
ⲉⲓⲉⲡⲥⲁ	N	ⲉⲓⲉⲡⲥⲁ
ⲉⲓⲉⲣϩ	V	ⲉⲓⲉⲣϩ
ⲉⲓⲉⲣⲉⲛⲛⲁⲓⲟⲥ	NPROP	ⲉⲓⲉⲣⲉⲛⲛⲁⲓⲟⲥ
ⲉⲓⲉⲣⲟ	N	ⲉⲓⲉⲣⲟ
ⲉⲓⲉ	ADV	ⲉⲓⲉ
ⲉⲓⲉ	AOPT_PPERS	ⲉⲣⲉ_ⲁⲛⲟⲕ
ⲉⲓⲉ	CONJ	ⲉⲓⲉ
ⲉⲓⲉ	PTC	ⲉⲓⲉ
ⲉⲓⲕⲏ	ADV	ⲉⲓⲕⲏ
ⲉⲓⲙⲁ	N	ⲉⲓⲙⲁ
ⲉⲓⲙⲉ	V	ⲉⲓⲙⲉ
ⲉⲓⲙⲏⲧⲉⲓ	CONJ	ⲉⲓⲙⲏⲧⲉⲓ
ⲉⲓⲙⲏⲧⲓ	CONJ	ⲉⲓⲙⲏⲧⲓ
ⲉⲓⲛⲉ	N	ⲉⲓⲛⲉ
ⲉⲓⲛⲉ	V	ⲉⲓⲛⲉ
ⲉⲓⲟⲙ	N	ⲉⲓⲟⲙ
ⲉⲓⲟⲟⲣ	N	ⲉⲓⲟⲟⲣ
ⲉⲓⲟⲟⲧⲉ	N	ⲉⲓⲟⲟⲧⲉ
ⲉⲓⲟⲟⲩⲉ	N	ⲉⲓⲟⲟⲩⲉ
ⲉⲓⲟⲡⲉ	N	ⲉⲓⲟⲡⲉ
ⲉⲓⲟⲣϩ	V	ⲉⲓⲟⲣϩ
ⲉⲓⲟⲧⲉ	N	ⲉⲓⲱⲧ
ⲉⲓⲟⲩⲗ	N	ⲉⲓⲟⲩⲗ
ⲉⲓⲣⲁⲥⲙⲟⲥ	N	ⲉⲓⲣⲁⲥⲙⲟⲥ
ⲉⲓⲣⲉ	V	ⲉⲓⲣⲉ
ⲉⲓⲣⲏⲛⲏⲕⲟⲛ	N	ⲉⲓⲣⲏⲛⲏⲕⲟⲛ
ⲉⲓⲣⲏⲛⲏ	N	ⲉⲓⲣⲏⲛⲏ
ⲉⲓⲣⲏⲛⲓⲕⲏ	N	ⲉⲓⲣⲏⲛⲓⲕⲏ
ⲉⲓⲣⲏⲛⲓⲕⲟⲛ	N	ⲉⲓⲣⲏⲛⲓⲕⲟⲛ
ⲉⲓⲣⲏⲛⲓⲕⲟⲥ	N	ⲉⲓⲣⲏⲛⲓⲕⲟⲥ
ⲉⲓⲣⲣⲱⲟⲩ	N	ⲣⲣⲟ
ⲉⲓⲥϩⲏⲏⲧⲉ	PTC	ⲉⲓⲥϩⲏⲏⲧⲉ
ⲉⲓⲥⲧⲟⲛⲥⲧⲁⲩⲣⲟⲛ	NPROP	ⲉⲓⲥⲧⲟⲛⲥⲧⲁⲩⲣⲟⲛ
ⲉⲓⲥ	PREP	ⲉⲓⲥ
ⲉⲓⲥ	PTC	ⲉⲓⲥ
ⲉⲓⲧⲁ	CONJ	ⲉⲓⲧⲁ
ⲉⲓⲧⲉ	CONJ	ⲉⲓⲧⲉ
ⲉⲓⲧⲛ	N	ⲉⲓⲧⲛ
ⲉⲓⲱϩⲉ	N	ⲉⲓⲱϩⲉ
ⲉⲓⲱⲣϩ	V	ⲉⲓⲱⲣϩ
ⲉⲓⲱⲣⲉ	N	ⲉⲓⲟⲟⲣ
ⲉⲓⲱⲣⲙ	V	ⲉⲓⲱⲣⲙ
ⲉⲓⲱⲧⲉ	N	ⲉⲓⲱⲧⲉ
ⲉⲓⲱⲧ	N	ⲉⲓⲱⲧ
ⲉⲓⲱ	N	ⲉⲓⲱ
ⲉⲓ	CONJ	ⲉⲓ
ⲉⲓ	PPERO	ⲁⲛⲟⲕ
ⲉⲓ	PPERS	ⲁⲛⲟⲕ
ⲉⲓ	V	ⲉⲓ
ⲉⲕϣⲁⲛ	ACOND_PPERS	ⲉⲣϣⲁⲛ_ⲛⲧⲟⲕ
ⲉⲕⲇⲓⲕⲏⲥⲓⲥ	N	ⲉⲕⲇⲓⲕⲏⲥⲓⲥ
ⲉⲕⲉ	AOPT_PPERS	ⲉⲕⲉ
ⲉⲕⲉ	N	ⲉⲕⲉ
ⲉⲕⲓⲃⲉ	N	ⲉⲕⲓⲃⲉ
ⲉⲕⲕⲗⲏⲥⲓⲁⲥⲧⲏⲥ	N	ⲉⲕⲕⲗⲏⲥⲓⲁⲥⲧⲏⲥ
ⲉⲕⲕⲗⲏⲥⲓⲁⲥⲧⲓⲕⲟⲛ	N	ⲉⲕⲕⲗⲏⲥⲓⲁⲥⲧⲓⲕⲟⲛ
ⲉⲕⲕⲗⲏⲥⲓⲁ	N	ⲉⲕⲕⲗⲏⲥⲓⲁ
ⲉⲕⲕⲗⲩⲥⲓⲁ	N	ⲉⲕⲕⲗⲩⲥⲓⲁ
ⲉⲕⲗⲉⲕⲧⲏ	N	ⲉⲕⲗⲉⲕⲧⲏ
ⲉⲕⲗⲉⲕⲧⲟⲥ	N	ⲉⲕⲗⲉⲕⲧⲟⲥ
ⲉⲕⲗⲟⲅⲏ	N	ⲉⲕⲗⲟⲅⲏ
ⲉⲕⲗⲟⲅⲓⲥⲧⲓⲁ	N	ⲉⲕⲗⲟⲅⲓⲥⲧⲓⲁ
ⲉⲕⲡⲗⲏⲝⲓⲥ	N	ⲉⲕⲡⲗⲏⲝⲓⲥ
ⲉⲕⲥⲁⲕⲧⲱⲣ	N	ⲉⲕⲥⲁⲕⲧⲱⲣ
ⲉⲕⲥⲧⲁⲥⲓⲥ	N	ⲉⲕⲥⲧⲁⲥⲓⲥ
ⲉⲕⲧⲏ	N	ⲉⲕⲧⲏ
ⲉⲕ	FM	ⲉⲕ
ⲉⲕ	PPERO	ⲉⲕ
ⲉⲗϩⲏⲙ	V	ⲉⲗϩⲏⲙ
ⲉⲗϩⲱⲃ	V	ⲉⲗϩⲱⲃ
ⲉⲗⲁⲙⲓⲧⲏⲥ	N	ⲉⲗⲁⲙⲓⲧⲏⲥ
ⲉⲗⲁⲣⲓⲭⲟⲥ	NPROP	ⲉⲗⲁⲣⲓⲭⲟⲥ
ⲉⲗⲁⲥⲥⲟⲙⲁ	N	ⲉⲗⲁⲥⲥⲟⲙⲁ
ⲉⲗⲁⲭⲉⲓⲥⲧⲟⲛ	N	ⲉⲗⲁⲭⲉⲓⲥⲧⲟⲛ
ⲉⲗⲁⲭⲓⲥⲧⲟⲛ	N	ⲉⲗⲁⲭⲓⲥⲧⲟⲛ
ⲉⲗⲁⲭⲓⲥⲧⲟⲥ	N	ⲉⲗⲁⲭⲓⲥⲧⲟⲥ
ⲉⲗⲉⲁⲍⲁⲣ	NPROP	ⲉⲗⲉⲁⲍⲁⲣ
ⲉⲗⲉⲅⲭⲉ	V	ⲉⲗⲉⲅⲭⲉ
ⲉⲗⲉⲏⲙⲟⲥⲩⲛⲏ	N	ⲉⲗⲉⲏⲙⲟⲥⲩⲛⲏ
ⲉⲗⲉⲥⲁⲓⲟⲥ	NPROP	ⲉⲗⲉⲥⲁⲓⲟⲥ
ⲉⲗⲉⲩⲑⲉⲣⲁ	N	ⲉⲗⲉⲩⲑⲉⲣⲁ
ⲉⲗⲉⲩⲑⲉⲣⲓⲁ	N	ⲉⲗⲉⲩⲑⲉⲣⲓⲁ
ⲉⲗⲉⲩⲑⲉⲣⲟⲥ	N	ⲉⲗⲉⲩⲑⲉⲣⲟⲥ
ⲉⲗⲉⲩⲑⲉⲣⲟⲩ	V	ⲉⲗⲉⲩⲑⲉⲣⲟⲩ
ⲉⲗⲉⲫⲁⲛⲧⲓⲛⲟⲛ	N	ⲉⲗⲉⲫⲁⲛⲧⲓⲛⲟⲛ
ⲉⲗⲏⲩ	VSTAT	ⲁⲗⲉ
ⲉⲗⲓⲁⲃ	NPROP	ⲉⲗⲓⲁⲃ
ⲉⲗⲓⲁⲕⲓⲙ	NPROP	ⲉⲗⲓⲁⲕⲓⲙ
ⲉⲗⲓⲟⲩⲇ	NPROP	ⲉⲗⲓⲟⲩⲇ
ⲉⲗⲓⲥⲁⲃⲉⲧ	NPROP	ⲉⲗⲓⲥⲁⲃⲉⲧ
ⲉⲗⲓⲥⲁⲓⲟⲥ	NPROP	ⲉⲗⲓⲥⲁⲓⲟⲥ
ⲉⲗⲓⲥⲥⲁⲓⲟⲥ	NPROP	ⲉⲗⲓⲥⲥⲁⲓⲟⲥ
ⲉⲗⲕⲥϣⲁ	N	ⲉⲗⲕⲥϣⲁ
ⲉⲗⲗⲉⲃⲟⲣⲟⲛ	N	ⲉⲗⲗⲉⲃⲟⲣⲟⲛ
ⲉⲗⲗⲏⲃ	N	ⲉⲗⲗⲏⲃ
ⲉⲗⲗⲟⲅⲓⲙⲟⲥ	N	ⲉⲗⲗⲟⲅⲓⲙⲟⲥ
ⲉⲗⲟⲟⲗⲉ	N	ⲉⲗⲟⲟⲗⲉ
ⲉⲗⲟ	V	ⲉⲗⲟ
ⲉⲗⲩⲥⲁⲓⲟⲥ	NPROP	ⲉⲗⲩⲥⲁⲓⲟⲥ
ⲉⲗⲱⲉⲓ	N	ⲉⲗⲱⲉⲓ
ⲉⲗⲱ	N	ⲉⲗⲱ
ⲉⲙϩⲓⲧ	N	ⲉⲙϩⲓⲧ
ⲉⲙⲁϣⲟ	ADV	ⲉⲙⲁϣⲟ
ⲉⲙⲁⲧⲉ	ADV	ⲉⲙⲁⲧⲉ
ⲉⲙⲁⲩ	ADV	ⲉⲙⲁⲩ
ⲉⲙⲉⲛⲧ	N	ⲉⲙⲉⲛⲧ
ⲉⲙⲏϣ	N	ⲉⲙⲏϣ
ⲉⲙⲙⲁⲛⲟⲩⲏⲗ	V	ⲉⲙⲙⲁⲛⲟⲩⲏⲗ
ⲉⲙⲛⲧ	N	ⲉⲙⲛⲧ
ⲉⲙⲡϣⲁ	V	ⲉⲙⲡϣⲁ
ⲉⲙⲡⲉⲣⲟⲥ	N	ⲉⲙⲡⲉⲣⲟⲥ
ⲉⲙⲡⲟⲣⲟⲥ	N	ⲉⲙⲡⲟⲣⲟⲥ
ⲉⲙⲧⲟⲛ	V	ⲉⲙⲧⲟⲛ
ⲉⲙⲫⲁⲛⲓⲍⲉ	V	ⲉⲙⲫⲁⲛⲓⲍⲉ
ⲉⲙⲫⲁⲛⲓⲥⲑⲁⲓ	V	ⲉⲙⲫⲁⲛⲓⲥⲑⲁⲓ
ⲉⲙⲯⲩⲭⲟⲛ	N	ⲉⲙⲯⲩⲭⲟⲛ
ⲉⲛϣⲁⲛ	ACOND_PPERS	ⲉⲣϣⲁⲛ_ⲁⲛⲟⲛ
ⲉⲛⲁⲅⲉ	V	ⲉⲛⲁⲅⲉ
ⲉⲛⲅⲟⲙⲓⲁⲍⲉ	V	ⲉⲛⲅⲟⲙⲓⲁⲍⲉ
ⲉⲛⲅⲱⲙⲓⲁⲍⲉ	V	ⲉⲛⲅⲱⲙⲓⲁⲍⲉ
ⲉⲛⲇⲁⲓⲙⲱⲛⲓⲟⲛ	N	ⲉⲛⲇⲁⲓⲙⲱⲛⲓⲟⲛ
ⲉⲛⲇⲏⲙⲁ	N	ⲉⲛⲇⲏⲙⲁ
ⲉⲛⲇⲟⲝ⸌ⲧ⸍	N	ⲉⲛⲇⲟⲝ⸌ⲧ⸍
ⲉⲛⲇⲩⲙⲁ	N	ⲉⲛⲇⲩⲙⲁ
ⲉⲛⲉϩ	ADV	ⲉⲛⲉϩ
ⲉⲛⲉϩ	N	ⲉⲛⲉϩ
ⲉⲛⲉⲣⲅⲉⲓⲁ	N	ⲉⲛⲉⲣⲅⲉⲓⲁ
ⲉⲛⲉⲣⲅⲉⲓ	V	ⲉⲛⲉⲣⲅⲉⲓ
ⲉⲛⲉⲣⲅⲏⲙⲁ	N	ⲉⲛⲉⲣⲅⲏⲙⲁ
ⲉⲛⲉⲣⲅⲓⲁ	N	ⲉⲛⲉⲣⲅⲓⲁ
ⲉⲛⲉⲣⲅⲓ	V	ⲉⲛⲉⲣⲅⲓ
ⲉⲛⲉⲭⲉⲣⲟⲛ	N	ⲉⲛⲉⲭⲉⲣⲟⲛ
ⲉⲛⲉ	AOPT_PPERS	ⲉⲛⲉ
ⲉⲛⲉ	CONJ	ⲉⲛⲉ
ⲉⲛⲉ	N	ⲉⲛⲉ
ⲉⲛⲑⲩⲙⲏⲥⲓⲥ	N	ⲉⲛⲑⲩⲙⲏⲥⲓⲥ
ⲉⲛⲕⲟⲙⲓⲁⲍⲉ	V	ⲉⲛⲕⲟⲙⲓⲁⲍⲉ
ⲉⲛⲕⲟⲧⲕ	V	ⲉⲛⲕⲟⲧⲕ
ⲉⲛⲕⲣⲁⲧⲱⲣ	NPROP	ⲉⲛⲕⲣⲁⲧⲱⲣ
ⲉⲛⲕⲱⲙⲓⲁⲍⲉ	V	ⲉⲛⲕⲱⲙⲓⲁⲍⲉ
ⲉⲛⲛⲁⲥ	N	ⲉⲛⲛⲁⲥ
ⲉⲛⲛⲁⲧⲏ	N	ⲉⲛⲛⲁⲧⲏ
ⲉⲛⲛⲉ	ANEGOPT	ⲉⲛⲛⲉ
ⲉⲛⲛⲉ	V	ⲉⲛⲛⲉ
ⲉⲛⲛⲟⲓⲁ	N	ⲉⲛⲛⲟⲓⲁ
ⲉⲛⲟⲭⲗⲉⲓ	V	ⲉⲛⲟⲭⲗⲉⲓ
ⲉⲛⲟⲭⲟⲥ	N	ⲉⲛⲟⲭⲟⲥ
ⲉⲛⲥⲩⲛⲕⲗⲏⲧⲓⲕⲟⲥ	N	ⲉⲛⲥⲩⲛⲕⲗⲏⲧⲓⲕⲟⲥ
ⲉⲛⲧⲁⲅⲓⲟⲛ	N	ⲉⲛⲧⲁⲅⲓⲟⲛ
ⲉⲛⲧⲉⲣ	ATEMP	ⲛⲧⲉⲣⲉ
ⲉⲛⲧⲏϭ	N	ⲉⲛⲧⲏϭ
ⲉⲛⲧⲓⲛⲁⲥⲥⲉ	V	ⲉⲛⲧⲓⲛⲁⲥⲥⲉ
ⲉⲛⲧⲟⲗⲏ	N	ⲉⲛⲧⲟⲗⲏ
ⲉⲛⲧ	CREL	ⲉⲧⲉⲣⲉ
ⲉⲛⲱⲭⲗⲉⲓ	V	ⲉⲛⲱⲭⲗⲉⲓ
ⲉⲛⲱⲭ	NPROP	ⲉⲛⲱⲭ
ⲉⲛ	V	ⲉⲛ
ⲉⲝϩⲟⲙⲟⲗⲟⲅⲏⲥⲓⲥ	N	ⲉⲝϩⲟⲙⲟⲗⲟⲅⲏⲥⲓⲥ
ⲉⲝⲁⲅⲉ	V	ⲉⲝⲁⲅⲉ
ⲉⲝⲁⲡⲁⲧⲁ	V	ⲉⲝⲁⲡⲁⲧⲁ
ⲉⲝⲁⲡⲓⲛⲁ	ADV	ⲉⲝⲁⲡⲓⲛⲁ
ⲉⲝⲁⲥ	N	ⲉⲝⲁⲥ
ⲉⲝⲉⲅⲏⲥⲓⲥ	N	ⲉⲝⲉⲅⲏⲥⲓⲥ
ⲉⲝⲉⲇⲣⲁ	N	ⲉⲝⲉⲇⲣⲁ
ⲉⲝⲉⲥⲧⲁⲓ	V	ⲉⲝⲉⲥⲧⲁⲓ
ⲉⲝⲉⲥⲧⲉⲓ	V	ⲉⲝⲉⲥⲧⲓ
ⲉⲝⲉⲥⲧⲓ	V	ⲉⲝⲉⲥⲧⲓ
ⲉⲝⲉⲧⲁⲍⲉ	V	ⲉⲝⲉⲧⲁⲍⲉ
ⲉⲝⲉⲧⲁⲥⲓⲥ	N	ⲉⲝⲉⲧⲁⲥⲓⲥ
ⲉⲝⲉⲫⲣⲁⲥⲉ	V	ⲉⲝⲉⲫⲣⲁⲥⲉ
ⲉⲝⲏⲅⲉⲓⲥⲑⲁⲓ	V	ⲉⲝⲏⲅⲉⲓⲥⲑⲁⲓ
ⲉⲝⲏⲅⲉⲓⲥⲓⲥ	N	ⲉⲝⲏⲅⲉⲓⲥⲓⲥ
ⲉⲝⲏⲅⲉⲓ	V	ⲉⲝⲏⲅⲉⲓ
ⲉⲝⲏⲅⲏⲥⲓⲥ	N	ⲉⲝⲏⲅⲏⲥⲓⲥ
ⲉⲝⲏⲅⲏⲧⲏⲥ	N	ⲉⲝⲏⲅⲏⲧⲏⲥ
ⲉⲝⲏⲅⲓⲥⲓⲥ	N	ⲉⲝⲏⲅⲓⲥⲓⲥ
ⲉⲝⲏⲕⲏⲥⲓⲥ	N	ⲉⲝⲏⲕⲏⲥⲓⲥ
ⲉⲝⲓⲗⲉ̄	N	ⲉⲝⲓⲗⲉ̄
ⲉⲝⲟⲇⲟⲥ	N	ⲉⲝⲟⲇⲟⲥ
ⲉⲝⲟⲙⲟⲗⲟⲅⲉⲓ	V	ⲉⲝⲟⲙⲟⲗⲟⲅⲉⲓ
ⲉⲝⲟⲙⲟⲗⲟⲅⲓ	V	ⲉⲝⲟⲙⲟⲗⲟⲅⲉⲓ
ⲉⲝⲟⲙⲟⲗⲱⲅⲉⲓ	V	ⲉⲝⲟⲙⲟⲗⲱⲅⲉⲓ
ⲉⲝⲟⲙⲱⲗⲟⲅⲉⲓ	V	ⲉⲝⲟⲙⲱⲗⲟⲅⲉⲓ
ⲉⲝⲟⲙⲱⲗⲱⲅⲉⲓ	V	ⲉⲝⲟⲙⲱⲗⲱⲅⲉⲓ
ⲉⲝⲟⲣⲅⲓⲥⲧⲏⲥ	N	ⲉⲝⲟⲣⲅⲓⲥⲧⲏⲥ
ⲉⲝⲟⲣⲏⲥⲧⲓⲁ	N	ⲉⲝⲟⲣⲏⲥⲧⲓⲁ
ⲉⲝⲟⲣⲓⲍⲉ	V	ⲉⲝⲟⲣⲓⲍⲉ
ⲉⲝⲟⲣⲓⲥⲧⲓⲁ	N	ⲉⲝⲟⲣⲓⲥⲧⲓⲁ
ⲉⲝⲟⲩⲑⲉⲛⲓ	V	ⲉⲝⲟⲩⲑⲉⲛⲓ
ⲉⲝⲟⲩⲥⲓⲁⲍⲓⲛ	V	ⲉⲝⲟⲩⲥⲓⲁⲍⲓⲛ
ⲉⲝⲟⲩⲥⲓⲁⲥⲧⲏⲥ	N	ⲉⲝⲟⲩⲥⲓⲁⲥⲧⲏⲥ
ⲉⲝⲟⲩⲥⲓⲁ	N	ⲉⲝⲟⲩⲥⲓⲁ
ⲉⲝⲱⲇⲓⲕⲟⲥ	N	ⲉⲝⲱⲇⲓⲕⲟⲥ
ⲉⲝⲱⲙⲟⲗⲟⲅⲉⲓ	V	ⲉⲝⲱⲙⲟⲗⲟⲅⲉⲓ
ⲉⲝⲱⲙⲟⲗⲱⲅⲉⲓ	V	ⲉⲝⲱⲙⲟⲗⲱⲅⲉⲓ
ⲉⲝⲱⲙⲱⲗⲟⲅⲉⲓ	V	ⲉⲝⲱⲙⲱⲗⲟⲅⲉⲓ
ⲉⲝⲱⲙⲱⲗⲱⲅⲉⲓ	V	ⲉⲝⲱⲙⲱⲗⲱⲅⲉⲓ
ⲉⲝⲱⲣⲉⲓⲥⲧⲓⲁ	N	ⲉⲝⲱⲣⲉⲓⲥⲧⲓⲁ
ⲉⲝⲱⲣⲏⲥⲧⲓⲁ	N	ⲉⲝⲱⲣⲏⲥⲧⲓⲁ
ⲉⲝⲱⲣⲓⲍⲓⲛ	V	ⲉⲝⲱⲣⲓⲍⲓⲛ
ⲉⲝⲱⲣⲓⲥⲧⲓⲁ	N	ⲉⲝⲱⲣⲓⲥⲧⲓⲁ
ⲉⲟⲟⲩ	N	ⲉⲟⲟⲩ
ⲉⲡϩⲁⲉ	ADV	ⲉⲡϩⲁⲉ
ⲉⲡϫⲓⲛϫⲏ	ADV	ⲉⲡϫⲓⲛϫⲏ
ⲉⲡⲁϩⲟⲩ	ADV	ⲉⲡⲁϩⲟⲩ
ⲉⲡⲁⲓⲛⲟⲩ	V	ⲉⲡⲁⲓⲛⲟⲩ
ⲉⲡⲁⲣⲭⲓⲁ	N	ⲉⲡⲁⲣⲭⲓⲁ
ⲉⲡⲁⲣⲭⲟⲥ	N	ⲉⲡⲁⲣⲭⲟⲥ
ⲉⲡⲉϩⲟⲩⲟ	ADV	ⲉⲡⲉϩⲟⲩⲟ
ⲉⲡⲉⲑⲩⲙⲉⲓ	V	ⲉⲡⲉⲑⲩⲙⲉⲓ
ⲉⲡⲉⲓⲇⲏ	CONJ	ⲉⲡⲉⲓⲇⲏ
ⲉⲡⲉⲓⲑⲩⲙⲓⲁ	N	ⲉⲡⲉⲓⲑⲩⲙⲓⲁ
ⲉⲡⲉⲓⲕⲁⲗⲉⲓ	V	ⲉⲡⲉⲓⲕⲁⲗⲉⲓ
ⲉⲡⲉⲓⲥⲁⲙⲛⲡⲁⲓ	ADV	ⲉⲡⲉⲓⲥⲁⲙⲛⲡⲁⲓ
ⲉⲡⲉⲓⲥⲧⲏⲙⲉⲓ	V	ⲉⲡⲉⲓⲥⲧⲏⲙⲉⲓ
ⲉⲡⲉⲓⲧⲁ	ADV	ⲉⲡⲉⲓⲧⲁ
ⲉⲡⲉⲓ	CONJ	ⲉⲡⲉⲓ
ⲉⲡⲉⲛⲇⲩⲧⲏⲥ	N	ⲉⲡⲉⲛⲇⲩⲧⲏⲥ
ⲉⲡⲉⲥⲏⲧ	ADV	ⲉⲡⲉⲥⲏⲧ
ⲉⲡⲉⲥⲏⲧ	PREP	ⲉⲡⲉⲥⲏⲧ
ⲉⲡⲉⲭⲏⲣⲓ	V	ⲉⲡⲉⲭⲏⲣⲓ
ⲉⲡⲏⲑⲩⲙⲓⲁ	N	ⲉⲡⲏⲑⲩⲙⲓⲁ
ⲉⲡⲏⲡ	NPROP	ⲉⲡⲏⲡ
ⲉⲡⲏⲣⲉⲁⲍⲉ	V	ⲉⲡⲏⲣⲉⲁⲍⲉ
ⲉⲡⲏⲣⲓⲁ	N	ⲉⲡⲏⲣⲓⲁ
ⲉⲡⲏⲧⲏⲙⲓⲁ	N	ⲉⲡⲏⲧⲏⲙⲓⲁ
ⲉⲡⲓⲃⲟⲗⲏ	N	ⲉⲡⲓⲃⲟⲗⲏ
ⲉⲡⲓⲃⲟⲩⲗⲉⲩⲉ	V	ⲉⲡⲓⲃⲟⲩⲗⲉⲩⲉ
ⲉⲡⲓⲃⲟⲩⲗⲏ	N	ⲉⲡⲓⲃⲟⲩⲗⲏ
ⲉⲡⲓⲃⲟⲩⲗⲟⲥ	N	ⲉⲡⲓⲃⲟⲩⲗⲟⲥ
ⲉⲡⲓⲅⲉⲁⲉⲓ	V	ⲉⲡⲓⲅⲉⲁⲉⲓ
ⲉⲡⲓⲅⲉⲛⲛⲓⲟⲥ	N	ⲉⲡⲓⲅⲉⲛⲛⲓⲟⲥ
ⲉⲡⲓⲅⲣⲁⲫⲏ	N	ⲉⲡⲓⲅⲣⲁⲫⲏ
ⲉⲡⲓⲇⲏ	CONJ	ⲉⲡⲓⲇⲏ
ⲉⲡⲓⲉⲓⲕⲏⲥ	N	ⲉⲡⲓⲉⲓⲕⲏⲥ
ⲉⲡⲓⲑⲁⲛⲁⲧⲏⲥ	N	ⲉⲡⲓⲑⲁⲛⲁⲧⲏⲥ
ⲉⲡⲓⲑⲩⲙⲉⲓ	V	ⲉⲡⲓⲑⲩⲙⲉⲓ
ⲉⲡⲓⲑⲩⲙⲓⲁ	N	ⲉⲡⲓⲑⲩⲙⲓⲁ
ⲉⲡⲓⲕⲁⲗⲉⲓ	V	ⲉⲡⲓⲕⲁⲗⲉⲓ
ⲉⲡⲓⲕⲁⲗⲓ	V	ⲉⲡⲓⲕⲁⲗⲓ
ⲉⲡⲓⲛⲟⲓⲁ	N	ⲉⲡⲓⲛⲟⲓⲁ
ⲉⲡⲓⲡ	NPROP	ⲉⲡⲓⲡ
ⲉⲡⲓⲥⲏⲙⲟⲥ	N	ⲉⲡⲓⲥⲏⲙⲟⲥ
ⲉⲡⲓⲥⲕⲟⲡⲏ	N	ⲉⲡⲓⲥⲕⲟⲡⲏ
ⲉⲡⲓⲥⲕⲟⲡⲓⲟⲛ	N	ⲉⲡⲓⲥⲕⲟⲡⲓⲟⲛ
ⲉⲡⲓⲥⲕⲟⲡⲟⲥ	N	ⲉⲡⲓⲥⲕⲟⲡⲟⲥ
ⲉⲡⲓⲥⲧⲏⲙⲉⲓ	V	ⲉⲡⲓⲥⲧⲏⲙⲉⲓ
ⲉⲡⲓⲥⲧⲏⲙⲏ	N	ⲉⲡⲓⲥⲧⲏⲙⲏ
ⲉⲡⲓⲥⲧⲟⲗⲏ	N	ⲉⲡⲓⲥⲧⲟⲗⲏ
ⲉⲡⲓⲧⲁⲕⲏ	N	ⲉⲡⲓⲧⲁⲕⲏ
ⲉⲡⲓⲧⲁⲥⲥⲉ	V	ⲉⲡⲓⲧⲁⲥⲥⲉ
ⲉⲡⲓⲧⲉⲗⲓⲛ	V	ⲉⲡⲓⲧⲉⲗⲓⲛ
ⲉⲡⲓⲧⲓⲙⲁ	V	ⲉⲡⲓⲧⲓⲙⲁ
ⲉⲡⲓⲧⲓⲙⲓⲁ	N	ⲉⲡⲓⲧⲓⲙⲓⲁ
ⲉⲡⲓⲧⲣⲉⲡⲉ	V	ⲉⲡⲓⲧⲣⲉⲡⲉ
ⲉⲡⲓⲧⲣⲟⲡⲏ	N	ⲉⲡⲓⲧⲣⲟⲡⲏ
ⲉⲡⲓⲧⲣⲟⲡⲟⲥ	N	ⲉⲡⲓⲧⲣⲟⲡⲟⲥ
ⲉⲡⲓⲭⲉⲓⲣⲉⲓ	V	ⲉⲡⲓⲭⲉⲓⲣⲉⲓ
ⲉⲡⲙⲁⲙ	PREP	ⲉⲡⲙⲁⲛ
ⲉⲡⲙⲁⲛ	PREP	ⲉⲡⲙⲁⲛ
ⲉⲡⲟⲓⲕⲓⲟⲛ 	N	ⲉⲡⲟⲓⲕⲓⲟⲛ 
ⲉⲡⲟⲩⲣⲁⲛⲓⲟⲛ	N	ⲉⲡⲟⲩⲣⲁⲛⲓⲟⲛ
ⲉⲡⲣⲁ	N	ⲉⲡⲣⲁ
ⲉⲡⲧⲏⲣϥ	ADV	ⲉⲡⲧⲏⲣϥ
ⲉⲡⲫⲁⲑⲁ	NPROP	ⲉⲡⲫⲁⲑⲁ
ⲉⲡ	V	ⲉⲡ
ⲉⲣϣⲁⲛ	ACOND	ⲉⲣϣⲁⲛ
ⲉⲣϣⲁⲛ	ACOND_PPERS	ⲉⲣϣⲁⲛ_ⲛⲧⲟ
ⲉⲣϣⲁⲛ	COND	ⲉⲣϣⲁⲛ
ⲉⲣϣⲙⲙⲟ	V	ⲉⲣϣⲙⲙⲟ
ⲉⲣϥⲛⲧ	V	ⲉⲣϥⲛⲧ
ⲣϩⲟⲧⲉ	V	ⲣϩⲟⲧⲉ
ⲣϩⲩⲙⲛⲟⲥ	V	ⲣϩⲩⲙⲛⲟⲥ
ⲉⲣⲁⲑⲉⲧⲓⲛ	V	ⲉⲣⲁⲑⲉⲧⲓⲛ
ⲉⲣⲁⲛⲁⲓ	V	ⲁⲛⲁⲓ
ⲉⲣⲁⲛⲁⲭⲱⲣⲓⲛ	V	ⲉⲣⲁⲛⲁⲭⲱⲣⲓⲛ
ⲉⲣⲁⲛⲁ	V	ⲁⲛⲁⲓ
ⲉⲣⲁⲡⲁⲛⲧⲁⲛ	V	ⲉⲣⲁⲡⲁⲛⲧⲁⲛ
ⲉⲣⲁⲡⲁⲧⲁⲛ	V	ⲉⲣⲁⲡⲁⲧⲁⲛ
ⲉⲣⲁⲡⲟⲧⲁⲍⲉⲥⲑⲉ	V	ⲉⲣⲁⲡⲟⲧⲁⲍⲉⲥⲑⲉ
ⲉⲣⲁⲥⲡⲁⲍⲉⲥⲑⲉ	V	ⲉⲣⲁⲥⲡⲁⲍⲉⲥⲑⲉ
ⲉⲣⲁⲧⲟⲩ	PREP	ⲉⲣⲁⲧ
ⲉⲣⲁⲧ	PREP	ⲉⲣⲁⲧ
ⲉⲣⲁ	PREP	ⲉⲣⲁ
ⲉⲣⲃⲁⲥⲁⲛⲓⲍⲓⲛ	V	ⲉⲣⲃⲁⲥⲁⲛⲓⲍⲓⲛ
ⲉⲣⲃⲗⲁⲡⲧⲓⲛ	V	ⲉⲣⲃⲗⲁⲡⲧⲓⲛ
ⲉⲣⲃⲟⲏⲑⲓⲛ	V	ⲉⲣⲃⲟⲏⲑⲓⲛ
ⲉⲣⲃ	V	ⲱⲣⲃ
ⲉⲣⲅⲁⲥⲓⲁ	N	ⲉⲣⲅⲁⲥⲓⲁ
ⲉⲣⲅⲁⲥⲧⲏⲣⲓⲟⲛ	N	ⲉⲣⲅⲁⲥⲧⲏⲣⲓⲟⲛ
ⲉⲣⲅⲁⲧⲏⲥ	N	ⲉⲣⲅⲁⲧⲏⲥ
ⲉⲣⲅⲟⲇⲓⲱⲕⲧⲏⲥ	N	ⲉⲣⲅⲟⲇⲓⲱⲕⲧⲏⲥ
ⲉⲣⲅⲟⲗⲁⲃⲓⲁ	N	ⲉⲣⲅⲟⲗⲁⲃⲓⲁ
ⲉⲣⲅⲟⲛ	N	ⲉⲣⲅⲟⲛ
ⲣⲇⲓⲁⲕⲟⲛⲓⲛ	V	ⲣⲇⲓⲁⲕⲟⲛⲓⲛ
ⲉⲣⲉⲙⲡⲟⲇⲁⲍⲓⲛ	V	ⲉⲣⲉⲙⲡⲟⲇⲁⲍⲓⲛ
ⲉⲣⲉⲛⲕⲁⲕⲓⲛ	V	ⲉⲣⲉⲛⲕⲁⲕⲓⲛ
ⲉⲣⲉⲡⲓⲛⲟⲓⲛ	V	ⲉⲣⲉⲡⲓⲛⲟⲓⲛ
ⲉⲣⲉⲥⲑⲁⲛⲉⲥⲑⲉ	V	ⲉⲣⲉⲥⲑⲁⲛⲉⲥⲑⲉ
ⲉⲣⲉ	AOPT	ⲉⲣⲉ
ⲉⲣⲉ	AOPT_PPERS	ⲉⲣⲉ
ⲉⲣⲉ	CCIRC	ⲉⲣⲉ
ⲉⲣⲉ	CCIRC_PPERS	ⲉⲣⲉ_ⲛⲧⲟ
ⲉⲣⲉ	CFOC	ⲉⲣⲉ
ⲉⲣⲉ	CFOC_PPERS	ⲉⲣⲉ
ⲉⲣⲉ	CREL	ⲉⲣⲉ
ⲉⲣⲏⲙⲓⲁ	N	ⲉⲣⲏⲙⲓⲁ
ⲉⲣⲏⲙⲟⲥ	N	ⲉⲣⲏⲙⲟⲥ
ⲉⲣⲏⲧ	V	ⲉⲣⲏⲧ
ⲉⲣⲏⲩ	N	ⲉⲣⲏⲩ
ⲉⲣⲑⲉⲱⲣⲓⲛ	V	ⲉⲣⲑⲉⲱⲣⲓⲛ
ⲉⲣⲓⲍⲉ	V	ⲉⲣⲓⲍⲉ
ⲉⲣⲕⲉⲗⲉⲩⲓⲛ	V	ⲉⲣⲕⲉⲗⲉⲩⲓⲛ
ⲉⲣⲕⲣⲓⲛⲓⲛ	V	ⲉⲣⲕⲣⲓⲛⲓⲛ
ⲉⲣⲗⲁⲁⲩ	N	ⲉⲣⲗⲁⲁⲩ
ⲉⲣⲗⲓⲧⲟⲩⲣⲅⲓⲁ	V	ⲉⲣⲗⲓⲧⲟⲩⲣⲅⲓⲁ
ⲉⲣⲙⲁⲑⲏⲧⲏⲥ	V	ⲉⲣⲙⲁⲑⲏⲧⲏⲥ
ⲉⲣⲙⲏⲧⲁⲣⲓⲟⲛ	N	ⲉⲣⲙⲏⲧⲁⲣⲓⲟⲛ
ⲉⲣⲙⲛⲧⲣⲉ	V	ⲉⲣⲙⲛⲧⲣⲉ
ⲉⲣⲙ	PREP	ⲉⲣⲛ
ⲉⲣⲛⲟⲃⲉ	V	ⲉⲣⲛⲟⲃⲉ
ⲉⲣⲛ	PREP	ⲉⲣⲛ
ⲉⲣⲟⲙⲟⲗⲟⲅⲓⲛ	V	ⲉⲣⲟⲙⲟⲗⲟⲅⲓⲛ
ⲉⲣⲟ	PREP	ⲉ
ⲉⲣⲟ	PREP_PPERO	ⲉ_ⲛⲧⲟ
ⲉⲣⲡⲃⲟⲗ	V	ⲉⲣⲡⲃⲟⲗ
ⲉⲣⲡⲣⲟⲥⲫⲉⲣⲓⲛ	V	ⲉⲣⲡⲣⲟⲥⲫⲉⲣⲓⲛ
ⲉⲣⲣⲏⲧⲱⲣⲉⲩⲓⲛ	V	ⲉⲣⲣⲏⲧⲱⲣⲉⲩⲓⲛ
ⲉⲣⲣⲱⲟⲩ	N	ⲣⲣⲟ
ⲉⲣⲥⲕⲉⲡⲁⲍⲓⲛ	V	ⲉⲣⲥⲕⲉⲡⲁⲍⲓⲛ
ⲉⲣⲥⲱⲙⲁ	V	ⲉⲣⲥⲱⲙⲁ
ⲉⲣⲧⲉⲗⲉⲓⲟⲥ	V	ⲉⲣⲧⲉⲗⲉⲓⲟⲥ
ⲉⲣⲩⲑⲣⲁ	N	ⲉⲣⲩⲑⲣⲁ
ⲉⲣⲱⲟⲩ	N	ⲣⲣⲟ
ⲉⲣⲱⲥ	N	ⲉⲣⲱⲥ
ⲉⲣⲱⲧⲉ	N	ⲉⲣⲱⲧⲉ
ⲉⲣⲱ	PREP	ⲉ
ⲉⲣ	CCIRC_PPERS	ⲉⲣⲉ_ⲛⲧⲟ
ⲉⲣ	CFOC_PPERS	ⲉⲣⲉ_ⲛⲧⲟ
ⲉⲣ	V	ⲉⲓⲣⲉ
ⲉⲥϣⲁⲛ	ACOND_PPERS	ⲉⲣϣⲁⲛ_ⲛⲧⲟⲥ
ⲉⲥⲉ	AOPT_PPERS	ⲉⲣⲉ_ⲛⲧⲟⲥ
ⲉⲥⲏⲧ	N	ⲉⲥⲏⲧ
ⲉⲥⲑⲁⲛⲉ	V	ⲉⲥⲑⲁⲛⲉ
ⲉⲥⲑⲏⲥⲓⲥ	N	ⲉⲥⲑⲏⲥⲓⲥ
ⲉⲥⲑⲏⲧⲏⲣⲓⲟⲛ	N	ⲉⲥⲑⲏⲧⲏⲣⲓⲟⲛ
ⲉⲥⲓⲇⲟⲣⲟⲥ	NPROP	ⲉⲥⲓⲇⲟⲣⲟⲥ
ⲉⲥⲟⲟⲩ	N	ⲉⲥⲟⲟⲩ
ⲉⲥⲣⲱⲙ	NPROP	ⲉⲥⲣⲱⲙ
ⲉⲥⲧⲱ	V	ⲉⲥⲧⲱ
ⲉⲥⲩⲭⲁⲍⲉ	V	ⲉⲥⲩⲭⲁⲍⲉ
ⲉⲥⲩⲭⲓⲁ	N	ⲉⲥⲩⲭⲓⲁ
ⲉⲥⲭⲁⲣⲁ	N	ⲉⲥⲭⲁⲣⲁ
ⲉⲥ	PPERO	ⲉⲥ
ⲉⲧ‎	N	ⲉⲧ‎
ⲉⲧⲃⲃⲏ	N	ⲉⲧⲃⲃⲏ
ⲉⲧⲃⲉ	PREP	ⲉⲧⲃⲉ
ⲉⲧⲃⲏⲏⲧ	PREP	ⲉⲧⲃⲉ
ⲉⲧⲃⲏⲏⲧ	PREP_PPERO	ⲉⲧⲃⲏⲏⲧ
ⲉⲧⲃⲏⲏ	PREP	ⲉⲧⲃⲉ
ⲉⲧⲉϩⲛⲁ	N	ⲉⲧⲉϩⲛⲁ
ⲉⲧⲉⲛⲁⲓⲛⲉ	CONJ	ⲉⲧⲉⲛⲁⲓⲛⲉ
ⲉⲧⲉⲛⲟⲩ	ADV	ⲉⲧⲉⲛⲟⲩ
ⲉⲧⲉⲡⲁⲓⲡⲉ	CONJ	ⲉⲧⲉⲡⲁⲓⲡⲉ
ⲉⲧⲉⲣⲉ	CREL	ⲉⲧⲉⲣⲉ
ⲉⲧⲉⲣⲉ	CREL_PPERS	ⲉⲧⲉⲣⲉ_ⲛⲧⲟ
ⲉⲧⲉⲣⲉ	N	ⲉⲧⲉⲣⲉ
ⲉⲧⲉⲣⲉ	V	ⲉⲧⲉⲣⲉ
ⲉⲧⲉⲧⲁⲓⲧⲉ	ADV	ⲉⲧⲉⲧⲁⲓⲧⲉ
ⲉⲧⲉⲧⲁⲓⲧⲉ	CONJ	ⲉⲧⲉⲧⲁⲓⲧⲉ
ⲉⲧⲉⲧⲛϣⲁⲛ	ACOND_PPERS	ⲉⲧⲉⲧⲛϣⲁⲛ
ⲉⲧⲉⲧⲛⲉ	AOPT_PPERS	ⲉⲧⲉⲧⲛⲉ
ⲉⲧⲉ	CCIRC	ⲉⲧⲉ
ⲉⲧⲉ	CREL	ⲉⲧⲉⲣⲉ
ⲉⲧⲓⲟⲥ	N	ⲉⲧⲓⲟⲥ
ⲉⲧⲓ	ADV	ⲉⲧⲓ
ⲉⲧⲙⲏⲧⲉⲛ	PREP	ⲉⲧⲙⲏⲧⲉⲛ
ⲉⲧⲛ	V	ⲉⲧⲛ
ⲉⲧⲟⲟⲧ	PREP	ⲉⲧⲛ
ⲉⲧⲡⲱ	N	ⲉⲧⲡⲱ
ⲉⲧⲣⲉ	N	ⲉⲧⲣⲉ
ⲉⲧ	CREL	ⲉⲧⲉⲣⲉ
ⲉⲧ	PPERO	ⲉⲧ
ⲉⲩϣⲁⲛ	ACOND_PPERS	ⲉⲣϣⲁⲛ_ⲛⲧⲟⲟⲩ
ⲉⲩϩⲁⲓⲟⲥ	N	ⲉⲩϩⲁⲓⲟⲥ
ⲉⲩϩⲁ	NPROP	ⲉⲩϩⲁ
ⲉⲩⲁⲅⲅⲉⲗⲓⲍⲉ	V	ⲉⲩⲁⲅⲅⲉⲗⲓⲍⲉ
ⲉⲩⲁⲅⲅⲉⲗⲓⲟⲛ	N	ⲉⲩⲁⲅⲅⲉⲗⲓⲟⲛ
ⲉⲩⲁⲅⲅⲉⲗⲓⲥⲧⲏⲥ	N	ⲉⲩⲁⲅⲅⲉⲗⲓⲥⲧⲏⲥ
ⲉⲩⲁⲅⲣⲓⲟⲥ	NPROP	ⲉⲩⲁⲅⲣⲓⲟⲥ
ⲉⲩⲅⲉⲛⲏⲥ	N	ⲉⲩⲅⲉⲛⲏⲥ
ⲉⲩⲅⲉ	ADV	ⲉⲩⲅⲉ
ⲉⲩⲇⲁⲓⲙⲟⲛⲓⲁ	N	ⲉⲩⲇⲁⲓⲙⲟⲛⲓⲁ
ⲉⲩⲇⲟⲕⲉⲓ	V	ⲉⲩⲇⲟⲕⲉⲓ
ⲉⲩⲉⲣⲅⲉⲥⲓⲁ	N	ⲉⲩⲉⲣⲅⲉⲥⲓⲁ
ⲉⲩⲉⲣⲅⲉⲧⲉⲓ	V	ⲉⲩⲉⲣⲅⲉⲧⲉⲓ
ⲉⲩⲉⲣⲅⲉⲧⲏⲥ	N	ⲉⲩⲉⲣⲅⲉⲧⲏⲥ
ⲉⲩⲉ	AOPT_PPERS	ⲉⲣⲉ_ⲛⲧⲟⲟⲩ
ⲉⲩⲉ	V	ⲉⲩⲉ
ⲉⲩⲑⲉⲱⲥ	ADV	ⲉⲩⲑⲉⲱⲥ
ⲉⲩⲑⲩⲥ	ADV	ⲉⲩⲑⲩⲥ
ⲉⲩⲕⲁⲓⲣⲓⲁ	N	ⲉⲩⲕⲁⲓⲣⲓⲁ
ⲉⲩⲕⲉⲣⲓⲁ	N	ⲉⲩⲕⲉⲣⲓⲁ
ⲉⲩⲕⲉⲣⲓ	V	ⲉⲩⲕⲉⲣⲓ
ⲉⲩⲕⲗⲉⲉⲥⲧⲁⲧⲟⲥ	N	ⲉⲩⲕⲗⲉⲉⲥⲧⲁⲧⲟⲥ
ⲉⲩⲕⲟⲡⲟⲛ	N	ⲉⲩⲕⲟⲡⲟⲛ
ⲉⲩⲕⲣⲁⲥⲓⲁ	N	ⲉⲩⲕⲣⲁⲥⲓⲁ
ⲉⲩⲕⲧⲏⲣⲓⲟⲛ	N	ⲉⲩⲕⲧⲏⲣⲓⲟⲛ
ⲉⲩⲗⲁⲃⲉⲓⲁ	N	ⲉⲩⲗⲁⲃⲉⲓⲁ
ⲉⲩⲗⲁⲃⲉⲥⲧⲁⲧⲟⲥ	N	ⲉⲩⲗⲁⲃⲉⲥⲧⲁⲧⲟⲥ
ⲉⲩⲗⲁⲃⲏⲥ	N	ⲉⲩⲗⲁⲃⲏⲥ
ⲉⲩⲗⲁⲃⲓⲁ	N	ⲉⲩⲗⲁⲃⲓⲁ
ⲉⲩⲗⲟⲅⲓⲁ	N	ⲉⲩⲗⲟⲅⲓⲁ
ⲉⲩⲗⲟⲅⲟⲛ	N	ⲉⲩⲗⲟⲅⲟⲛ
ⲉⲩⲗⲟⲅⲱⲥ	ADV	ⲉⲩⲗⲟⲅⲱⲥ
ⲉⲩⲛⲟⲓⲁ	N	ⲉⲩⲛⲟⲓⲁ
ⲉⲩⲛⲟⲙⲟⲥ	NPROP	ⲉⲩⲛⲟⲙⲟⲥ
ⲉⲩⲡⲟⲣⲉⲓ	V	ⲉⲩⲡⲟⲣⲉⲓ
ⲉⲩⲡⲟⲣⲓⲁ	N	ⲉⲩⲡⲟⲣⲓⲁ
ⲉⲩⲡⲟⲣⲓ	V	ⲉⲩⲡⲟⲣⲓ
ⲉⲩⲡⲟⲣⲟⲥ	N	ⲉⲩⲡⲟⲣⲟⲥ
ⲉⲩⲡⲣⲉⲡⲉⲓⲁ	N	ⲉⲩⲡⲣⲉⲡⲉⲓⲁ
ⲉⲩⲣⲓⲡⲟⲥ	N	ⲉⲩⲣⲓⲡⲟⲥ
ⲉⲩⲥⲉⲃⲉⲓⲁ	N	ⲉⲩⲥⲉⲃⲉⲓⲁ
ⲉⲩⲥⲉⲃⲏⲥ	N	ⲉⲩⲥⲉⲃⲏⲥ
ⲉⲩⲥⲉⲃⲓⲟⲥ	NPROP	ⲉⲩⲥⲉⲃⲓⲟⲥ
ⲉⲩⲥⲧⲁⲑⲓⲁⲛⲟⲥ	NPROP	ⲉⲩⲥⲧⲁⲑⲓⲁⲛⲟⲥ
ⲉⲩⲥⲧⲁⲑⲓⲟⲥ	NPROP	ⲉⲩⲥⲧⲁⲑⲓⲟⲥ
ⲉⲩⲥⲧⲟⲭⲓⲟⲥ	NPROP	ⲉⲩⲥⲧⲟⲭⲓⲟⲥ
ⲉⲩⲥⲭⲏⲙⲱⲛ	N	ⲉⲩⲥⲭⲏⲙⲱⲛ
ⲉⲩⲥⲭⲩⲙⲟⲥⲩⲛⲏ	N	ⲉⲩⲥⲭⲩⲙⲟⲥⲩⲛⲏ
ⲉⲩⲧⲉⲗⲉⲓⲁ	N	ⲉⲩⲧⲉⲗⲉⲓⲁ
ⲉⲩⲧⲏⲗⲉⲥ	N	ⲉⲩⲧⲏⲗⲉⲥ
ⲉⲩⲧⲏⲗⲓⲟⲩ	V	ⲉⲩⲧⲏⲗⲓⲟⲩ
ⲉⲩⲧⲏⲭⲓⲁⲛⲟⲥ	NPROP	ⲉⲩⲧⲏⲭⲓⲁⲛⲟⲥ
ⲉⲩⲧⲣⲟⲡⲓⲟⲥ	NPROP	ⲉⲩⲧⲣⲟⲡⲓⲟⲥ
ⲉⲩⲧⲩⲭⲏⲥ	NPROP	ⲉⲩⲧⲩⲭⲏⲥ
ⲉⲩⲫⲏⲙⲓⲁ	NPROP	ⲉⲩⲫⲏⲙⲓⲁ
ⲉⲩⲫⲣⲁⲛⲉ	V	ⲉⲩⲫⲣⲁⲛⲉ
ⲉⲩⲫⲣⲟⲥⲩⲛⲏ	N	ⲉⲩⲫⲣⲟⲥⲩⲛⲏ
ⲉⲩⲫⲩⲏⲥ	N	ⲉⲩⲫⲩⲏⲥ
ⲉⲩⲭⲁⲣⲓⲍⲉ	V	ⲉⲩⲭⲁⲣⲓⲍⲉ
ⲉⲩⲭⲁⲣⲓⲥⲧⲉⲓ	V	ⲉⲩⲭⲁⲣⲓⲥⲧⲉⲓ
ⲉⲩⲭⲁⲣⲓⲥⲧⲓⲁ	N	ⲉⲩⲭⲁⲣⲓⲥⲧⲓⲁ
ⲉⲩⲭⲁⲣⲓⲥⲧⲓ	V	ⲉⲩⲭⲁⲣⲓⲥⲧⲓ
ⲉⲩⲭⲁⲣⲓⲥⲧⲟⲩ	V	ⲉⲩⲭⲁⲣⲓⲥⲧⲟⲩ
ⲉⲩⲭⲏ	N	ⲉⲩⲭⲏ
ⲉⲩⲱ	N	ⲉⲩⲱ
ⲉⲩ	N	ⲉⲩ
ⲉⲩ	V	ⲉⲩ
ⲉⲫⲉⲥⲟⲥ	NPROP	ⲉⲫⲉⲥⲟⲥ
ⲉⲫⲟⲇⲓⲟⲛ	N	ⲉⲫⲟⲇⲓⲟⲛ
ⲉⲫⲟⲥⲟⲛ	CONJ	ⲉⲫⲟⲥⲟⲛ
ⲉⲫⲣⲉⲙ	NPROP	ⲉⲫⲣⲉⲙ
ⲉⲱⲛ	N	ⲉⲱⲛ
ⲉⲱⲥ	CONJ	ⲉⲱⲥ
ⲉ	ACOND	ⲉ
ⲉ	AOP	ⲉ
ⲉ	AOPT	ⲉ
ⲉ	CCIRC	ⲉⲣⲉ
ⲉ	CCOND	ⲉ
ⲉ	CFOC	ⲉⲣⲉ
ⲉ	CREL	ⲉⲧⲉⲣⲉ
ⲉ	PPERO	ⲛⲧⲟ
ⲉ	PREP	ⲉ
ⲍⲁⲃⲟⲩⲗⲟⲛ	NPROP	ⲍⲁⲃⲟⲩⲗⲟⲛ
ⲍⲁⲗⲉϩ	NPROP	ⲍⲁⲗⲉϩ
ⲍⲁⲭⲁⲓⲟⲥ	NPROP	ⲍⲁⲭⲁⲓⲟⲥ
ⲍⲁⲭⲁⲣⲓⲁⲥ	NPROP	ⲍⲁⲭⲁⲣⲓⲁⲥ
ⲍⲉⲃⲉⲇⲁⲓⲟⲥ	NPROP	ⲍⲉⲃⲉⲇⲁⲓⲟⲥ
ⲍⲉⲇⲉⲕⲓⲁⲥ	NPROP	ⲍⲉⲇⲉⲕⲓⲁⲥ
ⲍⲉⲗⲫⲁ	NPROP	ⲍⲉⲗⲫⲁ
ⲍⲉⲩⲥ	NPROP	ⲍⲉⲩⲥ
ⲍⲏⲛⲱⲛ	NPROP	ⲍⲏⲛⲱⲛ
ⲍⲏⲧⲏⲙⲁ	N	ⲍⲏⲧⲏⲙⲁ
ⲍⲏⲧⲏⲥⲓⲥ	N	ⲍⲏⲧⲏⲥⲓⲥ
ⲍⲓⲍⲁⲛⲓⲟⲛ	N	ⲍⲓⲍⲁⲛⲓⲟⲛ
ⲍⲟⲇⲓⲟⲛ	N	ⲍⲟⲇⲓⲟⲛ
ⲍⲟⲣⲟⲃⲁⲃⲉⲗ	NPROP	ⲍⲟⲣⲟⲃⲁⲃⲉⲗ
ⲍⲩⲅⲓⲥⲕⲟⲛ	N	ⲍⲩⲅⲓⲥⲕⲟⲛ
ⲍⲱⲅⲣⲁⲫⲉⲓⲁ	N	ⲍⲱⲅⲣⲁⲫⲉⲓⲁ
ⲍⲱⲅⲣⲁⲫⲉⲓ	V	ⲍⲱⲅⲣⲁⲫⲉⲓ
ⲍⲱⲅⲣⲁⲫⲓ	V	ⲍⲱⲅⲣⲁⲫⲓ
ⲍⲱⲇⲓⲟⲛ	N	ⲍⲱⲇⲓⲟⲛ
ⲍⲱⲏ	N	ⲍⲱⲏ
ⲍⲱⲕⲣⲁⲧⲱⲥ	NPROP	ⲍⲱⲕⲣⲁⲧⲱⲥ
ⲍⲱⲛⲏ	N	ⲍⲱⲛⲏ
ⲍⲱⲟⲛ	N	ⲍⲱⲟⲛ
ⲏⲇⲏ	ADV	ⲏⲇⲏ
ⲏⲇⲏ	N	ⲏⲇⲏ
ⲏⲉⲓ	N	ⲏⲓ
ⲏⲉⲓ	V	ⲏⲉⲓ
ⲏⲓ	N	ⲏⲓ
ⲏⲗⲓⲥⲥⲁⲓⲟⲥ	NPROP	ⲏⲗⲓⲥⲥⲁⲓⲟⲥ
ⲏⲛⲓⲟⲭⲟⲥ	N	ⲏⲛⲓⲟⲭⲟⲥ
ⲏⲝⲧⲁⲥⲓⲥ	N	ⲏⲝⲧⲁⲥⲓⲥ
ⲏⲡⲉ	N	ⲏⲡⲉ
ⲏⲡ	VSTAT	ⲱⲡ
ⲏⲣⲉⲙⲓⲟⲥ	N	ⲏⲣⲉⲙⲓⲟⲥ
ⲏⲣⲉⲙⲟⲥ	N	ⲏⲣⲉⲙⲟⲥ
ⲏⲣⲡ	N	ⲏⲣⲡ
ⲏⲥⲁⲓⲁⲥ	NPROP	ⲏⲥⲁⲓⲁⲥ
ⲏⲥⲁⲩ	NPROP	ⲏⲥⲁⲩ
ⲏⲥⲓⲭⲓⲁ	N	ⲏⲥⲓⲭⲓⲁ
ⲏⲥⲩⲭⲁⲍⲉ	V	ⲏⲥⲩⲭⲁⲍⲉ
ⲏⲥⲩⲭⲓⲁ	N	ⲏⲥⲩⲭⲓⲁ
ⲏⲩⲉ	N	ⲏⲩⲉ
ⲏ	CONJ	ⲏ
ⲑⲁⲃ	N	ⲑⲁⲃ
ⲑⲁⲇⲇⲁⲓⲟⲥ	N	ⲑⲁⲇⲇⲁⲓⲟⲥ
ⲑⲁⲏ	N	ⲑⲁⲏ
ⲑⲁⲓⲃⲉⲥ	N	ⲑⲁⲓⲃⲉⲥ
ⲑⲁⲗⲁⲥⲥⲁ	N	ⲑⲁⲗⲁⲥⲥⲁ
ⲑⲁⲗⲗⲓⲥ	N	ⲑⲁⲗⲗⲓⲥ
ⲑⲁⲗⲡⲉⲓ	V	ⲑⲁⲗⲡⲉⲓ
ⲑⲁⲣⲉⲓ	V	ⲑⲁⲣⲉⲓ
ⲑⲁⲣⲓ	V	ⲑⲁⲣⲓ
ⲑⲁⲣⲙⲉⲛⲓⲁ	NPROP	ⲑⲁⲣⲙⲉⲛⲓⲁ
ⲑⲁⲣⲙⲏⲛⲓⲁ	NPROP	ⲑⲁⲣⲙⲏⲛⲓⲁ
ⲑⲁⲣⲣⲉⲓ	V	ⲑⲁⲣⲣⲉⲓ
ⲑⲁⲣⲥⲟⲥ	N	ⲑⲁⲣⲥⲟⲥ
ⲑⲁⲩⲙⲁⲍⲉ	V	ⲑⲁⲩⲙⲁⲍⲉ
ⲑⲁⲩⲙⲁⲥⲓⲱⲧⲁⲧⲟⲥ	N	ⲑⲁⲩⲙⲁⲥⲓⲱⲧⲁⲧⲟⲥ
ⲑⲁⲩⲙⲁⲥⲧⲟⲛ	N	ⲑⲁⲩⲙⲁⲥⲧⲟⲛ
ⲑⲁⲩⲙⲁ	N	ⲑⲁⲩⲙⲁ
ⲑⲁⲯⲓⲥ	N	ⲑⲁⲯⲓⲥ
ⲑⲃⲃⲓⲉ	V	ⲑⲃⲃⲓⲟ
ⲑⲃⲃⲓⲏⲩ	VSTAT	ⲑⲃⲃⲓⲟ
ⲑⲃⲃⲓⲟ	N	ⲑⲃⲃⲓⲟ
ⲑⲃⲃⲓⲟ	V	ⲑⲃⲃⲓⲟ
ⲑⲉⲁⲧⲣⲟⲛ	N	ⲑⲉⲁⲧⲣⲟⲛ
ⲑⲉⲃⲁⲥⲓⲁ	NPROP	ⲑⲉⲃⲁⲥⲓⲁ
ⲑⲉⲃⲇⲟⲙⲁⲥ	N	ⲑⲉⲃⲇⲟⲙⲁⲥ
ⲑⲉⲃⲟⲃⲟⲗⲏ	N	ⲑⲉⲃⲟⲃⲟⲗⲏ
ⲑⲉⲓⲙⲁⲣⲙⲉⲛⲏ	N	ⲑⲉⲓⲙⲁⲣⲙⲉⲛⲏ
ⲑⲉⲓⲟⲛ	N	ⲑⲉⲓⲟⲛ
ⲑⲉⲓⲟⲥ	N	ⲑⲉⲓⲟⲥ
ⲑⲉⲗⲏⲙⲁ	N	ⲑⲉⲗⲏⲙⲁ
ⲑⲉⲗⲡⲓⲥ	N	ⲑⲉⲗⲡⲓⲥ
ⲑⲉⲟⲇⲟⲕⲟⲥ	N	ⲑⲉⲟⲇⲟⲕⲟⲥ
ⲑⲉⲟⲇⲟⲣⲓⲭⲟⲥ	NPROP	ⲑⲉⲟⲇⲟⲣⲓⲭⲟⲥ
ⲑⲉⲟⲇⲟⲣⲟⲥ	NPROP	ⲑⲉⲟⲇⲟⲣⲟⲥ
ⲑⲉⲟⲇⲟⲥⲓⲟⲥ	NPROP	ⲑⲉⲟⲇⲟⲥⲓⲟⲥ
ⲑⲉⲟⲇⲱⲣⲟⲥ	NPROP	ⲑⲉⲟⲇⲱⲣⲟⲥ
ⲑⲉⲟⲇⲱⲥⲓⲟⲥ	NPROP	ⲑⲉⲟⲇⲱⲥⲓⲟⲥ
ⲑⲉⲟⲗⲟⲅⲓⲁ	N	ⲑⲉⲟⲗⲟⲅⲓⲁ
ⲑⲉⲟⲗⲟⲅⲟⲥ	N	ⲑⲉⲟⲗⲟⲅⲟⲥ
ⲑⲉⲟⲣⲉⲓ	V	ⲑⲉⲟⲣⲉⲓ
ⲑⲉⲟⲥⲉⲃⲉⲓⲁ	N	ⲑⲉⲟⲥⲉⲃⲉⲓⲁ
ⲑⲉⲟⲥⲉⲃⲉⲥⲧⲁⲧⲟⲥ	N	ⲑⲉⲟⲥⲉⲃⲉⲥⲧⲁⲧⲟⲥ
ⲑⲉⲟⲥⲥⲉⲃⲏⲥ	N	ⲑⲉⲟⲥⲥⲉⲃⲏⲥ
ⲑⲉⲟⲧⲟⲕⲟⲥ	N	ⲑⲉⲟⲧⲟⲕⲟⲥ
ⲑⲉⲟⲫⲓⲗⲉⲥⲧⲁⲧⲟⲥ	N	ⲑⲉⲟⲫⲓⲗⲉⲥⲧⲁⲧⲟⲥ
ⲑⲉⲟⲫⲓⲗⲓⲁ	N	ⲑⲉⲟⲫⲓⲗⲓⲁ
ⲑⲉⲟⲫⲓⲗⲟⲥ	NPROP	ⲑⲉⲟⲫⲓⲗⲟⲥ
ⲑⲉⲟⲫⲟⲣⲟⲥ	N	ⲑⲉⲟⲫⲟⲣⲟⲥ
ⲑⲉⲟⲫⲩⲗⲟⲥ	NPROP	ⲑⲉⲟⲫⲩⲗⲟⲥ
ⲑⲉⲣⲁⲡⲉⲩⲉ	V	ⲑⲉⲣⲁⲡⲉⲩⲉ
ⲑⲉⲣⲁⲡⲓⲁ	N	ⲑⲉⲣⲁⲡⲓⲁ
ⲑⲉⲣⲁⲡⲟⲩ	V	ⲑⲉⲣⲁⲡⲟⲩ
ⲑⲉⲣⲙⲏⲛⲓⲁ	N	ⲑⲉⲣⲙⲏⲛⲓⲁ
ⲑⲉⲣⲙⲟⲫⲩⲗⲁⲕⲉ	N	ⲑⲉⲣⲙⲟⲫⲩⲗⲁⲕⲉ
ⲑⲉⲥⲓⲥ	N	ⲑⲉⲥⲓⲥ
ⲑⲉⲱⲇⲟⲥⲓⲟⲥ	NPROP	ⲑⲉⲱⲇⲟⲥⲓⲟⲥ
ⲑⲉⲱⲇⲱⲣⲟⲥ	NPROP	ⲑⲉⲱⲇⲱⲣⲟⲥ
ⲑⲉⲱⲇⲱⲥⲓⲟⲥ	NPROP	ⲑⲉⲱⲇⲱⲥⲓⲟⲥ
ⲑⲉⲱⲣⲉⲓ	V	ⲑⲉⲱⲣⲉⲓ
ⲑⲉⲱⲣⲓⲁ	N	ⲑⲉⲱⲣⲓⲁ
ⲑⲉⲱⲣⲓ	V	ⲑⲉⲱⲣⲓ
ⲑⲉⲱⲫⲓⲗⲟⲥ	NPROP	ⲑⲉⲱⲫⲓⲗⲟⲥ
ⲑⲏⲃⲁⲉⲓⲥ	NPROP	ⲑⲏⲃⲁⲉⲓⲥ
ⲑⲏⲃⲁⲓⲥ	NPROP	ⲑⲏⲃⲁⲓⲥ
ⲑⲏⲇⲟⲛⲏ	N	ⲑⲏⲇⲟⲛⲏ
ⲑⲏⲗⲩⲕⲟⲛ	N	ⲑⲏⲗⲩⲕⲟⲛ
ⲑⲏⲛ	N	ⲑⲏⲛ
ⲑⲏⲡ	N	ⲑⲏⲡ
ⲑⲏⲣⲁⲡⲉⲩⲉ	V	ⲑⲏⲣⲁⲡⲉⲩⲉ
ⲑⲏⲣⲓⲟⲛ	N	ⲑⲏⲣⲓⲟⲛ
ⲑⲏⲥⲁⲩⲣⲓⲁ	NPROP	ⲑⲏⲥⲁⲩⲣⲓⲁ
ⲑⲏⲥⲁⲩⲣⲟⲥ	N	ⲑⲏⲥⲁⲩⲣⲟⲥ
ⲑⲏⲥⲅⲉ	N	ⲑⲏⲥⲅⲉ
ⲑⲏⲥⲓⲁⲥⲧⲏⲣⲓⲟⲛ	N	ⲑⲏⲥⲓⲁⲥⲧⲏⲣⲓⲟⲛ
ⲑⲏ	N	ⲑⲏ
ⲑⲓⲉⲣⲟⲩⲥⲁⲗⲏⲙ	NPROP	ⲑⲓⲉⲣⲟⲩⲥⲁⲗⲏⲙ
ⲑⲓⲕⲱⲛ	N	ⲑⲓⲕⲱⲛ
ⲑⲓⲙⲁⲣⲙⲉⲛⲏ	N	ⲑⲓⲙⲁⲣⲙⲉⲛⲏ
ⲑⲓⲥⲁⲩⲣⲓⲁ	NPROP	ⲑⲓⲥⲁⲩⲣⲓⲁ
ⲑⲗⲓⲃⲉ	V	ⲑⲗⲓⲃⲉ
ⲑⲗⲓⲯⲓⲥ	N	ⲑⲗⲓⲯⲓⲥ
ⲑⲙⲕⲉ	V	ⲑⲙⲕⲟ
ⲑⲙⲕⲟ	N	ⲑⲙⲕⲟ
ⲑⲙⲕⲟ	V	ⲑⲙⲕⲟ
ⲑⲙⲙⲉ	N	ⲑⲙⲙⲉ
ⲑⲙⲟⲩⲓ	NPROP	ⲑⲙⲟⲩⲓ
ⲑⲙⲟ	V	ⲑⲙⲟ
ⲑⲙⲥⲟ	V	ⲑⲙⲥⲟ
ⲑⲛⲏⲧⲟⲛ	N	ⲑⲛⲏⲧⲟⲛ
ⲑⲛⲟⲛ	N	ⲑⲛⲟⲛ
ⲑⲟⲗⲟⲥ	N	ⲑⲟⲗⲟⲥ
ⲑⲟⲟⲩⲧ	NPROP	ⲑⲟⲟⲩⲧ
ⲑⲟⲣⲁⲥⲓⲥ	N	ⲑⲟⲣⲁⲥⲓⲥ
ⲑⲟⲧⲉ	N	ⲑⲟⲧⲉ
ⲑⲟⲩⲣⲁⲕⲓⲟⲛ	N	ⲑⲟⲩⲣⲁⲕⲓⲟⲛ
ⲑⲟ	V	ⲑⲟ
ⲑⲡⲟ	V	ⲧϩⲡⲟ
ⲑⲣϣⲟ	V	ⲧⲡⲣϣⲟ
ⲑⲣⲁⲝ	NPROP	ⲑⲣⲁⲝ
ⲑⲣⲉⲥⲕⲓⲁ	N	ⲑⲣⲉⲥⲕⲓⲁ
ⲑⲣⲏⲥⲕⲓⲁ	N	ⲑⲣⲏⲥⲕⲓⲁ
ⲑⲣⲓⲥⲕⲓⲁ	N	ⲑⲣⲓⲥⲕⲓⲁ
ⲑⲣⲟⲛⲟⲥ	N	ⲑⲣⲟⲛⲟⲥ
ⲑⲩⲕⲏ	N	ⲑⲩⲕⲏ
ⲑⲩⲗⲏ	N	ⲑⲩⲗⲏ
ⲑⲩⲗⲓⲕⲓⲁ	N	ⲑⲩⲗⲓⲕⲓⲁ
ⲑⲩⲙⲉⲗⲓⲕⲏ	N	ⲑⲩⲙⲉⲗⲓⲕⲏ
ⲑⲩⲙⲓⲁⲧⲏⲣⲓⲟⲛ	N	ⲑⲩⲙⲓⲁⲧⲏⲣⲓⲟⲛ
ⲑⲩⲙⲟⲥ	N	ⲑⲩⲙⲟⲥ
ⲑⲩⲡⲟⲧⲁⲅⲏ	N	ⲑⲩⲡⲟⲧⲁⲅⲏ
ⲑⲩⲡⲟⲩⲣⲅⲓⲁ	N	ⲑⲩⲡⲟⲩⲣⲅⲓⲁ
ⲑⲩⲣⲉⲟⲛ	N	ⲑⲩⲣⲉⲟⲛ
ⲑⲩⲣⲓⲟⲛ	N	ⲑⲩⲣⲓⲟⲛ
ⲑⲩⲣⲟⲣⲟⲥ	N	ⲑⲩⲣⲟⲣⲟⲥ
ⲑⲩⲥⲁⲩⲣⲟⲥ	N	ⲑⲩⲥⲁⲩⲣⲟⲥ
ⲑⲩⲥⲓⲁⲍⲉ	V	ⲑⲩⲥⲓⲁⲍⲉ
ⲑⲩⲥⲓⲁⲥⲧⲏⲣⲓⲟⲛ	N	ⲑⲩⲥⲓⲁⲥⲧⲏⲣⲓⲟⲛ
ⲑⲩⲥⲓⲁⲥⲧⲩⲣⲓⲟⲛ	N	ⲑⲩⲥⲓⲁⲥⲧⲩⲣⲓⲟⲛ
ⲑⲩⲥⲓⲁ	N	ⲑⲩⲥⲓⲁ
ⲑⲱⲙⲁⲥ	NPROP	ⲑⲱⲙⲁⲥ
ⲑ	ART	ⲑ
ⲓ̈ⲥⲟⲯⲩⲭⲟⲛ	N	ⲓ̈ⲥⲟⲯⲩⲭⲟⲛ
ⲓ̈ⲱⲧⲁ	N	ⲓ̈ⲱⲧⲁ
ⲓⲁⲉⲓⲣⲟⲥ	N	ⲓⲁⲉⲓⲣⲟⲥ
ⲓⲁⲕⲟⲃⲟⲥ	NPROP	ⲓⲁⲕⲟⲃⲟⲥ
ⲓⲁⲕⲱⲃⲟⲥ	NPROP	ⲓⲁⲕⲱⲃⲟⲥ
ⲓⲁⲕⲱⲃ	NPROP	ⲓⲁⲕⲱⲃ
ⲓⲁⲙⲃⲣⲏⲥ	NPROP	ⲓⲁⲙⲃⲣⲏⲥ
ⲓⲁⲛⲛϩⲥ	NPROP	ⲓⲁⲛⲛϩⲥ
ⲓⲁⲛⲛⲏⲥ	NPROP	ⲓⲁⲛⲛⲏⲥ
ⲓⲁⲥⲡⲓⲥ	N	ⲓⲁⲥⲡⲓⲥ
ⲓⲁ	V	ⲓⲁ
ⲓⲃⲉⲣⲟⲥ	N	ⲓⲃⲉⲣⲟⲥ
ⲓⲃⲉ	V	ⲓⲃⲉ
ⲓⲇⲟⲩⲙⲁⲓⲁ	N	ⲓⲇⲟⲩⲙⲁⲓⲁ
ⲓⲇⲟⲩⲙⲁⲓⲟⲥ	N	ⲓⲇⲟⲩⲙⲁⲓⲟⲥ
ⲓⲉⲃⲉⲧ	N	ⲓⲉⲃⲉⲧ
ⲓⲉⲍⲁ	NPROP	ⲓⲉⲍⲁ
ⲓⲉⲍⲉⲕⲓⲏⲗ	NPROP	ⲓⲉⲍⲉⲕⲓⲏⲗ
ⲓⲉⲍⲉⲕⲓⲥⲣⲁⲏⲗ	NPROP	ⲓⲉⲍⲉⲕⲓⲥⲣⲁⲏⲗ
ⲓⲉⲣⲉⲙⲓⲁⲥ	NPROP	ⲓⲉⲣⲉⲙⲓⲁⲥ
ⲓⲉⲣⲉⲙⲓⲁ	NPROP	ⲓⲉⲣⲉⲙⲓⲁ
ⲓⲉⲣⲉⲩⲥ	N	ⲓⲉⲣⲉⲩⲥ
ⲓⲉⲣⲏⲙⲓⲁⲥ	NPROP	ⲓⲉⲣⲏⲙⲓⲁⲥ
ⲓⲉⲣⲏⲛⲛⲁⲓⲟⲥ	NPROP	ⲓⲉⲣⲏⲛⲛⲁⲓⲟⲥ
ⲓⲉⲣⲟⲯⲁⲗⲧⲏⲥ	N	ⲓⲉⲣⲟⲯⲁⲗⲧⲏⲥ
ⲓⲉⲣⲟ	N	ⲓⲉⲣⲟ
ⲓⲉⲣⲱⲟⲩ	N	ⲉⲓⲟⲟⲣ
ⲓⲉⲥⲥⲁⲓ	NPROP	ⲓⲉⲥⲥⲁⲓ
ⲓⲉⲭⲟⲛⲓⲁⲥ	NPROP	ⲓⲉⲭⲟⲛⲓⲁⲥ
ⲓⲏⲥⲟⲩⲥ	N	ⲓⲏⲥⲟⲩⲥ
ⲓⲏⲥⲟⲩⲥ	NPROP	ⲓⲏⲥⲟⲩⲥ
ⲓⲏⲥ	NPROP	ⲓⲏⲥⲟⲩⲥ
ⲓⲕⲧⲉⲣⲟⲥ	N	ⲓⲕⲧⲉⲣⲟⲥ
ⲓⲗⲗⲟⲩⲥⲧⲣ/	N	ⲓⲗⲗⲟⲩⲥⲧⲣ/
ⲓⲛⲁ	ADV	ⲓⲛⲁ
ⲓⲛⲇⲓⲁ	NPROP	ⲓⲛⲇⲓⲁ
ⲓⲛⲇⲓⲕⲧⲓⲟⲛⲟⲥ	FM	ⲓⲛⲇⲓⲕⲧⲓⲟⲛⲟⲥ
ⲓⲟⲃⲉⲛⲛⲁⲗⲓⲟⲥ	NPROP	ⲓⲟⲃⲉⲛⲛⲁⲗⲓⲟⲥ
ⲓⲟⲃⲓⲁⲛⲟⲥ	NPROP	ⲓⲟⲃⲓⲁⲛⲟⲥ
ⲓⲟⲣⲇⲁⲛⲏⲥ	NPROP	ⲓⲟⲣⲇⲁⲛⲏⲥ
ⲓⲟⲧⲉ	N	ⲉⲓⲱⲧ
ⲓⲟⲩⲃⲉⲛⲁⲗⲓⲟⲥ	NPROP	ⲓⲟⲩⲃⲉⲛⲁⲗⲓⲟⲥ
ⲓⲟⲩⲃⲉⲛⲛⲁⲗⲓⲟⲥ	NPROP	ⲓⲟⲩⲃⲉⲛⲛⲁⲗⲓⲟⲥ
ⲓⲟⲩⲃⲓⲁⲛⲟⲥ	NPROP	ⲓⲟⲩⲃⲓⲁⲛⲟⲥ
ⲓⲟⲩⲇⲁⲓⲁ	N	ⲓⲟⲩⲇⲁⲓⲁ
ⲓⲟⲩⲇⲁⲓⲁ	NPROP	ⲓⲟⲩⲇⲁⲓⲁ
ⲓⲟⲩⲇⲁⲓⲟⲥ	N	ⲓⲟⲩⲇⲁⲓⲟⲥ
ⲓⲟⲩⲇⲁⲓ	N	ⲓⲟⲩⲇⲁⲓ
ⲓⲟⲩⲇⲁⲓ	NPROP	ⲓⲟⲩⲇⲁⲓ
ⲓⲟⲩⲇⲁⲥ	NPROP	ⲓⲟⲩⲇⲁⲥ
ⲓⲟⲩⲇⲁ	NPROP	ⲓⲟⲩⲇⲁ
ⲓⲟⲩⲗⲉ	NPROP	ⲓⲟⲩⲗⲉ
ⲓⲟⲩⲗⲓⲁⲛⲟⲥ	NPROP	ⲓⲟⲩⲗⲓⲁⲛⲟⲥ
ⲓⲟⲩⲗⲓⲟⲥ	NPROP	ⲓⲟⲩⲗⲓⲟⲥ
ⲓⲟⲩⲥϯⲛⲟⲥ	NPROP	ⲓⲟⲩⲥϯⲛⲟⲥ
ⲓⲟⲩⲥⲧⲓⲛⲟⲥ	NPROP	ⲓⲟⲩⲥⲧⲓⲛⲟⲥ
ⲓⲟⲩ	NPROP	ⲓⲟⲩ
ⲓⲣⲉ	V	ⲓⲣⲉ
ⲓⲣⲏⲛⲏⲕⲟⲛ	N	ⲓⲣⲏⲛⲏⲕⲟⲛ
ⲓⲣⲏⲛⲏ	N	ⲓⲣⲏⲛⲏ
ⲓⲣⲏⲛⲓⲕⲟⲛ	N	ⲓⲣⲏⲛⲓⲕⲟⲛ
ⲓⲥⲁⲁⲕ	NPROP	ⲓⲥⲁⲁⲕ
ⲓⲥⲁⲕ	NPROP	ⲓⲥⲁⲕ
ⲓⲥⲓⲇⲱⲣⲟⲥ	NPROP	ⲓⲥⲓⲇⲱⲣⲟⲥ
ⲓⲥⲕⲁⲣⲓⲱⲧⲏⲥ	N	ⲓⲥⲕⲁⲣⲓⲱⲧⲏⲥ
ⲓⲥⲕⲁⲣⲓⲱⲧⲏⲥ	NPROP	ⲓⲥⲕⲁⲣⲓⲱⲧⲏⲥ
ⲓⲥⲙⲁⲏⲗⲓⲧⲏⲥ	N	ⲓⲥⲙⲁⲏⲗⲓⲧⲏⲥ
ⲓⲥⲙⲁⲏⲗ	NPROP	ⲓⲥⲙⲁⲏⲗ
ⲓⲥⲣⲁⲏⲗⲓⲧⲏⲥ	N	ⲓⲥⲣⲁⲏⲗⲓⲧⲏⲥ
ⲓⲥⲣⲁⲏⲗ	NPROP	ⲓⲥⲣⲁⲏⲗ
ⲓⲥⲧⲟⲣⲓⲁ	N	ⲓⲥⲧⲟⲣⲓⲁ
ⲓⲥⲧⲱⲣⲓⲁ	N	ⲓⲥⲧⲱⲣⲓⲁ
ⲓⲥ	NPROP	ⲓⲏⲥⲟⲩⲥ
ⲓⲭⲛⲟⲥ	N	ⲓⲭⲛⲟⲥ
ⲓⲱϩⲁⲛⲏⲥ	NPROP	ⲓⲱϩⲁⲛⲏⲥ
ⲓⲱϩⲁⲛⲛⲏⲥ	N	ⲓⲱϩⲁⲛⲛⲏⲥ
ⲓⲱϩⲁⲛⲛⲏⲥ	NPROP	ⲓⲱϩⲁⲛⲛⲏⲥ
ⲓⲱⲁⲑⲁⲙ	NPROP	ⲓⲱⲁⲑⲁⲙ
ⲓⲱⲁⲕⲓⲙ	V	ⲓⲱⲁⲕⲓⲙ
ⲓⲱⲁⲛⲛⲏⲥ	NPROP	ⲓⲱⲁⲛⲛⲏⲥ
ⲓⲱⲃⲏⲇ	NPROP	ⲓⲱⲃⲏⲇ
ⲓⲱⲃ	NPROP	ⲓⲱⲃ
ⲓⲱⲛⲁⲑⲁⲙ	NPROP	ⲓⲱⲛⲁⲑⲁⲙ
ⲓⲱⲣⲁⲙ	NPROP	ⲓⲱⲣⲁⲙ
ⲓⲱⲥⲁⲫⲁⲧ	NPROP	ⲓⲱⲥⲁⲫⲁⲧ
ⲓⲱⲥⲏⲡⲡⲟⲥ	NPROP	ⲓⲱⲥⲏⲡⲡⲟⲥ
ⲓⲱⲥⲏⲫ	NPROP	ⲓⲱⲥⲏⲫ
ⲓⲱⲥⲏ	N	ⲓⲱⲥⲏ
ⲓⲱⲥⲏ	NPROP	ⲓⲱⲥⲏ
ⲓⲱⲥⲓⲁⲥ	NPROP	ⲓⲱⲥⲓⲁⲥ
ⲓⲱⲧ	N	ⲉⲓⲱⲧ
ⲓⲱⲧ	N	ⲓⲱⲧ
ⲓ	PPERO	ⲁⲛⲟⲕ
ⲓ	PPERS	ⲁⲛⲟⲕ
ⲕ̄ⲩ̅	N	ⲕ̄ⲩ̅
ⲕⲁϣ	N	ⲕⲁϣ
ⲕⲁϩⲏⲩ	ADV	ⲕⲁϩⲏⲩ
ⲕⲁϩⲕϩ	V	ⲕⲁϩⲕϩ
ⲕⲁϩⲕⲉϩ	V	ⲕⲁϩⲕⲉϩ
ⲕⲁϩⲧⲏ	V	ⲕⲁϩⲧⲏ
ⲕⲁϩ	N	ⲕⲁϩ
ⲕⲁϯⲭⲉ	V	ⲕⲁϯⲭⲉ
ⲕⲁⲁⲧ	VSTAT	ⲕⲁⲁⲧ
ⲕⲁⲁⲩ	V	ⲕⲁⲁⲩ
ⲕⲁⲁ	V	ⲕⲱ
ⲕⲁⲃⲁⲗⲗⲉⲩⲥ	N	ⲕⲁⲃⲁⲗⲗⲉⲩⲥ
ⲕⲁⲃⲓⲧⲁⲣⲉ	N	ⲕⲁⲃⲓⲧⲁⲣⲉ
ⲕⲁⲇⲁⲝⲓⲁⲣⲭⲏⲥ	N	ⲕⲁⲇⲁⲝⲓⲁⲣⲭⲏⲥ
ⲕⲁⲉⲓⲛ	NPROP	ⲕⲁⲉⲓⲛ
ⲕⲁⲉⲩⲱ	V	ⲕⲁⲉⲩⲱ
ⲕⲁⲍⲟⲫⲩⲗⲁⲅⲓⲟⲛ	N	ⲕⲁⲍⲟⲫⲩⲗⲁⲅⲓⲟⲛ
ⲕⲁⲍⲟⲫⲩⲗⲁⲕⲓⲟⲛ	N	ⲕⲁⲍⲟⲫⲩⲗⲁⲕⲓⲟⲛ
ⲕⲁⲑⲁⲓⲣⲉⲥⲓⲥ	N	ⲕⲁⲑⲁⲓⲣⲉⲥⲓⲥ
ⲕⲁⲑⲁⲓⲣⲏⲥⲓⲥ	N	ⲕⲁⲑⲁⲓⲣⲏⲥⲓⲥ
ⲕⲁⲑⲁⲓⲣⲟⲩ	V	ⲕⲁⲑⲁⲓⲣⲟⲩ
ⲕⲁⲑⲁⲣⲓⲍⲉ	V	ⲕⲁⲑⲁⲣⲓⲍⲉ
ⲕⲁⲑⲁⲣⲓⲥⲙⲟⲥ	N	ⲕⲁⲑⲁⲣⲓⲥⲙⲟⲥ
ⲕⲁⲑⲁⲣⲓⲱⲧⲏⲥ	N	ⲕⲁⲑⲁⲣⲓⲱⲧⲏⲥ
ⲕⲁⲑⲁⲣⲟⲛ	N	ⲕⲁⲑⲁⲣⲟⲛ
ⲕⲁⲑⲁⲣⲟⲥ	N	ⲕⲁⲑⲁⲣⲟⲥ
ⲕⲁⲑⲉⲇⲣⲁ	N	ⲕⲁⲑⲉⲇⲣⲁ
ⲕⲁⲑⲉⲇⲣⲟⲥ	N	ⲕⲁⲑⲉⲇⲣⲟⲥ
ⲕⲁⲑⲉⲣⲉⲥⲓⲥ	N	ⲕⲁⲑⲉⲣⲉⲥⲓⲥ
ⲕⲁⲑⲉⲣⲏⲥⲓⲥ	N	ⲕⲁⲑⲉⲣⲏⲥⲓⲥ
ⲕⲁⲑⲏⲅⲉⲓ	V	ⲕⲁⲑⲏⲅⲉⲓ
ⲕⲁⲑⲏⲅⲓ	V	ⲕⲁⲑⲏⲅⲓ
ⲕⲁⲑⲏⲕⲉⲓ	V	ⲕⲁⲑⲏⲕⲉⲓ
ⲕⲁⲑⲏⲕⲏⲥⲓⲥ	N	ⲕⲁⲑⲏⲕⲏⲥⲓⲥ
ⲕⲁⲑⲏⲕⲟⲩⲙⲉⲛⲓⲧⲏⲥ	N	ⲕⲁⲑⲏⲕⲟⲩⲙⲉⲛⲓⲧⲏⲥ
ⲕⲁⲑⲏⲕⲟⲩⲙⲉⲛⲟⲥ	N	ⲕⲁⲑⲏⲕⲟⲩⲙⲉⲛⲟⲥ
ⲕⲁⲑⲓⲥⲧⲁ	V	ⲕⲁⲑⲓⲥⲧⲁ
ⲕⲁⲑⲟⲗⲓⲕϩ	N	ⲕⲁⲑⲟⲗⲓⲕϩ
ⲕⲁⲑⲟⲗⲓⲕⲏ	N	ⲕⲁⲑⲟⲗⲓⲕⲏ
ⲕⲁⲑⲟⲗⲓⲕⲟⲛ	N	ⲕⲁⲑⲟⲗⲓⲕⲟⲛ
ⲕⲁⲑⲟⲧⲓ	ADV	ⲕⲁⲑⲟⲧⲓ
ⲕⲁⲓⲅⲁⲣ	CONJ	ⲕⲁⲓⲅⲁⲣ
ⲕⲁⲓⲉ	N	ⲕⲁⲓⲉ
ⲕⲁⲓⲕⲟⲛ	N	ⲕⲁⲓⲕⲟⲛ
ⲕⲁⲓⲙⲏⲛ	CONJ	ⲕⲁⲓⲙⲏⲛ
ⲕⲁⲓⲛⲏ	N	ⲕⲁⲓⲛⲏ
ⲕⲁⲓⲛ	NPROP	ⲕⲁⲓⲛ
ⲕⲁⲓⲡⲉⲣ	CONJ	ⲕⲁⲓⲡⲉⲣ
ⲕⲁⲓⲣⲟⲥ	N	ⲕⲁⲓⲣⲟⲥ
ⲕⲁⲓⲥⲁⲣⲉⲓⲁ	NPROP	ⲕⲁⲓⲥⲁⲣⲉⲓⲁ
ⲕⲁⲓⲥⲁⲣⲓⲁ	NPROP	ⲕⲁⲓⲥⲁⲣⲓⲁ
ⲕⲁⲓⲥⲁⲣⲓⲟⲥ	NPROP	ⲕⲁⲓⲥⲁⲣⲓⲟⲥ
ⲕⲁⲓⲥⲁⲣ	N	ⲕⲁⲓⲥⲁⲣ
ⲕⲁⲓⲥⲉ	N	ⲕⲁⲓⲥⲉ
ⲕⲁⲓⲧⲟⲓ	CONJ	ⲕⲁⲓⲧⲟⲓ
ⲕⲁⲓⲫⲁⲗⲁⲓⲟⲛ	N	ⲕⲁⲓⲫⲁⲗⲁⲓⲟⲛ
ⲕⲁⲓⲫⲁⲥ	NPROP	ⲕⲁⲓⲫⲁⲥ
ⲕⲁⲓ	CONJ	ⲕⲁⲓ
ⲕⲁⲕⲉ	N	ⲕⲁⲕⲉ
ⲕⲁⲕⲓⲁ	N	ⲕⲁⲕⲓⲁ
ⲕⲁⲕⲓⲛⲕⲁⲕⲱⲥ	ADV	ⲕⲁⲕⲓⲛⲕⲁⲕⲱⲥ
ⲕⲁⲕⲟⲅⲏⲣⲟⲥ	N	ⲕⲁⲕⲟⲅⲏⲣⲟⲥ
ⲕⲁⲕⲟⲏⲑⲉⲓⲁ	N	ⲕⲁⲕⲟⲏⲑⲉⲓⲁ
ⲕⲁⲕⲟⲛⲟⲓⲁ	N	ⲕⲁⲕⲟⲛⲟⲓⲁ
ⲕⲁⲕⲟⲛ	N	ⲕⲁⲕⲟⲛ
ⲕⲁⲕⲟⲥ	N	ⲕⲁⲕⲟⲥ
ⲕⲁⲕⲟⲩⲣⲅⲓⲁ	N	ⲕⲁⲕⲟⲩⲣⲅⲓⲁ
ⲕⲁⲕⲟⲩⲣⲅⲟⲥ	N	ⲕⲁⲕⲟⲩⲣⲅⲟⲥ
ⲕⲁⲕⲟⲩ	V	ⲕⲁⲕⲟⲩ
ⲕⲁⲕⲱⲥⲓⲥ	N	ⲕⲁⲕⲱⲥⲓⲥ
ⲕⲁⲕⲱⲥ	ADV	ⲕⲁⲕⲱⲥ
ⲕⲁⲗⲁϩⲏ	N	ⲕⲁⲗⲁϩⲏ
ⲕⲁⲗⲁⲉⲓⲛⲟⲥ	N	ⲕⲁⲗⲁⲉⲓⲛⲟⲥ
ⲕⲁⲗⲁⲕⲓⲁ	N	ⲕⲁⲗⲁⲕⲓⲁ
ⲕⲁⲗⲁⲙⲁⲣⲓⲟⲛ	N	ⲕⲁⲗⲁⲙⲁⲣⲓⲟⲛ
ⲕⲁⲗⲉⲓ	V	ⲕⲁⲗⲉⲓ
ⲕⲁⲗⲗⲁⲉⲓⲛⲏ	N	ⲕⲁⲗⲗⲁⲉⲓⲛⲏ
ⲕⲁⲗⲗⲓⲅⲣⲁⲫⲟⲥ	N	ⲕⲁⲗⲗⲓⲅⲣⲁⲫⲟⲥ
ⲕⲁⲗⲗⲓⲛⲓⲕⲟⲥ	N	ⲕⲁⲗⲗⲓⲛⲓⲕⲟⲥ
ⲕⲁⲗⲗⲓⲡⲁ	NPROP	ⲕⲁⲗⲗⲓⲡⲁ
ⲕⲁⲗⲗⲟⲥ	N	ⲕⲁⲗⲗⲟⲥ
ⲕⲁⲗⲟⲥ	ADV	ⲕⲁⲗⲟⲥ
ⲕⲁⲗⲩⲃⲏ	N	ⲕⲁⲗⲩⲃⲏ
ⲕⲁⲗⲩⲙⲙⲁ	N	ⲕⲁⲗⲩⲙⲙⲁ
ⲕⲁⲗⲩⲡⲧⲟⲥ	N	ⲕⲁⲗⲩⲡⲧⲟⲥ
ⲕⲁⲗⲱⲥ	ADV	ⲕⲁⲗⲱⲥ
ⲕⲁⲙⲁⲇⲓⲟⲛ	N	ⲕⲁⲙⲁⲇⲓⲟⲛ
ⲕⲁⲙⲁⲣⲉ	N	ⲕⲁⲙⲁⲣⲉ
ⲕⲁⲙⲁ	V	ⲕⲁⲙⲁ
ⲕⲁⲙⲃⲏ	N	ⲕⲁⲙⲃⲏ
ⲕⲁⲙⲓⲛⲟⲥ	N	ⲕⲁⲙⲓⲛⲟⲥ
ⲕⲁⲙⲓⲥⲓⲟⲛ	N	ⲕⲁⲙⲓⲥⲓⲟⲛ
ⲕⲁⲛⲁⲛⲁⲓⲟⲥ	N	ⲕⲁⲛⲁⲛⲁⲓⲟⲥ
ⲕⲁⲛⲁⲛⲓⲧⲏⲥ	N	ⲕⲁⲛⲁⲛⲓⲧⲏⲥ
ⲕⲁⲛⲇⲁⲕⲏ	NPROP	ⲕⲁⲛⲇⲁⲕⲏ
ⲕⲁⲛⲇⲓⲇⲓⲁⲛⲟⲥ	NPROP	ⲕⲁⲛⲇⲓⲇⲓⲁⲛⲟⲥ
ⲕⲁⲛⲇⲓⲧⲓⲁⲛⲟⲥ	NPROP	ⲕⲁⲛⲇⲓⲧⲓⲁⲛⲟⲥ
ⲕⲁⲛⲟⲛ	N	ⲕⲁⲛⲟⲛ
ⲕⲁⲛⲟⲡⲟⲥ	NPROP	ⲕⲁⲛⲟⲡⲟⲥ
ⲕⲁⲛⲱⲛⲓⲍⲉ	V	ⲕⲁⲛⲱⲛⲓⲍⲉ
ⲕⲁⲛⲱⲛ	N	ⲕⲁⲛⲱⲛ
ⲕⲁⲛ	CONJ	ⲕⲁⲛ
ⲕⲁⲡⲁⲣⲛⲁⲟⲩⲙ	NPROP	ⲕⲁⲡⲁⲣⲛⲁⲟⲩⲙ
ⲕⲁⲡⲏⲗⲉⲩⲉ	V	ⲕⲁⲡⲏⲗⲉⲩⲉ
ⲕⲁⲡⲏⲗⲟⲥ	N	ⲕⲁⲡⲏⲗⲟⲥ
ⲕⲁⲡⲛⲟⲥ	N	ⲕⲁⲡⲛⲟⲥ
ⲕⲁⲡⲡⲁⲇⲟⲕⲓⲁ	NPROP	ⲕⲁⲡⲡⲁⲇⲟⲕⲓⲁ
ⲕⲁⲡⲡⲁⲇⲟⲝ	N	ⲕⲁⲡⲡⲁⲇⲟⲝ
ⲕⲁⲣⲁⲧ	V	ⲕⲁⲣⲁⲧ
ⲕⲁⲣⲓⲛⲟⲥ	NPROP	ⲕⲁⲣⲓⲛⲟⲥ
ⲕⲁⲣⲙⲏⲗⲟⲥ	NPROP	ⲕⲁⲣⲙⲏⲗⲟⲥ
ⲕⲁⲣⲟⲓⲁ	N	ⲕⲁⲣⲟⲓⲁ
ⲕⲁⲣⲟⲥ	NPROP	ⲕⲁⲣⲟⲥ
ⲕⲁⲣⲡⲟⲥ	N	ⲕⲁⲣⲡⲟⲥ
ⲕⲁⲣⲡⲟⲥ	NPROP	ⲕⲁⲣⲡⲟⲥ
ⲕⲁⲣⲡⲟⲫⲟⲣⲓ̄ⲁ	N	ⲕⲁⲣⲡⲟⲫⲟⲣⲓ̄ⲁ
ⲕⲁⲣⲡⲱⲕⲣⲁⲧⲱⲣ	NPROP	ⲕⲁⲣⲡⲱⲕⲣⲁⲧⲱⲣ
ⲕⲁⲣⲭⲏⲇⲱⲛ	NPROP	ⲕⲁⲣⲭⲏⲇⲱⲛ
ⲕⲁⲣⲱϥ	N	ⲕⲁⲣⲱϥ
ⲕⲁⲣⲱ	V	ⲣⲟ
ⲕⲁⲥⲓⲁⲛⲟⲥ	NPROP	ⲕⲁⲥⲓⲁⲛⲟⲥ
ⲕⲁⲥⲓⲁ	N	ⲕⲁⲥⲓⲁ
ⲕⲁⲥⲓⲥ	N	ⲕⲁⲥⲓⲥ
ⲕⲁⲥⲕⲉⲥ	V	ⲕⲁⲥⲕⲉⲥ
ⲕⲁⲥⲕⲥ	V	ⲕⲁⲥⲕⲥ
ⲕⲁⲥⲧⲣⲟⲛ	N	ⲕⲁⲥⲧⲣⲟⲛ
ⲕⲁⲥⲧⲱⲣ	NPROP	ⲕⲁⲥⲧⲱⲣ
ⲕⲁⲥ	N	ⲕⲁⲥ
ⲕⲁⲧⲁϩⲣⲁⲕⲧⲏⲥ	N	ⲕⲁⲧⲁϩⲣⲁⲕⲧⲏⲥ
ⲕⲁⲧⲁⲃⲁⲥⲓⲥ	N	ⲕⲁⲧⲁⲃⲁⲥⲓⲥ
ⲕⲁⲧⲁⲃⲟⲗⲏ	N	ⲕⲁⲧⲁⲃⲟⲗⲏ
ⲕⲁⲧⲁⲅⲓⲛⲱⲥⲕⲉ	V	ⲕⲁⲧⲁⲅⲓⲛⲱⲥⲕⲉ
ⲕⲁⲧⲁⲅⲓⲟⲛ	N	ⲕⲁⲧⲁⲅⲓⲟⲛ
ⲕⲁⲧⲁⲅⲛⲱⲥⲓⲥ	N	ⲕⲁⲧⲁⲅⲛⲱⲥⲓⲥ
ⲕⲁⲧⲁⲇⲓⲕⲁⲍⲉ	V	ⲕⲁⲧⲁⲇⲓⲕⲁⲍⲉ
ⲕⲁⲧⲁⲇⲓⲕⲏ	N	ⲕⲁⲧⲁⲇⲓⲕⲏ
ⲕⲁⲧⲁⲇⲓⲕⲟⲥ	N	ⲕⲁⲧⲁⲇⲓⲕⲟⲥ
ⲕⲁⲧⲁⲇⲓⲕⲱⲥ	N	ⲕⲁⲧⲁⲇⲓⲕⲱⲥ
ⲕⲁⲧⲁⲕⲉⲛⲉ	V	ⲕⲁⲧⲁⲕⲉⲛⲉ
ⲕⲁⲧⲁⲕⲓⲟⲛ	N	ⲕⲁⲧⲁⲕⲓⲟⲛ
ⲕⲁⲧⲁⲕⲗⲉⲓⲥⲙⲟⲥ	N	ⲕⲁⲧⲁⲕⲗⲉⲓⲥⲙⲟⲥ
ⲕⲁⲧⲁⲕⲗⲩⲥⲙⲟⲥ	N	ⲕⲁⲧⲁⲕⲗⲩⲥⲙⲟⲥ
ⲕⲁⲧⲁⲕⲣⲓⲙⲁ	N	ⲕⲁⲧⲁⲕⲣⲓⲙⲁ
ⲕⲁⲧⲁⲕⲣⲓⲛⲉ	V	ⲕⲁⲧⲁⲕⲣⲓⲛⲉ
ⲕⲁⲧⲁⲕⲣⲓⲥⲓⲥ	N	ⲕⲁⲧⲁⲕⲣⲓⲥⲓⲥ
ⲕⲁⲧⲁⲗⲁⲗⲉⲓ	V	ⲕⲁⲧⲁⲗⲁⲗⲉⲓ
ⲕⲁⲧⲁⲗⲁⲗⲓⲁ	N	ⲕⲁⲧⲁⲗⲁⲗⲓⲁ
ⲕⲁⲧⲁⲗⲁⲙⲃⲁⲛⲉ	V	ⲕⲁⲧⲁⲗⲁⲙⲃⲁⲛⲉ
ⲕⲁⲧⲁⲗⲁⲥⲉ	V	ⲕⲁⲧⲁⲗⲁⲥⲉ
ⲕⲁⲧⲁⲗⲗⲁⲅⲏ	N	ⲕⲁⲧⲁⲗⲗⲁⲅⲏ
ⲕⲁⲧⲁⲗⲩⲉ	V	ⲕⲁⲧⲁⲗⲩⲉ
ⲕⲁⲧⲁⲗⲩ	V	ⲕⲁⲧⲁⲗⲩ
ⲕⲁⲧⲁⲙⲁ	ADV	ⲕⲁⲧⲁⲙⲁ
ⲕⲁⲧⲁⲛⲟⲉⲓ	V	ⲕⲁⲧⲁⲛⲟⲉⲓ
ⲕⲁⲧⲁⲛⲟⲓ	V	ⲕⲁⲧⲁⲛⲟⲓ
ⲕⲁⲧⲁⲛⲧⲁ	ADV	ⲕⲁⲧⲁⲛⲧⲁ
ⲕⲁⲧⲁⲛⲧⲁ	V	ⲕⲁⲧⲁⲛⲧⲁ
ⲕⲁⲧⲁⲝⲓⲟⲩ	V	ⲕⲁⲧⲁⲝⲓⲟⲩ
ⲕⲁⲧⲁⲡⲁⲧⲓ	V	ⲕⲁⲧⲁⲡⲁⲧⲓ
ⲕⲁⲧⲁⲡⲉⲧⲁⲥⲙⲁ	N	ⲕⲁⲧⲁⲡⲉⲧⲁⲥⲙⲁ
ⲕⲁⲧⲁⲡⲟⲛⲧⲓⲍⲉ	V	ⲕⲁⲧⲁⲡⲟⲛⲧⲓⲍⲉ
ⲕⲁⲧⲁⲡⲱⲛⲧⲓⲍⲉ	V	ⲕⲁⲧⲁⲡⲱⲛⲧⲓⲍⲉ
ⲕⲁⲧⲁⲣⲅⲉⲓ	V	ⲕⲁⲧⲁⲣⲅⲉⲓ
ⲕⲁⲧⲁⲣⲟ	PREP	ⲕⲁⲧⲁ
ⲕⲁⲧⲁⲣⲱ	PREP	ⲕⲁⲧⲁ
ⲕⲁⲧⲁⲥⲕⲟⲡⲟⲥ	N	ⲕⲁⲧⲁⲥⲕⲟⲡⲟⲥ
ⲕⲁⲧⲁⲥⲧⲁⲥⲓⲥ	N	ⲕⲁⲧⲁⲥⲧⲁⲥⲓⲥ
ⲕⲁⲧⲁⲥⲧⲣⲉⲫⲉ	V	ⲕⲁⲧⲁⲥⲧⲣⲉⲫⲉ
ⲕⲁⲧⲁⲥⲧⲣⲟⲫⲏ	N	ⲕⲁⲧⲁⲥⲧⲣⲟⲫⲏ
ⲕⲁⲧⲁⲥⲧⲩⲗⲉ	V	ⲕⲁⲧⲁⲥⲧⲩⲗⲉ
ⲕⲁⲧⲁⲧⲁⲝⲓⲥ	N	ⲕⲁⲧⲁⲧⲁⲝⲓⲥ
ⲕⲁⲧⲁⲧⲓⲕⲏ	N	ⲕⲁⲧⲁⲧⲓⲕⲏ
ⲕⲁⲧⲁⲫⲣⲟⲛⲉⲓ	V	ⲕⲁⲧⲁⲫⲣⲟⲛⲉⲓ
ⲕⲁⲧⲁⲫⲣⲟⲛⲏⲥⲓⲥ	N	ⲕⲁⲧⲁⲫⲣⲟⲛⲏⲥⲓⲥ
ⲕⲁⲧⲁⲫⲣⲟⲛⲏⲧⲏⲥ	N	ⲕⲁⲧⲁⲫⲣⲟⲛⲏⲧⲏⲥ
ⲕⲁⲧⲁⲫⲣⲟⲛⲓ	V	ⲕⲁⲧⲁⲫⲣⲟⲛⲓ
ⲕⲁⲧⲁ	PREP	ⲕⲁⲧⲁ
ⲕⲁⲧⲉⲭⲉ	V	ⲕⲁⲧⲉⲭⲉ
ⲕⲁⲧⲏⲅⲟⲣⲉⲓ	V	ⲕⲁⲧⲏⲅⲟⲣⲉⲓ
ⲕⲁⲧⲏⲅⲟⲣⲓⲁ	N	ⲕⲁⲧⲏⲅⲟⲣⲓⲁ
ⲕⲁⲧⲏⲅⲟⲣⲓ	V	ⲕⲁⲧⲏⲅⲟⲣⲓ
ⲕⲁⲧⲏⲅⲟⲣⲟⲥ	N	ⲕⲁⲧⲏⲅⲟⲣⲟⲥ
ⲕⲁⲧⲏⲭⲉⲓ	V	ⲕⲁⲧⲏⲭⲉⲓ
ⲕⲁⲧⲏⲭⲉⲥⲓⲥ	N	ⲕⲁⲧⲏⲭⲉⲥⲓⲥ
ⲕⲁⲧⲏⲭⲏ	V	ⲕⲁⲧⲏⲭⲏ
ⲕⲁⲧⲓⲗⲁ	N	ⲕⲁⲧⲓⲗⲁ
ⲕⲁⲧⲓⲭⲉ	V	ⲕⲁⲧⲓⲭⲉ
ⲕⲁⲧⲟⲟⲧ	V	ⲕⲁⲧⲟⲟⲧ
ⲕⲁⲧⲟⲣⲑⲟⲩ	V	ⲕⲁⲧⲟⲣⲑⲟⲩ
ⲕⲁⲧⲟⲣⲑⲱⲙⲁ	N	ⲕⲁⲧⲟⲣⲑⲱⲙⲁ
ⲕⲁⲧⲟⲣⲑⲱⲥⲓⲥ	N	ⲕⲁⲧⲟⲣⲑⲱⲥⲓⲥ
ⲕⲁⲧⲟⲥ	N	ⲕⲁⲧⲟⲥ
ⲕⲁⲧⲟⲭⲏ	N	ⲕⲁⲧⲟⲭⲏ
ⲕⲁⲩⲙⲁ	N	ⲕⲁⲩⲙⲁ
ⲕⲁⲩⲥⲟⲛ	N	ⲕⲁⲩⲥⲟⲛ
ⲕⲁⲩⲥⲱⲛ	N	ⲕⲁⲩⲥⲱⲛ
ⲕⲁⲩⲧⲏⲣⲓⲍⲉ	V	ⲕⲁⲩⲧⲏⲣⲓⲍⲉ
ⲕⲁⲫⲁⲣⲛⲁⲟⲩⲙ	NPROP	ⲕⲁⲫⲁⲣⲛⲁⲟⲩⲙ
ⲕⲁⲯⲁ	N	ⲕⲁⲯⲁ
ⲕⲁ	V	ⲕⲱ
ⲕⲁ	VIMP	ⲕⲁ
ⲕⲃⲁ	N	ⲕⲃⲁ
ⲕⲃⲟ	V	ⲕⲃⲟ
ⲕⲇⲏⲥⲓⲥ	N	ⲕⲇⲏⲥⲓⲥ
ⲕⲉⲃⲉⲣⲛⲁ	V	ⲕⲉⲃⲉⲣⲛⲁ
ⲕⲉⲃⲉⲣⲛⲏⲧⲏⲥ	N	ⲕⲉⲃⲉⲣⲛⲏⲧⲏⲥ
ⲕⲉⲃⲉⲣⲛⲓⲧⲏⲥ	N	ⲕⲉⲃⲉⲣⲛⲓⲧⲏⲥ
ⲕⲉⲃⲓⲱⲛ	N	ⲕⲉⲃⲓⲱⲛ
ⲕⲉⲇⲣⲟⲥ	N	ⲕⲉⲇⲣⲟⲥ
ⲕⲉⲉⲥ	N	ⲕⲉⲉⲥ
ⲕⲉⲓⲙⲏⲗⲓⲟⲛ	N	ⲕⲉⲓⲙⲏⲗⲓⲟⲛ
ⲕⲉⲓⲙⲓⲗⲓⲟⲛ	N	ⲕⲉⲓⲙⲓⲗⲓⲟⲛ
ⲕⲉⲓⲱⲟⲩ	VSTAT	ⲕⲉⲓⲱⲟⲩ
ⲕⲉⲕⲗⲉⲩⲧⲏⲥ	N	ⲕⲉⲕⲗⲉⲩⲧⲏⲥ
ⲕⲉⲗⲉⲃⲓⲛ	N	ⲕⲉⲗⲉⲃⲓⲛ
ⲕⲉⲗⲉⲥϯⲛⲟⲥ	NPROP	ⲕⲉⲗⲉⲥϯⲛⲟⲥ
ⲕⲉⲗⲉⲩⲉⲥⲑⲁⲓ	V	ⲕⲉⲗⲉⲩⲉⲥⲑⲁⲓ
ⲕⲉⲗⲉⲩⲉ	V	ⲕⲉⲗⲉⲩⲉ
ⲕⲉⲗⲉⲩⲥⲓⲥ	N	ⲕⲉⲗⲉⲩⲥⲓⲥ
ⲕⲉⲗⲗⲉ	N	ⲕⲉⲗⲗⲉ
ⲕⲉⲙⲧⲟ	N	ⲕⲉⲙⲧⲟ
ⲕⲉⲛⲇⲉⲛⲁⲣⲓⲟⲛ	N	ⲕⲉⲛⲇⲉⲛⲁⲣⲓⲟⲛ
ⲕⲉⲛⲇⲓⲛⲁⲣⲓⲟⲛ	N	ⲕⲉⲛⲇⲓⲛⲁⲣⲓⲟⲛ
ⲕⲉⲛⲉⲁ	N	ⲕⲉⲛⲉⲁ
ⲕⲉⲛⲉⲅⲓⲟⲥ	N	ⲕⲉⲛⲉⲅⲓⲟⲥ
ⲕⲉⲛⲟⲇⲟⲝⲓⲁ	N	ⲕⲉⲛⲟⲇⲟⲝⲓⲁ
ⲕⲉⲛⲟⲇⲟⲝⲟⲥ	N	ⲕⲉⲛⲟⲇⲟⲝⲟⲥ
ⲕⲉⲛⲧⲉⲛⲁⲣⲓⲟⲛ	N	ⲕⲉⲛⲧⲉⲛⲁⲣⲓⲟⲛ
ⲕⲉⲛⲧⲉⲣⲓⲟⲛ	N	ⲕⲉⲛⲧⲉⲣⲓⲟⲛ
ⲕⲉⲛⲧⲏⲛⲁⲣⲓⲟⲛ	N	ⲕⲉⲛⲧⲏⲛⲁⲣⲓⲟⲛ
ⲕⲉⲛⲧⲓⲛⲁⲣⲓⲟⲛ	N	ⲕⲉⲛⲧⲓⲛⲁⲣⲓⲟⲛ
ⲕⲉⲛⲧⲩⲣⲓⲱⲛ	N	ⲕⲉⲛⲧⲩⲣⲓⲱⲛ
ⲕⲉⲟⲙⲏⲧⲣⲓⲁ	N	ⲕⲉⲟⲙⲏⲧⲣⲓⲁ
ⲕⲉⲣⲁⲍⲉ	V	ⲕⲉⲣⲁⲍⲉ
ⲕⲉⲣⲁⲓⲁ	N	ⲕⲉⲣⲁⲓⲁ
ⲕⲉⲣⲁⲙⲉⲩⲥ	N	ⲕⲉⲣⲁⲙⲉⲩⲥ
ⲕⲉⲣⲁⲡⲧⲉⲥ	N	ⲕⲉⲣⲁⲡⲧⲉⲥ
ⲕⲉⲣⲁⲥⲙⲁ	N	ⲕⲉⲣⲁⲥⲙⲁ
ⲕⲉⲣⲁⲥⲧⲏⲥ	N	ⲕⲉⲣⲁⲥⲧⲏⲥ
ⲕⲉⲣⲁⲧⲥⲉ	N	ⲕⲉⲣⲁⲧⲥⲉ
ⲕⲉⲣⲁ	V	ⲕⲉⲣⲁ
ⲕⲉⲣⲃⲟⲩ	N	ⲕⲉⲣⲃⲟⲩ
ⲕⲉⲣⲉⲁ	N	ⲕⲉⲣⲉⲁ
ⲕⲉⲣⲉⲓⲁ	N	ⲕⲉⲣⲉⲓⲁ
ⲕⲉⲣⲉ	V	ⲕⲉⲣⲉ
ⲕⲉⲣⲙⲁ	N	ⲕⲉⲣⲙⲁ
ⲕⲉⲣⲙⲉⲥ	N	ⲕⲉⲣⲙⲉⲥ
ⲕⲉⲥⲁⲣⲉⲓⲁ	NPROP	ⲕⲉⲥⲁⲣⲉⲓⲁ
ⲕⲉⲥⲁⲣⲓⲁ	NPROP	ⲕⲉⲥⲁⲣⲓⲁ
ⲕⲉⲥⲉⲉⲡⲉ	N	ⲕⲉⲥⲉⲉⲡⲉ
ⲕⲉⲥⲏⲏⲡⲉ	N	ⲕⲉⲥⲏⲏⲡⲉ
ⲕⲉⲥⲧⲱⲛⲁⲣⲓⲟⲥ	N	ⲕⲉⲥⲧⲱⲛⲁⲣⲓⲟⲥ
ⲕⲉⲧⲱⲛ	N	ⲕⲉⲧⲱⲛ
ⲕⲉⲧ	N	ⲕⲉⲧ
ⲕⲉⲧ	V	ⲕⲱⲧ
ⲕⲉⲩⲁ	N	ⲕⲉⲩⲁ
ⲕⲉⲫⲁⲗⲁⲓⲟⲛ	N	ⲕⲉⲫⲁⲗⲁⲓⲟⲛ
ⲕⲉⲫⲁⲗⲁⲓⲱⲧⲏⲥ	N	ⲕⲉⲫⲁⲗⲁⲓⲱⲧⲏⲥ
ⲕⲉⲫⲁⲗⲏ	N	ⲕⲉⲫⲁⲗⲏ
ⲕⲉⲫⲁⲗⲓⲥ	N	ⲕⲉⲫⲁⲗⲓⲥ
ⲕⲉ	ART	ⲕⲉ
ⲕⲉ	N	ⲕⲉ
ⲕⲉ	V	ⲕⲉ
ⲕⲏϩ	VSTAT	ⲕⲱϩ
ⲕⲏⲃ	VSTAT	ⲕⲃⲟ
ⲕⲏⲕⲁϩⲏⲩ	VSTAT	ⲕⲱⲕ
ⲕⲏⲕ	V	ⲕⲏⲕ
ⲕⲏⲕ	VSTAT	ⲕⲏⲕ
ⲕⲏⲙⲉ	NPROP	ⲕⲏⲙⲉ
ⲕⲏⲙⲏⲧⲉⲣⲓⲟⲛ	N	ⲕⲏⲙⲏⲧⲉⲣⲓⲟⲛ
ⲕⲏⲛⲇⲉⲛⲁⲣⲓⲟⲛ	N	ⲕⲏⲛⲇⲉⲛⲁⲣⲓⲟⲛ
ⲕⲏⲛⲇⲓⲛⲁⲣⲓⲟⲛ	N	ⲕⲏⲛⲇⲓⲛⲁⲣⲓⲟⲛ
ⲕⲏⲛⲥⲟⲥ	N	ⲕⲏⲛⲥⲟⲥ
ⲕⲏⲛⲧⲉⲛⲁⲣⲓⲟⲛ	N	ⲕⲏⲛⲧⲉⲛⲁⲣⲓⲟⲛ
ⲕⲏⲛⲧⲓⲛⲁⲣⲓⲟⲛ	N	ⲕⲏⲛⲧⲓⲛⲁⲣⲓⲟⲛ
ⲕⲏⲛⲱⲧⲏⲥ	N	ⲕⲏⲛⲱⲧⲏⲥ
ⲕⲏⲡⲉ	N	ⲕⲏⲡⲉ
ⲕⲏⲡⲟⲥ	N	ⲕⲏⲡⲟⲥ
ⲕⲏⲡⲟⲩⲣⲟⲥ	N	ⲕⲏⲡⲟⲩⲣⲟⲥ
ⲕⲏⲣⲓⲁⲕⲏ	N	ⲕⲏⲣⲓⲁⲕⲏ
ⲕⲏⲣⲓⲥⲥⲉ	V	ⲕⲏⲣⲓⲥⲥⲉ
ⲕⲏⲣⲩⲅⲙⲁ	N	ⲕⲏⲣⲩⲅⲙⲁ
ⲕⲏⲣⲩⲝ	N	ⲕⲏⲣⲩⲝ
ⲕⲏⲣⲩⲥⲥⲉ	V	ⲕⲏⲣⲩⲥⲥⲉ
ⲕⲏⲧⲟⲥ	N	ⲕⲏⲧⲟⲥ
ⲕⲏⲧ	VSTAT	ⲕⲱⲧ
ⲕⲏⲫⲁⲥ	NPROP	ⲕⲏⲫⲁⲥ
ⲕⲏⲫⲁ	N	ⲕⲏⲫⲁ
ⲕⲏ	VSTAT	ⲕⲱ
ⲕⲓⲃⲟⲇⲟⲥ	N	ⲕⲓⲃⲟⲇⲟⲥ
ⲕⲓⲃⲟⲧⲟⲥ	N	ⲕⲓⲃⲟⲧⲟⲥ
ⲕⲓⲃⲱⲧⲟⲥ	N	ⲕⲓⲃⲱⲧⲟⲥ
ⲕⲓⲇⲁⲣⲓⲥ	N	ⲕⲓⲇⲁⲣⲓⲥ
ⲕⲓⲇⲣⲓⲟⲛ	N	ⲕⲓⲇⲣⲓⲟⲛ
ⲕⲓⲑⲁⲣⲁ	N	ⲕⲓⲑⲁⲣⲁ
ⲕⲓⲗⲓⲕⲓⲁ	N	ⲕⲓⲗⲓⲕⲓⲁ
ⲕⲓⲗⲓⲕⲓⲱⲧⲏⲥ	N	ⲕⲓⲗⲓⲕⲓⲱⲧⲏⲥ
ⲕⲓⲙ	V	ⲕⲓⲙ
ⲕⲓⲛⲇⲏⲛⲉⲩⲉ	V	ⲕⲓⲛⲇⲏⲛⲉⲩⲉ
ⲕⲓⲛⲇⲩⲛⲉⲩⲉ	V	ⲕⲓⲛⲇⲩⲛⲉⲩⲉ
ⲕⲓⲛⲇⲩⲛⲟⲥ	N	ⲕⲓⲛⲇⲩⲛⲟⲥ
ⲕⲓⲛⲏⲥⲓⲥ	N	ⲕⲓⲛⲏⲥⲓⲥ
ⲕⲓⲛⲛⲁⲙⲱⲙⲟⲛ	N	ⲕⲓⲛⲛⲁⲙⲱⲙⲟⲛ
ⲕⲓⲣⲁ	N	ⲕⲓⲣⲁ
ⲕⲓⲣⲓⲁ	N	ⲕⲓⲣⲓⲁ
ⲕⲓⲧⲣⲁ	N	ⲕⲓⲧⲣⲁ
ⲕⲓⲱⲟⲩ	VSTAT	ⲕⲓⲱⲟⲩ
ⲕⲗϫⲉ	N	ⲕⲗϫⲉ
ⲕⲗϫ	N	ⲕⲗϫ
ⲕⲗϫ	V	ⲕⲗϫ
ⲕⲗⲁϥⲧ	N	ⲕⲗⲁϥⲧ
ⲕⲗⲁⲃⲉⲕⲟⲗⲗⲁⲣⲓⲟⲥ	N	ⲕⲗⲁⲃⲉⲕⲟⲗⲗⲁⲣⲓⲟⲥ
ⲕⲗⲁⲃⲧ	N	ⲕⲗⲁⲃⲧ
ⲕⲗⲁⲇⲟⲥ	N	ⲕⲗⲁⲇⲟⲥ
ⲕⲗⲁⲥⲙⲁⲧⲓⲍⲉ	V	ⲕⲗⲁⲥⲙⲁⲧⲓⲍⲉ
ⲕⲗⲁⲥⲙⲁ	N	ⲕⲗⲁⲥⲙⲁ
ⲕⲗⲁⲩⲇⲓⲟⲥ	NPROP	ⲕⲗⲁⲩⲇⲓⲟⲥ
ⲕⲗⲉⲟⲡⲁ	V	ⲕⲗⲉⲟⲡⲁ
ⲕⲗⲉⲱⲡⲁ	V	ⲕⲗⲉⲱⲡⲁ
ⲕⲗⲏⲙⲁ	N	ⲕⲗⲏⲙⲁ
ⲕⲗⲏⲣⲓⲕⲟⲥ	N	ⲕⲗⲏⲣⲓⲕⲟⲥ
ⲕⲗⲏⲣⲟⲛⲟⲙⲉⲓ	N	ⲕⲗⲏⲣⲟⲛⲟⲙⲉⲓ
ⲕⲗⲏⲣⲟⲛⲟⲙⲉⲓ	V	ⲕⲗⲏⲣⲟⲛⲟⲙⲉⲓ
ⲕⲗⲏⲣⲟⲛⲟⲙⲓⲁ	N	ⲕⲗⲏⲣⲟⲛⲟⲙⲓⲁ
ⲕⲗⲏⲣⲟⲛⲟⲙⲟⲥ	N	ⲕⲗⲏⲣⲟⲛⲟⲙⲟⲥ
ⲕⲗⲏⲣⲟⲥ	N	ⲕⲗⲏⲣⲟⲥ
ⲕⲗⲏⲣⲟⲩ	V	ⲕⲗⲏⲣⲟⲩ
ⲕⲗⲓⲙⲁ	N	ⲕⲗⲓⲙⲁ
ⲕⲗⲗⲉ	N	ⲕⲗⲗⲉ
ⲕⲗⲟⲙ	N	ⲕⲗⲟⲙ
ⲕⲗⲟⲟⲗⲉ	N	ⲕⲗⲟⲟⲗⲉ
ⲕⲗⲩⲣⲓⲕⲟⲥ	N	ⲕⲗⲩⲣⲓⲕⲟⲥ
ⲕⲗⲩⲣⲟⲛⲟⲙⲉⲓ	V	ⲕⲗⲩⲣⲟⲛⲟⲙⲉⲓ
ⲕⲗⲩⲣⲟⲛⲟⲙⲓⲁ	N	ⲕⲗⲩⲣⲟⲛⲟⲙⲓⲁ
ⲕⲙⲟⲙ	N	ⲕⲙⲟⲙ
ⲕⲙⲧⲟ	N	ⲕⲙⲧⲟ
ⲕⲛⲛⲉ	V	ⲕⲛⲛⲉ
ⲕⲛⲧⲉ	N	ⲕⲛⲧⲉ
ⲕⲟⲇⲣⲁⲛⲧⲏⲥ	N	ⲕⲟⲇⲣⲁⲛⲧⲏⲥ
ⲕⲟⲉⲓϩ	N	ⲕⲟⲉⲓϩ
ⲕⲟⲉⲓⲥ	NPROP	ⲕⲟⲉⲓⲥ
ⲕⲟⲓⲗⲁⲥ	N	ⲕⲟⲓⲗⲁⲥ
ⲕⲟⲓⲗⲓⲁ	N	ⲕⲟⲓⲗⲓⲁ
ⲕⲟⲓⲙⲏⲧⲏⲣⲓⲟⲛ	N	ⲕⲟⲓⲙⲏⲧⲏⲣⲓⲟⲛ
ⲕⲟⲓⲛⲟⲃⲓⲟⲥ	N	ⲕⲟⲓⲛⲟⲃⲓⲟⲥ
ⲕⲟⲓⲛⲟⲛⲉⲓ	V	ⲕⲟⲓⲛⲟⲛⲉⲓ
ⲕⲟⲓⲛⲟⲛⲓⲁ	N	ⲕⲟⲓⲛⲟⲛⲓⲁ
ⲕⲟⲓⲛⲟⲛ	N	ⲕⲟⲓⲛⲟⲛ
ⲕⲟⲓⲛⲟⲥ	N	ⲕⲟⲓⲛⲟⲥ
ⲕⲟⲓⲛⲱⲃⲓⲟⲛ	N	ⲕⲟⲓⲛⲱⲃⲓⲟⲛ
ⲕⲟⲓⲛⲱⲛⲉⲓ	V	ⲕⲟⲓⲛⲱⲛⲉⲓ
ⲕⲟⲓⲛⲱⲛⲓⲁ	N	ⲕⲟⲓⲛⲱⲛⲓⲁ
ⲕⲟⲓⲛⲱⲛⲓ	V	ⲕⲟⲓⲛⲱⲛⲓ
ⲕⲟⲓⲛⲱⲛⲟⲥ	N	ⲕⲟⲓⲛⲱⲛⲟⲥ
ⲕⲟⲓⲧⲱⲛ	N	ⲕⲟⲓⲧⲱⲛ
ⲕⲟⲕⲕⲓⲛⲟⲥ	N	ⲕⲟⲕⲕⲓⲛⲟⲥ
ⲕⲟⲕⲕⲟⲥ	N	ⲕⲟⲕⲕⲟⲥ
ⲕⲟⲗϫ	V	ⲕⲟⲗϫ
ⲕⲟⲗⲁⲍⲉ	V	ⲕⲟⲗⲁⲍⲉ
ⲕⲟⲗⲁⲕⲉⲩⲉ	V	ⲕⲟⲗⲁⲕⲉⲩⲉ
ⲕⲟⲗⲁⲥⲓⲥ	N	ⲕⲟⲗⲁⲥⲓⲥ
ⲕⲟⲗⲁⲥⲧⲏⲣⲓⲟⲛ	N	ⲕⲟⲗⲁⲥⲧⲏⲣⲓⲟⲛ
ⲕⲟⲗⲏ	V	ⲕⲟⲗⲏ
ⲕⲟⲗⲓⲉ	V	ⲕⲟⲗⲓⲉ
ⲕⲟⲗⲓ	V	ⲕⲟⲗⲓ
ⲕⲟⲗⲗⲁⲣⲓⲟⲛ	N	ⲕⲟⲗⲗⲁⲣⲓⲟⲛ
ⲕⲟⲗⲗⲁ	V	ⲕⲟⲗⲗⲁ
ⲕⲟⲗⲗⲏⲅⲓⲟⲛ	N	ⲕⲟⲗⲗⲏⲅⲓⲟⲛ
ⲕⲟⲗⲗⲏⲕⲟⲛ	N	ⲕⲟⲗⲗⲏⲕⲟⲛ
ⲕⲟⲗⲗⲩⲃⲓⲥⲧⲏⲥ	N	ⲕⲟⲗⲗⲩⲃⲓⲥⲧⲏⲥ
ⲕⲟⲗⲗⲩⲕⲓⲟⲛ	N	ⲕⲟⲗⲗⲏⲅⲓⲟⲛ
ⲕⲟⲗⲟⲃⲟⲥ	N	ⲕⲟⲗⲟⲃⲟⲥ
ⲕⲟⲗⲡⲟⲥ	N	ⲕⲟⲗⲡⲟⲥ
ⲕⲟⲗⲩⲉ	V	ⲕⲟⲗⲩⲉ
ⲕⲟⲗⲩⲙⲃⲏⲑⲣⲁ	N	ⲕⲟⲗⲩⲙⲃⲏⲑⲣⲁ
ⲕⲟⲗⲩ	V	ⲕⲟⲗⲩ
ⲕⲟⲙϣ	V	ⲕⲱⲙϣ
ⲕⲟⲙⲁⲣⲓⲧⲏⲥ	N	ⲕⲟⲙⲁⲣⲓⲧⲏⲥ
ⲕⲟⲙⲉⲥ	N	ⲕⲟⲙⲉⲥ
ⲕⲟⲙⲏⲛⲧⲁⲣⲓⲥⲓⲟⲥ	N	ⲕⲟⲙⲏⲛⲧⲁⲣⲓⲥⲓⲟⲥ
ⲕⲟⲙⲏⲥ	N	ⲕⲟⲙⲏⲥ
ⲕⲟⲙⲏⲧⲁⲧⲟⲛ	N	ⲕⲟⲙⲏⲧⲁⲧⲟⲛ
ⲕⲟⲙⲓⲥ	N	ⲕⲟⲙⲓⲥ
ⲕⲟⲙⲡⲗⲉⲩⲥⲓⲥ	N	ⲕⲟⲙⲡⲗⲉⲩⲥⲓⲥ
ⲕⲟⲛⲇⲣⲁⲛⲧⲏⲥ	N	ⲕⲟⲛⲇⲣⲁⲛⲧⲏⲥ
ⲕⲟⲛⲓⲁ	V	ⲕⲟⲛⲓⲁ
ⲕⲟⲛⲥ	V	ⲕⲟⲛⲥ
ⲕⲟⲛⲧⲁⲣⲓⲟⲛ	N	ⲕⲟⲛⲧⲁⲣⲓⲟⲛ
ⲕⲟⲛⲱⲛ	NPROP	ⲕⲟⲛⲱⲛ
ⲕⲟⲟϩ	N	ⲕⲟⲟϩ
ⲕⲟⲟⲛⲥ	V	ⲕⲱⲱⲥ
ⲕⲟⲟⲥⲧ	N	ⲕⲟⲟⲥⲧ
ⲕⲟⲟⲥ	V	ⲕⲱⲱⲥ
ⲕⲟⲟⲩⲉ	N	ⲕⲉ
ⲕⲟⲟⲩ	N	ⲕⲟⲟⲩ
ⲕⲟⲡⲣⲓⲁ	N	ⲕⲟⲡⲣⲓⲁ
ⲕⲟⲣⲃⲁⲛⲟⲥ	N	ⲕⲟⲣⲃⲁⲛⲟⲥ
ⲕⲟⲣⲃⲁⲛ	N	ⲕⲟⲣⲃⲁⲛ
ⲕⲟⲣⲏ	N	ⲕⲟⲣⲏ
ⲕⲟⲣⲓⲛⲑⲟⲥ	N	ⲕⲟⲣⲓⲛⲑⲟⲥ
ⲕⲟⲣⲝ	N	ⲕⲟⲣⲝ
ⲕⲟⲥⲕⲉⲥ	V	ⲕⲟⲥⲕⲉⲥ
ⲕⲟⲥⲕⲥ	V	ⲕⲟⲥⲕⲥ
ⲕⲟⲥⲙⲉⲓⲥⲑⲁⲓ	V	ⲕⲟⲥⲙⲉⲓⲥⲑⲁⲓ
ⲕⲟⲥⲙⲉⲓ	V	ⲕⲟⲥⲙⲉⲓ
ⲕⲟⲥⲙⲏⲥⲓⲥ	N	ⲕⲟⲥⲙⲏⲥⲓⲥ
ⲕⲟⲥⲙⲓⲕⲟⲛ	N	ⲕⲟⲥⲙⲓⲕⲟⲛ
ⲕⲟⲥⲙⲓⲕⲟⲥ	N	ⲕⲟⲥⲙⲓⲕⲟⲥ
ⲕⲟⲥⲙⲟⲕⲣⲁⲧⲱⲣ	N	ⲕⲟⲥⲙⲟⲕⲣⲁⲧⲱⲣ
ⲕⲟⲥⲙⲟⲥ	N	ⲕⲟⲥⲙⲟⲥ
ⲕⲟⲥⲧⲁⲛⲧⲓⲛⲟⲥ	NPROP	ⲕⲟⲥⲧⲁⲛⲧⲓⲛⲟⲥ
ⲕⲟⲥⲧⲁⲥ	NPROP	ⲕⲟⲥⲧⲁⲥ
ⲕⲟⲧⲥ	N	ⲕⲟⲧⲥ
ⲕⲟⲧ	N	ⲕⲟⲧ
ⲕⲟⲧ	V	ⲕⲱⲧ
ⲕⲟⲩⲉⲓ	N	ⲕⲟⲩⲓ
ⲕⲟⲩⲓⲛⲉⲣⲱⲧ	NPROP	ⲕⲟⲩⲓⲛⲉⲣⲱⲧ
ⲕⲟⲩⲓ	N	ⲕⲟⲩⲓ
ⲕⲟⲩⲕⲗⲓⲟⲛ	N	ⲕⲟⲩⲕⲗⲓⲟⲛ
ⲕⲟⲩⲕⲟⲩⲙⲓⲟⲛ	N	ⲕⲟⲩⲕⲟⲩⲙⲓⲟⲛ
ⲕⲟⲩⲗⲁⲑⲉ	N	ⲕⲟⲩⲗⲁⲑⲉ
ⲕⲟⲩⲙⲫⲟⲥ	N	ⲕⲟⲩⲙⲫⲟⲥ
ⲕⲟⲩⲙ	V	ⲕⲟⲩⲙ
ⲕⲟⲩⲛⲥ	N	ⲕⲟⲩⲛⲥ
ⲕⲟⲩⲝ	N	ⲕⲟⲩⲝ
ⲕⲟⲩⲫⲓⲍⲉ	V	ⲕⲟⲩⲫⲓⲍⲉ
ⲕⲟⲩⲫⲟⲛ	N	ⲕⲟⲩⲫⲟⲛ
ⲕⲟⲭⲗⲓⲁⲣⲓⲛ	N	ⲕⲟⲭⲗⲓⲁⲣⲓⲛ
ⲕⲣⲁⲛⲓⲟⲛ	V	ⲕⲣⲁⲛⲓⲟⲛ
ⲕⲣⲁⲥⲓⲥ	N	ⲕⲣⲁⲥⲓⲥ
ⲕⲣⲁⲧⲏⲣ	N	ⲕⲣⲁⲧⲏⲣ
ⲕⲣⲁⲧⲟⲥ	N	ⲕⲣⲁⲧⲟⲥ
ⲕⲣⲁⲩⲅⲏ	N	ⲕⲣⲁⲩⲅⲏ
ⲕⲣⲏⲧⲉⲥ	N	ⲕⲣⲏⲧⲉⲥ
ⲕⲣⲓⲕⲟⲥ	N	ⲕⲣⲓⲕⲟⲥ
ⲕⲣⲓⲙⲁ	N	ⲕⲣⲓⲙⲁ
ⲕⲣⲓⲛⲉ	V	ⲕⲣⲓⲛⲉ
ⲕⲣⲓⲛⲟⲛ	N	ⲕⲣⲓⲛⲟⲛ
ⲕⲣⲓⲥⲓⲥ	N	ⲕⲣⲓⲥⲓⲥ
ⲕⲣⲓⲥⲡⲟⲥ	NPROP	ⲕⲣⲓⲥⲡⲟⲥ
ⲕⲣⲓⲧⲏⲣⲓⲟⲛ	N	ⲕⲣⲓⲧⲏⲣⲓⲟⲛ
ⲕⲣⲓⲧⲏⲥ	N	ⲕⲣⲓⲧⲏⲥ
ⲕⲣⲙⲉⲥ	N	ⲕⲣⲙⲉⲥ
ⲕⲣⲙⲣⲙ	V	ⲕⲣⲙⲣⲙ
ⲕⲣⲙⲣⲱⲙ	VSTAT	ⲕⲣⲟⲙⲣⲙ
ⲕⲣⲟϥ	N	ⲕⲣⲟϥ
ⲕⲣⲟⲕⲟⲥ	N	ⲕⲣⲟⲕⲟⲥ
ⲕⲣⲟⲙⲣⲉⲙ	V	ⲕⲣⲟⲙⲣⲉⲙ
ⲕⲣⲟⲙⲣⲙ	V	ⲕⲣⲟⲙⲣⲙ
ⲕⲣⲟⲛⲟⲥ	N	ⲕⲣⲟⲛⲟⲥ
ⲕⲣⲟⲛⲟⲥ	NPROP	ⲕⲣⲟⲛⲟⲥ
ⲕⲣⲟ	N	ⲕⲣⲟ
ⲕⲣⲟ	V	ⲕⲣⲟ
ⲕⲣⲩⲥⲧⲁⲗⲗⲟⲛ	N	ⲕⲣⲩⲥⲧⲁⲗⲗⲟⲛ
ⲕⲣⲩⲥⲧⲁⲗⲗⲟⲥ	N	ⲕⲣⲩⲥⲧⲁⲗⲗⲟⲥ
ⲕⲣⲱⲙ	N	ⲕⲣⲱⲙ
ⲕⲣⲱⲟⲩ	VSTAT	ⲕⲣⲱⲟⲩ
ⲕⲧⲉⲓⲁⲧ	V	ⲕⲧⲉⲓⲁⲧ
ⲕⲧⲉ	V	ⲕⲧⲟ
ⲕⲧⲏⲙⲁ	N	ⲕⲧⲏⲙⲁ
ⲕⲧⲏⲥⲓⲥ	N	ⲕⲧⲏⲥⲓⲥ
ⲕⲧⲏⲩ	VSTAT	ⲕⲧⲟ
ⲕⲧⲓⲥⲓⲥ	N	ⲕⲧⲓⲥⲓⲥ
ⲕⲧⲓⲥⲙⲁ	N	ⲕⲧⲓⲥⲙⲁ
ⲕⲧⲟⲛ	V	ⲕⲧⲟ
ⲕⲧⲟ	V	ⲕⲧⲟ
ⲕⲩⲃⲉⲣⲛⲁ	V	ⲕⲩⲃⲉⲣⲛⲁ
ⲕⲩⲃⲉⲣⲛⲏⲧⲉⲩⲉ	V	ⲕⲩⲃⲉⲣⲛⲏⲧⲉⲩⲉ
ⲕⲩⲇⲁⲣⲓⲧⲏⲥ	N	ⲕⲩⲇⲁⲣⲓⲧⲏⲥ
ⲕⲩⲕⲗⲟⲥ	N	ⲕⲩⲕⲗⲟⲥ
ⲕⲩⲗⲗⲟⲥ	N	ⲕⲩⲗⲗⲟⲥ
ⲕⲩⲙⲃⲁⲗⲟⲛ	N	ⲕⲩⲙⲃⲁⲗⲟⲛ
ⲕⲩⲙⲏⲗⲓⲟⲛ	N	ⲕⲩⲙⲏⲗⲓⲟⲛ
ⲕⲩⲛⲇⲉⲛⲁⲣⲓⲟⲛ	N	ⲕⲩⲛⲇⲉⲛⲁⲣⲓⲟⲛ
ⲕⲩⲛⲇⲓⲛⲁⲣⲓⲟⲛ	N	ⲕⲩⲛⲇⲓⲛⲁⲣⲓⲟⲛ
ⲕⲩⲛⲇⲩⲛⲟⲥ	N	ⲕⲩⲛⲇⲩⲛⲟⲥ
ⲕⲩⲛⲏⲅⲟⲥ	NPROP	ⲕⲩⲛⲏⲅⲟⲥ
ⲕⲩⲛⲧⲉⲛⲁⲣⲓⲟⲛ	N	ⲕⲩⲛⲧⲉⲛⲁⲣⲓⲟⲛ
ⲕⲩⲛⲧⲓⲛⲁⲣⲓⲟⲛ	N	ⲕⲩⲛⲧⲓⲛⲁⲣⲓⲟⲛ
ⲕⲩⲡⲁⲣⲓⲥⲥⲟⲥ	N	ⲕⲩⲡⲁⲣⲓⲥⲥⲟⲥ
ⲕⲩⲡⲏ	N	ⲕⲩⲡⲏ
ⲕⲩⲡⲟⲥ	N	ⲕⲩⲡⲟⲥ
ⲕⲩⲡⲣⲓⲟⲥ	N	ⲕⲩⲡⲣⲓⲟⲥ
ⲕⲩⲡⲣⲟⲥ	N	ⲕⲩⲡⲣⲟⲥ
ⲕⲩⲣⲁ	N	ⲕⲩⲣⲁ
ⲕⲩⲣⲏⲛⲁⲓⲟⲥ	N	ⲕⲩⲣⲏⲛⲁⲓⲟⲥ
ⲕⲩⲣⲏⲥⲥⲉ	V	ⲕⲩⲣⲏⲥⲥⲉ
ⲕⲩⲣⲓⲁⲕⲏ	N	ⲕⲩⲣⲓⲁⲕⲏ
ⲕⲩⲣⲓⲁⲕⲟⲛ	N	ⲕⲩⲣⲓⲁⲕⲟⲛ
ⲕⲩⲣⲓⲁ	N	ⲕⲩⲣⲓⲁ
ⲕⲩⲣⲓⲉⲩⲉⲥⲑⲁⲓ	V	ⲕⲩⲣⲓⲉⲩⲉⲥⲑⲁⲓ
ⲕⲩⲣⲓⲗⲗⲟⲥ	NPROP	ⲕⲩⲣⲓⲗⲗⲟⲥ
ⲕⲩⲣⲓⲟⲥ	N	ⲕⲩⲣⲓⲟⲥ
ⲕⲩⲣⲓⲥⲥⲉ	V	ⲕⲩⲣⲓⲥⲥⲉ
ⲕⲩⲣⲓⲱⲥ	ADV	ⲕⲩⲣⲓⲱⲥ
ⲕⲩⲣⲓ	N	ⲕⲩⲣⲓ
ⲕⲩⲣⲟⲥ	N	ⲕⲩⲣⲟⲥ
ⲕⲩⲣⲩⲝ	N	ⲕⲩⲣⲩⲝ
ⲕⲩⲣⲩⲥⲥⲉ	V	ⲕⲩⲣⲩⲥⲥⲉ
ⲕⲱϩⲧ	N	ⲕⲱϩⲧ
ⲕⲱϩ	N	ⲕⲱϩ
ⲕⲱϩ	V	ⲕⲱϩ
ⲕⲱⲃ	V	ⲕⲱⲃ
ⲕⲱⲗϩ	V	ⲕⲱⲗϩ
ⲕⲱⲗϫ	V	ⲕⲱⲗϫ
ⲕⲱⲗⲁⲥⲓⲥ	N	ⲕⲱⲗⲁⲥⲓⲥ
ⲕⲱⲗⲉⲓ	V	ⲕⲱⲗⲉⲓ
ⲕⲱⲗⲉ	V	ⲕⲱⲗⲉ
ⲕⲱⲗⲏ	V	ⲕⲱⲗⲏ
ⲕⲱⲗⲓⲉ	V	ⲕⲱⲗⲓⲉ
ⲕⲱⲗⲓ	V	ⲕⲱⲗⲓ
ⲕⲱⲗⲡ	V	ⲕⲱⲗⲡ
ⲕⲱⲗⲩⲉ	V	ⲕⲱⲗⲩⲉ
ⲕⲱⲗⲩ	V	ⲕⲱⲗⲩ
ⲕⲱⲙϣ	V	ⲕⲱⲙϣ
ⲕⲱⲙⲁⲣⲓⲟⲛ	N	ⲕⲱⲙⲁⲣⲓⲟⲛ
ⲕⲱⲙⲉⲥ	N	ⲕⲱⲙⲉⲥ
ⲕⲱⲙⲏⲧⲁⲧⲟⲛ	N	ⲕⲱⲙⲏⲧⲁⲧⲟⲛ
ⲕⲱⲙⲏ	N	ⲕⲱⲙⲏ
ⲕⲱⲙⲓⲥ	N	ⲕⲱⲙⲓⲥ
ⲕⲱⲙⲓⲧⲁⲧⲟⲛ	N	ⲕⲱⲙⲓⲧⲁⲧⲟⲛ
ⲕⲱⲙⲓⲧⲁⲧⲱⲛ	N	ⲕⲱⲙⲓⲧⲁⲧⲱⲛ
ⲕⲱⲛϩⲧⲏ	V	ⲕⲱⲛϩⲧⲏ
ⲕⲱⲛⲓⲁⲍⲉ	V	ⲕⲱⲛⲓⲁⲍⲉ
ⲕⲱⲛⲓⲁ	N	ⲕⲱⲛⲓⲁ
ⲕⲱⲛⲟⲛ	NPROP	ⲕⲱⲛⲟⲛ
ⲕⲱⲛⲣⲱ	V	ⲕⲱⲛⲣⲱ
ⲕⲱⲛⲥⲱ	V	ⲕⲱⲛⲥⲱ
ⲕⲱⲛⲥ	V	ⲕⲱⲛⲥ
ⲕⲱⲡⲓⲥ	N	ⲕⲱⲡⲓⲥ
ⲕⲱⲣϣ	V	ⲕⲱⲣϣ
ⲕⲱⲣⲉϣ	V	ⲕⲱⲣⲉϣ
ⲕⲱⲣⲉⲝ	N	ⲕⲱⲣⲉⲝ
ⲕⲱⲥⲙⲓⲕⲟⲛ	N	ⲕⲱⲥⲙⲓⲕⲟⲛ
ⲕⲱⲥⲧⲁⲛϯⲛⲟⲥ	NPROP	ⲕⲱⲥⲧⲁⲛϯⲛⲟⲥ
ⲕⲱⲥⲧⲁⲛϯⲟⲥ	NPROP	ⲕⲱⲥⲧⲁⲛϯⲟⲥ
ⲕⲱⲥⲧⲁⲛⲧⲓⲛⲟⲥ	NPROP	ⲕⲱⲥⲧⲁⲛⲧⲓⲛⲟⲥ
ⲕⲱⲥⲧⲁⲛⲧⲓⲛⲟⲩⲡⲟⲗⲉⲓⲥ	NPROP	ⲕⲱⲥⲧⲁⲛⲧⲓⲛⲟⲩⲡⲟⲗⲉⲓⲥ
ⲕⲱⲥⲧⲁⲛⲧⲓⲛⲟⲩⲡⲟⲗⲓⲥ	NPROP	ⲕⲱⲥⲧⲁⲛⲧⲓⲛⲟⲩⲡⲟⲗⲓⲥ
ⲕⲱⲥⲧⲁⲛⲧⲓⲟⲥ	NPROP	ⲕⲱⲥⲧⲁⲛⲧⲓⲟⲥ
ⲕⲱⲥⲧⲁⲥ	NPROP	ⲕⲱⲥⲧⲁⲥ
ⲕⲱⲥⲧⲟⲥ	NPROP	ⲕⲱⲥⲧⲟⲥ
ⲕⲱⲥⲧⲱϯⲁ	N	ⲕⲱⲥⲧⲱϯⲁ
ⲕⲱⲥ	NPROP	ⲕⲱⲥ
ⲕⲱⲧⲉ	N	ⲕⲱⲧⲉ
ⲕⲱⲧⲉ	V	ⲕⲱⲧⲉ
ⲕⲱⲧⲱⲛ	N	ⲕⲱⲧⲱⲛ
ⲕⲱⲧ	V	ⲕⲱⲧ
ⲕⲱⲫⲟⲛ	N	ⲕⲱⲫⲟⲛ
ⲕⲱⲱⲃⲉ	V	ⲕⲱⲱⲃⲉ
ⲕⲱⲱⲗⲉ	V	ⲕⲱⲱⲗⲉ
ⲕⲱⲱⲛⲥ	V	ⲕⲱⲱⲛⲥ
ⲕⲱⲱⲣⲉ	V	ⲕⲱⲱⲣⲉ
ⲕⲱⲱⲥ	V	ⲕⲱⲱⲥ
ⲕⲱ	N	ⲕⲱ
ⲕⲱ	V	ⲕⲱ
ⲕⲱ	VIMP	ⲕⲱ
ⲕ	PPERO	ⲛⲧⲟⲕ
ⲕ	PPERS	ⲛⲧⲟⲕ
ⲗϩⲏⲙ	V	ⲗϩⲏⲙ
ⲗϩⲱⲃ	V	ⲗϩⲱⲃ
ⲗⲁⲁⲩ	N	ⲗⲁⲁⲩ
ⲗⲁⲃⲁⲛ	NPROP	ⲗⲁⲃⲁⲛ
ⲗⲁⲍⲁⲣⲟⲥ	NPROP	ⲗⲁⲍⲁⲣⲟⲥ
ⲗⲁⲓⲕⲟⲥ	N	ⲗⲁⲓⲕⲟⲥ
ⲗⲁⲕⲁⲛⲏ	N	ⲗⲁⲕⲁⲛⲏ
ⲗⲁⲕⲉⲙ	N	ⲗⲁⲕⲉⲙ
ⲗⲁⲕⲕⲟⲥ	N	ⲗⲁⲕⲕⲟⲥ
ⲗⲁⲕⲙ	N	ⲗⲁⲕⲙ
ⲗⲁⲕⲟⲛ	N	ⲗⲁⲕⲟⲛ
ⲗⲁⲕⲧⲓⲍⲉ	V	ⲗⲁⲕⲧⲓⲍⲉ
ⲗⲁⲕⲱⲛ	N	ⲗⲁⲕⲱⲛ
ⲗⲁⲗⲓⲁ	N	ⲗⲁⲗⲓⲁ
ⲗⲁⲙϫⲁⲧⲡ	N	ⲗⲁⲙϫⲁⲧⲡ
ⲗⲁⲙⲁ	PINT	ⲗⲁⲙⲁ
ⲗⲁⲙⲡⲁⲥ	N	ⲗⲁⲙⲡⲁⲥ
ⲗⲁⲙⲡⲉⲩⲉ	V	ⲗⲁⲙⲡⲉⲩⲉ
ⲗⲁⲙⲡⲣⲟⲛ	N	ⲗⲁⲙⲡⲣⲟⲛ
ⲗⲁⲙⲡⲣⲟⲧⲁⲧⲟⲥ	N	ⲗⲁⲙⲡⲣⲟⲧⲁⲧⲟⲥ
ⲗⲁⲙⲡⲣⲟⲧⲏⲥ	N	ⲗⲁⲙⲡⲣⲟⲧⲏⲥ
ⲗⲁⲙⲯⲁⲛⲉ	N	ⲗⲁⲙⲯⲁⲛⲉ
ⲗⲁⲛⲑⲁⲛⲉ	V	ⲗⲁⲛⲑⲁⲛⲉ
ⲗⲁⲟⲇⲓⲕⲓⲁ	NPROP	ⲗⲁⲟⲇⲓⲕⲓⲁ
ⲗⲁⲟⲥ	N	ⲗⲁⲟⲥ
ⲗⲁⲥ	N	ⲗⲁⲥ
ⲗⲁⲧⲟⲙⲟⲥ	N	ⲗⲁⲧⲟⲙⲟⲥ
ⲗⲁⲩⲣⲁ	N	ⲗⲁⲩⲣⲁ
ⲗⲉϥⲗⲱϥ	VSTAT	ⲗⲟϥⲗϥ
ⲗⲉϫⲗⲱϫ	V	ⲗⲉϫⲗⲱϫ
ⲗⲉⲃⲏⲥ	N	ⲗⲉⲃⲏⲥ
ⲗⲉⲃⲓⲧⲱⲛ	N	ⲗⲉⲃⲓⲧⲱⲛ
ⲗⲉⲅⲅⲉⲓⲣⲓⲟⲛ	N	ⲗⲉⲅⲅⲉⲓⲣⲓⲟⲛ
ⲗⲉⲅⲉⲱⲛ	NPROP	ⲗⲉⲅⲉⲱⲛ
ⲗⲉⲅⲓⲱⲛ	NPROP	ⲗⲉⲅⲓⲱⲛ
ⲗⲉⲓⲧⲟⲩⲣⲅⲉⲓ	V	ⲗⲉⲓⲧⲟⲩⲣⲅⲉⲓ
ⲗⲉⲓⲧⲟⲩⲣⲅⲓⲁ	N	ⲗⲉⲓⲧⲟⲩⲣⲅⲓⲁ
ⲗⲉⲓⲧⲟⲩⲣⲅⲟⲥ	N	ⲗⲉⲓⲧⲟⲩⲣⲅⲟⲥ
ⲗⲉⲕⲧⲟⲩⲙⲉⲛⲟⲥ	N	ⲗⲉⲕⲧⲟⲩⲙⲉⲛⲟⲥ
ⲗⲉⲗⲟⲩ	N	ⲗⲉⲗⲟⲩ
ⲗⲉⲛⲧⲓⲟⲛ	N	ⲗⲉⲛⲧⲓⲟⲛ
ⲗⲉⲝⲓⲥ	N	ⲗⲉⲝⲓⲥ
ⲗⲉⲟⲡⲁⲣⲇⲁⲗⲓⲥ	N	ⲗⲉⲟⲡⲁⲣⲇⲁⲗⲓⲥ
ⲗⲉⲟⲩⲉⲓ	V	ⲗⲉⲟⲩⲉⲓ
ⲗⲉⲡⲧⲟⲇⲏⲙⲟⲥ	NPROP	ⲗⲉⲡⲧⲟⲇⲏⲙⲟⲥ
ⲗⲉⲡⲧⲟⲇⲩⲙⲟⲥ	NPROP	ⲗⲉⲡⲧⲟⲇⲩⲙⲟⲥ
ⲗⲉⲡⲧⲟⲛ	N	ⲗⲉⲡⲧⲟⲛ
ⲗⲉⲥⲭⲏ	N	ⲗⲉⲥⲭⲏ
ⲗⲉⲩⲓⲧⲏⲥ	N	ⲗⲉⲩⲓⲧⲏⲥ
ⲗⲉⲩⲕⲏ	V	ⲗⲉⲩⲕⲏ
ⲗⲉⲱⲛ	NPROP	ⲗⲉⲱⲛ
ⲗⲏϭ	VSTAT	ⲗⲱϭⲉ
ⲗⲏⲙⲏⲛ	N	ⲗⲏⲙⲏⲛ
ⲗⲏⲙⲙⲁ	N	ⲗⲏⲙⲙⲁ
ⲗⲏⲡⲉⲓ	V	ⲗⲏⲡⲉⲓ
ⲗⲏⲡⲉ	V	ⲗⲏⲡⲉ
ⲗⲏⲥⲧⲏⲥ	N	ⲗⲏⲥⲧⲏⲥ
ⲗⲓⲁ	NPROP	ⲗⲓⲁ
ⲗⲓⲃⲁⲛⲟⲥ	NPROP	ⲗⲓⲃⲁⲛⲟⲥ
ⲗⲓⲃⲉⲣⲓⲟⲥ	NPROP	ⲗⲓⲃⲉⲣⲓⲟⲥ
ⲗⲓⲃⲉⲣⲧⲓⲛⲟⲥ	N	ⲗⲓⲃⲉⲣⲧⲓⲛⲟⲥ
ⲗⲓⲃⲉ	V	ⲗⲓⲃⲉ
ⲗⲓⲃⲓⲧⲟⲛ	N	ⲗⲓⲃⲓⲧⲟⲛ
ⲗⲓⲃⲓⲧⲟⲩ	N	ⲗⲓⲃⲓⲧⲟⲩ
ⲗⲓⲃⲓⲧⲱⲛ	N	ⲗⲓⲃⲓⲧⲱⲛ
ⲗⲓⲅⲓⲕⲟⲛ	N	ⲗⲓⲅⲓⲕⲟⲛ
ⲗⲓⲇⲣⲁ	N	ⲗⲓⲇⲣⲁ
ⲗⲓⲕⲓⲕⲟⲛ	N	ⲗⲓⲕⲓⲕⲟⲛ
ⲗⲓⲕⲛⲟⲛ	N	ⲗⲓⲕⲛⲟⲛ
ⲗⲓⲙⲏⲛ	N	ⲗⲓⲙⲏⲛ
ⲗⲓⲙⲛⲏ	N	ⲗⲓⲙⲛⲏ
ⲗⲓⲥⲧⲏⲥ	N	ⲗⲓⲥⲧⲏⲥ
ⲗⲓⲧⲟⲩⲣⲅⲉⲓ	V	ⲗⲓⲧⲟⲩⲣⲅⲉⲓ
ⲗⲓⲧⲟⲩⲣⲅⲓⲁ	N	ⲗⲓⲧⲟⲩⲣⲅⲓⲁ
ⲗⲓⲧⲟⲩⲣⲅⲟⲥ	N	ⲗⲓⲧⲟⲩⲣⲅⲟⲥ
ⲗⲓⲧⲣⲁ	N	ⲗⲓⲧⲣⲁ
ⲗⲕϣⲁ	N	ⲗⲕϣⲁ
ⲗⲕⲥϣⲁ	N	ⲗⲕⲥϣⲁ
ⲗⲗⲉⲡⲧⲟⲛ	N	ⲗⲗⲉⲡⲧⲟⲛ
ⲗⲗⲏⲃ	N	ⲗⲗⲏⲃ
ⲗⲟϥⲗϥ	V	ⲗⲟϥⲗϥ
ⲗⲟϥⲗⲉϥ	V	ⲗⲟϥⲗⲉϥ
ⲗⲟϫϩ	V	ⲗⲟϫϩ
ⲗⲟϫⲗϫ	V	ⲗⲟϫⲗϫ
ⲗⲟϫⲗⲉϫ	V	ⲗⲟϫⲗⲉϫ
ⲗⲟϫⲧ	VSTAT	ⲗⲱϫⲧ
ⲗⲟⲃϣ	VSTAT	ⲗⲱⲃϣ
ⲗⲟⲃⲉ	VSTAT	ⲗⲓⲃⲉ
ⲗⲟⲅⲓⲍⲉ	V	ⲗⲟⲅⲓⲍⲉ
ⲗⲟⲅⲓⲕⲏ	N	ⲗⲟⲅⲓⲕⲏ
ⲗⲟⲅⲓⲕⲟⲛ	N	ⲗⲟⲅⲓⲕⲟⲛ
ⲗⲟⲅⲓⲕⲟⲥ	N	ⲗⲟⲅⲓⲕⲟⲥ
ⲗⲟⲅⲓⲟⲥ	N	ⲗⲟⲅⲓⲟⲥ
ⲗⲟⲅⲓⲥⲙⲟⲥ	N	ⲗⲟⲅⲓⲥⲙⲟⲥ
ⲗⲟⲅⲟⲅⲉⲛⲏⲥ	N	ⲗⲟⲅⲟⲅⲉⲛⲏⲥ
ⲗⲟⲅⲟⲅⲣⲁⲫⲟⲥ	N	ⲗⲟⲅⲟⲅⲣⲁⲫⲟⲥ
ⲗⲟⲅⲟⲥ	N	ⲗⲟⲅⲟⲥ
ⲗⲟⲅⲭⲏ	N	ⲗⲟⲅⲭⲏ
ⲗⲟⲅⲭⲓⲍⲉ	V	ⲗⲟⲅⲭⲓⲍⲉ
ⲗⲟⲉⲓϩⲉ	N	ⲗⲟⲉⲓϩⲉ
ⲗⲟⲉⲓϭⲉ	N	ⲗⲟⲉⲓϭⲉ
ⲗⲟⲓϩⲉ	N	ⲗⲟⲓϩⲉ
ⲗⲟⲓϭⲉ	N	ⲗⲟⲓϭⲉ
ⲗⲟⲓⲙⲟⲥ	N	ⲗⲟⲓⲙⲟⲥ
ⲗⲟⲓⲡⲁⲥ	N	ⲗⲟⲓⲡⲁⲥ
ⲗⲟⲓⲡⲟⲛ	CONJ	ⲗⲟⲓⲡⲟⲛ
ⲗⲟⲕⲥ	V	ⲗⲱⲕⲥ
ⲗⲟⲕⲥ	VSTAT	ⲗⲱⲕⲥ
ⲗⲟⲙⲥ	VSTAT	ⲗⲱⲙⲥ
ⲗⲟⲣⲟⲥ	N	ⲗⲟⲣⲟⲥ
ⲗⲟⲩⲕⲁⲥ	NPROP	ⲗⲟⲩⲕⲁⲥ
ⲗⲟⲩⲕⲓⲟⲥ	NPROP	ⲗⲟⲩⲕⲓⲟⲥ
ⲗⲟⲩⲗⲁⲓ	V	ⲗⲟⲩⲗⲁⲓ
ⲗⲟⲩⲡⲁⲥ	N	ⲗⲟⲩⲡⲁⲥ
ⲗⲟⲩⲥⲓⲙⲟⲛ	N	ⲗⲟⲩⲥⲓⲙⲟⲛ
ⲗⲟ	V	ⲗⲟ
ⲗⲩⲃⲓⲧⲟⲛ	N	ⲗⲩⲃⲓⲧⲟⲛ
ⲗⲩⲃⲓⲧⲱⲛ	N	ⲗⲩⲃⲓⲧⲱⲛ
ⲗⲩⲅⲓⲕⲟⲛ	N	ⲗⲩⲅⲓⲕⲟⲛ
ⲗⲩⲕⲁⲟⲛⲓⲥⲧⲓ	ADV	ⲗⲩⲕⲁⲟⲛⲓⲥⲧⲓ
ⲗⲩⲕⲓⲕⲟⲛ	N	ⲗⲩⲕⲓⲕⲟⲛ
ⲗⲩⲙⲏⲛ	N	ⲗⲩⲙⲏⲛ
ⲗⲩⲡⲉⲓ	V	ⲗⲩⲡⲉⲓ
ⲗⲩⲡⲏ	V	ⲗⲩⲡⲏ
ⲗⲩⲥⲧⲏⲥ	N	ⲗⲏⲥⲧⲏⲥ
ⲗⲩⲭⲛⲓⲁ	N	ⲗⲩⲭⲛⲓⲁ
ⲗⲭⲩⲛⲓⲕⲟⲛ	N	ⲗⲭⲩⲛⲓⲕⲟⲛ
ⲗⲱϩⲉⲙ	V	ⲗⲱϩⲉⲙ
ⲗⲱϩⲙ	V	ⲗⲱϩⲙ
ⲗⲱϫϩ	N	ⲗⲱϫϩ
ⲗⲱϭϫ	V	ⲗⲱϭϫ
ⲗⲱϭⲉ	V	ⲗⲱϭⲉ
ⲗⲱⲃϣ	V	ⲗⲱⲃϣ
ⲗⲱⲕϣ	N	ⲗⲱⲕϣ
ⲗⲱⲕⲥ	V	ⲗⲱⲕⲥ
ⲗⲱⲕ	V	ⲗⲱⲕ
ⲗⲱⲙⲉⲥ	V	ⲗⲱⲙⲉⲥ
ⲗⲱⲙⲥ	V	ⲗⲱⲙⲥ
ⲗⲱⲧⲉⲝ	N	ⲗⲱⲧⲉⲝ
ⲗⲱⲧ	NPROP	ⲗⲱⲧ
ⲗⲱⲱⲙⲉ	V	ⲗⲱⲱⲙⲉ
ⲗⲱⲱⲙ	V	ⲗⲱⲱⲙ
ⲙϣⲁ	V	ⲙϣⲁ
ⲙϩⲁⲁⲩ	N	ⲙϩⲁⲁⲩ
ⲙϩⲁⲟⲩ	N	ⲙϩⲁⲟⲩ
ⲙϩⲓⲧ	N	ⲙϩⲓⲧ
ⲙⲁϩⲉ	N	ⲙⲁϩⲉ
ⲙⲁϩⲧ	N	ⲙⲁϩⲧ
ⲙⲁϩ	V	ⲙⲟⲩϩ
ⲙⲁⲁϫⲉ	N	ⲙⲁⲁϫⲉ
ⲙⲁⲁⲃⲉⲙⲛϣⲟⲙⲧⲉ	N	ⲙⲁⲁⲃⲉⲙⲛϣⲟⲙⲧⲉ
ⲙⲁⲁⲃⲧⲏ	N	ⲙⲁⲁⲃⲧⲏ
ⲙⲁⲁⲃ	N	ⲙⲁⲁⲃ
ⲙⲁⲁⲩ	N	ⲙⲁⲁⲩ
ⲙⲁⲁ	V	ⲙⲁⲁ
ⲙⲁⲃⲧⲏ	N	ⲙⲁⲃⲧⲏ
ⲙⲁⲅⲁⲛⲟⲛ	N	ⲙⲁⲅⲁⲛⲟⲛ
ⲙⲁⲅⲇⲁⲗⲏⲛⲏ	NPROP	ⲙⲁⲅⲇⲁⲗⲏⲛⲏ
ⲙⲁⲅⲇⲁⲗⲓⲁ	NPROP	ⲙⲁⲅⲇⲁⲗⲓⲁ
ⲙⲁⲅⲇⲁⲗⲓⲛⲏ	NPROP	ⲙⲁⲅⲇⲁⲗⲓⲛⲏ
ⲙⲁⲅⲉⲓⲁ	N	ⲙⲁⲅⲉⲓⲁ
ⲙⲁⲅⲉⲓⲣⲟⲥ	N	ⲙⲁⲅⲉⲓⲣⲟⲥ
ⲙⲁⲅⲓⲁ	N	ⲙⲁⲅⲓⲁ
ⲙⲁⲅⲓⲣⲟⲥ	N	ⲙⲁⲅⲓⲣⲟⲥ
ⲙⲁⲅⲓⲥⲧⲣⲓⲁⲛⲟⲥ	N	ⲙⲁⲅⲓⲥⲧⲣⲓⲁⲛⲟⲥ
ⲙⲁⲅⲟⲥ	N	ⲙⲁⲅⲟⲥ
ⲙⲁⲅⲟⲩⲥⲁⲓⲟⲥ	N	ⲙⲁⲅⲟⲩⲥⲁⲓⲟⲥ
ⲙⲁⲉⲓⲛ	N	ⲙⲁⲉⲓⲛ
ⲙⲁⲉⲧϣϣⲉ	N	ⲙⲁⲉⲧϣϣⲉ
ⲙⲁⲉⲧⲉϣϣⲉ	N	ⲙⲁⲉⲧⲉϣϣⲉ
ⲙⲁⲑⲁⲓⲟⲥ	N	ⲙⲁⲑⲁⲓⲟⲥ
ⲙⲁⲑⲏⲧⲉⲩⲉ	V	ⲙⲁⲑⲏⲧⲉⲩⲉ
ⲙⲁⲑⲏⲧⲏⲥ	N	ⲙⲁⲑⲏⲧⲏⲥ
ⲙⲁⲑⲙⲥⲟ	VIMP	ⲙⲁⲑⲙⲥⲟ
ⲙⲁⲓ̈ⲛⲏⲥⲧⲓ̈ⲁ	N	ⲙⲁⲓ̈ⲛⲏⲥⲧⲓ̈ⲁ
ⲙⲁⲓϣⲙⲙⲟ	N	ⲙⲁⲓϣⲙⲙⲟ
ⲙⲁⲓϩⲏⲕⲉ	N	ⲙⲁⲓϩⲏⲕⲉ
ⲙⲁⲓϩⲏⲩ	N	ⲙⲁⲓϩⲏⲩ
ⲙⲁⲓϫⲁⲓⲉ	N	ⲙⲁⲓϫⲁⲓⲉ
ⲙⲁⲓϯⲧⲱⲛ	N	ⲙⲁⲓϯⲧⲱⲛ
ⲙⲁⲓⲁⲅⲁⲡⲏ	N	ⲙⲁⲓⲁⲅⲁⲡⲏ
ⲙⲁⲓⲛⲟⲩⲧⲉ	N	ⲙⲁⲓⲛⲟⲩⲧⲉ
ⲙⲁⲓⲛ	N	ⲙⲁⲓⲛ
ⲙⲁⲓⲡⲁⲑⲟⲥ	N	ⲙⲁⲓⲡⲁⲑⲟⲥ
ⲙⲁⲓⲡⲉⲭⲣⲓⲥⲧⲟⲥ	N	ⲙⲁⲓⲡⲉⲭⲣⲓⲥⲧⲟⲥ
ⲙⲁⲓⲣⲱⲙⲉ	N	ⲙⲁⲓⲣⲱⲙⲉ
ⲙⲁⲓⲥⲃⲱ	N	ⲙⲁⲓⲥⲃⲱ
ⲙⲁⲓⲥⲱⲧⲙ	N	ⲙⲁⲓⲥⲱⲧⲙ
ⲙⲁⲓⲧⲟⲛϩⲟⲩⲟ	N	ⲙⲁⲓⲧⲟⲛϩⲟⲩⲟ
ⲙⲁⲓⲧⲟ	N	ⲙⲁⲓⲧⲟ
ⲙⲁⲓⲭⲣⲏⲙⲁ	N	ⲙⲁⲓⲭⲣⲏⲙⲁ
ⲙⲁⲓ	N	ⲙⲁⲓ
ⲙⲁⲓ	V	ⲙⲁⲓ
ⲙⲁⲓ-ⲁⲅⲁⲑⲟⲛ	N	ⲙⲁⲓ-ⲁⲅⲁⲑⲟⲛ
ⲙⲁⲕϩ	N	ⲙⲁⲕϩ
ⲙⲁⲕⲁⲣⲓⲁ	N	ⲙⲁⲕⲁⲣⲓⲁ
ⲙⲁⲕⲁⲣⲓⲍⲉ	V	ⲙⲁⲕⲁⲣⲓⲍⲉ
ⲙⲁⲕⲁⲣⲓⲟⲛ	N	ⲙⲁⲕⲁⲣⲓⲟⲛ
ⲙⲁⲕⲁⲣⲓⲟⲥ	N	ⲙⲁⲕⲁⲣⲓⲟⲥ
ⲙⲁⲕⲁⲣⲓⲟⲧⲏⲥ	N	ⲙⲁⲕⲁⲣⲓⲟⲧⲏⲥ
ⲙⲁⲕⲁⲣⲓⲥⲙⲟⲥ	N	ⲙⲁⲕⲁⲣⲓⲥⲙⲟⲥ
ⲙⲁⲕⲇⲁⲗⲓⲁ	NPROP	ⲙⲁⲕⲇⲁⲗⲓⲁ
ⲙⲁⲕⲉⲗⲗⲟⲥ	N	ⲙⲁⲕⲉⲗⲗⲟⲥ
ⲙⲁⲕⲓⲥ	N	ⲙⲁⲕⲓⲥ
ⲙⲁⲗⲁⲕⲟⲥ	N	ⲙⲁⲗⲁⲕⲟⲥ
ⲙⲁⲗⲁⲭⲓⲁⲥ	NPROP	ⲙⲁⲗⲁⲭⲓⲁⲥ
ⲙⲁⲗⲓⲥⲧⲁ	ADV	ⲙⲁⲗⲓⲥⲧⲁ
ⲙⲁⲗⲓⲥⲧⲁ	CONJ	ⲙⲁⲗⲓⲥⲧⲁ
ⲙⲁⲗⲗⲟⲛ	ADV	ⲙⲁⲗⲗⲟⲛ
ⲙⲁⲙⲙⲟⲟⲛⲉ	N	ⲙⲁⲙⲙⲟⲟⲛⲉ
ⲙⲁⲙⲙⲱⲛⲁⲥ	NPROP	ⲙⲁⲙⲙⲱⲛⲁⲥ
ⲙⲁⲙⲡⲱⲧ	N	ⲙⲁⲙⲡⲱⲧ
ⲙⲁⲙⲱⲛⲁⲥ	N	ⲙⲁⲙⲱⲛⲁⲥ
ⲙⲁⲛϣⲁ	N	ⲙⲁⲛϣⲁ
ⲙⲁⲛϣⲉⲗⲉⲉⲧ	N	ⲙⲁⲛϣⲉⲗⲉⲉⲧ
ⲙⲁⲛϣⲓⲛⲉ	N	ⲙⲁⲛϣⲓⲛⲉ
ⲙⲁⲛϣⲱⲡⲉ	N	ⲙⲁⲛϣⲱⲡⲉ
ⲙⲁⲛϩⲁⲣⲉϩ	N	ⲙⲁⲛϩⲁⲣⲉϩ
ⲙⲁⲛϩⲱⲧⲡ	N	ⲙⲁⲛϩⲱⲧⲡ
ⲙⲁⲛϫⲁⲓⲉ	N	ⲙⲁⲛϫⲁⲓⲉ
ⲙⲁⲛⲁⲥⲥⲉ	NPROP	ⲙⲁⲛⲁⲥⲥⲉ
ⲙⲁⲛⲁⲥⲥⲏ	NPROP	ⲙⲁⲛⲁⲥⲥⲏ
ⲙⲁⲛⲅⲁⲛⲟⲛ	N	ⲙⲁⲛⲅⲁⲛⲟⲛ
ⲙⲁⲛⲉⲗⲟⲟⲗⲉ	N	ⲙⲁⲛⲉⲗⲟⲟⲗⲉ
ⲙⲁⲛⲏ	NPROP	ⲙⲁⲛⲏ
ⲙⲁⲛⲓⲁⲕⲏⲥ	N	ⲙⲁⲛⲓⲁⲕⲏⲥ
ⲙⲁⲛⲓⲁ	N	ⲙⲁⲛⲓⲁ
ⲙⲁⲛⲙⲧⲟⲛ	N	ⲙⲁⲛⲙⲧⲟⲛ
ⲙⲁⲛⲛⲁ	N	ⲙⲁⲛⲛⲁ
ⲙⲁⲛⲛⲉⲓⲇⲱⲗⲟⲛ	N	ⲙⲁⲛⲛⲉⲓⲇⲱⲗⲟⲛ
ⲙⲁⲛⲟⲩⲱϩ	N	ⲙⲁⲛⲟⲩⲱϩ
ⲙⲁⲛⲟⲩⲱⲙ	N	ⲙⲁⲛⲟⲩⲱⲙ
ⲙⲁⲛⲥⲁⲕⲏⲧⲏⲥ	NPROP	ⲙⲁⲛⲥⲁⲕⲏⲧⲏⲥ
ⲙⲁⲛⲥⲓⲕⲏⲧⲏⲥ	NPROP	ⲙⲁⲛⲥⲓⲕⲏⲧⲏⲥ
ⲙⲁⲛⲧⲁⲕⲏ	N	ⲙⲁⲛⲧⲁⲕⲏ
ⲙⲁⲛⲱⲧⲡⲉϩⲟⲩⲛ	N	ⲙⲁⲛⲱⲧⲡⲉϩⲟⲩⲛ
ⲙⲁⲝⲓⲙⲓⲛⲟⲥ	N	ⲙⲁⲝⲓⲙⲓⲛⲟⲥ
ⲙⲁⲟⲩⲁⲁ	V	ⲙⲁⲟⲩⲁⲁ
ⲙⲁⲡⲡⲁ	N	ⲙⲁⲡⲡⲁ
ⲙⲁⲣⲅⲁⲣⲓⲧⲏⲥ	N	ⲙⲁⲣⲅⲁⲣⲓⲧⲏⲥ
ⲙⲁⲣⲇⲟⲭⲁⲓⲟⲥ	NPROP	ⲙⲁⲣⲇⲟⲭⲁⲓⲟⲥ
ⲙⲁⲣⲉ	AJUS	ⲙⲁⲣⲉ
ⲙⲁⲣⲏⲥ	NPROP	ⲙⲁⲣⲏⲥ
ⲙⲁⲣⲑⲁ	NPROP	ⲙⲁⲣⲑⲁ
ⲙⲁⲣⲓϩⲁⲙ	NPROP	ⲙⲁⲣⲓϩⲁⲙ
ⲙⲁⲣⲓⲁ	NPROP	ⲙⲁⲣⲓⲁ
ⲙⲁⲣⲓⲛⲟⲥ	NPROP	ⲙⲁⲣⲓⲛⲟⲥ
ⲙⲁⲣⲓⲥ	NPROP	ⲙⲁⲣⲓⲥ
ⲙⲁⲣⲕⲉⲗⲗⲓⲁⲛⲟⲥ	NPROP	ⲙⲁⲣⲕⲉⲗⲗⲓⲁⲛⲟⲥ
ⲙⲁⲣⲕⲓⲁⲛⲟⲥ	NPROP	ⲙⲁⲣⲕⲓⲁⲛⲟⲥ
ⲙⲁⲣⲕⲟⲥ	NPROP	ⲙⲁⲣⲕⲟⲥ
ⲙⲁⲣⲕⲩⲁⲛⲟⲥ	NPROP	ⲙⲁⲣⲕⲩⲁⲛⲟⲥ
ⲙⲁⲣⲛ	V	ⲙⲁⲣⲛ
ⲙⲁⲣⲟ	VBD	ⲙⲁⲣⲟ
ⲙⲁⲣⲧⲉⲣⲓⲍⲉ	V	ⲙⲁⲣⲧⲉⲣⲓⲍⲉ
ⲙⲁⲣⲧⲏⲣⲓⲟⲛ	N	ⲙⲁⲣⲧⲏⲣⲓⲟⲛ
ⲙⲁⲣⲧⲩⲣⲓⲁ	N	ⲙⲁⲣⲧⲩⲣⲓⲁ
ⲙⲁⲣⲧⲩⲣⲓⲕⲟⲛ	N	ⲙⲁⲣⲧⲩⲣⲓⲕⲟⲛ
ⲙⲁⲣⲧⲩⲣⲓⲛ	V	ⲙⲁⲣⲧⲩⲣⲓⲛ
ⲙⲁⲣⲧⲩⲣⲓⲟⲛ	N	ⲙⲁⲣⲧⲩⲣⲓⲟⲛ
ⲙⲁⲣⲧⲩⲣⲟⲗⲟⲅⲓⲟⲛ	N	ⲙⲁⲣⲧⲩⲣⲟⲗⲟⲅⲓⲟⲛ
ⲙⲁⲣⲧⲩⲣⲟⲥ	N	ⲙⲁⲣⲧⲩⲣⲟⲥ
ⲙⲁⲣⲧⲩⲥ	N	ⲙⲁⲣⲧⲩⲥ
ⲙⲁⲣ	AJUS	ⲙⲁⲣⲉ
ⲙⲁⲣ	N	ⲙⲁⲣ
ⲙⲁⲥϯⲭⲉ	N	ⲙⲁⲥϯⲭⲉ
ⲙⲁⲥⲅⲝ	NPROP	ⲙⲁⲥⲅⲝ
ⲙⲁⲥⲉ	N	ⲙⲁⲥⲉ
ⲙⲁⲥⲟⲩⲣ	N	ⲙⲁⲥⲟⲩⲣ
ⲙⲁⲥⲧϩⲏⲧ	N	ⲙⲁⲥⲧϩⲏⲧ
ⲙⲁⲥⲧⲉⲛⲟⲩⲧⲉ	N	ⲙⲁⲥⲧⲉⲛⲟⲩⲧⲉ
ⲙⲁⲥⲧⲉ	N	ⲙⲁⲥⲧⲉ
ⲙⲁⲥⲧⲓⲅⲝ	N	ⲙⲁⲥⲧⲓⲅⲝ
ⲙⲁⲥⲧⲓⲅⲟⲩ	N	ⲙⲁⲥⲧⲓⲅⲟⲩ
ⲙⲁⲥⲧⲓⲕⲟⲥ	N	ⲙⲁⲥⲧⲓⲕⲟⲥ
ⲙⲁⲥⲧⲛⲟⲩⲧⲉ	N	ⲙⲁⲥⲧⲛⲟⲩⲧⲉ
ⲙⲁⲥⲧⲫⲑⲟⲛⲉⲓ	N	ⲙⲁⲥⲧⲫⲑⲟⲛⲉⲓ
ⲙⲁⲧⲁⲙⲟ	VIMP	ⲧⲁⲙⲟ
ⲙⲁⲧⲉ	V	ⲙⲁⲧⲉ
ⲙⲁⲧⲑⲁⲙ	NPROP	ⲙⲁⲧⲑⲁⲙ
ⲙⲁⲧⲟⲓ	N	ⲙⲁⲧⲟⲓ
ⲙⲁⲧⲟⲩϫⲟ	VIMP	ⲧⲟⲩϫⲟ
ⲙⲁⲧⲟⲩ	N	ⲙⲁⲧⲟⲩ
ⲙⲁⲧⲣⲱⲛⲁ	N	ⲙⲁⲧⲣⲱⲛⲁ
ⲙⲁⲩⲁⲁⲧ	IMOD	ⲙⲁⲩⲁⲁ
ⲙⲁⲩⲁⲁ	IMOD	ⲙⲁⲩⲁⲁ
ⲙⲁⲩⲁⲧ	V	ⲙⲁⲩⲁⲁ
ⲙⲁⲩⲁ	IMOD	ⲙⲁⲩⲁ
ⲙⲁⲩⲗⲓⲍⲉ	V	ⲙⲁⲩⲗⲓⲍⲉ
ⲙⲁ	ANEGAOR	ⲙⲁ
ⲙⲁ	N	ⲙⲁ
ⲙⲁ	V	ⲙⲁ
ⲙⲁ	VIMP	ⲙⲁ
ⲙⲉϣϣⲉ	V	ⲙⲉϣϣⲉ
ⲙⲉϣⲁⲕ	ADV	ⲙⲉϣⲁⲕ
ⲙⲉϣⲧ	V	ⲙⲟⲩϣⲧ
ⲙⲉϣ	V	ⲙⲉϣ
ⲙⲉϩϣⲟⲙⲛⲧ	NUM	ⲙⲉϩϣⲟⲙⲛⲧ
ⲙⲉϩϣⲟⲙⲧⲥⲱⲱⲡ	NUM	ⲙⲉϩϣⲟⲙⲧⲥⲱⲱⲡ
ⲙⲉϩϥⲧⲟⲟⲩ	NUM	ⲙⲉϩϥⲧⲟⲟⲩ
ⲙⲉϩⲣⲟ	N	ⲙⲉϩⲣⲟ
ⲙⲉϩⲣⲱ	V	ⲙⲉϩⲣⲱ
ⲙⲉϩⲥⲁϣϥ	NUM	ⲙⲉϩⲥⲁϣϥ
ⲙⲉϩⲥⲉⲡⲥⲛⲁⲩ	NUM	ⲙⲉϩⲥⲉⲡⲥⲛⲁⲩ
ⲙⲉϩⲥⲛⲁⲩ	NUM	ⲙⲉϩⲥⲛⲁⲩ
ⲙⲉϩⲥⲛⲧⲉ	NUM	ⲙⲉϩⲥⲛⲧⲉ
ⲙⲉϩ	N	ⲙⲉϩ
ⲙⲉϩ	V	ⲙⲟⲩϩ
ⲙⲉϩ	VSTAT	ⲙⲟⲩϩ
ⲙⲉⲅⲉⲑⲟⲥ	N	ⲙⲉⲅⲉⲑⲟⲥ
ⲙⲉⲅⲉⲛⲟⲓⲧⲟ	PTC	ⲙⲉⲅⲉⲛⲟⲓⲧⲟ
ⲙⲉⲅⲓⲥⲧⲁⲛⲟⲥ	N	ⲙⲉⲅⲓⲥⲧⲁⲛⲟⲥ
ⲙⲉⲉⲣⲉ	N	ⲙⲉⲉⲣⲉ
ⲙⲉⲉⲩⲉ	N	ⲙⲉⲉⲩⲉ
ⲙⲉⲉⲩⲉ	V	ⲙⲉⲉⲩⲉ
ⲙⲉⲓⲗⲓⲟⲛ	N	ⲙⲉⲓⲗⲓⲟⲛ
ⲙⲉⲕⲙⲟⲩⲕ	V	ⲙⲟⲕⲙⲉⲕ
ⲙⲉⲗⲁⲛ	N	ⲙⲉⲗⲁⲛ
ⲙⲉⲗⲉⲓ	V	ⲙⲉⲗⲉⲓ
ⲙⲉⲗⲉⲧⲁ	V	ⲙⲉⲗⲉⲧⲁ
ⲙⲉⲗⲉⲧⲏⲥⲓⲥ	N	ⲙⲉⲗⲉⲧⲏⲥⲓⲥ
ⲙⲉⲗⲉⲧⲏ	N	ⲙⲉⲗⲉⲧⲏ
ⲙⲉⲗⲉⲧⲓⲁⲛⲟⲥ	N	ⲙⲉⲗⲉⲧⲓⲁⲛⲟⲥ
ⲙⲉⲗⲓⲧⲓⲁⲛⲟⲥ	N	ⲙⲉⲗⲓⲧⲓⲁⲛⲟⲥ
ⲙⲉⲗⲓⲧⲓⲟⲥ	NPROP	ⲙⲉⲗⲓⲧⲓⲟⲥ
ⲙⲉⲗⲓ	V	ⲙⲉⲗⲓ
ⲙⲉⲗⲟⲅⲣⲁⲫⲟⲥ	N	ⲙⲉⲗⲟⲅⲣⲁⲫⲟⲥ
ⲙⲉⲗⲟⲥ	N	ⲙⲉⲗⲟⲥ
ⲙⲉⲗⲭⲓⲥⲉⲇⲉⲕ	NPROP	ⲙⲉⲗⲭⲓⲥⲉⲇⲉⲕ
ⲙⲉⲗⲱⲧ	N	ⲙⲉⲗⲱⲧ
ⲙⲉⲙⲫⲓ	V	ⲙⲉⲙⲫⲓ
ⲙⲉⲛⲁⲛⲇⲣⲟⲥ	NPROP	ⲙⲉⲛⲁⲛⲇⲣⲟⲥ
ⲙⲉⲛⲉⲩⲉ	V	ⲙⲉⲛⲉⲩⲉ
ⲙⲉⲛⲧⲟⲓⲅⲉ	CONJ	ⲙⲉⲛⲧⲟⲓⲅⲉ
ⲙⲉⲛⲧⲟⲓ	PTC	ⲙⲉⲛⲧⲟⲓ
ⲙⲉⲛⲧ-ϩⲏⲙⲉⲣⲟⲥ	N	ⲙⲉⲛⲧ-ϩⲏⲙⲉⲣⲟⲥ
ⲙⲉⲛ	CONJ	ⲙⲉⲛ
ⲙⲉⲛ	EXIST	ⲙⲛ
ⲙⲉⲛ	PTC	ⲙⲉⲛ
ⲙⲉⲣϩ	N	ⲙⲉⲣϩ
ⲙⲉⲣⲁⲧⲉ	N	ⲙⲉⲣⲓⲧ
ⲙⲉⲣⲉϩ	N	ⲙⲉⲣⲉϩ
ⲙⲉⲣⲉⲟⲩⲱϩ	V	ⲙⲉⲣⲉⲟⲩⲱϩ
ⲙⲉⲣⲉ	ANEGAOR	ⲙⲉⲣⲉ
ⲙⲉⲣⲉ	V	ⲙⲉ
ⲙⲉⲣⲓⲍⲉ	V	ⲙⲉⲣⲓⲍⲉ
ⲙⲉⲣⲓⲕⲟⲥ	N	ⲙⲉⲣⲓⲕⲟⲥ
ⲙⲉⲣⲓⲥⲙⲟⲥ	N	ⲙⲉⲣⲓⲥⲙⲟⲥ
ⲙⲉⲣⲓⲥ	N	ⲙⲉⲣⲓⲥ
ⲙⲉⲣⲓⲧ	N	ⲙⲉⲣⲓⲧ
ⲙⲉⲣⲓⲧ	V	ⲙⲉⲣⲓⲧ
ⲙⲉⲣⲕⲟⲩⲣⲓⲟⲥ	NPROP	ⲙⲉⲣⲕⲟⲩⲣⲓⲟⲥ
ⲙⲉⲣⲟⲉⲓⲧ	NPROP	ⲙⲉⲣⲟⲉⲓⲧ
ⲙⲉⲣⲟⲥ	N	ⲙⲉⲣⲟⲥ
ⲙⲉⲣⲟⲩⲥ	FM	ⲙⲉⲣⲟⲩⲥ
ⲙⲉⲣ	V	ⲙⲟⲩⲣ
ⲙⲉⲥⲏⲙⲃⲣⲓⲁ	N	ⲙⲉⲥⲏⲙⲃⲣⲓⲁ
ⲙⲉⲥⲓⲧⲏⲥ	N	ⲙⲉⲥⲓⲧⲏⲥ
ⲙⲉⲥⲟⲧⲏⲥ	N	ⲙⲉⲥⲟⲧⲏⲥ
ⲙⲉⲥⲟⲩⲁⲫⲓ	N	ⲙⲉⲥⲟⲩⲁⲫⲓ
ⲙⲉⲥⲧⲉ	V	ⲙⲟⲥⲧⲉ
ⲙⲉⲥⲧⲱ	V	ⲙⲟⲥⲧⲉ
ⲙⲉⲧⲁⲃⲟⲗⲏ	N	ⲙⲉⲧⲁⲃⲟⲗⲏ
ⲙⲉⲧⲁⲅⲅⲓⲥⲙⲟⲥ	N	ⲙⲉⲧⲁⲅⲅⲓⲥⲙⲟⲥ
ⲙⲉⲧⲁⲗⲗⲟⲛ	N	ⲙⲉⲧⲁⲗⲗⲟⲛ
ⲙⲉⲧⲁⲛⲟⲉⲓ	V	ⲙⲉⲧⲁⲛⲟⲉⲓ
ⲙⲉⲧⲁⲛⲟⲓⲁ	N	ⲙⲉⲧⲁⲛⲟⲓⲁ
ⲙⲉⲧⲁⲛⲟⲓ	V	ⲙⲉⲧⲁⲛⲟⲓ
ⲙⲉⲧⲁ	PREP	ⲙⲉⲧⲁ
ⲙⲉⲧⲉⲭⲉ	V	ⲙⲉⲧⲉⲭⲉ
ⲙⲉⲧⲟⲭⲟⲥ	N	ⲙⲉⲧⲟⲭⲟⲥ
ⲙⲉⲧⲡⲁⲧⲣⲓⲁⲣⲭⲏⲥ	N	ⲙⲉⲧⲡⲁⲧⲣⲓⲁⲣⲭⲏⲥ
ⲙⲉⲧⲣⲏⲧⲏⲥ	N	ⲙⲉⲧⲣⲏⲧⲏⲥ
ⲙⲉⲧⲣⲟⲛ	N	ⲙⲉⲧⲣⲟⲛ
ⲙⲉⲧⲥⲭⲟⲗⲁⲥⲧⲓⲕⲟⲥ	N	ⲙⲉⲧⲥⲭⲟⲗⲁⲥⲧⲓⲕⲟⲥ
ⲙⲉⲧⲧⲉⲭⲛⲓⲧⲏⲥ	N	ⲙⲉⲧⲧⲉⲭⲛⲓⲧⲏⲥ
ⲙⲉⲩⲉ	V	ⲙⲉⲩⲉ
ⲙⲉⲩⲧ	V	ⲙⲟⲩⲟⲩⲧ
ⲙⲉⲭⲣⲓ	PREP	ⲙⲉⲭⲣⲓ
ⲙⲉ	ANEGAOR	ⲙⲉⲣⲉ
ⲙⲉ	N	ⲙⲉ
ⲙⲉ	V	ⲙⲉ
ⲙⲏϣⲉ	N	ⲙⲏϣⲉ
ⲙⲏϩ	VSTAT	ⲙⲟⲩϩ
ⲙⲏⲃⲣⲁⲛⲟⲛ	N	ⲙⲏⲃⲣⲁⲛⲟⲛ
ⲙⲏⲅⲉⲛⲟⲉⲓⲧⲟ	PTC	ⲙⲏⲅⲉⲛⲟⲉⲓⲧⲟ
ⲙⲏⲅⲉⲛⲟⲓⲧⲟ	PTC	ⲙⲏⲅⲉⲛⲟⲓⲧⲟ
ⲙⲏⲇⲟⲥ	N	ⲙⲏⲇⲟⲥ
ⲙⲏⲉϣⲁϥ	CONJ	ⲙⲏⲉϣⲁϥ
ⲙⲏⲏϣⲉ	N	ⲙⲏⲏϣⲉ
ⲙⲏⲏϣⲉ	V	ⲙⲏⲏϣⲉ
ⲙⲏⲏⲛⲉ	N	ⲙⲏⲏⲛⲉ
ⲙⲏⲗⲓⲧⲓⲁⲛⲟⲥ	N	ⲙⲏⲗⲓⲧⲓⲁⲛⲟⲥ
ⲙⲏⲛⲉⲩⲉ	V	ⲙⲏⲛⲉⲩⲉ
ⲙⲏⲛⲉ	N	ⲙⲏⲛⲉ
ⲙⲏⲛ	VSTAT	ⲙⲟⲩⲛ
ⲙⲏⲡⲟⲧⲉ	CONJ	ⲙⲏⲡⲟⲧⲉ
ⲙⲏⲡⲱⲥ	ADV	ⲙⲏⲡⲱⲥ
ⲙⲏⲡⲱⲥ	CONJ	ⲙⲏⲡⲱⲥ
ⲙⲏⲡⲱⲥ	N	ⲙⲏⲡⲱⲥ
ⲙⲏⲣⲟⲥ	N	ⲙⲏⲣⲟⲥ
ⲙⲏⲣ	VSTAT	ⲙⲟⲩⲣ
ⲙⲏⲥⲉ	N	ⲙⲏⲥⲉ
ⲙⲏⲥⲧⲏⲣⲓⲟⲛ	N	ⲙⲏⲥⲧⲏⲣⲓⲟⲛ
ⲙⲏⲧϣⲙⲏⲛⲉ	N	ⲙⲏⲧϣⲙⲏⲛⲉ
ⲙⲏⲧⲉⲓ	CONJ	ⲙⲏⲧⲉⲓ
ⲙⲏⲧⲉ	N	ⲙⲏⲧⲉ
ⲙⲏⲧⲓ	CONJ	ⲙⲏⲧⲓ
ⲙⲏⲧⲛϣⲏ	N	ⲙⲏⲧⲛϣⲏ
ⲙⲏⲧⲣⲁ	N	ⲙⲏⲧⲣⲁ
ⲙⲏⲧⲣⲟⲡⲁⲧⲱⲣ	N	ⲙⲏⲧⲣⲟⲡⲁⲧⲱⲣ
ⲙⲏⲧⲣⲟⲡⲟⲗⲓⲥ	N	ⲙⲏⲧⲣⲟⲡⲟⲗⲓⲥ
ⲙⲏⲧ	N	ⲙⲏⲧ
ⲙⲏⲭⲁⲛⲏ	N	ⲙⲏⲭⲁⲛⲏ
ⲙⲏ	CONJ	ⲙⲏ
ⲙⲏ	N	ⲙⲏ
ⲙⲓϣⲉ	N	ⲙⲓϣⲉ
ⲙⲓϣⲉ	V	ⲙⲓϣⲉ
ⲙⲓⲗⲓⲟⲛ	N	ⲙⲓⲗⲓⲟⲛ
ⲙⲓⲙⲁⲣⲓⲟⲛ	N	ⲙⲓⲙⲁⲣⲓⲟⲛ
ⲙⲓⲙⲏⲥⲓⲥ	N	ⲙⲓⲙⲏⲥⲓⲥ
ⲙⲓⲛⲉ	N	ⲙⲓⲛⲉ
ⲙⲓⲟⲕ	PTC	ⲙⲓⲟⲕ
ⲙⲓⲥⲉ	V	ⲙⲓⲥⲉ
ⲙⲓⲥⲑⲱⲥⲓⲥ	N	ⲙⲓⲥⲑⲱⲥⲓⲥ
ⲙⲓⲥⲑⲱⲧⲏⲥ	N	ⲙⲓⲥⲑⲱⲧⲏⲥ
ⲙⲓⲧⲁⲧⲱⲣ	N	ⲙⲓⲧⲁⲧⲱⲣ
ⲙⲓⲧⲣⲁ	N	ⲙⲓⲧⲣⲁ
ⲙⲓⲭⲁⲏⲗ	NPROP	ⲙⲓⲭⲁⲏⲗ
ⲙⲓⲭⲁⲓⲁⲥ	NPROP	ⲙⲓⲭⲁⲓⲁⲥ
ⲙⲕⲁϩⲛϩⲏⲧ	V	ⲙⲕⲁϩⲛϩⲏⲧ
ⲙⲕⲁϩ	N	ⲙⲕⲁϩ
ⲙⲕⲁϩ	V	ⲙⲕⲁϩ
ⲙⲕⲙⲟⲩⲕⲉ	V	ⲙⲟⲕⲙⲉⲕ
ⲙⲕⲙⲟⲩⲕ	V	ⲙⲟⲕⲙⲉⲕ
ⲙⲗⲁϩ	N	ⲙⲗⲁϩ
ⲙⲙⲁⲁⲩ	N	ⲙⲙⲁⲁⲩ
ⲙⲙⲁⲧⲉ	ADV	ⲙⲙⲁⲧⲉ
ⲙⲙⲁⲩ	ADV	ⲙⲙⲁⲩ
ⲙⲙⲁ	N	ⲙⲙⲁ
ⲙⲙⲏⲛⲉ	ADV	ⲙⲙⲏⲛⲉ
ⲙⲙⲓⲛⲉⲙⲓⲛⲉ	ADV	ⲙⲙⲓⲛⲉⲙⲓⲛⲉ
ⲙⲙⲓⲛⲙⲙⲟ	IMOD	ⲙⲙⲓⲛⲙⲙⲟ
ⲙⲙⲓⲛⲙⲙⲟ	IMOD_PPERO	ⲙⲙⲓⲛⲙⲙⲟ_ⲛⲧⲟ
ⲙⲙⲓⲛⲙⲙⲟ	PREP	ⲙⲙⲓⲛⲙⲙⲟ
ⲙⲙⲓⲛⲙⲙⲱ	IMOD	ⲙⲙⲓⲛⲙⲙⲟ
ⲙⲙⲓⲛ	N	ⲙⲙⲓⲛ
ⲙⲙⲓⲛ	V	ⲙⲙⲓⲛ
ⲙⲙⲛⲛⲥⲁ	PREP	ⲙⲙⲛⲛⲥⲁ
ⲙⲙⲛⲧⲁ	EXIST	ⲙⲙⲛⲧⲁ
ⲙⲙⲛⲧⲉ	EXIST	ⲙⲙⲛⲧⲉ
ⲙⲙⲛⲧⲏ	EXIST	ⲙⲙⲛⲧⲏ
ⲙⲙⲛⲧ	EXIST	ⲙⲛⲧⲁ
ⲙⲙⲛ	EXIST	ⲙⲛ
ⲙⲙⲟⲛ	CONJ	ⲙⲙⲟⲛ
ⲙⲙⲟⲛ	NEG	ⲙⲙⲟⲛ
ⲙⲙⲟⲛ	PTC	ⲙⲙⲟⲛ
ⲙⲙⲟⲟⲩ	N	ⲙⲙⲟⲟⲩ
ⲙⲙⲟⲩ	N	ⲙⲙⲟⲩ
ⲙⲙⲟ	PREP	ⲛ
ⲙⲙⲟ	PREP_PPERO	ⲛ_ⲛⲧⲟ
ⲙⲙⲱ	PREP	ⲛ
ⲙⲛⲏⲙⲏ	N	ⲙⲛⲏⲙⲏ
ⲙⲛⲛⲥⲁⲛⲁⲓ	CONJ	ⲙⲛⲛⲥⲁⲛⲁⲓ
ⲙⲛⲛⲥⲁ	PREP	ⲙⲛⲛⲥⲁ
ⲙⲛⲛⲥⲱ	PREP	ⲙⲛⲛⲥⲁ
ⲙⲛⲟⲩⲧ	N	ⲙⲛⲟⲩⲧ
ⲙⲛⲧϣⲁϥⲧⲉ	N	ⲙⲛⲧϣⲁϥⲧⲉ
ⲙⲛⲧϣⲁϥⲧⲉ	NUM	ⲙⲛⲧϣⲁϥⲧⲉ
ⲙⲛⲧϣⲁⲛϩⲧⲏϥ	N	ⲙⲛⲧϣⲁⲛϩⲧⲏϥ
ⲙⲛⲧϣⲁⲛϩⲧⲏ	N	ⲙⲛⲧϣⲁⲛϩⲧⲏ
ⲙⲛⲧϣⲁⲛⲁϩⲧⲏϥ	N	ⲙⲛⲧϣⲁⲛⲁϩⲧⲏϥ
ⲙⲛⲧϣⲁⲩ	N	ⲙⲛⲧϣⲁⲩ
ⲙⲛⲧϣⲁ	N	ⲙⲛⲧϣⲁ
ⲙⲛⲧϣⲃⲏⲣ	N	ⲙⲛⲧϣⲃⲏⲣ
ⲙⲛⲧϣⲏⲣⲉϣⲏⲙ	N	ⲙⲛⲧϣⲏⲣⲉϣⲏⲙ
ⲙⲛⲧϣⲏⲣⲉ	N	ⲙⲛⲧϣⲏⲣⲉ
ⲙⲛⲧϣⲙⲏⲛ	N	ⲙⲛⲧϣⲙⲏⲛ
ⲙⲛⲧϣⲙⲙⲟ	N	ⲙⲛⲧϣⲙⲙⲟ
ⲙⲛⲧϣⲟⲙⲧⲉ	N	ⲙⲛⲧϣⲟⲙⲧⲉ
ⲙⲛⲧϣⲟⲩϣⲟ	N	ⲙⲛⲧϣⲟⲩϣⲟ
ⲙⲛⲧϣⲱⲥ	N	ⲙⲛⲧϣⲱⲥ
ⲙⲛⲧϥⲁⲓⲣⲟⲟⲩϣ	N	ⲙⲛⲧϥⲁⲓⲣⲟⲟⲩϣ
ⲙⲛⲧϩⲁⲕⲟ	N	ⲙⲛⲧϩⲁⲕⲟ
ⲙⲛⲧϩⲁⲕ	N	ⲙⲛⲧϩⲁⲕ
ⲙⲛⲧϩⲁⲡⲗⲟⲩⲥ	N	ⲙⲛⲧϩⲁⲡⲗⲟⲩⲥ
ⲙⲛⲧϩⲁⲣϣϩⲏⲧ	N	ⲙⲛⲧϩⲁⲣϣϩⲏⲧ
ⲙⲛⲧϩⲉⲃⲣⲁⲓⲟⲥ	N	ⲙⲛⲧϩⲉⲃⲣⲁⲓⲟⲥ
ⲙⲛⲧϩⲉⲗⲗⲏⲛ	N	ⲙⲛⲧϩⲉⲗⲗⲏⲛ
ⲙⲛⲧϩⲉⲣⲉⲥⲓⲥ	N	ⲙⲛⲧϩⲉⲣⲉⲥⲓⲥ
ⲙⲛⲧϩⲏⲕⲉ	N	ⲙⲛⲧϩⲏⲕⲉ
ⲙⲛⲧϩⲗⲗⲏⲛ	N	ⲙⲛⲧϩⲗⲗⲏⲛ
ⲙⲛⲧϩⲗⲗⲟ	N	ⲙⲛⲧϩⲗⲗⲟ
ⲙⲛⲧϩⲗⲗⲱ	N	ⲙⲛⲧϩⲗⲗⲱ
ⲙⲛⲧϩⲙϩⲁⲗ	N	ⲙⲛⲧϩⲙϩⲁⲗ
ⲙⲛⲧϩⲣⲟⲩⲱ	N	ⲙⲛⲧϩⲣⲟⲩⲱ
ⲙⲛⲧϩⲣⲱⲙⲁⲓⲟⲥ	N	ⲙⲛⲧϩⲣⲱⲙⲁⲓⲟⲥ
ⲙⲛⲧϫⲁϫⲉ	N	ⲙⲛⲧϫⲁϫⲉ
ⲙⲛⲧϫⲁⲣϩⲏⲧ	N	ⲙⲛⲧϫⲁⲣϩⲏⲧ
ⲙⲛⲧϫⲁⲥⲓϩⲏⲧ	N	ⲙⲛⲧϫⲁⲥⲓϩⲏⲧ
ⲙⲛⲧϫⲓⲟⲩⲁ	N	ⲙⲛⲧϫⲓⲟⲩⲁ
ⲙⲛⲧϫⲟⲉⲓⲥ	N	ⲙⲛⲧϫⲟⲉⲓⲥ
ⲙⲛⲧϫⲟⲓⲥ	N	ⲙⲛⲧϫⲟⲓⲥ
ⲙⲛⲧϫⲱⲱⲣⲉ	N	ⲙⲛⲧϫⲱⲱⲣⲉ
ⲙⲛⲧϭⲱⲃ	N	ⲙⲛⲧϭⲱⲃ
ⲙⲛⲧⲁⲅⲁⲑⲟⲥ	N	ⲙⲛⲧⲁⲅⲁⲑⲟⲥ
ⲙⲛⲧⲁⲅⲉⲛⲛⲏⲧⲟⲥ	N	ⲙⲛⲧⲁⲅⲉⲛⲛⲏⲧⲟⲥ
ⲙⲛⲧⲁⲅⲣⲟⲓⲕⲟⲥ	N	ⲙⲛⲧⲁⲅⲣⲟⲓⲕⲟⲥ
ⲙⲛⲧⲁⲑⲏⲧ	N	ⲙⲛⲧⲁⲑⲏⲧ
ⲙⲛⲧⲁⲕⲁⲑⲁⲣⲧⲟⲥ	N	ⲙⲛⲧⲁⲕⲁⲑⲁⲣⲧⲟⲥ
ⲙⲛⲧⲁⲕⲁⲕⲟⲥ	N	ⲙⲛⲧⲁⲕⲁⲕⲟⲥ
ⲙⲛⲧⲁⲕⲉⲣⲁⲓⲟⲥ	N	ⲙⲛⲧⲁⲕⲉⲣⲁⲓⲟⲥ
ⲙⲛⲧⲁⲕⲣⲓⲃⲏⲥ	N	ⲙⲛⲧⲁⲕⲣⲓⲃⲏⲥ
ⲙⲛⲧⲁⲗⲁⲍⲱⲛ	N	ⲙⲛⲧⲁⲗⲁⲍⲱⲛ
ⲙⲛⲧⲁⲙⲉⲗⲏⲥ	N	ⲙⲛⲧⲁⲙⲉⲗⲏⲥ
ⲙⲛⲧⲁⲛⲁⲓⲥⲑⲏⲧⲟⲥ	N	ⲙⲛⲧⲁⲛⲁⲓⲥⲑⲏⲧⲟⲥ
ⲙⲛⲧⲁⲛⲁⲭⲱⲣⲓⲧⲏⲥ	N	ⲙⲛⲧⲁⲛⲁⲭⲱⲣⲓⲧⲏⲥ
ⲙⲛⲧⲁⲛⲟⲏⲧⲟⲥ	N	ⲙⲛⲧⲁⲛⲟⲏⲧⲟⲥ
ⲙⲛⲧⲁⲛⲟⲩⲥⲓⲟⲥ	N	ⲙⲛⲧⲁⲛⲟⲩⲥⲓⲟⲥ
ⲙⲛⲧⲁⲡⲁⲛⲑⲣⲱⲡⲟⲥ	N	ⲙⲛⲧⲁⲡⲁⲛⲑⲣⲱⲡⲟⲥ
ⲙⲛⲧⲁⲡⲓⲥⲧⲟⲥ	N	ⲙⲛⲧⲁⲡⲓⲥⲧⲟⲥ
ⲙⲛⲧⲁⲡⲟⲥⲧⲁⲧⲏⲥ	N	ⲙⲛⲧⲁⲡⲟⲥⲧⲁⲧⲏⲥ
ⲙⲛⲧⲁⲡⲟⲥⲧⲟⲗⲟⲥ	N	ⲙⲛⲧⲁⲡⲟⲥⲧⲟⲗⲟⲥ
ⲙⲛⲧⲁⲡⲟⲥⲧⲟⲥ	N	ⲙⲛⲧⲁⲡⲟⲥⲧⲟⲥ
ⲙⲛⲧⲁⲡⲟⲧⲁⲕⲧⲓⲕⲟⲥ	N	ⲙⲛⲧⲁⲡⲟⲧⲁⲕⲧⲓⲕⲟⲥ
ⲙⲛⲧⲁⲣⲅⲟⲥ	N	ⲙⲛⲧⲁⲣⲅⲟⲥ
ⲙⲛⲧⲁⲣⲭⲏⲉⲡⲓⲥⲕⲟⲡⲟⲥ	N	ⲙⲛⲧⲁⲣⲭⲏⲉⲡⲓⲥⲕⲟⲡⲟⲥ
ⲙⲛⲧⲁⲣⲭⲓⲉⲡⲓⲥⲕⲟⲡⲟⲥ	N	ⲙⲛⲧⲁⲣⲭⲓⲉⲡⲓⲥⲕⲟⲡⲟⲥ
ⲙⲛⲧⲁⲣⲭⲓⲉⲣⲉⲩⲥ	N	ⲙⲛⲧⲁⲣⲭⲓⲉⲣⲉⲩⲥ
ⲙⲛⲧⲁⲥⲉⲃⲏⲥ	N	ⲙⲛⲧⲁⲥⲉⲃⲏⲥ
ⲙⲛⲧⲁⲥⲑⲉⲛⲏⲥ	N	ⲙⲛⲧⲁⲥⲑⲉⲛⲏⲥ
ⲙⲛⲧⲁⲥⲕⲏⲧⲏⲥ	N	ⲙⲛⲧⲁⲥⲕⲏⲧⲏⲥ
ⲙⲛⲧⲁⲥⲥⲉ	N	ⲙⲛⲧⲁⲥⲥⲉ
ⲙⲛⲧⲁⲧϣⲓⲡⲉ	N	ⲙⲛⲧⲁⲧϣⲓⲡⲉ
ⲙⲛⲧⲁⲧϣⲟϫⲛⲉ	N	ⲙⲛⲧⲁⲧϣⲟϫⲛⲉ
ⲙⲛⲧⲁⲧϩⲏⲧ	N	ⲙⲛⲧⲁⲧϩⲏⲧ
ⲙⲛⲧⲁⲧϩⲛⲁⲁⲩ	N	ⲙⲛⲧⲁⲧϩⲛⲁⲁⲩ
ⲙⲛⲧⲁⲧϩⲟⲧⲉ	N	ⲙⲛⲧⲁⲧϩⲟⲧⲉ
ⲙⲛⲧⲁⲧϭⲟⲙ	N	ⲙⲛⲧⲁⲧϭⲟⲙ
ⲙⲛⲧⲁⲧϯⲥⲟ	N	ⲙⲛⲧⲁⲧϯⲥⲟ
ⲙⲛⲧⲁⲧⲁⲙⲁϩⲧⲉ	N	ⲙⲛⲧⲁⲧⲁⲙⲁϩⲧⲉ
ⲙⲛⲧⲁⲧⲁⲝⲓⲁ	N	ⲙⲛⲧⲁⲧⲁⲝⲓⲁ
ⲙⲛⲧⲁⲧⲃⲁⲗ	N	ⲙⲛⲧⲁⲧⲃⲁⲗ
ⲙⲛⲧⲁⲧⲃⲟⲧⲉ	N	ⲙⲛⲧⲁⲧⲃⲟⲧⲉ
ⲙⲛⲧⲁⲧⲇⲓⲁⲕⲣⲓⲛⲉ	N	ⲙⲛⲧⲁⲧⲇⲓⲁⲕⲣⲓⲛⲉ
ⲙⲛⲧⲁⲧⲙⲟⲩ	N	ⲙⲛⲧⲁⲧⲙⲟⲩ
ⲙⲛⲧⲁⲧⲛⲁϩⲧⲉ	N	ⲙⲛⲧⲁⲧⲛⲁϩⲧⲉ
ⲙⲛⲧⲁⲧⲛⲁ	N	ⲙⲛⲧⲁⲧⲛⲁ
ⲙⲛⲧⲁⲧⲛⲟⲩⲧⲉ	N	ⲙⲛⲧⲁⲧⲛⲟⲩⲧⲉ
ⲙⲛⲧⲁⲧⲣⲟⲟⲩϣ	N	ⲙⲛⲧⲁⲧⲣⲟⲟⲩϣ
ⲙⲛⲧⲁⲧⲥⲃⲃⲉ	N	ⲙⲛⲧⲁⲧⲥⲃⲃⲉ
ⲙⲛⲧⲁⲧⲥⲃⲱ	N	ⲙⲛⲧⲁⲧⲥⲃⲱ
ⲙⲛⲧⲁⲧⲥⲉⲓ	N	ⲙⲛⲧⲁⲧⲥⲉⲓ
ⲙⲛⲧⲁⲧⲥⲟⲟⲩⲛ	N	ⲙⲛⲧⲁⲧⲥⲟⲟⲩⲛ
ⲙⲛⲧⲁⲧⲥⲱⲧⲙ	N	ⲙⲛⲧⲁⲧⲥⲱⲧⲙ
ⲙⲛⲧⲁⲧⲧⲱϣ	N	ⲙⲛⲧⲁⲧⲧⲱϣ
ⲙⲛⲧⲁⲧⲫⲑⲟⲛⲟⲥ	N	ⲙⲛⲧⲁⲧⲫⲑⲟⲛⲟⲥ
ⲙⲛⲧⲁⲩⲑⲁⲇⲏⲥ	N	ⲙⲛⲧⲁⲩⲑⲁⲇⲏⲥ
ⲙⲛⲧⲁⲩⲑⲉⲛⲧⲏⲥ	N	ⲙⲛⲧⲁⲩⲑⲉⲛⲧⲏⲥ
ⲙⲛⲧⲁⲩⲥⲧⲏⲣⲟⲥ	N	ⲙⲛⲧⲁⲩⲥⲧⲏⲣⲟⲥ
ⲙⲛⲧⲁ	EXIST	ⲙⲛⲧⲁ
ⲙⲛⲧⲃⲁⲃⲉⲣⲱⲙⲉ	N	ⲙⲛⲧⲃⲁⲃⲉⲣⲱⲙⲉ
ⲙⲛⲧⲃⲁⲃⲉ	N	ⲙⲛⲧⲃⲁⲃⲉ
ⲙⲛⲧⲃⲁⲗϩⲏⲧ	N	ⲙⲛⲧⲃⲁⲗϩⲏⲧ
ⲙⲛⲧⲃⲗⲗⲉ	N	ⲙⲛⲧⲃⲗⲗⲉ
ⲙⲛⲧⲅⲉⲛⲛⲉⲟⲥ	N	ⲙⲛⲧⲅⲉⲛⲛⲉⲟⲥ
ⲙⲛⲧⲇⲓⲁⲃⲟⲗⲟⲥ	N	ⲙⲛⲧⲇⲓⲁⲃⲟⲗⲟⲥ
ⲙⲛⲧⲇⲓⲕⲁⲓⲟⲥ	N	ⲙⲛⲧⲇⲓⲕⲁⲓⲟⲥ
ⲙⲛⲧⲉϣⲱⲱⲧ	N	ⲙⲛⲧⲉϣⲱⲱⲧ
ⲙⲛⲧⲉⲃⲓⲏⲛ	N	ⲙⲛⲧⲉⲃⲓⲏⲛ
ⲙⲛⲧⲉⲓⲱⲧ	N	ⲙⲛⲧⲉⲓⲱⲧ
ⲙⲛⲧⲉⲕⲗⲉⲕⲧⲟⲥ	N	ⲙⲛⲧⲉⲕⲗⲉⲕⲧⲟⲥ
ⲙⲛⲧⲉⲗⲁⲭⲓⲥⲧⲟⲥ	N	ⲙⲛⲧⲉⲗⲁⲭⲓⲥⲧⲟⲥ
ⲙⲛⲧⲉⲗⲉⲩⲑⲉⲣⲟⲥ	N	ⲙⲛⲧⲉⲗⲉⲩⲑⲉⲣⲟⲥ
ⲙⲛⲧⲉⲡⲓⲉⲓⲕⲏⲥ	N	ⲙⲛⲧⲉⲡⲓⲉⲓⲕⲏⲥ
ⲙⲛⲧⲉⲡⲓⲥⲕⲟⲡⲟⲥ	N	ⲙⲛⲧⲉⲡⲓⲥⲕⲟⲡⲟⲥ
ⲙⲛⲧⲉⲣⲟ	N	ⲙⲛⲧⲉⲣⲟ
ⲙⲛⲧⲉⲣⲱⲟⲩ	N	ⲙⲛⲧⲉⲣⲟ
ⲙⲛⲧⲉⲥⲭⲣⲟⲥ	N	ⲙⲛⲧⲉⲥⲭⲣⲟⲥ
ⲙⲛⲧⲉⲩⲅⲉⲛⲏⲥ	N	ⲙⲛⲧⲉⲩⲅⲉⲛⲏⲥ
ⲙⲛⲧⲉⲩⲥⲉⲃⲏⲥ	N	ⲙⲛⲧⲉⲩⲥⲉⲃⲏⲥ
ⲙⲛⲧⲉⲩⲧⲁⲕⲧⲟⲥ	N	ⲙⲛⲧⲉⲩⲧⲁⲕⲧⲟⲥ
ⲙⲛⲧⲉⲩⲧⲉⲗⲏⲥ	N	ⲙⲛⲧⲉⲩⲧⲉⲗⲏⲥ
ⲙⲛⲧⲉ	EXIST	ⲙⲛⲧⲁ
ⲙⲛⲧⲏⲡⲉ	N	ⲙⲛⲧⲏⲡⲉ
ⲙⲛⲧⲏ	EXIST	ⲙⲛⲧⲏ
ⲙⲛⲧⲏ	N	ⲙⲛⲧⲏ
ⲙⲛⲧⲓⲱⲧ	N	ⲙⲛⲧⲓⲱⲧ
ⲙⲛⲧⲕⲁⲑⲁⲣⲟⲥ	N	ⲙⲛⲧⲕⲁⲑⲁⲣⲟⲥ
ⲙⲛⲧⲕⲁⲕⲟⲩⲣⲅⲟⲥ	N	ⲙⲛⲧⲕⲁⲕⲟⲩⲣⲅⲟⲥ
ⲙⲛⲧⲕⲁⲧⲁⲣⲱⲙⲉ	N	ⲙⲛⲧⲕⲁⲧⲁⲣⲱⲙⲉ
ⲙⲛⲧⲕⲗⲏⲣⲓⲕⲟⲥ	N	ⲙⲛⲧⲕⲗⲏⲣⲓⲕⲟⲥ
ⲙⲛⲧⲕⲟⲓⲛⲱⲛⲟⲥ	N	ⲙⲛⲧⲕⲟⲓⲛⲱⲛⲟⲥ
ⲙⲛⲧⲕⲟⲥⲙⲓⲕⲟⲛ	N	ⲙⲛⲧⲕⲟⲥⲙⲓⲕⲟⲛ
ⲙⲛⲧⲕⲟⲩⲉⲓ	N	ⲙⲛⲧⲕⲟⲩⲉⲓ
ⲙⲛⲧⲕⲟⲩⲓ	N	ⲙⲛⲧⲕⲟⲩⲓ
ⲙⲛⲧⲗⲁⲙⲡⲣⲟⲥ	N	ⲙⲛⲧⲗⲁⲙⲡⲣⲟⲥ
ⲙⲛⲧⲗⲏⲥⲧⲏⲥ	N	ⲙⲛⲧⲗⲏⲥⲧⲏⲥ
ⲙⲛⲧⲙⲁⲅⲟⲥ	N	ⲙⲛⲧⲙⲁⲅⲟⲥ
ⲙⲛⲧⲙⲁⲓϣⲏⲣⲉ	N	ⲙⲛⲧⲙⲁⲓϣⲏⲣⲉ
ⲙⲛⲧⲙⲁⲓⲕⲟⲥⲙⲉⲓ	N	ⲙⲛⲧⲙⲁⲓⲕⲟⲥⲙⲉⲓ
ⲙⲛⲧⲙⲁⲓⲛⲟⲩⲧⲉ	N	ⲙⲛⲧⲙⲁⲓⲛⲟⲩⲧⲉ
ⲙⲛⲧⲙⲁⲓⲣⲱⲙⲉ	N	ⲙⲛⲧⲙⲁⲓⲣⲱⲙⲉ
ⲙⲛⲧⲙⲁⲓⲥⲟⲛ	N	ⲙⲛⲧⲙⲁⲓⲥⲟⲛ
ⲙⲛⲧⲙⲁⲓⲭⲣⲏⲙⲁ	N	ⲙⲛⲧⲙⲁⲓⲭⲣⲏⲙⲁ
ⲙⲛⲧⲙⲁⲓ	N	ⲙⲛⲧⲙⲁⲓ
ⲙⲛⲧⲙⲁⲕⲁⲣⲓⲟⲥ	N	ⲙⲛⲧⲙⲁⲕⲁⲣⲓⲟⲥ
ⲙⲛⲧⲙⲁⲣⲧⲩⲣⲟⲥ	N	ⲙⲛⲧⲙⲁⲣⲧⲩⲣⲟⲥ
ⲙⲛⲧⲙⲁⲧⲟⲓ	N	ⲙⲛⲧⲙⲁⲧⲟⲓ
ⲙⲛⲧⲙⲉⲧⲣⲓⲟⲥ	N	ⲙⲛⲧⲙⲉⲧⲣⲓⲟⲥ
ⲙⲛⲧⲙⲉ	N	ⲙⲛⲧⲙⲉ
ⲙⲛⲧⲙⲛⲧⲣⲉ	N	ⲙⲛⲧⲙⲛⲧⲣⲉ
ⲙⲛⲧⲙⲟⲛⲁⲭⲟⲥ	N	ⲙⲛⲧⲙⲟⲛⲁⲭⲟⲥ
ⲙⲛⲧⲙⲟⲛⲟⲭⲟⲥ	N	ⲙⲛⲧⲙⲟⲛⲟⲭⲟⲥ
ⲙⲛⲧⲛⲁϣⲧϩⲏⲧ	N	ⲙⲛⲧⲛⲁϣⲧϩⲏⲧ
ⲙⲛⲧⲛⲁϣⲧⲙⲁⲕϩ	N	ⲙⲛⲧⲛⲁϣⲧⲙⲁⲕϩ
ⲙⲛⲧⲛⲁⲏⲧ	N	ⲙⲛⲧⲛⲁⲏⲧ
ⲙⲛⲧⲛⲁ	N	ⲙⲛⲧⲛⲁ
ⲙⲛⲧⲛⲟϭ	N	ⲙⲛⲧⲛⲟϭ
ⲙⲛⲧⲛⲟⲉⲓⲕ	N	ⲙⲛⲧⲛⲟⲉⲓⲕ
ⲙⲛⲧⲛⲟⲩϫ	N	ⲙⲛⲧⲛⲟⲩϫ
ⲙⲛⲧⲛⲟⲩⲧⲉ	N	ⲙⲛⲧⲛⲟⲩⲧⲉ
ⲙⲛⲧⲟⲓⲅⲉ	CONJ	ⲙⲛⲧⲟⲓⲅⲉ
ⲙⲛⲧⲟⲩⲉⲓⲉⲛⲓⲛ	N	ⲙⲛⲧⲟⲩⲉⲓⲉⲛⲓⲛ
ⲙⲛⲧⲟⲩⲉ	N	ⲙⲛⲧⲟⲩⲉ
ⲙⲛⲧⲟⲩⲏⲏⲃ	N	ⲙⲛⲧⲟⲩⲏⲏⲃ
ⲙⲛⲧⲟⲩⲥⲓⲁ	N	ⲙⲛⲧⲟⲩⲥⲓⲁ
ⲙⲛⲧⲡⲁⲛⲟⲩⲣⲅⲟⲥ	N	ⲙⲛⲧⲡⲁⲛⲟⲩⲣⲅⲟⲥ
ⲙⲛⲧⲡⲁⲛⲧⲟⲕⲣⲁⲧⲱⲣ	N	ⲙⲛⲧⲡⲁⲛⲧⲟⲕⲣⲁⲧⲱⲣ
ⲙⲛⲧⲡⲁⲣⲁⲃⲁⲧⲏⲥ	N	ⲙⲛⲧⲡⲁⲣⲁⲃⲁⲧⲏⲥ
ⲙⲛⲧⲡⲁⲣⲁⲛⲟⲙⲟⲥ	N	ⲙⲛⲧⲡⲁⲣⲁⲛⲟⲙⲟⲥ
ⲙⲛⲧⲡⲁⲣⲁ[ⲫⲣⲱⲛ]	N	ⲙⲛⲧⲡⲁⲣⲁ[ⲫⲣⲱⲛ]
ⲙⲛⲧⲡⲁⲣⲑⲉⲛⲟⲥ	N	ⲙⲛⲧⲡⲁⲣⲑⲉⲛⲟⲥ
ⲙⲛⲧⲡⲉⲣⲓⲉⲣⲅⲟⲥ	N	ⲙⲛⲧⲡⲉⲣⲓⲉⲣⲅⲟⲥ
ⲙⲛⲧⲡⲉⲣⲓⲟⲩⲣⲅⲟⲥ	N	ⲙⲛⲧⲡⲉⲣⲓⲟⲩⲣⲅⲟⲥ
ⲙⲛⲧⲡⲉⲧϣⲟⲩⲉⲓⲧ	N	ⲙⲛⲧⲡⲉⲧϣⲟⲩⲉⲓⲧ
ⲙⲛⲧⲡⲉⲧⲟⲩⲁⲁⲃ	N	ⲙⲛⲧⲡⲉⲧⲟⲩⲁⲁⲃ
ⲙⲛⲧⲡⲟⲛⲏⲣⲟⲥ	N	ⲙⲛⲧⲡⲟⲛⲏⲣⲟⲥ
ⲙⲛⲧⲡⲣⲉⲥⲃⲩⲧⲉⲣⲟⲥ	N	ⲙⲛⲧⲡⲣⲉⲥⲃⲩⲧⲉⲣⲟⲥ
ⲙⲛⲧⲡⲣⲟⲇⲟⲧⲏⲥ	N	ⲙⲛⲧⲡⲣⲟⲇⲟⲧⲏⲥ
ⲙⲛⲧⲡⲣⲟⲡⲉⲧⲏⲥ	N	ⲙⲛⲧⲡⲣⲟⲡⲉⲧⲏⲥ
ⲙⲛⲧⲡⲣⲟⲫⲏⲧⲏⲥ	N	ⲙⲛⲧⲡⲣⲟⲫⲏⲧⲏⲥ
ⲙⲛⲧⲣⲉϥϣⲉⲙϣⲉⲛⲟⲩⲧⲉ	N	ⲙⲛⲧⲣⲉϥϣⲉⲙϣⲉⲛⲟⲩⲧⲉ
ⲙⲛⲧⲣⲉϥϣⲙϣⲉⲉⲓⲇⲱⲗⲟⲛ	N	ⲙⲛⲧⲣⲉϥϣⲙϣⲉⲉⲓⲇⲱⲗⲟⲛ
ⲙⲛⲧⲣⲉϥϣⲙϣⲉⲛⲟⲩⲧⲉ	N	ⲙⲛⲧⲣⲉϥϣⲙϣⲉⲛⲟⲩⲧⲉ
ⲙⲛⲧⲣⲉϥϣⲙϣⲉ	N	ⲙⲛⲧⲣⲉϥϣⲙϣⲉ
ⲙⲛⲧⲣⲉϥϣⲟⲟⲣ	N	ⲙⲛⲧⲣⲉϥϣⲟⲟⲣ
ⲙⲛⲧⲣⲉϥϩⲉⲧⲃⲣⲱⲙⲉ	N	ⲙⲛⲧⲣⲉϥϩⲉⲧⲃⲣⲱⲙⲉ
ⲙⲛⲧⲣⲉϥϩⲉⲧⲃⲯⲩⲭⲏ	N	ⲙⲛⲧⲣⲉϥϩⲉⲧⲃⲯⲩⲭⲏ
ⲙⲛⲧⲣⲉϥϩⲓⲗⲁ	N	ⲙⲛⲧⲣⲉϥϩⲓⲗⲁ
ⲙⲛⲧⲣⲉϥϫⲓϩⲟ	N	ⲙⲛⲧⲣⲉϥϫⲓϩⲟ
ⲙⲛⲧⲣⲉϥϫⲓⲙⲏⲥⲉ	N	ⲙⲛⲧⲣⲉϥϫⲓⲙⲏⲥⲉ
ⲙⲛⲧⲣⲉϥϫⲓⲛϭⲟⲛⲥ	N	ⲙⲛⲧⲣⲉϥϫⲓⲛϭⲟⲛⲥ
ⲙⲛⲧⲣⲉϥϫⲓⲟⲩⲁ	N	ⲙⲛⲧⲣⲉϥϫⲓⲟⲩⲁ
ⲙⲛⲧⲣⲉϥϫⲓ	N	ⲙⲛⲧⲣⲉϥϫⲓ
ⲙⲛⲧⲣⲉϥϫⲛⲁⲁⲩ	N	ⲙⲛⲧⲣⲉϥϫⲛⲁⲁⲩ
ⲙⲛⲧⲣⲉϥϫⲱϩⲙ	N	ⲙⲛⲧⲣⲉϥϫⲱϩⲙ
ⲙⲛⲧⲣⲉϥϭⲛⲁⲣⲓⲕⲉ	N	ⲙⲛⲧⲣⲉϥϭⲛⲁⲣⲓⲕⲉ
ⲙⲛⲧⲣⲉϥϭⲛ	N	ⲙⲛⲧⲣⲉϥϭⲛ
ⲙⲛⲧⲣⲉϥϯϭⲱⲛⲧ	N	ⲙⲛⲧⲣⲉϥϯϭⲱⲛⲧ
ⲙⲛⲧⲣⲉϥϯⲧⲱⲛ	N	ⲙⲛⲧⲣⲉϥϯⲧⲱⲛ
ⲙⲛⲧⲣⲉϥⲇⲓⲁⲕⲟⲛⲉⲓ	N	ⲙⲛⲧⲣⲉϥⲇⲓⲁⲕⲟⲛⲉⲓ
ⲙⲛⲧⲣⲉϥⲣϩⲁⲗ	N	ⲙⲛⲧⲣⲉϥⲣϩⲁⲗ
ⲙⲛⲧⲣⲉϥⲣϩⲟⲧⲉ	N	ⲙⲛⲧⲣⲉϥⲣϩⲟⲧⲉ
ⲙⲛⲧⲣⲉϥⲧⲁⲕⲉϩⲏⲧ	N	ⲙⲛⲧⲣⲉϥⲧⲁⲕⲉϩⲏⲧ
ⲙⲛⲧⲣⲉϥⲧⲱϩ	N	ⲙⲛⲧⲣⲉϥⲧⲱϩ
ⲙⲛⲧⲣⲉⲙⲙⲁⲟ	N	ⲙⲛⲧⲣⲉⲙⲙⲁⲟ
ⲙⲛⲧⲣⲉⲙⲛϩⲏⲧ	N	ⲙⲛⲧⲣⲉⲙⲛϩⲏⲧ
ⲙⲛⲧⲣⲉⲛⲛⲟⲩϫ	N	ⲙⲛⲧⲣⲉⲛⲛⲟⲩϫ
ⲙⲛⲧⲣⲉⲩⲉ	V	ⲙⲛⲧⲣⲉⲩⲉ
ⲙⲛⲧⲣⲉ	N	ⲙⲛⲧⲣⲉ
ⲙⲛⲧⲣⲙϩⲉ	N	ⲙⲛⲧⲣⲙϩⲉ
ⲙⲛⲧⲣⲙⲙⲁⲟ	N	ⲙⲛⲧⲣⲙⲙⲁⲟ
ⲙⲛⲧⲣⲙⲛϩⲏⲧ	N	ⲙⲛⲧⲣⲙⲛϩⲏⲧ
ⲙⲛⲧⲣⲙⲛⲧϩⲏⲧ	N	ⲙⲛⲧⲣⲙⲛⲧϩⲏⲧ
ⲙⲛⲧⲣⲙⲣⲁϣ	N	ⲙⲛⲧⲣⲙⲣⲁϣ
ⲙⲛⲧⲣⲣⲟ	N	ⲙⲛⲧⲣⲣⲟ
ⲙⲛⲧⲣⲣⲱⲟⲩ	N	ⲙⲛⲧⲉⲣⲟ
ⲙⲛⲧⲣⲱⲙⲉ	N	ⲙⲛⲧⲣⲱⲙⲉ
ⲙⲛⲧⲥⲁⲃⲉ	N	ⲙⲛⲧⲥⲁⲃⲉ
ⲙⲛⲧⲥⲁⲓⲉ	N	ⲙⲛⲧⲥⲁⲓⲉ
ⲙⲛⲧⲥⲉⲙⲛⲟⲥ	N	ⲙⲛⲧⲥⲉⲙⲛⲟⲥ
ⲙⲛⲧⲥⲕⲗⲏⲣⲟⲥ	N	ⲙⲛⲧⲥⲕⲗⲏⲣⲟⲥ
ⲙⲛⲧⲥⲛⲟⲟⲩⲥ	N	ⲙⲛⲧⲥⲛⲟⲟⲩⲥ
ⲙⲛⲧⲥⲛⲟⲟⲩⲥ	NUM	ⲙⲛⲧⲥⲛⲟⲟⲩⲥ
ⲙⲛⲧⲥⲟϭ	N	ⲙⲛⲧⲥⲟϭ
ⲙⲛⲧⲥⲡⲁⲑⲁⲣⲓⲟⲥ	N	ⲙⲛⲧⲥⲡⲁⲑⲁⲣⲓⲟⲥ
ⲙⲛⲧⲥⲧⲙⲏⲧ	N	ⲙⲛⲧⲥⲧⲙⲏⲧ
ⲙⲛⲧⲥⲧⲣⲁⲧⲏⲗⲁⲧⲏⲥ	N	ⲙⲛⲧⲥⲧⲣⲁⲧⲏⲗⲁⲧⲏⲥ
ⲙⲛⲧⲥⲩⲅⲅⲉⲛⲏⲥ	N	ⲙⲛⲧⲥⲩⲅⲅⲉⲛⲏⲥ
ⲙⲛⲧⲥⲩⲛⲕⲗⲏⲧⲓⲕⲟⲥ	N	ⲙⲛⲧⲥⲩⲛⲕⲗⲏⲧⲓⲕⲟⲥ
ⲙⲛⲧⲧⲁⲗⲁⲓⲡⲱⲣⲟⲥ	N	ⲙⲛⲧⲧⲁⲗⲁⲓⲡⲱⲣⲟⲥ
ⲙⲛⲧⲧⲉⲗⲉⲓⲟⲥ	N	ⲙⲛⲧⲧⲉⲗⲉⲓⲟⲥ
ⲙⲛⲧⲧⲉⲗⲓⲟⲥ	N	ⲙⲛⲧⲧⲉⲗⲓⲟⲥ
ⲙⲛⲧⲧⲟⲗⲙⲏⲣⲟⲥ	N	ⲙⲛⲧⲧⲟⲗⲙⲏⲣⲟⲥ
ⲙⲛⲧⲧⲩⲣⲁⲛⲛⲟⲥ	N	ⲙⲛⲧⲧⲩⲣⲁⲛⲛⲟⲥ
ⲙⲛⲧⲫⲁⲩⲗⲟⲥ	N	ⲙⲛⲧⲫⲁⲩⲗⲟⲥ
ⲙⲛⲧⲫⲓⲗⲁⲧⲉⲗⲫⲟⲥ	N	ⲙⲛⲧⲫⲓⲗⲁⲧⲉⲗⲫⲟⲥ
ⲙⲛⲧⲫⲗⲩⲁⲣⲟⲥ	N	ⲙⲛⲧⲫⲗⲩⲁⲣⲟⲥ
ⲙⲛⲧⲭⲏⲣⲁ	N	ⲙⲛⲧⲭⲏⲣⲁ
ⲙⲛⲧⲭⲣⲏⲥⲧⲟⲥ	N	ⲙⲛⲧⲭⲣⲏⲥⲧⲟⲥ
ⲙⲛⲧⲭⲣⲓⲥⲧⲓⲁⲛⲟⲥ	N	ⲙⲛⲧⲭⲣⲓⲥⲧⲓⲁⲛⲟⲥ
ⲙⲛⲧ	EXIST	ⲙⲛⲧⲁ
ⲙⲛⲧ	NUM	ⲙⲛⲧ
ⲙⲛ	EXIST	ⲙⲛ
ⲙⲛ	PREP	ⲙⲛ
ⲙⲟϣⲧ	V	ⲙⲟϣⲧ
ⲙⲟϫϩ	N	ⲙⲟϫϩ
ⲙⲟϫϭ	V	ⲙⲟⲩϫϭ
ⲙⲟϫϭ	VSTAT	ⲙⲟⲩϫϭ
ⲙⲟϫⲧ	VSTAT	ⲙⲟⲩϫϭ
ⲙⲟϫ	N	ⲙⲟϫ
ⲙⲟⲅⲓⲥ	ADV	ⲙⲟⲅⲓⲥ
ⲙⲟⲇⲓⲟⲛ	N	ⲙⲟⲇⲓⲟⲛ
ⲙⲟⲉⲓϩⲉ	N	ⲙⲟⲉⲓϩⲉ
ⲙⲟⲉⲓⲧ	N	ⲙⲟⲉⲓⲧ
ⲙⲟⲓϩⲉ	N	ⲙⲟⲓϩⲉ
ⲙⲟⲓⲣⲁ	N	ⲙⲟⲓⲣⲁ
ⲙⲟⲓⲭⲉⲓⲁ	N	ⲙⲟⲓⲭⲉⲓⲁ
ⲙⲟⲕϩⲛϩⲏⲧ	V	ⲙⲟⲕϩⲛϩⲏⲧ
ⲙⲟⲕϩⲥ	VSTAT	ⲙⲟⲕϩ
ⲙⲟⲕϩ	V	ⲙⲟⲕϩ
ⲙⲟⲕϩ	VSTAT	ⲙⲟⲩⲕϩ
ⲙⲟⲕⲉϩⲛϩⲏⲧ	V	ⲙⲟⲕⲉϩⲛϩⲏⲧ
ⲙⲟⲕⲉϩ	VSTAT	ⲙⲟⲕϩ
ⲙⲟⲕⲙⲉⲕ	N	ⲙⲟⲕⲙⲉⲕ
ⲙⲟⲕⲙⲉⲕ	V	ⲙⲟⲕⲙⲉⲕ
ⲙⲟⲕⲙⲕ	V	ⲙⲟⲕⲙⲕ
ⲙⲟⲗϩ	V	ⲙⲟⲩⲗϩ
ⲙⲟⲗϩ	VSTAT	ⲙⲟⲩⲗϩ
ⲙⲟⲛⲁⲍⲉⲓ	V	ⲙⲟⲛⲁⲍⲉⲓ
ⲙⲟⲛⲁⲣⲭⲏⲥ	N	ⲙⲟⲛⲁⲣⲭⲏⲥ
ⲙⲟⲛⲁⲣⲭⲓⲁ	N	ⲙⲟⲛⲁⲣⲭⲓⲁ
ⲙⲟⲛⲁⲥⲧⲏⲣⲓⲟⲛ	N	ⲙⲟⲛⲁⲥⲧⲏⲣⲓⲟⲛ
ⲙⲟⲛⲁⲥ	N	ⲙⲟⲛⲁⲥ
ⲙⲟⲛⲁⲭⲏ	N	ⲙⲟⲛⲁⲭⲏ
ⲙⲟⲛⲁⲭⲟⲥ	N	ⲙⲟⲛⲁⲭⲟⲥ
ⲙⲟⲛⲏ	N	ⲙⲟⲛⲏ
ⲙⲟⲛⲑⲩⲗⲟⲥ	N	ⲙⲟⲛⲑⲩⲗⲟⲥ
ⲙⲟⲛⲕ	V	ⲙⲟⲛⲕ
ⲙⲟⲛⲟⲅⲉⲛⲏⲥ	N	ⲙⲟⲛⲟⲅⲉⲛⲏⲥ
ⲙⲟⲛⲟⲕⲉⲣⲱⲥ	N	ⲙⲟⲛⲟⲕⲉⲣⲱⲥ
ⲙⲟⲛⲟⲛ	CONJ	ⲙⲟⲛⲟⲛ
ⲙⲟⲛⲟⲛ	FM	ⲙⲟⲛⲟⲛ
ⲙⲟⲛⲟⲭⲟⲥ	N	ⲙⲟⲛⲟⲭⲟⲥ
ⲙⲟⲟϣⲉ	V	ⲙⲟⲟϣⲉ
ⲙⲟⲟⲛⲉ	V	ⲙⲟⲟⲛⲉ
ⲙⲟⲟⲩⲧ	V	ⲙⲟⲩⲟⲩⲧ
ⲙⲟⲟⲩⲧ	VSTAT	ⲙⲟⲩⲟⲩⲧ
ⲙⲟⲟⲩ	N	ⲙⲟⲟⲩ
ⲙⲟⲣⲧ	N	ⲙⲟⲣⲧ
ⲙⲟⲣⲫⲏ	N	ⲙⲟⲣⲫⲏ
ⲙⲟⲣ	V	ⲙⲟⲩⲣ
ⲙⲟⲥⲧⲉ	N	ⲙⲟⲥⲧⲉ
ⲙⲟⲥⲧⲉ	V	ⲙⲟⲥⲧⲉ
ⲙⲟⲧⲉⲛ	VSTAT	ⲙⲧⲟⲛ
ⲙⲟⲧⲉ	N	ⲙⲟⲧⲉ
ⲙⲟⲧⲛⲉⲥ	N	ⲙⲟⲧⲛⲉⲥ
ⲙⲟⲧⲛ	VSTAT	ⲙⲧⲟⲛ
ⲙⲟⲩϣⲧ	V	ⲙⲟⲩϣⲧ
ⲙⲟⲩϩ	V	ⲙⲟⲩϩ
ⲙⲟⲩⲉⲓⲟⲟⲩⲉ	N	ⲙⲟⲟⲩ
ⲙⲟⲩⲓⲟⲟⲩⲉ	N	ⲙⲟⲟⲩ
ⲙⲟⲩⲓ	N	ⲙⲟⲩⲓ
ⲙⲟⲩⲕϩ	V	ⲙⲟⲩⲕϩ
ⲙⲟⲩⲗϩ	V	ⲙⲟⲩⲗϩ
ⲙⲟⲩⲗⲗⲁ	N	ⲙⲟⲩⲗⲗⲁ
ⲙⲟⲩⲛϩⲱⲟⲩ	N	ⲙⲟⲩⲛϩⲱⲟⲩ
ⲙⲟⲩⲛⲅ	N	ⲙⲟⲩⲛⲅ
ⲙⲟⲩⲛⲉⲓⲟⲟⲩⲉ	N	ⲙⲟⲩⲛⲉⲓⲟⲟⲩⲉ
ⲙⲟⲩⲛⲕ	N	ⲙⲟⲩⲛⲕ
ⲙⲟⲩⲟⲩⲧ	V	ⲙⲟⲩⲟⲩⲧ
ⲙⲟⲩⲣ	V	ⲙⲟⲩⲣ
ⲙⲟⲩⲥⲓⲕⲉ	N	ⲙⲟⲩⲥⲓⲕⲉ
ⲙⲟⲩⲥⲓⲕⲟⲛ	N	ⲙⲟⲩⲥⲓⲕⲟⲛ
ⲙⲟⲩⲥⲭⲁⲧⲱⲛ	N	ⲙⲟⲩⲥⲭⲁⲧⲱⲛ
ⲙⲟⲩⲥ	N	ⲙⲟⲩⲥ
ⲙⲟⲩⲧⲉ	V	ⲙⲟⲩⲧⲉ
ⲙⲟⲩⲧ	N	ⲙⲟⲩⲧ
ⲙⲟⲩ	N	ⲙⲟⲩ
ⲙⲟⲩ	V	ⲙⲟⲩ
ⲙⲟⲭⲗⲟⲥ	N	ⲙⲟⲭⲗⲟⲥ
ⲙⲡϣⲁ	N	ⲙⲡϣⲁ
ⲙⲡϣⲁ	V	ⲙⲡϣⲁ
ⲙⲡϩⲟⲩⲛⲛ	PREP	ⲙⲡϩⲟⲩⲛⲛ
ⲙⲡϩⲣⲉⲙ	PREP	ⲙⲡϩⲣⲉⲙ
ⲙⲡϩⲱⲧⲉⲃⲟⲗⲙ	PREP	ⲙⲡϩⲱⲧⲉⲃⲟⲗⲙ
ⲙⲡϩⲱⲧⲉⲃⲟⲗⲛ	PREP	ⲙⲡϩⲱⲧⲉⲃⲟⲗⲛ
ⲙⲡⲁⲙⲧⲟⲉⲃⲟⲗ	PREP	ⲙⲡⲁⲙⲧⲟⲉⲃⲟⲗ
ⲙⲡⲁⲣⲁ	PREP	ⲙⲡⲁⲣⲁ
ⲙⲡⲁⲧⲉⲱⲥⲕϣⲱⲡⲉ	ADV	ⲙⲡⲁⲧⲉⲱⲥⲕϣⲱⲡⲉ
ⲙⲡⲁⲧⲉ	ANY	ⲙⲡⲁⲧⲉ
ⲙⲡⲁⲧⲉ	N	ⲙⲡⲁⲧⲉ
ⲙⲡⲁⲧ	ANY	ⲙⲡⲁⲧⲉ
ⲙⲡⲁ	N	ⲙⲡⲁ
ⲙⲡⲁ	NPROP	ⲙⲡⲁ
ⲙⲡⲁ	V	ⲙⲡⲁ
ⲙⲡⲃⲟⲗⲛ	PREP	ⲙⲡⲃⲟⲗⲛ
ⲙⲡⲉϥⲣⲁⲥⲧⲉ	ADV	ⲙⲡⲉϥⲣⲁⲥⲧⲉ
ⲙⲡⲉϥ	V	ⲙⲡⲉϥ
ⲙⲡⲉϩⲟⲟⲩⲙⲛⲧⲉⲩϣⲏ	ADV	ⲙⲡⲉϩⲟⲟⲩⲙⲛⲧⲉⲩϣⲏ
ⲙⲡⲉⲓⲥⲙⲟⲧⲙ	PREP	ⲙⲡⲉⲓⲥⲙⲟⲧⲛ
ⲙⲡⲉⲓⲥⲙⲟⲧⲛ	PREP	ⲙⲡⲉⲓⲥⲙⲟⲧⲛ
ⲙⲡⲉⲓⲥⲟⲡ	ADV	ⲙⲡⲉⲓⲥⲟⲡ
ⲙⲡⲉⲙⲧⲟⲉⲃⲟⲗⲙ	PREP	ⲙⲡⲉⲙⲧⲟⲉⲃⲟⲗⲛ
ⲙⲡⲉⲟⲩⲟⲉⲓϣⲉⲧⲙⲙⲁⲩ	ADV	ⲙⲡⲉⲟⲩⲟⲉⲓϣⲉⲧⲙⲙⲁⲩ
ⲙⲡⲉⲥⲏⲧ	ADV	ⲙⲡⲉⲥⲏⲧ
ⲙⲡⲉⲥⲙⲟⲧⲙ	PREP	ⲙⲡⲉⲥⲙⲟⲧⲛ
ⲙⲡⲉⲥⲙⲟⲧⲛ	PREP	ⲙⲡⲉⲥⲙⲟⲧⲛ
ⲙⲡⲉⲥⲛⲁⲩ	ADV	ⲙⲡⲉⲥⲛⲁⲩ
ⲙⲡⲉⲩⲟⲉⲓϣⲉⲧⲙⲙⲁⲩ	ADV	ⲙⲡⲉⲩⲟⲉⲓϣⲉⲧⲙⲙⲁⲩ
ⲙⲡⲉ	ANEGPST	ⲙⲡⲉ
ⲙⲡⲉ	ANEGPST_PPERS	ⲙⲡⲉ_ⲛⲧⲟ
ⲙⲡⲉ	PTC	ⲙⲡⲉ
ⲙⲡⲓⲟⲩⲟⲉⲓϣ	ADV	ⲙⲡⲓⲟⲩⲟⲉⲓϣ
ⲙⲡⲕ	ANEGPST	ⲙⲡⲕ
ⲙⲡⲙϩⲓⲧⲛ	PREP	ⲙⲡⲙϩⲓⲧⲛ
ⲙⲡⲙⲧⲟⲉⲃⲟⲗⲙ	PREP	ⲙⲡⲙⲧⲟⲉⲃⲟⲗⲙ
ⲙⲡⲙⲧⲟⲉⲃⲟⲗⲛ	PREP	ⲙⲡⲙⲧⲟⲉⲃⲟⲗⲛ
ⲙⲡⲛⲁⲩⲉⲧⲙⲙⲁⲩ	ADV	ⲙⲡⲛⲁⲩⲉⲧⲙⲙⲁⲩ
ⲙⲡⲛⲁⲩⲙⲡⲟⲩⲟⲉⲓⲛ	ADV	ⲙⲡⲛⲁⲩⲙⲡⲟⲩⲟⲉⲓⲛ
ⲙⲡⲛⲁⲩⲙ	PREP	ⲙⲡⲛⲁⲩⲛ
ⲙⲡⲛⲁⲩⲛⲙ	PREP	ⲙⲡⲛⲁⲩⲛ
ⲙⲡⲛⲁⲩⲛ	PREP	ⲙⲡⲛⲁⲩⲛ
ⲙⲡⲟⲇⲓⲍⲉ	V	ⲙⲡⲟⲇⲓⲍⲉ
ⲙⲡⲟⲟⲩ	ADV	ⲙⲡⲟⲟⲩ
ⲙⲡⲟⲩⲉ	ADV	ⲙⲡⲟⲩⲉ
ⲙⲡⲟⲩ	N	ⲙⲡⲟⲩ
ⲙⲡⲟ	V	ⲙⲡⲟ
ⲙⲡⲣⲧⲣⲉ	ANEGJUS	ⲙⲡⲣⲧⲣⲉ
ⲙⲡⲣ	NEG	ⲙⲡⲣ
ⲙⲡⲥⲁⲥⲛⲁⲩ	ADV	ⲙⲡⲥⲁⲥⲛⲁⲩ
ⲙⲡⲥⲟⲡ	ADV	ⲙⲡⲥⲟⲡ
ⲙⲡⲱⲣ	N	ⲙⲡⲱⲣ
ⲙⲡ	ANEGPST	ⲙⲡⲉ
ⲙⲡ	V	ⲙⲡ
ⲙⲣⲣⲉ	N	ⲙⲣⲣⲉ
ⲙⲣⲱ	N	ⲙⲣⲱ
ⲙⲥⲁϩ	N	ⲙⲥⲁϩ
ⲙⲧⲟⲛⲛϩⲏⲧ	N	ⲙⲧⲟⲛⲛϩⲏⲧ
ⲙⲧⲟⲛ	N	ⲙⲧⲟⲛ
ⲙⲧⲟⲛ	V	ⲙⲧⲟⲛ
ⲙⲧⲟ	N	ⲙⲧⲟ
ⲙⲧⲱ	N	ⲙⲧⲱ
ⲙⲩⲣⲓⲁⲣⲭⲟⲥ	N	ⲙⲩⲣⲓⲁⲣⲭⲟⲥ
ⲙⲩⲥⲧⲏⲣⲓⲟⲛ	N	ⲙⲩⲥⲧⲏⲣⲓⲟⲛ
ⲙⲱⲁⲃⲓⲧⲏⲥ	N	ⲙⲱⲁⲃⲓⲧⲏⲥ
ⲙⲱⲅⲓⲥ	ADV	ⲙⲱⲅⲓⲥ
ⲙⲱⲙϣ	N	ⲙⲱⲙϣ
ⲙⲱⲛⲁⲭⲏ	N	ⲙⲱⲛⲁⲭⲏ
ⲙⲱⲛⲟⲛ	ADV	ⲙⲱⲛⲟⲛ
ⲙⲱⲩⲥⲏⲥ	NPROP	ⲙⲱⲩⲥⲏⲥ
ⲙ	ART	ⲡ
ⲙ	NEG	ⲙ
ⲙ	PREP	ⲛ
ⲛϣⲏⲣⲉ	N	ⲛϣⲏⲣⲉ
ⲛϣⲟⲧ	N	ⲛϣⲟⲧ
ⲛϥⲓ	ADV	ⲛϥⲓ
ⲛϩⲁϩⲛⲥⲟⲡ	ADV	ⲛϩⲁϩⲛⲥⲟⲡ
ⲛϩⲏⲧ	PREP	ϩⲛ
ⲛϩⲏⲧ	PREP_PPERO	ⲛϩⲏⲧ
ⲛϩⲏ	PREP	ϩⲛ
ⲛϩⲟϩⲓϩⲟ	ADV	ⲛϩⲟϩⲓϩⲟ
ⲛϩⲟⲥⲟⲛ	ADV	ⲛϩⲟⲥⲟⲛ
ⲛϩⲟⲧ	VSTAT	ⲛⲁϩⲧⲉ
ⲛϩⲟⲩⲛ	ADV	ⲛϩⲟⲩⲛ
ⲛϩⲟⲩⲟ	ADV	ⲛϩⲟⲩⲟ
ⲛϩⲟⲩⲧ	V	ⲛϩⲟⲩⲧ
ⲛϩⲧⲏ	PREP	ϩⲛ
ⲛϩⲱⲥⲟⲛ	ADV	ⲛϩⲱⲥⲟⲛ
ⲛϫⲓⲟⲩⲉ	ADV	ⲛϫⲓⲟⲩⲉ
ⲛϫⲓ	CONJ	ⲛϫⲓ
ⲛϭⲓ	PTC	ⲛϭⲓ
ⲛϯⲙⲓⲛⲉ	ADV	ⲛϯⲙⲓⲛⲉ
ⲛⲁϣⲉ	VBD	ⲛⲁϣⲉ
ⲛⲁϣⲛϩⲉ	ADV	ⲛⲁϣⲛϩⲉ
ⲛⲁϣⲧϩⲏⲧ	N	ⲛⲁϣⲧϩⲏⲧ
ⲛⲁϣⲧ	VSTAT	ⲛϣⲟⲧ
ⲛⲁϣⲱ	VBD	ⲛⲁϣⲱ
ⲛⲁϩⲃ	N	ⲛⲁϩⲃ
ⲛⲁϩⲙⲉ	V	ⲛⲟⲩϩⲙ
ⲛⲁϩⲙⲟⲩ	V	ⲛⲟⲩϩⲙ
ⲛⲁϩⲙ	V	ⲛⲟⲩϩⲙ
ⲛⲁϩⲣⲁ	PREP	ⲛⲁϩⲣⲛ
ⲛⲁϩⲣⲉⲙ	PREP	ⲛⲁϩⲣⲉⲛ
ⲛⲁϩⲣⲉⲛ	PREP	ⲛⲁϩⲣⲉⲛ
ⲛⲁϩⲣⲙ	PREP	ⲛⲁϩⲣⲛ
ⲛⲁϩⲣⲛ	PREP	ⲛⲁϩⲣⲛ
ⲛⲁϩⲧⲉ	V	ⲛⲁϩⲧⲉ
ⲛⲁϩⲧ	V	ⲛⲁϩⲧⲉ
ⲛⲁϫϩⲉ	N	ⲛⲁϫϩⲉ
ⲛⲁⲁϫⲉ	N	ⲛⲁⲁϫⲉ
ⲛⲁⲁⲕⲉ	N	ⲛⲁⲁⲕⲉ
ⲛⲁⲁⲥⲥⲱⲛ	NPROP	ⲛⲁⲁⲥⲥⲱⲛ
ⲛⲁⲁ	V	ⲛⲁⲁ
ⲛⲁⲃⲟⲩⲭⲟⲇⲟⲛⲟⲥⲟⲣ	NPROP	ⲛⲁⲃⲟⲩⲭⲟⲇⲟⲛⲟⲥⲟⲣ
ⲛⲁⲉⲓⲁⲧ	VBD	ⲉⲓⲁ
ⲛⲁⲍⲁⲣⲉⲑ	NPROP	ⲛⲁⲍⲁⲣⲉⲑ
ⲛⲁⲍⲁⲣⲏⲛⲟⲥ	NPROP	ⲛⲁⲍⲁⲣⲏⲛⲟⲥ
ⲛⲁⲍⲱⲣⲁⲓⲟⲥ	N	ⲛⲁⲍⲱⲣⲁⲓⲟⲥ
ⲛⲁⲏⲧ	N	ⲛⲁⲏⲧ
ⲛⲁⲓⲁⲧ	N	ⲛⲁⲓⲁⲧ
ⲛⲁⲓⲁⲧ	VBD	ⲛⲁⲓⲁⲧ
ⲛⲁⲓⲙⲁⲛ	NPROP	ⲛⲁⲓⲙⲁⲛ
ⲛⲁⲓ	PDEM	ⲡⲁⲓ
ⲛⲁⲙⲉ	ADV	ⲛⲁⲙⲉ
ⲛⲁⲛⲟⲩ	VBD	ⲛⲁⲛⲟⲩ
ⲛⲁⲟⲥ	N	ⲛⲁⲟⲥ
ⲛⲁⲟⲩⲟⲩⲛⲟⲩ	ADV	ⲛⲁⲟⲩⲟⲩⲛⲟⲩ
ⲛⲁⲡϣⲁⲩ	ADV	ⲛⲁⲡϣⲁⲩ
ⲛⲁⲣⲇⲓⲝ	N	ⲛⲁⲣⲇⲓⲝ
ⲛⲁⲣⲇⲟⲥ	N	ⲛⲁⲣⲇⲟⲥ
ⲛⲁⲣⲧⲟⲥ	N	ⲛⲁⲣⲧⲟⲥ
ⲛⲁⲩⲕⲗⲏⲣⲟⲥ	N	ⲛⲁⲩⲕⲗⲏⲣⲟⲥ
ⲛⲁⲩ	N	ⲛⲁⲩ
ⲛⲁⲩ	V	ⲛⲁⲩ
ⲛⲁ	ART	ⲛⲁ
ⲛⲁ	FUT	ⲛⲁ
ⲛⲁ	N	ⲛⲁ
ⲛⲁ	PPOS	ⲡⲁ
ⲛⲁ	PREP	ⲛⲁ
ⲛⲁ	V	ⲛⲁ
ⲛⲁ	VSTAT	ⲛⲁ
ⲛⲃⲗⲁ	PREP	ⲛⲃⲗⲁ
ⲛⲉϥ	PPOS	ⲡⲉϥ
ⲛⲉϩϣⲗϥ	V	ⲛⲉϩϣⲗϥ
ⲛⲉϩⲉⲙ	V	ⲛⲟⲩϩⲙ
ⲛⲉϩⲙ	V	ⲛⲟⲩϩⲙ
ⲛⲉϩⲡⲉ	V	ⲛⲉϩⲡⲉ
ⲛⲉϩⲥⲉ	V	ⲛⲉϩⲥⲉ
ⲛⲉϩ	N	ⲛⲉϩ
ⲛⲉϩ	V	ⲛⲟⲩϩⲉ
ⲛⲉϫⲧⲁϥ	V	ⲛⲉϫⲧⲁϥ
ⲛⲉϫ	V	ⲛⲟⲩϫⲉ
ⲛⲉϭⲛⲟϭ	V	ⲛⲟϭⲛⲉϭ
ⲛⲉϭⲛⲟⲩϭ	V	ⲛⲉϭⲛⲟⲩϭ
ⲛⲉⲁⲛⲓⲥⲕⲟⲥ	N	ⲛⲉⲁⲛⲓⲥⲕⲟⲥ
ⲛⲉⲁⲡⲟⲗⲉⲓⲥ	NPROP	ⲛⲉⲁⲡⲟⲗⲉⲓⲥ
ⲛⲉⲁⲡⲟⲗⲓⲥ	NPROP	ⲛⲉⲁⲡⲟⲗⲓⲥ
ⲛⲉⲃⲟⲗ	V	ⲛⲉⲃⲟⲗ
ⲛⲉⲉⲃⲉ	N	ⲛⲉⲉⲃⲉ
ⲛⲉⲑⲏⲡ	N	ⲛⲉⲑⲏⲡ
ⲛⲉⲓ	PDEM	ⲡⲉⲓ
ⲛⲉⲓ	V	ⲛⲉⲓ
ⲛⲉⲕⲣⲟⲥ	N	ⲛⲉⲕⲣⲟⲥ
ⲛⲉⲕ	PPOS	ⲡⲉⲕ
ⲛⲉⲙⲫⲏ	N	ⲛⲉⲙⲫⲏ
ⲛⲉⲛⲉⲣⲏⲟⲩ	N	ⲛⲉⲛⲉⲣⲏⲟⲩ
ⲛⲉⲛ	PPOS	ⲡⲉⲛ
ⲛⲉⲟⲕⲁⲓⲥⲁⲣⲉⲓⲁ	NPROP	ⲛⲉⲟⲕⲁⲓⲥⲁⲣⲉⲓⲁ
ⲛⲉⲣⲉ	CPRET	ⲛⲉⲣⲉ
ⲛⲉⲣⲉ	CPRET_PPERS	ⲛⲉⲣⲉ_ⲛⲧⲟ
ⲛⲉⲣ	CPRET_PPERS	ⲛⲉⲣⲉ_ⲛⲧⲟ
ⲛⲉⲥϯⲁ	N	ⲛⲉⲥϯⲁ
ⲛⲉⲥⲧⲉⲟⲩⲉ	V	ⲛⲉⲥⲧⲉⲟⲩⲉ
ⲛⲉⲥⲧⲉⲩⲉ	V	ⲛⲉⲥⲧⲉⲩⲉ
ⲛⲉⲥⲧⲟⲣⲓⲁⲛⲟⲥ	N	ⲛⲉⲥⲧⲟⲣⲓⲁⲛⲟⲥ
ⲛⲉⲥⲧⲟⲣⲓⲟⲥ	NPROP	ⲛⲉⲥⲧⲟⲣⲓⲟⲥ
ⲛⲉⲥⲧⲱⲣⲓⲁⲛⲟⲥ	N	ⲛⲉⲥⲧⲱⲣⲓⲁⲛⲟⲥ
ⲛⲉⲥⲧⲱⲣⲓⲟⲥ	NPROP	ⲛⲉⲥⲧⲱⲣⲓⲟⲥ
ⲛⲉⲥⲱ	VBD	ⲛⲉⲥⲉ
ⲛⲉⲥ	PPOS	ⲡⲉⲥ
ⲛⲉⲧⲛ	PPERS	ⲛⲉⲧⲛ
ⲛⲉⲧⲛ	PPOS	ⲡⲉⲧⲛ
ⲛⲉⲧ	N	ⲛⲉⲧ
ⲛⲉⲩⲣⲟⲛ	N	ⲛⲉⲩⲣⲟⲛ
ⲛⲉⲩ	PPOS	ⲡⲉⲩ
ⲛⲉⲫⲑⲁⲗⲉⲓⲙ	NPROP	ⲛⲉⲫⲑⲁⲗⲉⲓⲙ
ⲛⲉ	ART	ⲡ
ⲛⲉ	CIMPF	ⲛⲉ
ⲛⲉ	COP	ⲡⲉ
ⲛⲉ	CPRET	ⲛⲉⲣⲉ
ⲛⲉ	PREP_PPERO	ⲛⲉ
ⲛⲏϫ	VSTAT	ⲛⲟⲩϫⲉ
ⲛⲏⲥⲟⲥ	N	ⲛⲏⲥⲟⲥ
ⲛⲏⲥⲧⲉⲓⲁ	N	ⲛⲏⲥⲧⲉⲓⲁ
ⲛⲏⲥⲧⲉⲟⲩⲉ	V	ⲛⲏⲥⲧⲉⲟⲩⲉ
ⲛⲏⲥⲧⲉⲩⲉ	V	ⲛⲏⲥⲧⲉⲩⲉ
ⲛⲏⲥⲧⲓⲁ	N	ⲛⲏⲥⲧⲓⲁ
ⲛⲏⲧⲛ	PREP	ⲛⲁ
ⲛⲏⲩ	ADV	ⲛⲏⲩ
ⲛⲏⲩ	V	ⲛⲏⲩ
ⲛⲏⲩ	VSTAT	ⲉⲓ
ⲛⲏⲫⲉ	V	ⲛⲏⲫⲉ
ⲛⲏ	PDEM	ⲛⲏ
ⲛⲏ	PREP	ⲛⲁ
ⲛⲓϣϭⲣⲱⲟⲩ	NPROP	ⲛⲓϣϭⲣⲱⲟⲩ
ⲛⲓϥⲉ	V	ⲛⲓϥⲉ
ⲛⲓⲃⲉ	V	ⲛⲓⲃⲉ
ⲛⲓⲕⲁⲓⲁ	NPROP	ⲛⲓⲕⲁⲓⲁ
ⲛⲓⲕⲏⲧⲏⲥ	N	ⲛⲓⲕⲏⲧⲏⲥ
ⲛⲓⲕⲏ	N	ⲛⲓⲕⲏ
ⲛⲓⲕⲟⲙⲏⲇⲏⲥ	NPROP	ⲛⲓⲕⲟⲙⲏⲇⲏⲥ
ⲛⲓⲕⲟⲙⲏⲧⲏⲥ	NPROP	ⲛⲓⲕⲟⲙⲏⲧⲏⲥ
ⲛⲓⲕⲟⲫⲟⲣⲟⲥ	N	ⲛⲓⲕⲟⲫⲟⲣⲟⲥ
ⲛⲓⲙ	PINT	ⲛⲓⲙ
ⲛⲓⲛⲉⲩⲏⲓⲧⲏⲥ	N	ⲛⲓⲛⲉⲩⲏⲓⲧⲏⲥ
ⲛⲓⲥⲉ	V	ⲛⲓⲥⲉ
ⲛⲓⲧⲣⲓⲁ	NPROP	ⲛⲓⲧⲣⲓⲁ
ⲛⲓ	PDEM	ⲡⲓ
ⲛⲕⲁⲛⲓⲙ	N	ⲛⲕⲁⲛⲓⲙ
ⲛⲕⲁ	N	ⲛⲕⲁ
ⲛⲕⲉⲥⲟⲡ	ADV	ⲛⲕⲉⲥⲟⲡ
ⲛⲕⲟⲧⲕ	V	ⲛⲕⲟⲧⲕ
ⲛⲙⲙⲁ	PREP	ⲙⲛ
ⲛⲙⲙⲏ	PREP	ⲙⲛ
ⲛⲙⲙ	N	ⲛⲙⲙ
ⲛⲙⲙ	PREP	ⲙⲛ
ⲛⲙⲛⲁ	V	ⲛⲙⲛⲁ
ⲛⲙ	PREP	ⲙⲛ
ⲛⲛⲁϩⲣⲁ	PREP	ⲛⲁϩⲣⲏⲛ
ⲛⲛⲁϩⲣⲉⲙ	PREP	ⲛⲛⲁϩⲣⲛ
ⲛⲛⲁϩⲣⲉⲛ	PREP	ⲛⲛⲁϩⲣⲛ
ⲛⲛⲁϩⲣⲏ	PREP	ⲛⲁϩⲣⲏⲛ
ⲛⲛⲁϩⲣⲙ	PREP	ⲛⲛⲁϩⲣⲛ
ⲛⲛⲁϩⲣⲛ	PREP	ⲛⲛⲁϩⲣⲛ
ⲛⲛⲁⲩⲛⲓⲙ	ADV	ⲛⲛⲁⲩⲛⲓⲙ
ⲛⲛⲁ	ANEGOPT_PPERS	ⲛⲛⲉ_ⲁⲛⲟⲕ
ⲛⲛⲉⲥϣⲱⲡⲉ	PTC	ⲛⲛⲉⲥϣⲱⲡⲉ
ⲛⲛⲉ	ANEGOPT	ⲛⲛⲉ
ⲛⲛ	ANEGOPT	ⲛⲛ
ⲛⲟϣⲡ	V	ⲛⲟⲩϣⲡ
ⲛⲟϥⲣⲉ	N	ⲛⲟϥⲣⲉ
ⲛⲟϫⲟⲩ	N	ⲛⲟϫⲟⲩ
ⲛⲟϫ	V	ⲛⲟⲩϫⲉ
ⲛⲟϭⲙⲡⲟⲗⲓⲥ	N	ⲛⲟϭⲙⲡⲟⲗⲓⲥ
ⲛⲟϭⲛϭⲟⲙ	N	ⲛⲟϭⲛϭⲟⲙ
ⲛⲟϭⲛϭⲱⲛⲧ	N	ⲛⲟϭⲛϭⲱⲛⲧ
ⲛⲟϭⲛϭ	V	ⲛⲟϭⲛϭ
ⲛⲟϭⲛⲉϭⲟⲙ	N	ⲛⲟϭⲛⲉϭⲟⲙ
ⲛⲟϭⲛⲉϭ	V	ⲛⲟϭⲛⲉϭ
ⲛⲟϭⲥ	VSTAT	ⲛⲟⲩϭⲥ
ⲛⲟϭ	N	ⲛⲟϭ
ⲛⲟⲃⲉ	N	ⲛⲟⲃⲉ
ⲛⲟⲃⲣⲉ	N	ⲛⲟⲃⲣⲉ
ⲛⲟⲉⲃⲣⲓⲟⲥ	N	ⲛⲟⲉⲃⲣⲓⲟⲥ
ⲛⲟⲉⲓⲕ	N	ⲛⲟⲉⲓⲕ
ⲛⲟⲉⲓⲛ	V	ⲛⲟⲉⲓⲛ
ⲛⲟⲉⲓ	V	ⲛⲟⲉⲓ
ⲛⲟⲉⲣⲁ	N	ⲛⲟⲉⲣⲁ
ⲛⲟⲉⲣⲟⲛ	N	ⲛⲟⲉⲣⲟⲛ
ⲛⲟⲉⲣⲟⲥ	N	ⲛⲟⲉⲣⲟⲥ
ⲛⲟⲏⲙⲁ	N	ⲛⲟⲏⲙⲁ
ⲛⲟⲏⲥⲓⲥ	N	ⲛⲟⲏⲥⲓⲥ
ⲛⲟⲏⲧⲟⲛ	N	ⲛⲟⲏⲧⲟⲛ
ⲛⲟⲏⲧⲟⲥ	N	ⲛⲟⲏⲧⲟⲥ
ⲛⲟⲏ	NPROP	ⲛⲟⲏ
ⲛⲟⲓ	V	ⲛⲟⲓ
ⲛⲟⲙⲏ	N	ⲛⲟⲙⲏ
ⲛⲟⲙⲓⲕⲟⲛ	N	ⲛⲟⲙⲓⲕⲟⲛ
ⲛⲟⲙⲓⲕⲟⲥ	N	ⲛⲟⲙⲓⲕⲟⲥ
ⲛⲟⲙⲓⲙⲟⲛ	N	ⲛⲟⲙⲓⲙⲟⲛ
ⲛⲟⲙⲓⲥⲙⲁ	N	ⲛⲟⲙⲓⲥⲙⲁ
ⲛⲟⲙⲟⲇⲓⲇⲁⲥⲕⲁⲗⲟⲥ	N	ⲛⲟⲙⲟⲇⲓⲇⲁⲥⲕⲁⲗⲟⲥ
ⲛⲟⲙⲟⲑⲉⲧⲏⲥ	N	ⲛⲟⲙⲟⲑⲉⲧⲏⲥ
ⲛⲟⲙⲟⲑⲉⲧⲓ	V	ⲛⲟⲙⲟⲑⲉⲧⲓ
ⲛⲟⲙⲟⲥ	N	ⲛⲟⲙⲟⲥ
ⲛⲟⲙⲧⲉ	N	ⲛⲟⲙⲧⲉ
ⲛⲟⲧⲁⲣⲓⲟⲥ	N	ⲛⲟⲧⲁⲣⲓⲟⲥ
ⲛⲟⲩϣⲏⲙ	ADV	ⲛⲟⲩϣⲏⲙ
ⲛⲟⲩϣⲡ	V	ⲛⲟⲩϣⲡ
ⲛⲟⲩϣⲥ	V	ⲛⲟⲩϣⲥ
ⲛⲟⲩϥ	N	ⲛⲟⲩϥ
ⲛⲟⲩϩⲉ	V	ⲛⲟⲩϩⲉ
ⲛⲟⲩϩⲙ	V	ⲛⲟⲩϩⲙ
ⲛⲟⲩϩ	N	ⲛⲟⲩϩ
ⲛⲟⲩϫⲉ	V	ⲛⲟⲩϫⲉ
ⲛⲟⲩϫⲉ	VIMP	ⲛⲟⲩϫⲉ
ⲛⲟⲩϫ	ADV	ⲛⲟⲩϫ
ⲛⲟⲩϫ	N	ⲛⲟⲩϫ
ⲛⲟⲩϫ	V	ⲛⲟⲩϫ
ⲛⲟⲩϭⲥ	N	ⲛⲟⲩϭⲥ
ⲛⲟⲩϭⲥ	V	ⲛⲟⲩϭⲥ
ⲛⲟⲩⲃⲏϭ	PREP	ⲛⲟⲩⲃⲏϭ
ⲛⲟⲩⲃⲧ	V	ⲛⲟⲩⲃⲧ
ⲛⲟⲩⲃ	N	ⲛⲟⲩⲃ
ⲛⲟⲩⲉ	V	ⲛⲟⲩⲉ
ⲛⲟⲩⲏⲣ	ADV	ⲛⲟⲩⲏⲣ
ⲛⲟⲩⲑⲉⲧⲉⲓ	V	ⲛⲟⲩⲑⲉⲧⲉⲓ
ⲛⲟⲩⲓ	PPOS	ⲛⲟⲩⲓ
ⲛⲟⲩⲕ	V	ⲛⲟⲩⲕ
ⲛⲟⲩⲙⲉⲣⲓⲁⲛⲟⲥ	NPROP	ⲛⲟⲩⲙⲉⲣⲓⲁⲛⲟⲥ
ⲛⲟⲩⲙⲉⲣⲟⲛ	N	ⲛⲟⲩⲙⲉⲣⲟⲛ
ⲛⲟⲩⲙⲉⲣⲟⲥ	N	ⲛⲟⲩⲙⲉⲣⲟⲥ
ⲛⲟⲩⲙⲟⲥ	N	ⲛⲟⲩⲙⲟⲥ
ⲛⲟⲩⲛⲉ	N	ⲛⲟⲩⲛⲉ
ⲛⲟⲩⲛ	N	ⲛⲟⲩⲛ
ⲛⲟⲩⲟⲉⲓϣⲛⲓⲙ	ADV	ⲛⲟⲩⲟⲉⲓϣⲛⲓⲙ
ⲛⲟⲩⲥⲟⲡ	ADV	ⲛⲟⲩⲥⲟⲡ
ⲛⲟⲩⲥ	N	ⲛⲟⲩⲥ
ⲛⲟⲩⲧⲉ	N	ⲛⲟⲩⲧⲉ
ⲛⲟⲩ	ART	ⲛⲟⲩ
ⲛⲟⲩ	PPOS	ⲡⲟⲩ
ⲛⲟⲩ	V	ⲛⲟⲩ
ⲛⲣⲁⲧ	PREP	ⲛⲣⲁⲧ
ⲛⲥⲁϥ	ADV	ⲛⲥⲁϥ
ⲛⲥⲁⲃⲏⲗϫⲉ	CONJ	ⲛⲥⲁⲃⲏⲗϫⲉ
ⲛⲥⲁⲃⲏⲗ	CONJ	ⲛⲥⲁⲃⲏⲗ
ⲛⲥⲁⲃⲗⲗⲁ	PREP	ⲛⲥⲁⲃⲟⲗ
ⲛⲥⲁⲟⲩⲥⲁ	ADV	ⲛⲥⲁⲟⲩⲥⲁ
ⲛⲥⲁ	PREP	ⲛⲥⲁ
ⲛⲥⲱ	PREP	ⲛⲥⲁ
ⲛⲥⲱ	PREP_PPERO	ⲛⲥⲁ_ⲛⲧⲟ
ⲛⲧϥ	V	ⲛⲧϥ
ⲛⲧⲁ	ACONJ	ⲛⲧⲁ
ⲛⲧⲁ	ACONJ_PPERS	ⲛⲧⲉ_ⲁⲛⲟⲕ
ⲛⲧⲁ	CREL	ⲛⲧⲁ
ⲛⲧⲁ	N	ⲛⲧⲁ
ⲛⲧⲉⲣⲉ	APREC	ⲛⲧⲉⲣⲉ
ⲛⲧⲉⲣ	APREC	ⲛⲧⲉⲣⲉ
ⲛⲧⲉⲧⲛ	PPERI	ⲛⲧⲱⲧⲛ
ⲛⲧⲉⲧⲛ	PPERS	ⲛⲧⲉⲧⲛ
ⲛⲧⲉⲩⲛⲟⲩ	ADV	ⲛⲧⲉⲩⲛⲟⲩ
ⲛⲧⲉ	ACONJ	ⲛⲧⲉ
ⲛⲧⲉ	CONJ	ⲛⲧⲉ
ⲛⲧⲉ	PPERI	ⲛⲧⲟ
ⲛⲧⲉ	PREP	ⲛⲧⲉ
ⲛⲧⲏϭ	N	ⲛⲧⲏϭ
ⲛⲧⲕ	PPERI	ⲛⲧⲟⲕ
ⲛⲧⲕ	PPERS	ⲛⲧⲕ
ⲛⲧⲙ	PREP	ⲛⲧⲛ
ⲛⲧⲛ	PREP	ⲛⲧⲛ
ⲛⲧⲟϣ	N	ⲛⲧⲟϣ
ⲛⲧⲟϥ	ADV	ⲛⲧⲟϥ
ⲛⲧⲟϥ	PPERI	ⲛⲧⲟϥ
ⲛⲧⲟⲕ	PPERI	ⲛⲧⲟⲕ
ⲛⲧⲟⲗⲏ	N	ⲛⲧⲟⲗⲏ
ⲛⲧⲟⲟⲧ	PREP	ⲛⲧⲛ
ⲛⲧⲟⲟⲩⲛ	ADV	ⲛⲧⲟⲟⲩⲛ
ⲛⲧⲟⲟⲩ	PPERI	ⲛⲧⲟⲟⲩ
ⲛⲧⲟⲟⲩ	PPERS	ⲛⲧⲟⲟⲩ
ⲛⲧⲟⲥ	PPERI	ⲛⲧⲟⲥ
ⲛⲧⲟ	PPERI	ⲛⲧⲟ
ⲛⲧⲡⲉⲛ	PREP	ⲛⲧⲡⲉⲛ
ⲛⲧⲱⲕ	V	ⲛⲧⲱⲕ
ⲛⲧⲱⲧⲛ	PPERI	ⲛⲧⲱⲧⲛ
ⲛⲧ	ACONJ	ⲛⲧ
ⲛⲧ	CFOC	ⲉⲣⲉ
ⲛⲧ	CREL	ⲉⲧⲉⲣⲉ
ⲛⲧ	N	ⲛⲧ
ⲛⲧ	V	ⲉⲓⲛⲉ
ⲛⲧ	V_PPERO	ⲛⲧ
ⲛⲩⲕⲏⲥⲓⲥ	N	ⲛⲩⲕⲏⲥⲓⲥ
ⲛⲩⲕⲧⲉⲣⲓⲥ	N	ⲛⲩⲕⲧⲉⲣⲓⲥ
ⲛⲩⲙⲫⲏ	N	ⲛⲩⲙⲫⲏ
ⲛⲩⲙⲫⲓⲟⲥ	N	ⲛⲩⲙⲫⲓⲟⲥ
ⲛⲩⲙⲫⲱⲛ	N	ⲛⲩⲙⲫⲱⲛ
ⲛⲩⲙⲯⲓⲥ	N	ⲛⲩⲙⲯⲓⲥ
ⲛⲩⲥⲁⲉⲩⲥ	N	ⲛⲩⲥⲁⲉⲩⲥ
ⲛⲱϩⲉ	NPROP	ⲛⲱϩⲉ
ⲛ	ACONJ	ⲛⲧⲉ
ⲛ	ART	ⲡ
ⲛ	N	ⲛ
ⲛ	NEG	ⲛ
ⲛ	PPERO	ⲁⲛⲟⲛ
ⲛ	PPERS	ⲁⲛⲟⲛ
ⲛ	PREP	ⲛ
ⲛ	V	ⲉⲓⲛⲉ
ⲝⲉⲛⲉⲓⲟⲥ	N	ⲝⲉⲛⲉⲓⲟⲥ
ⲝⲉⲛⲓⲟⲛ	N	ⲝⲉⲛⲓⲟⲛ
ⲝⲉⲥⲧⲏⲥ	N	ⲝⲉⲥⲧⲏⲥ
ⲝⲟⲩⲣ	N	ⲝⲟⲩⲣ
ⲟϣϥ	V	ⲟϣϥ
ⲟϣⲉ	V	ⲟϣⲉ
ⲟϣⲙ	V	ⲱϣⲙ
ⲟϣⲟⲩ	V	ⲟϣⲟⲩ
ⲟϣ	V	ⲱϣ
ⲟϣ	VSTAT	ⲱϣ
ⲟϥⲧ	VSTAT	ⲱϥⲧ
ⲟϩⲉ	N	ⲟϩⲉ
ⲟϩⲥ	V	ⲱϩⲥ
ⲟϭⲉ	N	ⲟϭⲉ
ⲟϭⲧϥ	V	ⲱϭⲧ
ⲟϭⲧ	V	ⲟϭⲧ
ⲟⲃϣ	V	ⲱⲃϣ
ⲟⲃϣ	VSTAT	ⲟⲃϣ
ⲟⲃϩⲉ	N	ⲟⲃϩⲉ
ⲟⲃⲉ	VSTAT	ⲱϥⲉ
ⲟⲃⲣⲣⲉ	VSTAT	ⲟⲃⲣⲣⲉ
ⲟⲃⲣⲩⲍⲟⲛ	N	ⲟⲃⲣⲩⲍⲟⲛ
ⲟⲅⲇⲟⲁⲥ	N	ⲟⲅⲇⲟⲁⲥ
ⲟⲇⲟⲗⲗⲁ	NPROP	ⲟⲇⲟⲗⲗⲁ
ⲟⲉⲓϣ	N	ⲟⲉⲓϣ
ⲟⲉⲓⲉ	N	ⲟⲉⲓⲉ
ⲟⲉⲓⲕ	N	ⲟⲉⲓⲕ
ⲟⲍⲉⲓⲁⲥ	NPROP	ⲟⲍⲉⲓⲁⲥ
ⲟⲓⲕⲟⲇⲉⲥⲡⲟⲧⲏⲥ	N	ⲟⲓⲕⲟⲇⲉⲥⲡⲟⲧⲏⲥ
ⲟⲓⲕⲟⲇⲟⲙⲏ	N	ⲟⲓⲕⲟⲇⲟⲙⲏ
ⲟⲓⲕⲟⲑⲉⲛ	ADV	ⲟⲓⲕⲟⲑⲉⲛ
ⲟⲓⲕⲟⲛⲟⲙⲉⲓ	V	ⲟⲓⲕⲟⲛⲟⲙⲉⲓ
ⲟⲓⲕⲟⲛⲟⲙⲓⲁ	N	ⲟⲓⲕⲟⲛⲟⲙⲓⲁ
ⲟⲓⲕⲟⲛⲟⲙⲟⲥ	N	ⲟⲓⲕⲟⲛⲟⲙⲟⲥ
ⲟⲓⲕⲟⲥ	N	ⲟⲓⲕⲟⲥ
ⲟⲓⲕⲟⲩⲙⲉⲛⲏ	N	ⲟⲓⲕⲟⲩⲙⲉⲛⲏ
ⲟⲓⲕⲟⲩⲙⲛⲏ	N	ⲟⲓⲕⲟⲩⲙⲛⲏ
ⲟⲓ	V	ⲟⲓ
ⲟⲓ	VSTAT	ⲟⲓ
ⲟⲕⲙ	VSTAT	ⲱⲕⲙ
ⲟⲕⲧⲟⲏⲥ	N	ⲟⲕⲧⲟⲏⲥ
ⲟⲗⲃⲓⲟⲥ	NPROP	ⲟⲗⲃⲓⲟⲥ
ⲟⲗⲓⲅⲱⲣⲉⲓ	V	ⲟⲗⲓⲅⲱⲣⲉⲓ
ⲟⲗⲓⲕⲉ	V	ⲟⲗⲓⲕⲉ
ⲟⲗⲕ	N	ⲟⲗⲕ
ⲟⲗⲗⲁⲣⲓⲟⲛ	N	ⲟⲗⲗⲁⲣⲓⲟⲛ
ⲟⲗⲟⲕⲁⲩⲧⲱⲙⲁ	N	ⲟⲗⲟⲕⲁⲩⲧⲱⲙⲁ
ⲟⲗ	V	ⲱⲗ
ⲟⲙⲉ	N	ⲟⲙⲉ
ⲟⲙⲕ	V	ⲱⲙⲕ
ⲟⲙⲟⲓⲱⲥ	ADV	ⲟⲙⲟⲓⲱⲥ
ⲟⲙⲥⲟ	V	ⲱⲙⲥ
ⲟⲙⲥ	V	ⲱⲙⲥ
ⲟⲙ	V	ⲟⲙ
ⲟⲛϩ	VSTAT	ⲱⲛϩ
ⲟⲛⲅⲓⲁ	N	ⲟⲛⲅⲓⲁ
ⲟⲛⲛⲟⲣⲓⲟⲥ	NPROP	ⲟⲛⲛⲟⲣⲓⲟⲥ
ⲟⲛⲛⲱⲣⲓⲟⲥ	NPROP	ⲟⲛⲛⲱⲣⲓⲟⲥ
ⲟⲛⲟⲙⲁⲍⲉ	V	ⲟⲛⲟⲙⲁⲍⲉ
ⲟⲛⲟⲙⲁⲥⲓⲁ	N	ⲟⲛⲟⲙⲁⲥⲓⲁ
ⲟⲛⲟⲙⲁⲥⲧⲟⲥ	N	ⲟⲛⲟⲙⲁⲥⲧⲟⲥ
ⲟⲛⲟⲣⲓⲟⲥ	NPROP	ⲟⲛⲟⲣⲓⲟⲥ
ⲟⲛⲧⲉ	N	ⲟⲛⲧⲉ
ⲟⲛⲧⲟⲥ	ADV	ⲟⲛⲧⲟⲥ
ⲟⲛⲧⲱⲥ	ADV	ⲟⲛⲧⲱⲥ
ⲟⲛⲱⲣⲓⲟⲥ	NPROP	ⲟⲛⲱⲣⲓⲟⲥ
ⲟⲛ	ADV	ⲟⲛ
ⲟⲟϩ	N	ⲟⲟϩ
ⲟⲟⲙⲉ	N	ⲟⲟⲙⲉ
ⲟⲟⲧⲉ	N	ⲟⲟⲧⲉ
ⲟⲟⲩ	N	ⲟⲟⲩ
ⲟⲡⲓⲥⲱ	ADV	ⲟⲡⲓⲥⲱ
ⲟⲡⲧⲁⲥⲓⲁ	N	ⲟⲡⲧⲁⲥⲓⲁ
ⲟⲡⲧ	V	ⲱⲧⲡ
ⲟⲡⲱⲣⲁ	N	ⲟⲡⲱⲣⲁ
ⲟⲡ	V	ⲟⲡ
ⲟⲣϫ	V	ⲱⲣϫ
ⲟⲣϫ	VSTAT	ⲱⲣϫ
ⲟⲣⲁⲝ	N	ⲟⲣⲁⲝ
ⲟⲣⲃⲉ	V	ⲱⲣⲃ
ⲟⲣⲅⲁⲛⲟⲛ	N	ⲟⲣⲅⲁⲛⲟⲛ
ⲟⲣⲅⲏ	N	ⲟⲣⲅⲏ
ⲟⲣⲇⲓⲛⲟⲛ	N	ⲟⲣⲇⲓⲛⲟⲛ
ⲟⲣⲑⲏⲥⲓⲥ	N	ⲟⲣⲑⲏⲥⲓⲥ
ⲟⲣⲑⲟⲇⲟⲝⲟⲥ	N	ⲟⲣⲑⲟⲇⲟⲝⲟⲥ
ⲟⲣⲑⲟⲛ	N	ⲟⲣⲑⲟⲛ
ⲟⲣⲑⲱⲧⲱⲕⲝⲏⲓⲁ	N	ⲟⲣⲑⲱⲧⲱⲕⲝⲏⲓⲁ
ⲟⲣⲫⲁⲛⲟⲥ	N	ⲟⲣⲫⲁⲛⲟⲥ
ⲟⲣⲭⲉⲓ	V	ⲟⲣⲭⲉⲓ
ⲟⲣⲭⲉ	V	ⲟⲣⲭⲉ
ⲟⲥⲉ	N	ⲟⲥⲉ
ⲟⲧϩ	V	ⲟⲧϩ
ⲟⲧⲓ	CONJ	ⲟⲧⲓ
ⲟⲧⲡⲉⲛ	V	ⲟⲧⲡⲉⲛ
ⲟⲧⲡ	VSTAT	ⲱⲧⲡ
ⲟⲩϣⲏⲛⲣⲟⲉⲓⲥ	N	ⲟⲩϣⲏⲛⲣⲟⲉⲓⲥ
ⲟⲩϣⲏ	N	ⲟⲩϣⲏ
ⲟⲩϣⲟⲟⲩⲉ	N	ⲟⲩϣⲟⲟⲩⲉ
ⲟⲩϩⲟⲟⲣ	N	ⲟⲩϩⲟⲣ
ⲟⲩϫⲁⲉⲓ	V	ⲟⲩϫⲁⲉⲓ
ⲟⲩϫⲁⲓ	N	ⲟⲩϫⲁⲓ
ⲟⲩϫⲁⲓ	V	ⲟⲩϫⲁⲓ
ⲟⲩϭⲁⲥ	N	ⲟⲩϭⲁⲥ
ⲟⲩϯ	V	ⲟⲩϯ
ⲟⲩⲁϣⲟⲩ	V	ⲟⲩⲱϣ
ⲟⲩⲁϣ	V	ⲟⲩⲱϣ
ⲟⲩⲁϩⲉⲧ	N	ⲟⲩⲁϩⲉⲧ
ⲟⲩⲁϩⲉ	N	ⲟⲩⲁϩⲉ
ⲟⲩⲁϩⲓⲏⲧ	N	ⲟⲩⲁϩⲓⲏⲧ
ⲟⲩⲁϩⲕⲥϥⲛ	V	ⲟⲩⲁϩⲕⲥϥⲛ
ⲟⲩⲁϩⲙⲉ	V	ⲟⲩⲁϩⲙⲉ
ⲟⲩⲁϩⲙ	V	ⲟⲩⲱϩⲙ
ⲟⲩⲁϩ	V	ⲟⲩⲱϩ
ⲟⲩⲁⲁⲃ	VSTAT	ⲟⲩⲟⲡ
ⲟⲩⲁⲁⲧ	IMOD	ⲟⲩⲁⲁ
ⲟⲩⲁⲁ	IMOD	ⲟⲩⲁⲁ
ⲟⲩⲁⲗⲉⲛϯⲛⲟⲥ	V	ⲟⲩⲁⲗⲉⲛϯⲛⲟⲥ
ⲟⲩⲁⲗⲉⲛⲧⲓⲛⲟⲥ	NPROP	ⲟⲩⲁⲗⲉⲛⲧⲓⲛⲟⲥ
ⲟⲩⲁⲗⲏⲥ	NPROP	ⲟⲩⲁⲗⲏⲥ
ⲟⲩⲁⲙⲟⲙⲉ	N	ⲟⲩⲁⲙⲟⲙⲉ
ⲟⲩⲁⲙⲣⲱⲙⲉ	N	ⲟⲩⲁⲙⲣⲱⲙⲉ
ⲟⲩⲁⲛⲟⲩⲱⲧ	N	ⲟⲩⲁⲛⲟⲩⲱⲧ
ⲟⲩⲁ	N	ⲟⲩⲁ
ⲟⲩⲁ	NUM	ⲟⲩⲁ
ⲟⲩⲃⲁϣ	V	ⲟⲩⲃⲁϣ
ⲟⲩⲃⲉ	PREP	ⲟⲩⲃⲉ
ⲟⲩⲃⲏ	PREP	ⲟⲩⲃⲉ
ⲟⲩⲅⲁⲣ	CONJ	ⲟⲩⲅⲁⲣ
ⲟⲩⲇⲉ	CONJ	ⲟⲩⲇⲉ
ⲟⲩⲉϣⲥ	V	ⲟⲩⲱϣⲥ
ⲟⲩⲉϣ	N	ⲟⲩⲉϣ
ⲟⲩⲉϣ	V	ⲟⲩⲱϣ
ⲟⲩⲉϩϩⲓⲥⲉ	V	ⲟⲩⲉϩϩⲓⲥⲉ
ⲟⲩⲉϩⲥⲁϩⲛⲉ	V	ⲟⲩⲉϩⲥⲁϩⲛⲉ
ⲟⲩⲉϩ	V	ⲟⲩⲱϩ
ⲟⲩⲉϭⲡ	V	ⲟⲩⲉϭⲡ
ⲟⲩⲉϭⲣⲟ	N	ⲟⲩⲉϭⲣⲟ
ⲟⲩⲉⲓⲉⲛⲓⲛ	N	ⲟⲩⲉⲓⲉⲛⲓⲛ
ⲟⲩⲉⲓⲛⲉ	V	ⲟⲩⲉⲓⲛⲉ
ⲟⲩⲉⲓ	N	ⲟⲩⲉⲓ
ⲟⲩⲉⲓ	NUM	ⲟⲩⲉⲓ
ⲟⲩⲉⲙ	V	ⲟⲩⲱⲙ
ⲟⲩⲉⲛϩ	V	ⲟⲩⲱⲛϩ
ⲟⲩⲉⲛ	V	ⲟⲩⲱⲛ
ⲟⲩⲉⲣⲏⲧⲉ	N	ⲟⲩⲉⲣⲏⲧⲉ
ⲟⲩⲉⲥⲡⲁⲥⲓⲁⲛⲟⲥ	NPROP	ⲟⲩⲉⲥⲡⲁⲥⲓⲁⲛⲟⲥ
ⲟⲩⲉⲧⲟⲩⲱⲧ	N	ⲟⲩⲉⲧⲟⲩⲱⲧ
ⲟⲩⲉⲧ	VBD	ⲟⲩⲱⲧ
ⲟⲩⲉ	N	ⲟⲩⲉ
ⲟⲩⲉ	NUM	ⲟⲩⲉ
ⲟⲩⲉ	V	ⲟⲩⲉ
ⲟⲩⲏϩ	VSTAT	ⲟⲩⲱϩ
ⲟⲩⲏⲉⲓⲃ	N	ⲟⲩⲏⲉⲓⲃ
ⲟⲩⲏⲏⲃ	N	ⲟⲩⲏⲏⲃ
ⲟⲩⲏⲗⲟⲛ	N	ⲟⲩⲏⲗⲟⲛ
ⲟⲩⲏⲛ	VSTAT	ⲟⲩⲱⲛ
ⲟⲩⲏⲣ	N	ⲟⲩⲏⲣ
ⲟⲩⲏⲣ	PINT	ⲟⲩⲏⲣ
ⲟⲩⲏⲧ	N	ⲟⲩⲏⲧ
ⲟⲩⲏⲩ	VSTAT	ⲟⲩⲉ
ⲟⲩⲕⲉⲝⲉⲥⲧⲉⲓ	V	ⲟⲩⲕⲉⲝⲉⲥⲧⲉⲓ
ⲟⲩⲕⲉⲝⲉⲥⲧⲓ	V	ⲟⲩⲕⲉⲝⲉⲥⲧⲓ
ⲟⲩⲕⲉⲧⲓ	ADV	ⲟⲩⲕⲉⲧⲓ
ⲟⲩⲕⲟⲩⲛ	CONJ	ⲟⲩⲕⲟⲩⲛ
ⲟⲩⲕ	NEG	ⲟⲩⲕ
ⲟⲩⲕ	V	ⲟⲩⲕ
ⲟⲩⲗⲏ	N	ⲟⲩⲗⲏ
ⲟⲩⲗⲗⲉ	N	ⲟⲩⲗⲗⲉ
ⲟⲩⲙⲟⲛⲟⲛϫⲉ	CONJ	ⲟⲩⲙⲟⲛⲟⲛϫⲉ
ⲟⲩⲙⲟⲛⲟⲛ	CONJ	ⲟⲩⲙⲟⲛⲟⲛ
ⲟⲩⲛⲁⲙ	N	ⲟⲩⲛⲁⲙ
ⲟⲩⲛⲟϥ	V	ⲟⲩⲛⲟϥ
ⲟⲩⲛⲟⲩ	N	ⲟⲩⲛⲟⲩ
ⲟⲩⲛⲣⲟ	V	ⲟⲩⲛⲣⲟ
ⲟⲩⲛⲧⲁ	EXIST	ⲟⲩⲛⲧⲁ
ⲟⲩⲛⲧⲉ	EXIST	ⲟⲩⲛⲧⲁ
ⲟⲩⲛⲧⲏ	EXIST	ⲟⲩⲛⲧⲁ
ⲟⲩⲛⲧ	EXIST	ⲟⲩⲛⲧⲁ
ⲟⲩⲛⲧ	VBD	ⲟⲩⲛⲧ
ⲟⲩⲛ	ADV	ⲟⲩⲛ
ⲟⲩⲛ	CONJ	ⲟⲩⲛ
ⲟⲩⲛ	EXIST	ⲟⲩⲛ
ⲟⲩⲛ	N	ⲟⲩⲛ
ⲟⲩⲛ	PTC	ⲟⲩⲛ
ⲟⲩⲟϣⲃⲉ	V	ⲟⲩⲱϣⲃ
ⲟⲩⲟϣⲃ	V	ⲟⲩⲱϣⲃ
ⲟⲩⲟϣⲥ	VSTAT	ⲟⲩⲱϣⲥ
ⲟⲩⲟϩ	V	ⲟⲩⲱϩ
ⲟⲩⲟϫ	VSTAT	ⲟⲩⲱϫⲉ
ⲟⲩⲟϭⲉ	VSTAT	ⲟⲩⲟϭⲉ
ⲟⲩⲟϭⲡ	VSTAT	ⲟⲩⲱϭⲡ
ⲟⲩⲟⲃϣ	N	ⲟⲩⲟⲃϣ
ⲟⲩⲟⲉⲓϣ	N	ⲟⲩⲟⲉⲓϣ
ⲟⲩⲟⲉⲓⲉ	N	ⲟⲩⲟⲉⲓⲉ
ⲟⲩⲟⲉⲓⲏ	N	ⲟⲩⲟⲉⲓⲉ
ⲟⲩⲟⲉⲓⲕ	N	ⲟⲩⲟⲉⲓⲕ
ⲟⲩⲟⲉⲓⲛⲁ	PTC	ⲟⲩⲟⲉⲓⲛⲁ
ⲟⲩⲟⲉⲓⲛⲏⲧⲛ	PTC	ⲟⲩⲟⲉⲓⲛⲏⲧⲛ
ⲟⲩⲟⲉⲓⲛ	N	ⲟⲩⲟⲉⲓⲛ
ⲟⲩⲟⲉⲓ	N	ⲟⲩⲟⲉⲓ
ⲟⲩⲟⲓⲉϣ	N	ⲟⲩⲟⲓⲉϣ
ⲟⲩⲟⲓⲉϣ	V	ⲟⲩⲟⲓⲉϣ
ⲟⲩⲟⲓⲛⲁ	PTC	ⲟⲩⲟⲓⲛⲁ
ⲟⲩⲟⲓⲛⲏⲧⲛ	PTC	ⲟⲩⲟⲓⲛⲏⲧⲛ
ⲟⲩⲟⲓ	N	ⲟⲩⲟⲓ
ⲟⲩⲟⲓ	PTC	ⲟⲩⲟⲓ
ⲟⲩⲟⲗⲥ	V	ⲟⲩⲱⲗⲥ
ⲟⲩⲟⲙϥ	N	ⲟⲩⲟⲙϥ
ⲟⲩⲟⲙ	V	ⲟⲩⲱⲙ
ⲟⲩⲟⲛϩⲛⲛ	N	ⲟⲩⲟⲛϩⲛⲛ
ⲟⲩⲟⲛϩ	V	ⲟⲩⲱⲛϩ
ⲟⲩⲟⲛϩ	VSTAT	ⲟⲩⲱⲛϩ
ⲟⲩⲟⲛⲛⲓⲙ	N	ⲟⲩⲟⲛⲛⲓⲙ
ⲟⲩⲟⲛ	N	ⲟⲩⲟⲛ
ⲟⲩⲟⲟϩⲉ	VSTAT	ⲟⲩⲟⲟϩⲉ
ⲟⲩⲟⲟⲗⲉ	VSTAT	ⲟⲩⲱⲱⲗⲉ
ⲟⲩⲟⲟⲙ	N	ⲟⲩⲟⲟⲙ
ⲟⲩⲟⲟⲧⲉ	N	ⲟⲩⲟⲟⲧⲉ
ⲟⲩⲟⲥϥ	V	ⲟⲩⲟⲥϥ
ⲟⲩⲟⲧⲃ	VSTAT	ⲟⲩⲱⲧⲃ
ⲟⲩⲟⲧⲟⲩⲉⲓⲧ	V	ⲟⲩⲟⲧⲟⲩⲉⲓⲧ
ⲟⲩⲟⲧⲟⲩⲉⲧ	V	ⲟⲩⲟⲧⲟⲩⲉⲧ
ⲟⲩⲡⲉⲡⲁⲓ	N	ⲟⲩⲡⲉⲡⲁⲓ
ⲟⲩⲣⲃⲁⲧⲟⲥ	NPROP	ⲟⲩⲣⲃⲁⲧⲟⲥ
ⲟⲩⲣⲓⲁⲥ	NPROP	ⲟⲩⲣⲓⲁⲥ
ⲟⲩⲣⲟⲧ	N	ⲟⲩⲣⲟⲧ
ⲟⲩⲣⲟⲧ	V	ⲟⲩⲣⲟⲧ
ⲟⲩⲥⲓⲁⲣⲭⲏⲥ	N	ⲟⲩⲥⲓⲁⲣⲭⲏⲥ
ⲟⲩⲥⲓⲁ	N	ⲟⲩⲥⲓⲁ
ⲟⲩⲧⲃⲁ	N	ⲟⲩⲧⲃⲁ
ⲟⲩⲧⲉ	CONJ	ⲟⲩⲧⲉ
ⲟⲩⲧⲉ	PREP	ⲟⲩⲧⲉ
ⲟⲩⲧⲱ	PREP	ⲟⲩⲧⲉ
ⲟⲩⲭⲓ	PTC	ⲟⲩⲭⲓ
ⲟⲩⲭ	PTC	ⲟⲩⲭ
ⲟⲩⲱϣϥ	V	ⲟⲩⲱϣϥ
ⲟⲩⲱϣⲃ	V	ⲟⲩⲱϣⲃ
ⲟⲩⲱϣⲙ	N	ⲟⲩⲱϣⲙ
ⲟⲩⲱϣⲙ	V	ⲟⲩⲱϣⲙ
ⲟⲩⲱϣⲥ	V	ⲟⲩⲱϣⲥ
ⲟⲩⲱϣⲧ	V	ⲟⲩⲱϣⲧ
ⲟⲩⲱϣ	N	ⲟⲩⲱϣ
ⲟⲩⲱϣ	V	ⲟⲩⲱϣ
ⲟⲩⲱϩⲉ	N	ⲟⲩⲱϩⲉ
ⲟⲩⲱϩⲙ	V	ⲟⲩⲱϩⲙ
ⲟⲩⲱϩ	V	ⲟⲩⲱϩ
ⲟⲩⲱϭⲡ	V	ⲟⲩⲱϭⲡ
ⲟⲩⲱⲗⲉ	V	ⲟⲩⲱⲗⲉ
ⲟⲩⲱⲗⲥⲛϩⲏⲧ	N	ⲟⲩⲱⲗⲥⲛϩⲏⲧ
ⲟⲩⲱⲗⲥ	V	ⲟⲩⲱⲗⲥ
ⲟⲩⲱⲙ	N	ⲟⲩⲱⲙ
ⲟⲩⲱⲙ	V	ⲟⲩⲱⲙ
ⲟⲩⲱⲛϣ	N	ⲟⲩⲱⲛϣ
ⲟⲩⲱⲛϩ	N	ⲟⲩⲱⲛϩ
ⲟⲩⲱⲛϩ	V	ⲟⲩⲱⲛϩ
ⲟⲩⲱⲛ	V	ⲟⲩⲱⲛ
ⲟⲩⲱⲥϥ	V	ⲟⲩⲱⲥϥ
ⲟⲩⲱⲧⲃ	V	ⲟⲩⲱⲧⲃ
ⲟⲩⲱⲧⲛ	V	ⲟⲩⲱⲧⲛ
ⲟⲩⲱⲧ	N	ⲟⲩⲱⲧ
ⲟⲩⲱ	N	ⲟⲩⲱ
ⲟⲩⲱ	V	ⲟⲩⲱ
ⲟⲩ	ART	ⲟⲩ
ⲟⲩ	FM	ⲟⲩ
ⲟⲩ	NEG	ⲟⲩ
ⲟⲩ	NUM	ⲟⲩ
ⲟⲩ	PINT	ⲟⲩ
ⲟⲩ	PPERO	ⲛⲧⲟⲟⲩ
ⲟⲩ	PPERS	ⲛⲧⲟⲟⲩ
ⲟⲩ	PTC	ⲟⲩ
ⲟⲫⲉⲗⲉⲓⲁ	N	ⲟⲫⲉⲗⲉⲓⲁ
ⲟⲫⲉⲗⲉⲓ	V	ⲟⲫⲉⲗⲉⲓ
ⲟⲭⲉⲙⲁ	N	ⲟⲭⲉⲙⲁ
ⲟⲭⲗⲏⲥⲓⲥ	N	ⲟⲭⲗⲏⲥⲓⲥ
ⲟⲭⲗⲟⲥ	N	ⲟⲭⲗⲟⲥ
ⲟⲯⲱⲛⲓⲟⲛ	N	ⲟⲯⲱⲛⲓⲟⲛ
ⲟ	VSTAT	ⲉⲓⲣⲉ
ⲡϣϭⲉⲡⲟϩⲉ	NPROP	ⲡϣϭⲉⲡⲟϩⲉ
ⲡϣⲟⲓ	NPROP	ⲡϣⲟⲓ
ⲡⲁϣⲉ	N	ⲡⲁϣⲉ
ⲡⲁϣⲟⲛⲥ	NPROP	ⲡⲁϣⲟⲛⲥ
ⲡⲁϩⲟⲙⲱ	NPROP	ⲡⲁϩⲟⲙⲱ
ⲡⲁϩⲟⲩ	N	ⲡⲁϩⲟⲩ
ⲡⲁϩⲟⲩ	V	ⲡⲁϩⲟⲩ
ⲡⲁϩⲣⲉ	N	ⲡⲁϩⲣⲉ
ⲡⲁϩⲧ	V	ⲡⲱϩⲧ
ⲡⲁϩⲱⲙⲟ	NPROP	ⲡⲁϩⲱⲙⲟ
ⲡⲁϩⲱⲙⲱ	NPROP	ⲡⲁϩⲱⲙⲱ
ⲡⲁϩⲱⲙ	NPROP	ⲡⲁϩⲱⲙ
ⲡⲁϩ	V	ⲡⲱϩ
ⲡⲁϭⲉⲛϣⲉ	N	ⲡⲁϭⲉⲛϣⲉ
ⲡⲁϭⲥⲉ	N	ⲡⲁϭⲥⲉ
ⲡⲁⲅⲁⲛⲟⲥ	N	ⲡⲁⲅⲁⲛⲟⲥ
ⲡⲁⲅⲁⲣⲭⲟⲥ	N	ⲡⲁⲅⲁⲣⲭⲟⲥ
ⲡⲁⲏⲥⲉ	NPROP	ⲡⲁⲏⲥⲉ
ⲡⲁⲑⲏⲧⲟⲥ	N	ⲡⲁⲑⲏⲧⲟⲥ
ⲡⲁⲑⲓ	V	ⲡⲁⲑⲓ
ⲡⲁⲑⲟⲥ	N	ⲡⲁⲑⲟⲥ
ⲡⲁⲓⲇⲁⲅⲱⲅⲟⲥ	N	ⲡⲁⲓⲇⲁⲅⲱⲅⲟⲥ
ⲡⲁⲓⲇⲉⲓⲁ	N	ⲡⲁⲓⲇⲉⲓⲁ
ⲡⲁⲓⲇⲉⲥ	N	ⲡⲁⲓⲇⲉⲥ
ⲡⲁⲓⲇⲉⲩⲉ	V	ⲡⲁⲓⲇⲉⲩⲉ
ⲡⲁⲓⲇⲉⲩⲥⲓⲥ	N	ⲡⲁⲓⲇⲉⲩⲥⲓⲥ
ⲡⲁⲓⲇⲓⲁ	N	ⲡⲁⲓⲇⲓⲁ
ⲡⲁⲓ	PDEM	ⲡⲁⲓ
ⲡⲁⲕⲁⲛⲟⲥ	N	ⲡⲁⲕⲁⲛⲟⲥ
ⲡⲁⲕⲧⲟⲛ	N	ⲡⲁⲕⲧⲟⲛ
ⲡⲁⲗⲁϯⲟⲛ	N	ⲡⲁⲗⲁϯⲟⲛ
ⲡⲁⲗⲁⲓⲁ	N	ⲡⲁⲗⲁⲓⲁ
ⲡⲁⲗⲁⲧⲓⲛⲟⲥ	NPROP	ⲡⲁⲗⲁⲧⲓⲛⲟⲥ
ⲡⲁⲗⲁⲧⲓⲟⲛ	N	ⲡⲁⲗⲁⲧⲓⲟⲛ
ⲡⲁⲗⲓⲛ	ADV	ⲡⲁⲗⲓⲛ
ⲡⲁⲗⲓⲛ	CONJ	ⲡⲁⲗⲓⲛ
ⲡⲁⲗⲓⲥϯⲛⲏ	NPROP	ⲡⲁⲗⲓⲥϯⲛⲏ
ⲡⲁⲗⲗⲁϯⲟⲛ	N	ⲡⲁⲗⲗⲁϯⲟⲛ
ⲡⲁⲗⲗⲁⲇⲓⲟⲛ	N	ⲡⲁⲗⲗⲁⲇⲓⲟⲛ
ⲡⲁⲗⲗⲁⲕⲏ	N	ⲡⲁⲗⲗⲁⲕⲏ
ⲡⲁⲗⲗⲁⲧⲓⲛⲟⲥ	NPROP	ⲡⲁⲗⲗⲁⲧⲓⲛⲟⲥ
ⲡⲁⲗⲗⲁⲧⲓⲟⲛ	N	ⲡⲁⲗⲗⲁⲧⲓⲟⲛ
ⲡⲁⲙⲃⲱ	NPROP	ⲡⲁⲙⲃⲱ
ⲡⲁⲙⲙⲏⲧⲱⲣ	N	ⲡⲁⲙⲙⲏⲧⲱⲣ
ⲡⲁⲙⲟⲩⲛ	NPROP	ⲡⲁⲙⲟⲩⲛ
ⲡⲁⲛϩⲁⲅⲛⲟⲛ	N	ⲡⲁⲛϩⲁⲅⲛⲟⲛ
ⲡⲁⲛϩⲟⲗⲱⲛ	N	ⲡⲁⲛϩⲟⲗⲱⲛ
ⲡⲁⲛϩⲟⲡⲗⲓⲁ	N	ⲡⲁⲛϩⲟⲡⲗⲓⲁ
ⲡⲁⲛⲁⲅⲓ̈ⲟⲥ	N	ⲡⲁⲛⲁⲅⲓ̈ⲟⲥ
ⲡⲁⲛⲁⲣⲉ	N	ⲡⲁⲛⲁⲣⲉ
ⲡⲁⲛⲅⲉⲛⲓⲁ	N	ⲡⲁⲛⲅⲉⲛⲓⲁ
ⲡⲁⲛⲅⲛⲱⲥⲓⲥ	N	ⲡⲁⲛⲅⲛⲱⲥⲓⲥ
ⲡⲁⲛⲇⲏⲗⲟⲥ	N	ⲡⲁⲛⲇⲏⲗⲟⲥ
ⲡⲁⲛⲇⲓⲁ	N	ⲡⲁⲛⲇⲓⲁ
ⲡⲁⲛⲇⲟⲩⲣⲁ	N	ⲡⲁⲛⲇⲟⲩⲣⲁ
ⲡⲁⲛⲇⲩⲛⲁⲙⲓⲥ	N	ⲡⲁⲛⲇⲩⲛⲁⲙⲓⲥ
ⲡⲁⲛⲉⲩⲫⲏⲙⲟⲥ	N	ⲡⲁⲛⲉⲩⲫⲏⲙⲟⲥ
ⲡⲁⲛⲏⲣⲉⲙⲟⲥ	N	ⲡⲁⲛⲏⲣⲉⲙⲟⲥ
ⲡⲁⲛⲑⲏⲣ	N	ⲡⲁⲛⲑⲏⲣ
ⲡⲁⲛⲓⲡⲉ	N	ⲡⲁⲛⲓⲡⲉ
ⲡⲁⲛⲙⲩⲥⲧⲏⲣⲓⲟⲛ	N	ⲡⲁⲛⲙⲩⲥⲧⲏⲣⲓⲟⲛ
ⲡⲁⲛⲟⲡⲟⲗⲓⲧⲏⲥ	N	ⲡⲁⲛⲟⲡⲟⲗⲓⲧⲏⲥ
ⲡⲁⲛⲟⲥⲓⲟⲥ	N	ⲡⲁⲛⲟⲥⲓⲟⲥ
ⲡⲁⲛⲟⲥ	NPROP	ⲡⲁⲛⲟⲥ
ⲡⲁⲛⲟⲩⲣⲅⲓⲁ	N	ⲡⲁⲛⲟⲩⲣⲅⲓⲁ
ⲡⲁⲛⲟⲩⲣⲅⲟⲥ	N	ⲡⲁⲛⲟⲩⲣⲅⲟⲥ
ⲡⲁⲛⲟⲩⲥⲓⲟⲥ	N	ⲡⲁⲛⲟⲩⲥⲓⲟⲥ
ⲡⲁⲛⲡⲏⲅⲏ	N	ⲡⲁⲛⲡⲏⲅⲏ
ⲡⲁⲛⲥⲟⲫⲟⲥ	N	ⲡⲁⲛⲥⲟⲫⲟⲥ
ⲡⲁⲛⲧⲉⲗⲏⲥ	N	ⲡⲁⲛⲧⲉⲗⲏⲥ
ⲡⲁⲛⲧⲉⲗⲓⲟⲥ	N	ⲡⲁⲛⲧⲉⲗⲓⲟⲥ
ⲡⲁⲛⲧⲟⲇⲩⲛⲁⲙⲓⲥ	N	ⲡⲁⲛⲧⲟⲇⲩⲛⲁⲙⲓⲥ
ⲡⲁⲛⲧⲟⲇⲩⲛⲁⲙⲟⲥ	N	ⲡⲁⲛⲧⲟⲇⲩⲛⲁⲙⲟⲥ
ⲡⲁⲛⲧⲟⲕⲣⲁⲧⲱⲣ	N	ⲡⲁⲛⲧⲟⲕⲣⲁⲧⲱⲣ
ⲡⲁⲛⲧⲟⲙⲟⲣⲫⲟⲥ	N	ⲡⲁⲛⲧⲟⲙⲟⲣⲫⲟⲥ
ⲡⲁⲛⲧⲟⲡⲁⲧⲱⲣ	N	ⲡⲁⲛⲧⲟⲡⲁⲧⲱⲣ
ⲡⲁⲛⲧⲟⲥ	ADV	ⲡⲁⲛⲧⲟⲥ
ⲡⲁⲛⲧⲟⲭⲓⲟⲛ	N	ⲡⲁⲛⲧⲟⲭⲓⲟⲛ
ⲡⲁⲛⲧⲱⲥ	ADV	ⲡⲁⲛⲧⲱⲥ
ⲡⲁⲟⲡⲉ	N	ⲡⲁⲟⲡⲉ
ⲡⲁⲡⲁⲥ	N	ⲡⲁⲡⲁⲥ
ⲡⲁⲡⲛⲟⲩⲧⲉ	NPROP	ⲡⲁⲡⲛⲟⲩⲧⲉ
ⲡⲁⲡⲟϩⲉ	NPROP	ⲡⲁⲡⲟϩⲉ
ⲡⲁⲣϩⲏⲥⲓⲁⲍⲉ	V	ⲡⲁⲣϩⲏⲥⲓⲁⲍⲉ
ⲡⲁⲣϩⲓⲥⲧⲁ	V	ⲡⲁⲣϩⲓⲥⲧⲁ
ⲡⲁⲣϩⲟⲓⲙⲓⲁ	N	ⲡⲁⲣϩⲟⲓⲙⲓⲁ
ⲡⲁⲣϩⲩⲙⲓⲁⲥⲧⲏⲥ	N	ⲡⲁⲣϩⲩⲙⲓⲁⲥⲧⲏⲥ
ⲡⲁⲣⲁⲃⲁⲗⲗⲉⲓ	V	ⲡⲁⲣⲁⲃⲁⲗⲗⲉⲓ
ⲡⲁⲣⲁⲃⲁⲗⲗⲉ	V	ⲡⲁⲣⲁⲃⲁⲗⲗⲉ
ⲡⲁⲣⲁⲃⲁⲥⲓⲥ	N	ⲡⲁⲣⲁⲃⲁⲥⲓⲥ
ⲡⲁⲣⲁⲃⲁⲧⲏⲥ	N	ⲡⲁⲣⲁⲃⲁⲧⲏⲥ
ⲡⲁⲣⲁⲃⲁ	V	ⲡⲁⲣⲁⲃⲁ
ⲡⲁⲣⲁⲃⲉⲛⲓⲛ	V	ⲡⲁⲣⲁⲃⲉⲛⲓⲛ
ⲡⲁⲣⲁⲃⲟⲗⲏ	N	ⲡⲁⲣⲁⲃⲟⲗⲏ
ⲡⲁⲣⲁⲅⲅⲉⲓⲗⲉ	V	ⲡⲁⲣⲁⲅⲅⲉⲓⲗⲉ
ⲡⲁⲣⲁⲅⲅⲉⲗⲓⲁ	N	ⲡⲁⲣⲁⲅⲅⲉⲗⲓⲁ
ⲡⲁⲣⲁⲅⲅⲓⲗⲉ	V	ⲡⲁⲣⲁⲅⲅⲓⲗⲉ
ⲡⲁⲣⲁⲅⲉ	V	ⲡⲁⲣⲁⲅⲉ
ⲡⲁⲣⲁⲇⲉⲓⲅⲙⲁ	N	ⲡⲁⲣⲁⲇⲉⲓⲅⲙⲁ
ⲡⲁⲣⲁⲇⲉⲓⲥⲟⲥ	N	ⲡⲁⲣⲁⲇⲉⲓⲥⲟⲥ
ⲡⲁⲣⲁⲇⲉⲭⲉ	V	ⲡⲁⲣⲁⲇⲉⲭⲉ
ⲡⲁⲣⲁⲇⲓⲅⲙⲁⲧⲓⲍⲉ	V	ⲡⲁⲣⲁⲇⲓⲅⲙⲁⲧⲓⲍⲉ
ⲡⲁⲣⲁⲇⲓⲅⲙⲁ	N	ⲡⲁⲣⲁⲇⲓⲅⲙⲁ
ⲡⲁⲣⲁⲇⲓⲇⲟⲩ	V	ⲡⲁⲣⲁⲇⲓⲇⲟⲩ
ⲡⲁⲣⲁⲇⲓⲥⲟⲥ	N	ⲡⲁⲣⲁⲇⲓⲥⲟⲥ
ⲡⲁⲣⲁⲇⲓⲥⲱⲥ	N	ⲡⲁⲣⲁⲇⲓⲥⲱⲥ
ⲡⲁⲣⲁⲇⲟⲝⲟⲛ	N	ⲡⲁⲣⲁⲇⲟⲝⲟⲛ
ⲡⲁⲣⲁⲇⲟⲥⲓⲥ	N	ⲡⲁⲣⲁⲇⲟⲥⲓⲥ
ⲡⲁⲣⲁⲑⲏⲕⲏ	N	ⲡⲁⲣⲁⲑⲏⲕⲏ
ⲡⲁⲣⲁⲓⲧⲉⲓ	V	ⲡⲁⲣⲁⲓⲧⲉⲓ
ⲡⲁⲣⲁⲕⲁⲗⲉⲓ	V	ⲡⲁⲣⲁⲕⲁⲗⲉⲓ
ⲡⲁⲣⲁⲕⲗⲏⲥⲓⲥ	N	ⲡⲁⲣⲁⲕⲗⲏⲥⲓⲥ
ⲡⲁⲣⲁⲕⲗⲏⲧⲓⲕⲟⲛ	N	ⲡⲁⲣⲁⲕⲗⲏⲧⲓⲕⲟⲛ
ⲡⲁⲣⲁⲕⲗⲏⲧⲟⲛ	N	ⲡⲁⲣⲁⲕⲗⲏⲧⲟⲛ
ⲡⲁⲣⲁⲕⲗⲏⲧⲟⲥ	N	ⲡⲁⲣⲁⲕⲗⲏⲧⲟⲥ
ⲡⲁⲣⲁⲗⲏⲙⲡⲧⲱⲣ	N	ⲡⲁⲣⲁⲗⲏⲙⲡⲧⲱⲣ
ⲡⲁⲣⲁⲗⲓⲁ	N	ⲡⲁⲣⲁⲗⲓⲁ
ⲡⲁⲣⲁⲗⲟⲅⲟⲛ	N	ⲡⲁⲣⲁⲗⲟⲅⲟⲛ
ⲡⲁⲣⲁⲙⲉⲓⲛⲉ	V	ⲡⲁⲣⲁⲙⲉⲓⲛⲉ
ⲡⲁⲣⲁⲙⲟⲛⲏ	N	ⲡⲁⲣⲁⲙⲟⲛⲏ
ⲡⲁⲣⲁⲙⲩⲑⲓⲁ	N	ⲡⲁⲣⲁⲙⲩⲑⲓⲁ
ⲡⲁⲣⲁⲙⲩⲑⲓⲍⲉ	V	ⲡⲁⲣⲁⲙⲩⲑⲓⲍⲉ
ⲡⲁⲣⲁⲛⲟⲙⲉⲓ	V	ⲡⲁⲣⲁⲛⲟⲙⲉⲓ
ⲡⲁⲣⲁⲛⲟⲙⲓⲁ	N	ⲡⲁⲣⲁⲛⲟⲙⲓⲁ
ⲡⲁⲣⲁⲛⲟⲙⲟⲛ	N	ⲡⲁⲣⲁⲛⲟⲙⲟⲛ
ⲡⲁⲣⲁⲛⲟⲙⲟⲥ	N	ⲡⲁⲣⲁⲛⲟⲙⲟⲥ
ⲡⲁⲣⲁⲛⲱⲙⲓⲁ	N	ⲡⲁⲣⲁⲛⲱⲙⲓⲁ
ⲡⲁⲣⲁⲡⲉⲧⲁⲥⲙⲁ	N	ⲡⲁⲣⲁⲡⲉⲧⲁⲥⲙⲁ
ⲡⲁⲣⲁⲡⲧⲱⲙⲁ	N	ⲡⲁⲣⲁⲡⲧⲱⲙⲁ
ⲡⲁⲣⲁⲥⲕⲉⲩⲁⲍⲉ	V	ⲡⲁⲣⲁⲥⲕⲉⲩⲁⲍⲉ
ⲡⲁⲣⲁⲥⲕⲉⲩⲉⲍⲉ	V	ⲡⲁⲣⲁⲥⲕⲉⲩⲉⲍⲉ
ⲡⲁⲣⲁⲥⲕⲉⲩⲏ	N	ⲡⲁⲣⲁⲥⲕⲉⲩⲏ
ⲡⲁⲣⲁⲥⲧⲁⲧⲏⲥ	N	ⲡⲁⲣⲁⲥⲧⲁⲧⲏⲥ
ⲡⲁⲣⲁⲧⲏⲣⲉⲓ	V	ⲡⲁⲣⲁⲧⲏⲣⲉⲓ
ⲡⲁⲣⲁⲧⲏⲣⲓ	V	ⲡⲁⲣⲁⲧⲏⲣⲓ
ⲡⲁⲣⲁⲧⲓⲅⲙⲁⲧⲓⲍⲉ	V	ⲡⲁⲣⲁⲧⲓⲅⲙⲁⲧⲓⲍⲉ
ⲡⲁⲣⲁⲫⲣⲁⲥⲓⲥ	N	ⲡⲁⲣⲁⲫⲣⲁⲥⲓⲥ
ⲡⲁⲣⲁⲫⲩⲥⲓⲥ	N	ⲡⲁⲣⲁⲫⲩⲥⲓⲥ
ⲡⲁⲣⲁⲭⲓⲙⲁⲍⲉ	V	ⲡⲁⲣⲁⲭⲓⲙⲁⲍⲉ
ⲡⲁⲣⲁⲭⲱⲣⲉⲓ	V	ⲡⲁⲣⲁⲭⲱⲣⲉⲓ
ⲡⲁⲣⲁ	FM	ⲡⲁⲣⲁ
ⲡⲁⲣⲁ	PREP	ⲡⲁⲣⲁ
ⲡⲁⲣⲁ<ⲫⲣⲱⲛ>	N	ⲡⲁⲣⲁ<ⲫⲣⲱⲛ>
ⲡⲁⲣⲃⲁⲥⲓⲥ	N	ⲡⲁⲣⲃⲁⲥⲓⲥ
ⲡⲁⲣⲇⲁⲗⲓⲥ	N	ⲡⲁⲣⲇⲁⲗⲓⲥ
ⲡⲁⲣⲉⲗⲑⲉ	V	ⲡⲁⲣⲉⲗⲑⲉ
ⲡⲁⲣⲉⲙϩⲟⲧⲡ	NPROP	ⲡⲁⲣⲉⲙϩⲟⲧⲡ
ⲡⲁⲣⲉⲙⲃⲟⲗⲏ	N	ⲡⲁⲣⲉⲙⲃⲟⲗⲏ
ⲡⲁⲣⲑⲉⲛⲓⲁ	N	ⲡⲁⲣⲑⲉⲛⲓⲁ
ⲡⲁⲣⲑⲉⲛⲓⲕⲏ	N	ⲡⲁⲣⲑⲉⲛⲓⲕⲏ
ⲡⲁⲣⲑⲉⲛⲓⲕⲟⲛ	N	ⲡⲁⲣⲑⲉⲛⲓⲕⲟⲛ
ⲡⲁⲣⲑⲉⲛⲟⲥ	N	ⲡⲁⲣⲑⲉⲛⲟⲥ
ⲡⲁⲣⲑⲟⲥ	N	ⲡⲁⲣⲑⲟⲥ
ⲡⲁⲣⲓⲅⲟⲣⲓ	NPROP	ⲡⲁⲣⲓⲅⲟⲣⲓ
ⲡⲁⲣⲓⲥⲑⲙⲓⲟⲛ	N	ⲡⲁⲣⲓⲥⲑⲙⲓⲟⲛ
ⲡⲁⲣⲙϩⲟⲧⲡ	NPROP	ⲡⲁⲣⲙϩⲟⲧⲡ
ⲡⲁⲣⲙⲟⲩⲧⲉ	NPROP	ⲡⲁⲣⲙⲟⲩⲧⲉ
ⲡⲁⲣⲟⲓⲕⲏⲥⲓⲥ	N	ⲡⲁⲣⲟⲓⲕⲏⲥⲓⲥ
ⲡⲁⲣⲟⲝⲩⲥⲙⲟⲥ	N	ⲡⲁⲣⲟⲝⲩⲥⲙⲟⲥ
ⲡⲁⲣⲟⲣⲁ	V	ⲡⲁⲣⲟⲣⲁ
ⲡⲁⲣⲟⲩⲥⲓⲁ	N	ⲡⲁⲣⲟⲩⲥⲓⲁ
ⲡⲁⲣⲣϩⲏⲥⲓⲁⲍⲉ	V	ⲡⲁⲣⲣϩⲏⲥⲓⲁⲍⲉ
ⲡⲁⲣⲣⲏⲥⲓⲁⲍⲉ	V	ⲡⲁⲣⲣⲏⲥⲓⲁⲍⲉ
ⲡⲁⲣⲣⲏⲥⲓⲁ	N	ⲡⲁⲣⲣⲏⲥⲓⲁ
ⲡⲁⲣⲣⲟⲩⲥⲓⲁ	N	ⲡⲁⲣⲣⲟⲩⲥⲓⲁ
ⲡⲁⲣⲱⲝⲩⲛⲉ	V	ⲡⲁⲣⲱⲝⲩⲛⲉ
ⲡⲁⲥⲧⲁⲙⲱⲛ	NPROP	ⲡⲁⲥⲧⲁⲙⲱⲛ
ⲡⲁⲥⲧⲟⲥ	N	ⲡⲁⲥⲧⲟⲥ
ⲡⲁⲥⲧ	V	ⲡⲓⲥⲉ
ⲡⲁⲥⲭⲁ	N	ⲡⲁⲥⲭⲁ
ⲡⲁⲥⲭⲱⲣ	NPROP	ⲡⲁⲥⲭⲱⲣ
ⲡⲁⲥ	N	ⲡⲁⲥ
ⲡⲁⲧⲁⲥⲥⲉⲓ	V	ⲡⲁⲧⲁⲥⲥⲉⲓ
ⲡⲁⲧⲁⲥⲥⲉ	V	ⲡⲁⲧⲁⲥⲥⲉ
ⲡⲁⲧⲉⲓ	V	ⲡⲁⲧⲉⲓ
ⲡⲁⲧⲣⲓⲁⲣⲭⲏⲥ	N	ⲡⲁⲧⲣⲓⲁⲣⲭⲏⲥ
ⲡⲁⲧⲣⲓⲁ	N	ⲡⲁⲧⲣⲓⲁ
ⲡⲁⲧⲣⲓⲥ	N	ⲡⲁⲧⲣⲓⲥ
ⲡⲁⲧ	N	ⲡⲁⲧ
ⲡⲁⲩⲗⲉ	NPROP	ⲡⲁⲩⲗⲉ
ⲡⲁⲩⲗⲟⲥ	NPROP	ⲡⲁⲩⲗⲟⲥ
ⲡⲁⲱⲛⲉ	NPROP	ⲡⲁⲱⲛⲉ
ⲡⲁ	PPOS	ⲡⲁ
ⲡⲃⲁⲩ	NPROP	ⲡⲃⲁⲩ
ⲡⲉϣⲛ	V	ⲡⲱϣⲛ
ⲡⲉϣⲥ	V	ⲡⲱϣⲥ
ⲡⲉϣ	V	ⲡⲱϣ
ⲡⲉϥ	PPOS	ⲡⲉϥ
ⲡⲉϩⲟⲩⲟ	ADV	ⲡⲉϩⲟⲩⲟ
ⲡⲉϩⲧ	V	ⲡⲱϩⲧ
ⲡⲉϩ	N	ⲡⲉϩ
ⲡⲉϩ	V	ⲡⲉϩ
ⲡⲉϫⲁ	VBD	ⲡⲉϫⲉ
ⲡⲉϫⲉ	VBD	ⲡⲉϫⲉ
ⲡⲉⲇⲉⲩⲉ	V	ⲡⲉⲇⲉⲩⲉ
ⲡⲉⲇⲉⲩⲥⲓⲥ	N	ⲡⲉⲇⲉⲩⲥⲓⲥ
ⲡⲉⲇⲏⲥ	N	ⲡⲉⲇⲏⲥ
ⲡⲉⲇⲏ	N	ⲡⲉⲇⲏ
ⲡⲉⲑⲁⲅⲟⲣⲁⲥ	NPROP	ⲡⲉⲑⲁⲅⲟⲣⲁⲥ
ⲡⲉⲑⲁⲅⲟⲣⲁ	NPROP	ⲡⲉⲑⲁⲅⲟⲣⲁ
ⲡⲉⲑⲏⲡ	N	ⲡⲉⲑⲏⲡ
ⲡⲉⲑⲓⲧⲟⲩⲱ	N	ⲡⲉⲑⲓⲧⲟⲩⲱ
ⲡⲉⲑⲟⲟⲩ	N	ⲡⲉⲑⲟⲟⲩ
ⲡⲉⲓⲑⲉ	N	ⲡⲉⲓⲑⲉ
ⲡⲉⲓⲑⲉ	V	ⲡⲉⲓⲑⲉ
ⲡⲉⲓⲣⲁⲍⲉ	V	ⲡⲉⲓⲣⲁⲍⲉ
ⲡⲉⲓⲣⲁⲥⲙⲟⲥ	N	ⲡⲉⲓⲣⲁⲥⲙⲟⲥ
ⲡⲉⲓⲣⲁⲧⲏⲣⲓⲟⲛ	N	ⲡⲉⲓⲣⲁⲧⲏⲣⲓⲟⲛ
ⲡⲉⲓⲣⲉ	V	ⲡⲉⲓⲣⲉ
ⲡⲉⲓ	ART	ⲡⲉⲓ
ⲡⲉⲓ	PDEM	ⲡⲉⲓ
ⲡⲉⲓ	V	ⲡⲉⲓ
ⲡⲉⲕ	PPOS	ⲡⲉⲕ
ⲡⲉⲗϭⲉ	N	ⲡⲉⲗϭⲉ
ⲡⲉⲗⲁⲅⲟⲥ	N	ⲡⲉⲗⲁⲅⲟⲥ
ⲡⲉⲗⲙⲁ	N	ⲡⲉⲗⲙⲁ
ⲡⲉⲙϫⲉ	NPROP	ⲡⲉⲙϫⲉ
ⲡⲉⲙⲡⲧⲉ	N	ⲡⲉⲙⲡⲧⲉ
ⲡⲉⲛⲁⲅⲓⲥ	N	ⲡⲉⲛⲁⲅⲓⲥ
ⲡⲉⲛⲑⲉⲓ	V	ⲡⲉⲛⲑⲉⲓ
ⲡⲉⲛⲑⲟⲥ	N	ⲡⲉⲛⲑⲟⲥ
ⲡⲉⲛⲓⲡⲉ	N	ⲡⲉⲛⲓⲡⲉ
ⲡⲉⲛⲧⲁⲥ	N	ⲡⲉⲛⲧⲁⲥ
ⲡⲉⲛⲧⲉⲕⲟⲛⲧⲁⲣⲭⲟⲥ	N	ⲡⲉⲛⲧⲉⲕⲟⲛⲧⲁⲣⲭⲟⲥ
ⲡⲉⲛⲧⲏⲕⲟⲥⲧⲏ	N	ⲡⲉⲛⲧⲏⲕⲟⲥⲧⲏ
ⲡⲉⲛ	PPOS	ⲡⲉⲛ
ⲡⲉⲡⲧⲉⲓ	V	ⲡⲉⲡⲧⲉⲓ
ⲡⲉⲣϫ	V	ⲡⲱⲣϫ
ⲡⲉⲣⲁ	V	ⲡⲉⲣⲁ
ⲡⲉⲣⲉ	V	ⲡⲱⲱⲣⲉ
ⲡⲉⲣⲓⲁⲅⲉ	V	ⲡⲉⲣⲓⲁⲅⲉ
ⲡⲉⲣⲓⲅⲣⲁⲫⲏ	N	ⲡⲉⲣⲓⲅⲣⲁⲫⲏ
ⲡⲉⲣⲓⲇⲱⲛ	N	ⲡⲉⲣⲓⲇⲱⲛ
ⲡⲉⲣⲓⲉⲣⲅⲟⲥ	N	ⲡⲉⲣⲓⲉⲣⲅⲟⲥ
ⲡⲉⲣⲓⲍⲱⲙⲁ	N	ⲡⲉⲣⲓⲍⲱⲙⲁ
ⲡⲉⲣⲓⲕⲁⲑⲁⲣⲙⲁ	N	ⲡⲉⲣⲓⲕⲁⲑⲁⲣⲙⲁ
ⲡⲉⲣⲓⲕⲉⲫⲁⲗⲁⲓⲁ	N	ⲡⲉⲣⲓⲕⲉⲫⲁⲗⲁⲓⲁ
ⲡⲉⲣⲓⲟⲇⲟⲥ	N	ⲡⲉⲣⲓⲟⲇⲟⲥ
ⲡⲉⲣⲓⲥⲟⲛ	N	ⲡⲉⲣⲓⲥⲟⲛ
ⲡⲉⲣⲓⲥⲡⲁⲥⲙⲟⲥ	N	ⲡⲉⲣⲓⲥⲡⲁⲥⲙⲟⲥ
ⲡⲉⲣⲓⲥⲥⲟⲛ	N	ⲡⲉⲣⲓⲥⲥⲟⲛ
ⲡⲉⲣⲓⲭⲱⲣⲟⲥ	N	ⲡⲉⲣⲓⲭⲱⲣⲟⲥ
ⲡⲉⲣⲡⲉⲣⲟⲥ	N	ⲡⲉⲣⲡⲉⲣⲟⲥ
ⲡⲉⲣⲥⲏⲥ	N	ⲡⲉⲣⲥⲏⲥ
ⲡⲉⲣⲥⲓⲥ	NPROP	ⲡⲉⲣⲥⲓⲥ
ⲡⲉⲣⲥⲓⲧⲏⲥ	N	ⲡⲉⲣⲥⲓⲧⲏⲥ
ⲡⲉⲣⲥⲟⲥ	NPROP	ⲡⲉⲣⲥⲟⲥ
ⲡⲉⲥⲏⲧ	N	ⲡⲉⲥⲏⲧ
ⲡⲉⲥ	PPOS	ⲡⲉⲥ
ⲡⲉⲧⲛ	PPOS	ⲡⲉⲧⲛ
ⲡⲉⲧⲣⲁ	N	ⲡⲉⲧⲣⲁ
ⲡⲉⲧⲣⲁ	NPROP	ⲡⲉⲧⲣⲁ
ⲡⲉⲧⲣⲟⲥ	NPROP	ⲡⲉⲧⲣⲟⲥ
ⲡⲉⲧ	N	ⲡⲉⲧ
ⲡⲉⲧ	V	ⲡⲉⲧ
ⲡⲉⲩϣⲟⲙⲛⲧ	ADV	ⲡⲉⲩϣⲟⲙⲛⲧ
ⲡⲉⲩ	PPOS	ⲡⲉⲩ
ⲡⲉ	ART	ⲡ
ⲡⲉ	COP	ⲡⲉ
ⲡⲉ	N	ⲡⲉ
ⲡⲏϣ	VSTAT	ⲡⲱϣ
ⲡⲏϩ	VSTAT	ⲡⲱϩ
ⲡⲏⲅⲏ	N	ⲡⲏⲅⲏ
ⲡⲏⲟⲩⲉ	N	ⲡⲉ
ⲡⲏⲣⲁ	N	ⲡⲏⲣⲁ
ⲡⲏⲥⲥⲉ	V	ⲡⲏⲥⲥⲉ
ⲡⲏⲧ	VSTAT	ⲡⲱⲧ
ⲡⲏⲩ̣ⲉ	ART	ⲡⲏⲩ̣ⲉ
ⲡⲏⲩⲉ	N	ⲡⲉ
ⲡⲏ	N	ⲡⲏ
ⲡⲓⲑⲁⲅⲟⲣⲁⲥ	NPROP	ⲡⲓⲑⲁⲅⲟⲣⲁⲥ
ⲡⲓⲑⲁⲅⲟⲣⲁ	NPROP	ⲡⲓⲑⲁⲅⲟⲣⲁ
ⲡⲓⲑⲉⲥⲑⲁⲓ	V	ⲡⲓⲑⲉⲥⲑⲁⲓ
ⲡⲓⲑⲉ	N	ⲡⲓⲑⲉ
ⲡⲓⲑⲉ	V	ⲡⲓⲑⲉ
ⲡⲓⲑⲟⲥ	N	ⲡⲓⲑⲟⲥ
ⲡⲓⲕⲣⲓⲁ	N	ⲡⲓⲕⲣⲓⲁ
ⲡⲓⲗⲁⲧⲟⲥ	NPROP	ⲡⲓⲗⲁⲧⲟⲥ
ⲡⲓⲗⲁⲧⲟⲥ	V	ⲡⲓⲗⲁⲧⲟⲥ
ⲡⲓⲛⲁⲅⲓⲥ	N	ⲡⲓⲛⲁⲅⲓⲥ
ⲡⲓⲛⲁⲝ	N	ⲡⲓⲛⲁⲝ
ⲡⲓⲛⲟⲩ	N	ⲡⲓⲛⲟⲩ
ⲡⲓⲣⲁⲍⲉ	V	ⲡⲓⲣⲁⲍⲉ
ⲡⲓⲣⲁⲥⲙⲟⲥ	N	ⲡⲓⲣⲁⲥⲙⲟⲥ
ⲡⲓⲣⲉ	V	ⲡⲓⲣⲉ
ⲡⲓⲥⲧⲉⲩⲉ	V	ⲡⲓⲥⲧⲉⲩⲉ
ⲡⲓⲥⲧⲏⲥ	N	ⲡⲓⲥⲧⲏⲥ
ⲡⲓⲥⲧⲏ	N	ⲡⲓⲥⲧⲏ
ⲡⲓⲥⲧⲓⲕⲏ	N	ⲡⲓⲥⲧⲓⲕⲏ
ⲡⲓⲥⲧⲓⲥ	N	ⲡⲓⲥⲧⲓⲥ
ⲡⲓⲥⲧⲟⲛ	N	ⲡⲓⲥⲧⲟⲛ
ⲡⲓⲥⲧⲟⲥ	N	ⲡⲓⲥⲧⲟⲥ
ⲡⲓⲧⲧⲁ	NPROP	ⲡⲓⲧⲧⲁ
ⲡⲓ	PDEM	ⲡⲓ
ⲡⲕⲱⲟⲩ	NPROP	ⲡⲕⲱⲟⲩ
ⲡⲗϭⲉ	N	ⲡⲗϭⲉ
ⲡⲗⲁϯⲁ	N	ⲡⲗⲁϯⲁ
ⲡⲗⲁⲕⲟⲩⲧⲟⲛ	N	ⲡⲗⲁⲕⲟⲩⲧⲟⲛ
ⲡⲗⲁⲕⲩⲧⲟⲛ	N	ⲡⲗⲁⲕⲩⲧⲟⲛ
ⲡⲗⲁⲕⲱⲧⲟⲛ	N	ⲡⲗⲁⲕⲱⲧⲟⲛ
ⲡⲗⲁⲛⲁⲥⲑⲁⲓ	V	ⲡⲗⲁⲛⲁⲥⲑⲁⲓ
ⲡⲗⲁⲛⲁⲥⲑⲉ	V	ⲡⲗⲁⲛⲁⲥⲑⲉ
ⲡⲗⲁⲛⲁ	V	ⲡⲗⲁⲛⲁ
ⲡⲗⲁⲛⲏ	N	ⲡⲗⲁⲛⲏ
ⲡⲗⲁⲛⲟⲥ	N	ⲡⲗⲁⲛⲟⲥ
ⲡⲗⲁⲝ	N	ⲡⲗⲁⲝ
ⲡⲗⲁⲥⲓⲥ	N	ⲡⲗⲁⲥⲓⲥ
ⲡⲗⲁⲥⲙⲁ	N	ⲡⲗⲁⲥⲙⲁ
ⲡⲗⲁⲥⲥⲉ	V	ⲡⲗⲁⲥⲥⲉ
ⲡⲗⲁⲥⲧⲏⲥ	N	ⲡⲗⲁⲥⲧⲏⲥ
ⲡⲗⲁⲧⲁⲛⲟⲥ	N	ⲡⲗⲁⲧⲁⲛⲟⲥ
ⲡⲗⲁⲧⲉⲓⲁ	N	ⲡⲗⲁⲧⲉⲓⲁ
ⲡⲗⲁⲧⲏⲣⲉ	N	ⲡⲗⲁⲧⲏⲣⲉ
ⲡⲗⲁⲧⲓⲁ	N	ⲡⲗⲁⲧⲓⲁ
ⲡⲗⲉⲁ	V	ⲡⲗⲉⲁ
ⲡⲗⲉⲟⲛⲉⲕⲧⲉⲓ	V	ⲡⲗⲉⲟⲛⲉⲕⲧⲉⲓ
ⲡⲗⲉⲟⲛⲉⲕⲧⲏⲥ	N	ⲡⲗⲉⲟⲛⲉⲕⲧⲏⲥ
ⲡⲗⲉⲟⲛⲉⲝⲓⲁ	N	ⲡⲗⲉⲟⲛⲉⲝⲓⲁ
ⲡⲗⲉⲣⲟⲫⲟⲣⲓⲁ	N	ⲡⲗⲉⲣⲟⲫⲟⲣⲓⲁ
ⲡⲗⲉⲥⲥⲉ	V	ⲡⲗⲉⲥⲥⲉ
ⲡⲗⲏⲅⲉ	V	ⲡⲗⲏⲅⲉ
ⲡⲗⲏⲅⲏ	N	ⲡⲗⲏⲅⲏ
ⲡⲗⲏⲕⲧⲣⲟⲛ	N	ⲡⲗⲏⲕⲧⲣⲟⲛ
ⲡⲗⲏⲛ	CONJ	ⲡⲗⲏⲛ
ⲡⲗⲏⲣⲟⲩ	V	ⲡⲗⲏⲣⲟⲩ
ⲡⲗⲏⲣⲟⲫⲟⲣⲉⲓ	V	ⲡⲗⲏⲣⲟⲫⲟⲣⲉⲓ
ⲡⲗⲏⲣⲟⲫⲟⲣⲓⲁ	N	ⲡⲗⲏⲣⲟⲫⲟⲣⲓⲁ
ⲡⲗⲏⲣⲟⲫⲟⲣⲓ	V	ⲡⲗⲏⲣⲟⲫⲟⲣⲓ
ⲡⲗⲏⲣⲱⲙⲁ	N	ⲡⲗⲏⲣⲱⲙⲁ
ⲡⲗⲏⲱⲣⲙⲁ	N	ⲡⲗⲏⲱⲣⲙⲁ
ⲡⲗⲟⲩⲧⲱⲛⲓⲟⲥ	N	ⲡⲗⲟⲩⲧⲱⲛⲓⲟⲥ
ⲡⲗⲩⲅⲏ	N	ⲡⲗⲩⲅⲏ
ⲡⲛⲉⲩⲙⲁⲧⲓⲕⲏ	N	ⲡⲛⲉⲩⲙⲁⲧⲓⲕⲏ
ⲡⲛⲉⲩⲙⲁⲧⲓⲕⲟⲛ	N	ⲡⲛⲉⲩⲙⲁⲧⲓⲕⲟⲛ
ⲡⲛⲉⲩⲙⲁⲧⲓⲕⲟⲥ	N	ⲡⲛⲉⲩⲙⲁⲧⲓⲕⲟⲥ
ⲡⲛⲉⲩⲙⲁⲧⲓⲕⲱⲥ	ADV	ⲡⲛⲉⲩⲙⲁⲧⲓⲕⲱⲥ
ⲡⲛⲉⲩⲙⲁⲧⲟⲫⲟⲣⲟⲥ	N	ⲡⲛⲉⲩⲙⲁⲧⲟⲫⲟⲣⲟⲥ
ⲡⲛⲉⲩⲙⲁ	N	ⲡⲛⲉⲩⲙⲁ
ⲡⲛⲉⲩⲙⲱⲛ	N	ⲡⲛⲉⲩⲙⲱⲛ
ⲡⲛⲏ	N	ⲡⲛⲏ
ⲡⲛⲟⲏ	N	ⲡⲛⲟⲏ
ⲡⲛⲟⲩⲧⲉ	N	ⲡⲛⲟⲩⲧⲉ
ⲡⲟϣ	V	ⲡⲟϣ
ⲡⲟϩⲥ	N	ⲡⲟϩⲥ
ⲡⲟⲇⲏⲣⲏ	N	ⲡⲟⲇⲏⲣⲏ
ⲡⲟⲇⲟⲛⲓⲡⲧⲏⲣ	N	ⲡⲟⲇⲟⲛⲓⲡⲧⲏⲣ
ⲡⲟⲓⲏⲧⲏⲥ	N	ⲡⲟⲓⲏⲧⲏⲥ
ⲡⲟⲓⲙⲏⲛ	N	ⲡⲟⲓⲙⲏⲛ
ⲡⲟⲗⲉⲓⲥ	N	ⲡⲟⲗⲉⲓⲥ
ⲡⲟⲗⲉⲙⲁⲣⲭⲏⲥ	N	ⲡⲟⲗⲉⲙⲁⲣⲭⲏⲥ
ⲡⲟⲗⲉⲙⲉⲓ	V	ⲡⲟⲗⲉⲙⲉⲓ
ⲡⲟⲗⲉⲙⲓⲕⲟⲛ	N	ⲡⲟⲗⲉⲙⲓⲕⲟⲛ
ⲡⲟⲗⲉⲙⲓⲥⲧⲏⲥ	N	ⲡⲟⲗⲉⲙⲓⲥⲧⲏⲥ
ⲡⲟⲗⲉⲙⲟⲥ	N	ⲡⲟⲗⲉⲙⲟⲥ
ⲡⲟⲗⲓⲥ	N	ⲡⲟⲗⲓⲥ
ⲡⲟⲗⲓⲧⲉⲓⲁ	N	ⲡⲟⲗⲓⲧⲉⲓⲁ
ⲡⲟⲗⲓⲧⲉⲩⲉⲥⲑⲁⲓ	V	ⲡⲟⲗⲓⲧⲉⲩⲉⲥⲑⲁⲓ
ⲡⲟⲗⲓⲧⲉⲩⲉ	V	ⲡⲟⲗⲓⲧⲉⲩⲉ
ⲡⲟⲗⲓⲧⲉⲩⲙⲁ	N	ⲡⲟⲗⲓⲧⲉⲩⲙⲁ
ⲡⲟⲗⲓⲧⲉⲩⲧⲏⲥ	N	ⲡⲟⲗⲓⲧⲉⲩⲧⲏⲥ
ⲡⲟⲗⲓⲧⲏⲥ	N	ⲡⲟⲗⲓⲧⲏⲥ
ⲡⲟⲗⲓⲧⲓⲁ	N	ⲡⲟⲗⲓⲧⲓⲁ
ⲡⲟⲗⲗⲁⲕⲓⲥ	ADV	ⲡⲟⲗⲗⲁⲕⲓⲥ
ⲡⲟⲗⲗⲩⲗⲟⲅⲟⲥ	N	ⲡⲟⲗⲗⲩⲗⲟⲅⲟⲥ
ⲡⲟⲗⲩϯⲁ	N	ⲡⲟⲗⲩϯⲁ
ⲡⲟⲗⲩⲗⲟⲅⲟⲥ	N	ⲡⲟⲗⲩⲗⲟⲅⲟⲥ
ⲡⲟⲗⲩⲙⲁⲣⲭⲏⲥ	N	ⲡⲟⲗⲩⲙⲁⲣⲭⲏⲥ
ⲡⲟⲗⲩⲙⲉⲓ	V	ⲡⲟⲗⲩⲙⲉⲓ
ⲡⲟⲗⲩⲙⲓⲥⲧⲏⲥ	N	ⲡⲟⲗⲩⲙⲓⲥⲧⲏⲥ
ⲡⲟⲗⲩⲙⲟⲥ	N	ⲡⲟⲗⲩⲙⲟⲥ
ⲡⲟⲗⲩⲫⲁⲛⲏⲥ	NPROP	ⲡⲟⲗⲩⲫⲁⲛⲏⲥ
ⲡⲟⲛⲉⲣⲟⲥ	N	ⲡⲟⲛⲉⲣⲟⲥ
ⲡⲟⲛⲏⲣⲁ	N	ⲡⲟⲛⲏⲣⲁ
ⲡⲟⲛⲏⲣⲉⲩⲉ	V	ⲡⲟⲛⲏⲣⲉⲩⲉ
ⲡⲟⲛⲏⲣⲓⲁ	N	ⲡⲟⲛⲏⲣⲓⲁ
ⲡⲟⲛⲏⲣⲟⲛ	N	ⲡⲟⲛⲏⲣⲟⲛ
ⲡⲟⲛⲏⲣⲟⲥ	N	ⲡⲟⲛⲏⲣⲟⲥ
ⲡⲟⲛⲧⲓⲟⲥ	NPROP	ⲡⲟⲛⲧⲓⲟⲥ
ⲡⲟⲛ	V	ⲡⲟⲛ
ⲡⲟⲟⲛⲉ	V	ⲡⲱⲱⲛⲉ
ⲡⲟⲟⲛ	V	ⲡⲟⲟⲛ
ⲡⲟⲟⲩⲛϩⲟⲟⲩ	ADV	ⲡⲟⲟⲩⲛϩⲟⲟⲩ
ⲡⲟⲟⲩ	ADV	ⲡⲟⲟⲩ
ⲡⲟⲟⲩ	N	ⲡⲟⲟⲩ
ⲡⲟⲣϣ	VSTAT	ⲡⲱⲣϣ
ⲡⲟⲣϫ	V	ⲡⲱⲣϫ
ⲡⲟⲣϫ	VSTAT	ⲡⲱⲣϫ
ⲡⲟⲣⲕⲉ	V	ⲡⲱⲣⲕ
ⲡⲟⲣⲕ	V	ⲡⲱⲣⲕ
ⲡⲟⲣⲛⲉⲓⲁ	N	ⲡⲟⲣⲛⲉⲓⲁ
ⲡⲟⲣⲛⲉⲩⲉ	V	ⲡⲟⲣⲛⲉⲩⲉ
ⲡⲟⲣⲛⲏ	N	ⲡⲟⲣⲛⲏ
ⲡⲟⲣⲛⲓⲁ	N	ⲡⲟⲣⲛⲓⲁ
ⲡⲟⲣⲛⲓⲕⲟⲛ	N	ⲡⲟⲣⲛⲓⲕⲟⲛ
ⲡⲟⲣⲛⲓⲟⲛ	N	ⲡⲟⲣⲛⲓⲟⲛ
ⲡⲟⲣⲛⲟⲕⲟⲡⲟⲥ	N	ⲡⲟⲣⲛⲟⲕⲟⲡⲟⲥ
ⲡⲟⲣⲛⲟⲥ	N	ⲡⲟⲣⲛⲟⲥ
ⲡⲟⲣⲫⲉⲣⲓⲟⲥ	NPROP	ⲡⲟⲣⲫⲉⲣⲓⲟⲥ
ⲡⲟⲣⲫⲏⲣⲁ	N	ⲡⲟⲣⲫⲏⲣⲁ
ⲡⲟⲣⲫⲏⲣⲓⲟⲥ	NPROP	ⲡⲟⲣⲫⲏⲣⲓⲟⲥ
ⲡⲟⲣⲫⲓⲣⲁ	N	ⲡⲟⲣⲫⲓⲣⲁ
ⲡⲟⲣⲫⲓⲣⲓⲟⲥ	NPROP	ⲡⲟⲣⲫⲓⲣⲓⲟⲥ
ⲡⲟⲣⲫⲩⲣⲁ	N	ⲡⲟⲣⲫⲩⲣⲁ
ⲡⲟⲣⲫⲩⲣⲓⲟⲥ	NPROP	ⲡⲟⲣⲫⲩⲣⲓⲟⲥ
ⲡⲟⲣⲭⲏⲣⲓⲁ	NPROP	ⲡⲟⲣⲭⲏⲣⲓⲁ
ⲡⲟⲥⲉ	VSTAT	ⲡⲓⲥⲉ
ⲡⲟⲥⲓⲇⲱⲛ	N	ⲡⲟⲥⲓⲇⲱⲛ
ⲡⲟⲥⲟⲙⲁⲗⲗⲟⲛ	ADV	ⲡⲟⲥⲟⲙⲁⲗⲗⲟⲛ
ⲡⲟⲥⲱ	ADV	ⲡⲟⲥⲱ
ⲡⲟⲧⲁⲕⲓⲟⲛ	N	ⲡⲟⲧⲁⲕⲓⲟⲛ
ⲡⲟⲧⲏⲣⲓⲟⲛ	N	ⲡⲟⲧⲏⲣⲓⲟⲛ
ⲡⲟⲩⲁⲇⲉⲡⲟⲩⲁ	N	ⲡⲟⲩⲁⲇⲉⲡⲟⲩⲁ
ⲡⲟⲩⲁⲡⲟⲩⲁ	N	ⲡⲟⲩⲁⲡⲟⲩⲁ
ⲡⲟⲩ	PPOS	ⲡⲟⲩ
ⲡⲣ̣ⲟⲧⲣⲟⲡⲏ	N	ⲡⲣ̣ⲟⲧⲣⲟⲡⲏ
ⲡⲣϣ	V	ⲡⲱⲣϣ
ⲡⲣϫ	V	ⲡⲱⲣϫ
ⲡⲣϭⲟⲩϣ	NPROP	ⲡⲣϭⲟⲩϣ
ⲡⲣⲁⲅⲇⲟⲥ	N	ⲡⲣⲁⲅⲇⲟⲥ
ⲡⲣⲁⲅⲙⲁⲧⲉⲩⲉⲥⲑⲁⲓ	V	ⲡⲣⲁⲅⲙⲁⲧⲉⲩⲉⲥⲑⲁⲓ
ⲡⲣⲁⲅⲙⲁⲧⲉⲩⲧⲏⲥ	N	ⲡⲣⲁⲅⲙⲁⲧⲉⲩⲧⲏⲥ
ⲡⲣⲁⲅⲙⲁⲧⲓⲁ	N	ⲡⲣⲁⲅⲙⲁⲧⲓⲁ
ⲡⲣⲁⲅⲙⲁ	N	ⲡⲣⲁⲅⲙⲁ
ⲡⲣⲁⲅⲧⲟⲥ	N	ⲡⲣⲁⲅⲧⲟⲥ
ⲡⲣⲁⲓⲧⲁⲛⲓⲁ	N	ⲡⲣⲁⲓⲧⲁⲛⲓⲁ
ⲡⲣⲁⲓⲧⲁ	V	ⲡⲣⲁⲓⲧⲁ
ⲡⲣⲁⲓⲧⲱⲣⲓⲟⲛ	N	ⲡⲣⲁⲓⲧⲱⲣⲓⲟⲛ
ⲡⲣⲁⲕⲇⲟⲥ	N	ⲡⲣⲁⲕⲇⲟⲥ
ⲡⲣⲁⲕⲧⲓⲕⲟⲛ	N	ⲡⲣⲁⲕⲧⲓⲕⲟⲛ
ⲡⲣⲁⲕⲧⲟⲥ	N	ⲡⲣⲁⲕⲧⲟⲥ
ⲡⲣⲁⲝⲓⲥ	N	ⲡⲣⲁⲝⲓⲥ
ⲡⲣⲁⲥⲓⲥ	N	ⲡⲣⲁⲥⲓⲥ
ⲡⲣⲁⲥⲥⲁ	V	ⲡⲣⲁⲥⲥⲁ
ⲡⲣⲁⲥⲥⲉ	V	ⲡⲣⲁⲥⲥⲉ
ⲡⲣⲁⲧⲧⲉⲥⲑⲁⲓ	V	ⲡⲣⲁⲧⲧⲉⲥⲑⲁⲓ
ⲡⲣⲁⲧⲧⲉⲩⲑⲁⲓ	V	ⲡⲣⲁⲧⲧⲉⲩⲑⲁⲓ
ⲡⲣⲉⲓⲱⲟⲩ	VSTAT	ⲡⲉⲓⲣⲉ
ⲡⲣⲉⲡⲉⲓ	V	ⲡⲣⲉⲡⲉⲓ
ⲡⲣⲉⲡⲟⲥⲓⲧⲟⲥ	N	ⲡⲣⲉⲡⲟⲥⲓⲧⲟⲥ
ⲡⲣⲉⲥⲃⲉⲓⲁ	N	ⲡⲣⲉⲥⲃⲉⲓⲁ
ⲡⲣⲉⲥⲃⲉⲩⲉ	V	ⲡⲣⲉⲥⲃⲉⲩⲉ
ⲡⲣⲉⲥⲃⲉⲩⲧⲏⲥ	N	ⲡⲣⲉⲥⲃⲉⲩⲧⲏⲥ
ⲡⲣⲉⲥⲃⲩⲧⲉⲣⲟⲥ	N	ⲡⲣⲉⲥⲃⲩⲧⲉⲣⲟⲥ
ⲡⲣⲉⲥⲃⲩⲧⲏⲣⲟⲥ	N	ⲡⲣⲉⲥⲃⲩⲧⲏⲣⲟⲥ
ⲡⲣⲏϣ	N	ⲡⲱⲣϣ
ⲡⲣⲟϩⲁⲓⲣⲉⲥⲓⲥ	N	ⲡⲣⲟϩⲁⲓⲣⲉⲥⲓⲥ
ⲡⲣⲟϩⲁⲓⲣⲏⲥⲓⲥ	N	ⲡⲣⲟϩⲁⲓⲣⲏⲥⲓⲥ
ⲡⲣⲟϩⲉⲣⲉⲥⲓⲥ	N	ⲡⲣⲟϩⲉⲣⲉⲥⲓⲥ
ⲡⲣⲟϩⲉⲣⲏⲥⲓⲥ	N	ⲡⲣⲟϩⲉⲣⲏⲥⲓⲥ
ⲡⲣⲟϩⲓⲥⲧⲁ	V	ⲡⲣⲟϩⲓⲥⲧⲁ
ⲡⲣⲟϩⲟⲓⲙⲓⲟⲛ	N	ⲡⲣⲟϩⲟⲓⲙⲓⲟⲛ
ⲡⲣⲟⲁⲓⲥⲧⲓⲟⲛ	N	ⲡⲣⲟⲁⲓⲥⲧⲓⲟⲛ
ⲡⲣⲟⲃⲁⲗⲉ	V	ⲡⲣⲟⲃⲁⲗⲉ
ⲡⲣⲟⲃⲁⲧⲓⲕⲏ	N	ⲡⲣⲟⲃⲁⲧⲓⲕⲏ
ⲡⲣⲟⲃⲗⲏⲙⲁ	N	ⲡⲣⲟⲃⲗⲏⲙⲁ
ⲡⲣⲟⲅⲉⲛⲏⲧⲱⲣ	N	ⲡⲣⲟⲅⲉⲛⲏⲧⲱⲣ
ⲡⲣⲟⲅⲛⲱⲥⲓⲥ	N	ⲡⲣⲟⲅⲛⲱⲥⲓⲥ
ⲡⲣⲟⲅⲛⲱⲥⲧⲏⲥ	N	ⲡⲣⲟⲅⲛⲱⲥⲧⲏⲥ
ⲡⲣⲟⲇⲓⲇⲟⲩ	V	ⲡⲣⲟⲇⲓⲇⲟⲩ
ⲡⲣⲟⲇⲟⲇⲓ̈ⲁⲕⲟⲛⲟⲥ	N	ⲡⲣⲟⲇⲟⲇⲓ̈ⲁⲕⲟⲛⲟⲥ
ⲡⲣⲟⲇⲟⲥⲓⲁ	N	ⲡⲣⲟⲇⲟⲥⲓⲁ
ⲡⲣⲟⲇⲟⲧⲏⲥ	N	ⲡⲣⲟⲇⲟⲧⲏⲥ
ⲡⲣⲟⲇⲣⲟⲙⲟⲥ	N	ⲡⲣⲟⲇⲣⲟⲙⲟⲥ
ⲡⲣⲟⲉⲗⲑⲉ	V	ⲡⲣⲟⲉⲗⲑⲉ
ⲡⲣⲟⲉⲥⲧⲱⲥ	N	ⲡⲣⲟⲉⲥⲧⲱⲥ
ⲡⲣⲟⲏⲗⲑⲉ	V	ⲡⲣⲟⲏⲗⲑⲉ
ⲡⲣⲟⲑⲉⲙⲓⲁ	N	ⲡⲣⲟⲑⲉⲙⲓⲁ
ⲡⲣⲟⲑⲉⲥⲓⲛ	N	ⲡⲣⲟⲑⲉⲥⲓⲛ
ⲡⲣⲟⲑⲉⲥⲓⲥ	N	ⲡⲣⲟⲑⲉⲥⲓⲥ
ⲡⲣⲟⲑⲉⲥⲙⲓⲁ	N	ⲡⲣⲟⲑⲉⲥⲙⲓⲁ
ⲡⲣⲟⲑⲩⲙⲓⲁ	N	ⲡⲣⲟⲑⲩⲙⲓⲁ
ⲡⲣⲟⲑⲩⲙⲟⲥ	N	ⲡⲣⲟⲑⲩⲙⲟⲥ
ⲡⲣⲟⲕⲓⲙⲉⲛⲟⲛ	N	ⲡⲣⲟⲕⲓⲙⲉⲛⲟⲛ
ⲡⲣⲟⲕⲟⲡⲏ	N	ⲡⲣⲟⲕⲟⲡⲏ
ⲡⲣⲟⲕⲟⲡⲧⲉⲓ	V	ⲡⲣⲟⲕⲟⲡⲧⲉⲓ
ⲡⲣⲟⲕⲟⲡⲧⲉ	V	ⲡⲣⲟⲕⲟⲡⲧⲉ
ⲡⲣⲟⲕⲣⲓⲙⲁⲧⲓⲍⲉ	V	ⲡⲣⲟⲕⲣⲓⲙⲁⲧⲓⲍⲉ
ⲡⲣⲟⲛⲓⲁ	N	ⲡⲣⲟⲛⲓⲁ
ⲡⲣⲟⲛⲓⲕⲟⲥ	N	ⲡⲣⲟⲛⲓⲕⲟⲥ
ⲡⲣⲟⲛⲟⲏⲧⲏⲥ	N	ⲡⲣⲟⲛⲟⲏⲧⲏⲥ
ⲡⲣⲟⲛⲟⲏⲧⲟⲥ	N	ⲡⲣⲟⲛⲟⲏⲧⲟⲥ
ⲡⲣⲟⲛⲟⲓⲁ	N	ⲡⲣⲟⲛⲟⲓⲁ
ⲡⲣⲟⲡⲁⲧⲱⲣ	N	ⲡⲣⲟⲡⲁⲧⲱⲣ
ⲡⲣⲟⲡⲉⲧⲏⲥ	N	ⲡⲣⲟⲡⲉⲧⲏⲥ
ⲡⲣⲟⲥⲁⲃⲃⲁⲧⲟⲛ	N	ⲡⲣⲟⲥⲁⲃⲃⲁⲧⲟⲛ
ⲡⲣⲟⲥⲇⲟⲕⲁ	V	ⲡⲣⲟⲥⲇⲟⲕⲁ
ⲡⲣⲟⲥⲇⲟⲕⲉⲓ	V	ⲡⲣⲟⲥⲇⲟⲕⲉⲓ
ⲡⲣⲟⲥⲇⲟⲕⲓⲁ	N	ⲡⲣⲟⲥⲇⲟⲕⲓⲁ
ⲡⲣⲟⲥⲉⲗⲉⲩⲥⲓⲥ	N	ⲡⲣⲟⲥⲉⲗⲉⲩⲥⲓⲥ
ⲡⲣⲟⲥⲉⲗⲑⲉ	V	ⲡⲣⲟⲥⲉⲗⲑⲉ
ⲡⲣⲟⲥⲉⲩⲭⲉ	V	ⲡⲣⲟⲥⲉⲩⲭⲉ
ⲡⲣⲟⲥⲉⲩⲭⲏ	N	ⲡⲣⲟⲥⲉⲩⲭⲏ
ⲡⲣⲟⲥⲉⲭⲉ	V	ⲡⲣⲟⲥⲉⲭⲉ
ⲡⲣⲟⲥⲏⲗⲩⲧⲟⲥ	N	ⲡⲣⲟⲥⲏⲗⲩⲧⲟⲥ
ⲡⲣⲟⲥⲑⲉⲙⲁ	N	ⲡⲣⲟⲥⲑⲉⲙⲁ
ⲡⲣⲟⲥⲑⲏⲣⲟⲥ	N	ⲡⲣⲟⲥⲑⲏⲣⲟⲥ
ⲡⲣⲟⲥⲕⲁⲣⲧⲉⲣⲉⲓ	V	ⲡⲣⲟⲥⲕⲁⲣⲧⲉⲣⲉⲓ
ⲡⲣⲟⲥⲕⲁⲣⲧⲏⲣⲉⲓ	V	ⲡⲣⲟⲥⲕⲁⲣⲧⲏⲣⲉⲓ
ⲡⲣⲟⲥⲕⲁⲣⲧⲏⲣⲉ	V	ⲡⲣⲟⲥⲕⲁⲣⲧⲏⲣⲉ
ⲡⲣⲟⲥⲕⲁⲣⲧⲩⲣⲉ	V	ⲡⲣⲟⲥⲕⲁⲣⲧⲩⲣⲉ
ⲡⲣⲟⲥⲕⲩⲛⲉⲓ	V	ⲡⲣⲟⲥⲕⲩⲛⲉⲓ
ⲡⲣⲟⲥⲕⲩⲛⲏⲥⲓⲥ	N	ⲡⲣⲟⲥⲕⲩⲛⲏⲥⲓⲥ
ⲡⲣⲟⲥⲕ/	N	ⲡⲣⲟⲥⲕ/
ⲡⲣⲟⲥⲟⲇⲟⲥ	N	ⲡⲣⲟⲥⲟⲇⲟⲥ
ⲡⲣⲟⲥⲟⲡⲟⲛ	N	ⲡⲣⲟⲥⲟⲡⲟⲛ
ⲡⲣⲟⲥⲟⲩⲕⲟⲩⲓ	ADV	ⲡⲣⲟⲥⲟⲩⲕⲟⲩⲓ
ⲡⲣⲟⲥⲟⲩⲟⲉⲓϣ	NPROP	ⲡⲣⲟⲥⲟⲩⲟⲉⲓϣ
ⲡⲣⲟⲥⲟⲩⲟⲩⲛⲟⲩ	ADV	ⲡⲣⲟⲥⲟⲩⲟⲩⲛⲟⲩ
ⲡⲣⲟⲥⲟⲩⲟⲩⲟⲉⲓϣ	ADV	ⲡⲣⲟⲥⲟⲩⲟⲩⲟⲉⲓϣ
ⲡⲣⲟⲥⲟⲩⲟⲩⲟⲓϣ	ADV	ⲡⲣⲟⲥⲟⲩⲟⲩⲟⲓϣ
ⲡⲣⲟⲥⲧⲁⲅⲙⲁ	N	ⲡⲣⲟⲥⲧⲁⲅⲙⲁ
ⲡⲣⲟⲥⲧⲁⲥⲓⲁ	N	ⲡⲣⲟⲥⲧⲁⲥⲓⲁ
ⲡⲣⲟⲥⲧⲁⲧⲏⲥ	N	ⲡⲣⲟⲥⲧⲁⲧⲏⲥ
ⲡⲣⲟⲥⲧⲓⲙⲟⲛ	N	ⲡⲣⲟⲥⲧⲓⲙⲟⲛ
ⲡⲣⲟⲥⲫⲉⲣⲉⲓ	V	ⲡⲣⲟⲥⲫⲉⲣⲉⲓ
ⲡⲣⲟⲥⲫⲟⲣⲁ	N	ⲡⲣⲟⲥⲫⲟⲣⲁ
ⲡⲣⲟⲥⲫⲱⲛⲉⲓ	V	ⲡⲣⲟⲥⲫⲱⲛⲉⲓ
ⲡⲣⲟⲥⲫⲱⲣⲁ	N	ⲡⲣⲟⲥⲫⲱⲣⲁ
ⲡⲣⲟⲥⲱⲡⲟⲛ	N	ⲡⲣⲟⲥⲱⲡⲟⲛ
ⲡⲣⲟⲥ	PREP	ⲡⲣⲟⲥ
ⲡⲣⲟⲧⲉⲕⲧⲱⲣ	N	ⲡⲣⲟⲧⲉⲕⲧⲱⲣ
ⲡⲣⲟⲧⲉⲣⲓⲟⲥ	NPROP	ⲡⲣⲟⲧⲉⲣⲓⲟⲥ
ⲡⲣⲟⲧⲟⲅⲉⲛⲏⲧⲟⲥ	N	ⲡⲣⲟⲧⲟⲅⲉⲛⲏⲧⲟⲥ
ⲡⲣⲟⲧⲟⲅⲉⲛⲛⲏⲧⲱⲣ	N	ⲡⲣⲟⲧⲟⲅⲉⲛⲛⲏⲧⲱⲣ
ⲡⲣⲟⲧⲟⲡⲗⲁⲥⲙⲁ	N	ⲡⲣⲟⲧⲟⲡⲗⲁⲥⲙⲁ
ⲡⲣⲟⲧⲟⲡⲟⲗⲓⲧⲏⲥ	N	ⲡⲣⲟⲧⲟⲡⲟⲗⲓⲧⲏⲥ
ⲡⲣⲟⲧⲟⲫⲓⲗⲟⲥ	N	ⲡⲣⲟⲧⲟⲫⲓⲗⲟⲥ
ⲡⲣⲟⲧⲣⲉⲡⲉ	V	ⲡⲣⲟⲧⲣⲉⲡⲉ
ⲡⲣⲟⲧⲣⲉⲡⲧⲓⲕⲟⲛ	N	ⲡⲣⲟⲧⲣⲉⲡⲧⲓⲕⲟⲛ
ⲡⲣⲟⲧⲣⲟⲡⲏ	N	ⲡⲣⲟⲧⲣⲟⲡⲏ
ⲡⲣⲟⲫⲁⲥⲓⲥ	N	ⲡⲣⲟⲫⲁⲥⲓⲥ
ⲡⲣⲟⲫⲉⲧⲉⲩⲉ	V	ⲡⲣⲟⲫⲉⲧⲉⲩⲉ
ⲡⲣⲟⲫⲏⲧⲉⲓⲁ	N	ⲡⲣⲟⲫⲏⲧⲉⲓⲁ
ⲡⲣⲟⲫⲏⲧⲉⲩⲉ	V	ⲡⲣⲟⲫⲏⲧⲉⲩⲉ
ⲡⲣⲟⲫⲏⲧⲏⲥ	N	ⲡⲣⲟⲫⲏⲧⲏⲥ
ⲡⲣⲟⲫⲏⲧⲓⲁ	N	ⲡⲣⲟⲫⲏⲧⲓⲁ
ⲡⲣⲟⲫⲏⲧⲓⲕⲟⲛ	N	ⲡⲣⲟⲫⲏⲧⲓⲕⲟⲛ
ⲡⲣⲟⲱⲛⲧⲟⲥ	N	ⲡⲣⲟⲱⲛⲧⲟⲥ
ⲡⲣⲱⲧⲁⲣⲭⲱⲛ	N	ⲡⲣⲱⲧⲁⲣⲭⲱⲛ
ⲡⲣⲱⲧⲉⲛⲛⲟⲓⲁ	N	ⲡⲣⲱⲧⲉⲛⲛⲟⲓⲁ
ⲡⲣⲱⲧⲏ	N	ⲡⲣⲱⲧⲏ
ⲡⲣⲱⲧⲓⲁ	N	ⲡⲣⲱⲧⲓⲁ
ⲡⲣⲱⲧⲟⲕⲟⲓⲙⲏⲗⲓⲁⲣⲭⲏⲥ	N	ⲡⲣⲱⲧⲟⲕⲟⲓⲙⲏⲗⲓⲁⲣⲭⲏⲥ
ⲡⲣⲱⲧⲟⲛ	ADV	ⲡⲣⲱⲧⲟⲛ
ⲡⲣⲱⲧⲟⲧⲩⲡⲱⲥ	ADV	ⲡⲣⲱⲧⲟⲧⲩⲡⲱⲥ
ⲡⲣⲱⲧⲟⲫⲁⲛⲏⲥ	N	ⲡⲣⲱⲧⲟⲫⲁⲛⲏⲥ
ⲡⲣⲱ	N	ⲡⲣⲱ
ⲡⲥⲟⲓ	NPROP	ⲡⲥⲟⲓ
ⲡⲧⲁⲉⲓⲟ	V	ⲡⲧⲁⲉⲓⲟ
ⲡⲧⲱⲙⲁ	N	ⲡⲧⲱⲙⲁ
ⲡⲧ	V	ⲡⲧ
ⲡⲩⲑⲁⲅⲟⲣⲁⲥ	NPROP	ⲡⲩⲑⲁⲅⲟⲣⲁⲥ
ⲡⲩⲑⲁⲅⲟⲣⲁ	NPROP	ⲡⲩⲑⲁⲅⲟⲣⲁ
ⲡⲩⲕⲧⲉⲩⲉ	V	ⲡⲩⲕⲧⲉⲩⲉ
ⲡⲩⲗⲏ	N	ⲡⲩⲗⲏ
ⲡⲩⲗⲱⲛ	N	ⲡⲩⲗⲱⲛ
ⲡⲩⲝⲓⲟⲛ	N	ⲡⲩⲝⲓⲟⲛ
ⲡⲩⲣⲁ	N	ⲡⲩⲣⲁ
ⲡⲩⲣⲅⲟⲥ	N	ⲡⲩⲣⲅⲟⲥ
ⲡⲩⲣⲟⲩ	V	ⲡⲩⲣⲟⲩ
ⲡⲱϣⲛ	V	ⲡⲱϣⲛ
ⲡⲱϣⲥ	V	ⲡⲱϣⲥ
ⲡⲱϣ	V	ⲡⲱϣ
ⲡⲱϩⲥ	V	ⲡⲱϩⲥ
ⲡⲱϩⲧ	V	ⲡⲱϩⲧ
ⲡⲱϩ	V	ⲡⲱϩ
ⲡⲱϭⲉ	V	ⲡⲱϭⲉ
ⲡⲱⲗϩ	V	ⲡⲱⲗϩ
ⲡⲱⲗϭ	V	ⲡⲱⲗϭ
ⲡⲱⲗⲁϩ	N	ⲡⲱⲗⲁϩ
ⲡⲱⲛⲅ	V	ⲡⲱⲛⲅ
ⲡⲱⲛⲕ	V	ⲡⲱⲛⲕ
ⲡⲱⲛⲩⲣⲓⲁ	N	ⲡⲱⲛⲩⲣⲓⲁ
ⲡⲱⲛ	V	ⲡⲱⲛ
ⲡⲱⲣϣ	V	ⲡⲱⲣϣ
ⲡⲱⲣϫ	N	ⲡⲱⲣϫ
ⲡⲱⲣϫ	V	ⲡⲱⲣϫ
ⲡⲱⲣⲕ	V	ⲡⲱⲣⲕ
ⲡⲱⲥ	ADV	ⲡⲱⲥ
ⲡⲱⲥ	PINT	ⲡⲱⲥ
ⲡⲱⲧⲏⲣⲓⲟⲛ	N	ⲡⲱⲧⲏⲣⲓⲟⲛ
ⲡⲱⲧⲛ	PPOS	ⲡⲱⲧⲛ
ⲡⲱⲧⲥ	V	ⲡⲱⲧⲥ
ⲡⲱⲧ	V	ⲡⲱⲧ
ⲡⲱⲱⲛⲉ	N	ⲡⲱⲱⲛⲉ
ⲡⲱⲱⲛⲉ	V	ⲡⲱⲱⲛⲉ
ⲡⲱⲱⲡⲉ	V	ⲡⲱⲱⲡⲉ
ⲡⲱⲱⲣⲉ	V	ⲡⲱⲱⲣⲉ
ⲡ	ART	ⲡ
ⲡ	N	ⲡ
ⲣϣϥⲉ	V	ⲣϣϥⲉ
ⲣϣⲁⲩ	V	ⲣϣⲁⲩ
ⲣϣⲁ	V	ⲣϣⲁ
ⲣϣⲙⲙⲟ	V	ⲣϣⲙⲙⲟ
ⲣϣⲟⲣⲡ	V	ⲣϣⲟⲣⲡ
ⲣϣⲡⲏⲣⲉ	V	ⲣϣⲡⲏⲣⲉ
ⲣϣⲣⲡ	V	ⲣϣⲣⲡ
ⲣϣⲱⲛ	N	ⲣϣⲱⲛ
ⲣϥⲛⲧ	V	ⲣϥⲛⲧ
ⲣϩⲁϩ	V	ⲣϩⲁϩ
ⲣϩⲁⲗ	V	ⲣϩⲁⲗ
ⲣϩⲃⲁ	V	ⲣϩⲃⲁ
ⲣϩⲃⲃⲉ	V	ⲣϩⲃⲃⲉ
ⲣϩⲉⲗⲡⲓⲍⲉ	V	ⲣϩⲉⲗⲡⲓⲍⲉ
ⲣϩⲉⲙⲉⲣⲟⲥ	N	ⲣϩⲉⲙⲉⲣⲟⲥ
ⲣϩⲉ	V	ⲣϩⲉ
ⲣϩⲏⲃⲉ	V	ⲣϩⲏⲃⲉ
ⲣϩⲗⲗⲟ	V	ⲣϩⲗⲗⲟ
ⲣϩⲙⲉ	V	ⲣϩⲙⲉ
ⲣϩⲙⲙⲉ	N	ⲣϩⲙⲙⲉ
ⲣϩⲙⲙⲉ	V	ⲣϩⲙⲙⲉ
ⲣϩⲟⲧⲉ	V	ⲣϩⲟⲧⲉ
ⲣϩⲟⲩⲟ	V	ⲣϩⲟⲩⲟ
ⲣϩⲱⲃ	N	ⲣϩⲱⲃ
ⲣϩⲱⲃ	V	ⲣϩⲱⲃ
ⲣϫⲟⲉⲓⲥ	V	ⲣϫⲟⲉⲓⲥ
ⲣϫⲟⲓⲥ	V	ⲣϫⲟⲓⲥ
ⲣϫⲟⲗⲉⲥ	V	ⲣϫⲟⲗⲉⲥ
ⲣϫⲟⲟⲗⲉⲥ	V	ⲣϫⲟⲟⲗⲉⲥ
ⲣϫⲟⲩⲱⲧ	V	ⲣϫⲟⲩⲱⲧ
ⲣϭⲟⲙ	V	ⲣϭⲟⲙ
ⲣϭⲣⲱϩ	V	ⲣϭⲣⲱϩ
ⲣⲁϣⲉ	N	ⲣⲁϣⲉ
ⲣⲁϣⲉ	V	ⲣⲁϣⲉ
ⲣⲁϩⲧ	N	ⲣⲁϩⲧ
ⲣⲁϩⲧ	V	ⲣⲱϩⲧ
ⲣⲁϩⲧ	VSTAT	ⲣⲱϩⲧ
ⲣⲁⲇⲓⲕⲓⲁ	V	ⲣⲁⲇⲓⲕⲓⲁ
ⲣⲁⲕⲟⲧⲉ	NPROP	ⲣⲁⲕⲟⲧⲉ
ⲣⲁⲕⲧⲟⲩ	V	ⲣⲁⲕⲧⲟⲩ
ⲣⲁⲛⲁϣ	V	ⲣⲁⲛⲁϣ
ⲣⲁⲛⲁⲡⲁⲩⲉⲥⲑⲁⲓ	V	ⲣⲁⲛⲁⲡⲁⲩⲉⲥⲑⲁⲓ
ⲣⲁⲛⲁⲭⲱⲣⲉⲓ	V	ⲣⲁⲛⲁⲭⲱⲣⲉⲓ
ⲣⲁⲛⲁ	V	ⲁⲛⲁⲓ
ⲣⲁⲛⲟⲩⲥⲓⲟⲥ	N	ⲣⲁⲛⲟⲩⲥⲓⲟⲥ
ⲣⲁⲛ	N	ⲣⲁⲛ
ⲣⲁⲝⲓⲟⲥ	N	ⲣⲁⲝⲓⲟⲥ
ⲣⲁⲡⲁⲅⲅⲉⲗⲓⲛ	V	ⲣⲁⲡⲁⲅⲅⲉⲗⲓⲛ
ⲣⲁⲡⲁⲧⲟⲟⲧ	V	ⲣⲁⲡⲁⲧⲟⲟⲧ
ⲣⲁⲡⲉ	V	ⲣⲁⲡⲉ
ⲣⲁⲡⲓⲥⲧⲟⲥ	N	ⲣⲁⲡⲓⲥⲧⲟⲥ
ⲣⲁⲡⲟⲕⲣⲓⲥⲓⲥ	V	ⲣⲁⲡⲟⲕⲣⲓⲥⲓⲥ
ⲣⲁⲡⲟⲥⲧⲟⲗⲟⲥ	V	ⲣⲁⲡⲟⲥⲧⲟⲗⲟⲥ
ⲣⲁⲣⲅⲟⲛ	N	ⲣⲁⲣⲅⲟⲛ
ⲣⲁⲣⲓⲥⲧⲟⲛ	V	ⲣⲁⲣⲓⲥⲧⲟⲛ
ⲣⲁⲣⲭⲏⲅⲟⲥ	V	ⲣⲁⲣⲭⲏⲅⲟⲥ
ⲣⲁⲣⲭⲏ	V	ⲣⲁⲣⲭⲏ
ⲣⲁⲥⲉⲃⲏⲥ	N	ⲣⲁⲥⲉⲃⲏⲥ
ⲣⲁⲥⲟⲩ	N	ⲣⲁⲥⲟⲩ
ⲣⲁⲥⲧⲉ	N	ⲣⲁⲥⲧⲉ
ⲣⲁⲧϣⲁⲩ	V	ⲣⲁⲧϣⲁⲩ
ⲣⲁⲧⲛⲁϩⲧⲉ	V	ⲣⲁⲧⲛⲁϩⲧⲉ
ⲣⲁⲧⲟⲟⲧ	V	ⲣⲁⲧⲟⲟⲧ
ⲣⲁⲧⲥⲟⲟⲩⲛ	V	ⲣⲁⲧⲥⲟⲟⲩⲛ
ⲣⲁⲧⲥⲱⲧⲙ	V	ⲣⲁⲧⲥⲱⲧⲙ
ⲣⲁⲧ	N	ⲣⲁⲧ
ⲣⲁⲧ	PREP	ⲣⲁⲧ
ⲣⲃⲟⲏⲑⲓⲁ	V	ⲣⲃⲟⲏⲑⲓⲁ
ⲣⲃⲟⲟⲛⲉ	V	ⲣⲃⲟⲟⲛⲉ
ⲣⲉϣⲧ	V	ⲣⲱϣⲧ
ⲣⲉϥϣⲁϫⲉ	N	ⲣⲉϥϣⲁϫⲉ
ⲣⲉϥϣⲉⲙϣⲉⲉⲓⲇⲟⲗⲟⲛ	N	ⲣⲉϥϣⲉⲙϣⲉⲉⲓⲇⲟⲗⲟⲛ
ⲣⲉϥϣⲉⲙϣⲉⲛⲟⲩⲧⲉ	N	ⲣⲉϥϣⲉⲙϣⲉⲛⲟⲩⲧⲉ
ⲣⲉϥϣⲙϣⲉⲉⲓⲇⲱⲗⲟⲛ	N	ⲣⲉϥϣⲙϣⲉⲉⲓⲇⲱⲗⲟⲛ
ⲣⲉϥϣⲙϣⲉⲛⲟⲩⲧⲉ	N	ⲣⲉϥϣⲙϣⲉⲛⲟⲩⲧⲉ
ⲣⲉϥϣⲙϣⲉ	N	ⲣⲉϥϣⲙϣⲉ
ⲣⲉϥϣⲟⲟⲣ	N	ⲣⲉϥϣⲟⲟⲣ
ⲣⲉϥϣⲡϩⲓⲥⲉ	N	ⲣⲉϥϣⲡϩⲓⲥⲉ
ⲣⲉϥϣⲱⲛⲉ	N	ⲣⲉϥϣⲱⲛⲉ
ⲣⲉϥϣⲱⲥ	N	ⲣⲉϥϣⲱⲥ
ⲣⲉϥϩⲉⲧⲃⲛⲟⲩⲧⲉ	N	ⲣⲉϥϩⲉⲧⲃⲛⲟⲩⲧⲉ
ⲣⲉϥϩⲉⲧⲃⲣⲱⲙⲉ	N	ⲣⲉϥϩⲉⲧⲃⲣⲱⲙⲉ
ⲣⲉϥϩⲉⲧⲃⲯⲩⲭⲏ	N	ⲣⲉϥϩⲉⲧⲃⲯⲩⲭⲏ
ⲣⲉϥϩⲩⲡⲟⲙⲓⲛⲉ	N	ⲣⲉϥϩⲩⲡⲟⲙⲓⲛⲉ
ⲣⲉϥϩⲱϥⲧ	N	ⲣⲉϥϩⲱϥⲧ
ⲣⲉϥϩⲱⲧⲃ	N	ⲣⲉϥϩⲱⲧⲃ
ⲣⲉϥϫⲉϭⲟⲗ	N	ⲣⲉϥϫⲉϭⲟⲗ
ⲣⲉϥϫⲉϭⲥⲟⲣⲧ	N	ⲣⲉϥϫⲉϭⲥⲟⲣⲧ
ⲣⲉϥϫⲓϣⲟϫⲛⲉ	N	ⲣⲉϥϫⲓϣⲟϫⲛⲉ
ⲣⲉϥϫⲓϭⲟⲗ	N	ⲣⲉϥϫⲓϭⲟⲗ
ⲣⲉϥϫⲓⲛϭⲟⲛⲉⲥ	N	ⲣⲉϥϫⲓⲛϭⲟⲛⲉⲥ
ⲣⲉϥϫⲓⲛϭⲟⲛⲥ	N	ⲣⲉϥϫⲓⲛϭⲟⲛⲥ
ⲣⲉϥϫⲓⲟⲩⲉ	N	ⲣⲉϥϫⲓⲟⲩⲉ
ⲣⲉϥϫⲓ	N	ⲣⲉϥϫⲓ
ⲣⲉϥϫⲣⲟ	N	ⲣⲉϥϫⲣⲟ
ⲣⲉϥϭⲉⲡⲣⲱⲙⲉ	N	ⲣⲉϥϭⲉⲡⲣⲱⲙⲉ
ⲣⲉϥϯϩⲁⲡ	N	ⲣⲉϥϯϩⲁⲡ
ⲣⲉϥϯϩⲉ	N	ⲣⲉϥϯϩⲉ
ⲣⲉϥϯⲉⲱⲛ	N	ⲣⲉϥϯⲉⲱⲛ
ⲣⲉϥϯⲙⲛⲧⲛⲁ	N	ⲣⲉϥϯⲙⲛⲧⲛⲁ
ⲣⲉϥϯⲣⲁⲥⲟⲩ	N	ⲣⲉϥϯⲣⲁⲥⲟⲩ
ⲣⲉϥϯⲥⲃⲱ	N	ⲣⲉϥϯⲥⲃⲱ
ⲣⲉϥϯ	N	ⲣⲉϥϯ
ⲣⲉϥⲁⲅⲱⲛⲓⲍⲉ	N	ⲣⲉϥⲁⲅⲱⲛⲓⲍⲉ
ⲣⲉϥⲁⲣⲉⲥⲕⲉ	N	ⲣⲉϥⲁⲣⲉⲥⲕⲉ
ⲣⲉϥⲇⲓⲁⲕⲟⲛⲉⲓ	N	ⲣⲉϥⲇⲓⲁⲕⲟⲛⲉⲓ
ⲣⲉϥⲇⲓⲁⲕⲣⲓⲛⲉ	N	ⲣⲉϥⲇⲓⲁⲕⲣⲓⲛⲉ
ⲣⲉϥⲇⲓⲓⲙⲙⲁⲣ	N	ⲣⲉϥⲇⲓⲓⲙⲙⲁⲣ
ⲣⲉϥⲉⲓⲣⲉ	N	ⲣⲉϥⲉⲓⲣⲉ
ⲣⲉϥⲉⲡⲓⲑⲩⲙⲉⲓ	N	ⲣⲉϥⲉⲡⲓⲑⲩⲙⲉⲓ
ⲣⲉϥⲉⲣϩⲟⲧⲉ	N	ⲣⲉϥⲉⲣϩⲟⲧⲉ
ⲣⲉϥⲉⲣⲙⲉⲗⲉⲧⲁ	N	ⲣⲉϥⲉⲣⲙⲉⲗⲉⲧⲁ
ⲣⲉϥⲉⲣⲛⲟⲃⲉ	N	ⲣⲉϥⲉⲣⲛⲟⲃⲉ
ⲣⲉϥⲉⲣⲡⲁϩⲣⲉ	N	ⲣⲉϥⲉⲣⲡⲁϩⲣⲉ
ⲣⲉϥⲉⲣⲡⲉⲑⲟⲟⲩ	N	ⲣⲉϥⲉⲣⲡⲉⲑⲟⲟⲩ
ⲣⲉϥⲑⲉⲱⲣⲉⲓ	N	ⲣⲉϥⲑⲉⲱⲣⲉⲓ
ⲣⲉϥⲑⲩⲣⲁⲡⲉⲩⲉ	N	ⲣⲉϥⲑⲩⲣⲁⲡⲉⲩⲉ
ⲣⲉϥⲕⲁⲗⲉⲓ	N	ⲣⲉϥⲕⲁⲗⲉⲓ
ⲣⲉϥⲕⲁⲥⲕⲥ	N	ⲣⲉϥⲕⲁⲥⲕⲥ
ⲣⲉϥⲕⲁⲧⲁⲗⲁⲗⲉⲓ	N	ⲣⲉϥⲕⲁⲧⲁⲗⲁⲗⲉⲓ
ⲣⲉϥⲕⲁⲧⲁⲫⲣⲟⲛⲉⲓ	N	ⲣⲉϥⲕⲁⲧⲁⲫⲣⲟⲛⲉⲓ
ⲣⲉϥⲕⲣⲟⲙⲣⲉⲙ	N	ⲣⲉϥⲕⲣⲟⲙⲣⲉⲙ
ⲣⲉϥⲕⲣⲟⲙⲣⲙ	N	ⲣⲉϥⲕⲣⲟⲙⲣⲙ
ⲣⲉϥⲗⲟⲕⲥ	N	ⲣⲉϥⲗⲟⲕⲥ
ⲣⲉϥⲗⲱⲕⲥ	N	ⲣⲉϥⲗⲱⲕⲥ
ⲣⲉϥⲙⲉⲩⲧ	N	ⲣⲉϥⲙⲉⲩⲧ
ⲣⲉϥⲙⲓϣⲉ	N	ⲣⲉϥⲙⲓϣⲉ
ⲣⲉϥⲙⲟⲟⲛⲉ	N	ⲣⲉϥⲙⲟⲟⲛⲉ
ⲣⲉϥⲙⲟⲟⲩⲧ	N	ⲣⲉϥⲙⲟⲟⲩⲧ
ⲣⲉϥⲙⲟⲩⲟⲩⲧ	N	ⲣⲉϥⲙⲟⲩⲟⲩⲧ
ⲣⲉϥⲙⲟⲩⲧⲉ	N	ⲣⲉϥⲙⲟⲩⲧⲉ
ⲣⲉϥⲛⲏⲫⲉ	N	ⲣⲉϥⲛⲏⲫⲉ
ⲣⲉϥⲛⲕⲟⲧⲕ	N	ⲣⲉϥⲛⲕⲟⲧⲕ
ⲣⲉϥⲛⲟⲓ	N	ⲣⲉϥⲛⲟⲓ
ⲣⲉϥⲡⲉϩⲧⲥⲛⲟϥ	N	ⲣⲉϥⲡⲉϩⲧⲥⲛⲟϥ
ⲣⲉϥⲡⲉⲣⲉⲣⲁⲥⲟⲩ	N	ⲣⲉϥⲡⲉⲣⲉⲣⲁⲥⲟⲩ
ⲣⲉϥⲡⲗⲁⲛⲁ	N	ⲣⲉϥⲡⲗⲁⲛⲁ
ⲣⲉϥⲣϩⲙⲙⲉ	N	ⲣⲉϥⲣϩⲙⲙⲉ
ⲣⲉϥⲣϩⲟⲧⲉ	N	ⲣⲉϥⲣϩⲟⲧⲉ
ⲣⲉϥⲣⲁⲓⲥⲑⲁⲛⲉ	N	ⲣⲉϥⲣⲁⲓⲥⲑⲁⲛⲉ
ⲣⲉϥⲣⲉⲓⲟⲡⲉ	N	ⲣⲉϥⲣⲉⲓⲟⲡⲉ
ⲣⲉϥⲣⲉⲡⲓⲑⲩⲙⲉⲓ	N	ⲣⲉϥⲣⲉⲡⲓⲑⲩⲙⲉⲓ
ⲣⲉϥⲣⲕⲁⲧⲁⲫⲣⲟⲛⲉⲓ	N	ⲣⲉϥⲣⲕⲁⲧⲁⲫⲣⲟⲛⲉⲓ
ⲣⲉϥⲣⲗⲩⲡⲉⲓ	N	ⲣⲉϥⲣⲗⲩⲡⲉⲓ
ⲣⲉϥⲣⲛⲟⲃⲉ	N	ⲣⲉϥⲣⲛⲟⲃⲉ
ⲣⲉϥⲣⲟⲩⲟⲉⲓⲛ	N	ⲣⲉϥⲣⲟⲩⲟⲉⲓⲛ
ⲣⲉϥⲣⲟⲩⲟⲓⲛ	N	ⲣⲉϥⲣⲟⲩⲟⲓⲛ
ⲣⲉϥⲣⲡⲁϩⲣⲉ	N	ⲣⲉϥⲣⲡⲁϩⲣⲉ
ⲣⲉϥⲣⲡⲉⲑⲟⲟⲩ	N	ⲣⲉϥⲣⲡⲉⲑⲟⲟⲩ
ⲣⲉϥⲣⲧⲉⲭⲛⲏ	N	ⲣⲉϥⲣⲧⲉⲭⲛⲏ
ⲣⲉϥⲣⲱⲕϩ	N	ⲣⲉϥⲣⲱⲕϩ
ⲣⲉϥⲥⲁϩⲟⲩ	N	ⲣⲉϥⲥⲁϩⲟⲩ
ⲣⲉϥⲥⲉⲥⲛⲟϥ	N	ⲣⲉϥⲥⲉⲥⲛⲟϥ
ⲣⲉϥⲥⲩⲗⲁ	N	ⲣⲉϥⲥⲩⲗⲁ
ⲣⲉϥⲥⲱⲛⲧ	N	ⲣⲉϥⲥⲱⲛⲧ
ⲣⲉϥⲧⲁⲕⲉⲯⲩⲭⲏ	N	ⲣⲉϥⲧⲁⲕⲉⲯⲩⲭⲏ
ⲣⲉϥⲧⲁⲗϭⲟ	N	ⲣⲉϥⲧⲁⲗϭⲟ
ⲣⲉϥⲧⲁⲙⲉⲓⲟ	N	ⲣⲉϥⲧⲁⲙⲉⲓⲟ
ⲣⲉϥⲧⲁⲙⲓⲟ	N	ⲣⲉϥⲧⲁⲙⲓⲟ
ⲣⲉϥⲧⲁⲛϩⲟ	N	ⲣⲉϥⲧⲁⲛϩⲟ
ⲣⲉϥⲧⲃⲃⲟ	N	ⲣⲉϥⲧⲃⲃⲟ
ⲣⲉϥⲧⲱⲣⲡ	N	ⲣⲉϥⲧⲱⲣⲡ
ⲣⲉϥⲫⲑⲟⲛⲉⲓ	N	ⲣⲉϥⲫⲑⲟⲛⲉⲓ
ⲣⲉϥⲫⲟⲣⲉⲓ	N	ⲣⲉϥⲫⲟⲣⲉⲓ
ⲣⲉϥⲯⲁⲗⲗⲉⲓ	N	ⲣⲉϥⲯⲁⲗⲗⲉⲓ
ⲣⲉϥⲱϣ	N	ⲣⲉϥⲱϣ
ⲣⲉϩⲧ	V	ⲣⲱϩⲧ
ⲣⲉⲃⲏ	V	ⲣⲉⲃⲏ
ⲣⲉⲓⲣⲏⲛⲏ	V	ⲣⲉⲓⲣⲏⲛⲏ
ⲣⲉⲕϩ	V	ⲣⲱⲕϩ
ⲣⲉⲕⲣⲓⲕⲉ	N	ⲣⲉⲕⲣⲓⲕⲉ
ⲣⲉⲕ	V	ⲣⲓⲕⲉ
ⲣⲉⲗⲁⲙⲓⲧⲏⲥ	V	ⲣⲉⲗⲁⲙⲓⲧⲏⲥ
ⲣⲉⲙⲏⲧ	N	ⲣⲉⲙⲏⲧ
ⲣⲉⲙⲓⲟⲟⲩⲉ	N	ⲣⲉⲙⲓⲟⲟⲩⲉ
ⲣⲉⲙⲣⲁϣ	N	ⲣⲉⲙⲣⲁϣ
ⲣⲉⲛⲟⲩⲥⲓⲟⲥ	N	ⲣⲉⲛⲟⲩⲥⲓⲟⲥ
ⲣⲉⲡⲓⲥⲕⲟⲡⲟⲥ	V	ⲣⲉⲡⲓⲥⲕⲟⲡⲟⲥ
ⲣⲉ	V	ⲣⲉ
ⲣⲏⲥⲓⲥ	N	ⲣⲏⲥⲓⲥ
ⲣⲏⲥ	N	ⲣⲏⲥ
ⲣⲏⲧ	VSTAT	ⲣⲟⲉⲓⲥ
ⲣⲏ	N	ⲣⲏ
ⲣⲑⲁⲩⲙⲁ	V	ⲣⲑⲁⲩⲙⲁ
ⲣⲑⲉⲙ	V	ⲣⲑⲉ
ⲣⲑⲉⲛ	V	ⲣⲑⲉ
ⲣⲑⲉ	V	ⲣⲑⲉ
ⲣⲑⲩⲥⲓⲁ	V	ⲣⲑⲩⲥⲓⲁ
ⲣⲓⲕⲉ	V	ⲣⲓⲕⲉ
ⲣⲓⲙⲉ	N	ⲣⲓⲙⲉ
ⲣⲓⲙⲉ	V	ⲣⲓⲙⲉ
ⲣⲓⲣ	N	ⲣⲓⲣ
ⲣⲓ	N	ⲣⲓ
ⲣⲕⲁⲕⲉ	V	ⲣⲕⲁⲕⲉ
ⲣⲕⲁⲩⲙⲁ	V	ⲣⲕⲁⲩⲙⲁ
ⲣⲕⲃⲁ	V	ⲣⲕⲃⲁ
ⲣⲕⲟⲓⲛⲟⲛ	N	ⲣⲕⲟⲓⲛⲟⲛ
ⲣⲕⲟⲓⲛⲱⲛⲟⲥ	V	ⲣⲕⲟⲓⲛⲱⲛⲟⲥ
ⲣⲕⲟⲩⲉⲓ	V	ⲣⲕⲟⲩⲉⲓ
ⲣⲕⲣⲓⲕⲉ	N	ⲣⲕⲣⲓⲕⲉ
ⲣⲗⲁⲁⲩ	V	ⲣⲗⲁⲁⲩ
ⲣⲗⲟⲓⲙⲟⲥ	V	ⲣⲗⲟⲓⲙⲟⲥ
ⲣⲗⲩⲡⲏ	V	ⲣⲗⲩⲡⲏ
ⲣⲙϩⲉ	N	ⲣⲙϩⲉ
ⲣⲙϩⲏ	N	ⲣⲙϩⲏ
ⲣⲙϩⲣⲱⲙⲏ	N	ⲣⲙϩⲣⲱⲙⲏ
ⲣⲙⲁⲅⲉⲓⲁ	V	ⲣⲙⲁⲅⲉⲓⲁ
ⲣⲙⲁⲕⲁⲣⲓⲟⲥ	N	ⲣⲙⲁⲕⲁⲣⲓⲟⲥ
ⲣⲙⲁⲣⲧⲩⲣⲟⲥ	V	ⲣⲙⲁⲣⲧⲩⲣⲟⲥ
ⲣⲙⲁⲧⲟⲓ	V	ⲣⲙⲁⲧⲟⲓ
ⲣⲙⲉⲉⲩⲉ	N	ⲣⲙⲉⲉⲩⲉ
ⲣⲙⲉⲓⲏ	N	ⲣⲙⲉⲓⲏ
ⲣⲙⲉⲓⲟⲟⲩⲉ	N	ⲣⲙⲉⲓⲟⲟⲩⲉ
ⲣⲙⲉⲧⲟⲭⲟⲥ	N	ⲣⲙⲉⲧⲟⲭⲟⲥ
ⲣⲙⲏ	N	ⲣⲙⲉⲓⲏ
ⲣⲙⲏ	V	ⲣⲙⲏ
ⲣⲙⲙⲁⲟ	N	ⲣⲙⲙⲁⲟ
ⲣⲙⲙⲙⲉ	N	ⲣⲙⲙⲙⲉ
ⲣⲙⲛϩⲏⲧ	N	ⲣⲙⲛϩⲏⲧ
ⲣⲙⲛϩⲓⲏ	N	ⲣⲙⲛϩⲓⲏ
ⲣⲙⲛⲕⲁϩ	N	ⲣⲙⲛⲕⲁϩ
ⲣⲙⲛⲕⲏⲙⲉ	N	ⲣⲙⲛⲕⲏⲙⲉ
ⲣⲙⲛⲛⲟⲙⲟⲥ	N	ⲣⲙⲛⲛⲟⲙⲟⲥ
ⲣⲙⲛⲛⲟⲩⲧⲉ	N	ⲣⲙⲛⲛⲟⲩⲧⲉ
ⲣⲙⲛⲡⲟⲗⲓⲥ	N	ⲣⲙⲛⲡⲟⲗⲓⲥ
ⲣⲙⲛⲥⲁⲣⲝ	N	ⲣⲙⲛⲥⲁⲣⲝ
ⲣⲙⲛⲧⲣⲉ	V	ⲣⲙⲛⲧⲣⲉ
ⲣⲙⲛ	N	ⲣⲙⲛ
ⲣⲙⲛ	V	ⲣⲙⲛ
ⲣⲙⲟⲛⲁⲭⲟⲥ	V	ⲣⲙⲟⲛⲁⲭⲟⲥ
ⲣⲙⲡⲉⲡⲟⲓⲕⲓⲟⲛ	N	ⲣⲙⲡⲉⲡⲟⲓⲕⲓⲟⲛ
ⲣⲙⲡⲣϭⲟⲩϣ	N	ⲣⲙⲡⲣϭⲟⲩϣ
ⲣⲙⲣⲁϣ	N	ⲣⲙⲣⲁϣ
ⲣⲙⲣⲁⲕⲟⲧⲉ	N	ⲣⲙⲣⲁⲕⲟⲧⲉ
ⲣⲙⲧⲁⲙⲙⲁ	N	ⲣⲙⲧⲁⲙⲙⲁ
ⲣⲙⲧⲁⲛⲇⲓⲟⲭⲓⲁ	N	ⲣⲙⲧⲁⲛⲇⲓⲟⲭⲓⲁ
ⲣⲙⲱⲛⲁⲭⲏ	V	ⲣⲙⲱⲛⲁⲭⲏ
ⲣⲛⲟϥⲣⲉ	V	ⲣⲛⲟϥⲣⲉ
ⲣⲛⲟϭ	V	ⲣⲛⲟϭ
ⲣⲛⲟⲃⲉ	V	ⲣⲛⲟⲃⲉ
ⲣⲛⲟⲃⲣⲉ	V	ⲣⲛⲟⲃⲣⲉ
ⲣⲛⲧ	V	ⲣⲛⲧ
ⲣⲟⲉⲓⲥ	N	ⲣⲟⲉⲓⲥ
ⲣⲟⲉⲓⲥ	V	ⲣⲟⲉⲓⲥ
ⲣⲟⲕϩ	V	ⲣⲱⲕϩ
ⲣⲟⲙⲡⲉ	N	ⲣⲟⲙⲡⲉ
ⲣⲟⲟⲩϣ	N	ⲣⲟⲟⲩϣ
ⲣⲟⲟⲩⲉ	N	ⲣⲟⲟⲩⲉ
ⲣⲟⲟⲩⲧ	VSTAT	ⲟⲩⲣⲟⲧ
ⲣⲟⲣⲫⲁⲛⲟⲥ	N	ⲣⲟⲣⲫⲁⲛⲟⲥ
ⲣⲟⲩϩⲉ	N	ⲣⲟⲩϩⲉ
ⲣⲟⲩⲟⲉⲓⲛ	V	ⲣⲟⲩⲟⲉⲓⲛ
ⲣⲟⲩⲟⲓⲛ	V	ⲣⲟⲩⲟⲓⲛ
ⲣⲟⲩⲱ	V	ⲣⲟⲩⲱ
ⲣⲟ	N	ⲣⲟ
ⲣⲡⲁⲓ	V	ⲣⲡⲁⲓ
ⲣⲡⲁⲣⲏⲥⲓⲁ	V	ⲣⲡⲁⲣⲏⲥⲓⲁ
ⲣⲡⲁⲥⲭⲁ	V	ⲣⲡⲁⲥⲭⲁ
ⲣⲡⲃⲟⲗ	V	ⲣⲡⲃⲟⲗ
ⲣⲡⲉⲓⲑⲉⲓ	V	ⲣⲡⲉⲓⲑⲉⲓ
ⲣⲡⲉ	N	ⲣⲡⲉ
ⲣⲡⲏⲩⲉ	N	ⲣⲡⲏⲩⲉ
ⲣⲡⲓⲥⲧⲟⲥ	V	ⲣⲡⲓⲥⲧⲟⲥ
ⲣⲡⲗⲁⲛⲏ	V	ⲣⲡⲗⲁⲛⲏ
ⲣⲡⲟⲗⲉⲙⲟⲥ	V	ⲣⲡⲟⲗⲉⲙⲟⲥ
ⲣⲡⲣⲟⲫⲏⲧⲏⲥ	V	ⲣⲡⲣⲟⲫⲏⲧⲏⲥ
ⲣⲡⲱⲃϣ	V	ⲣⲡⲱⲃϣ
ⲣⲣⲙϩⲉ	V	ⲣⲣⲙϩⲉ
ⲣⲣⲙⲙⲁⲟ	V	ⲣⲣⲙⲙⲁⲟ
ⲣⲣⲙ	N	ⲣⲣⲙ
ⲣⲣⲟⲟⲩϣ	V	ⲣⲣⲟⲟⲩϣ
ⲣⲣⲟ	N	ⲣⲣⲟ
ⲣⲣⲣⲟ	V	ⲣⲣⲣⲟ
ⲣⲣⲱⲟⲩ	N	ⲣⲣⲱⲟⲩ
ⲣⲣⲱ	N	ⲣⲣⲱ
ⲣⲥϩⲓⲙⲉ	V	ⲣⲥϩⲓⲙⲉ
ⲣⲥⲁϣϥ	V	ⲣⲥⲁϣϥ
ⲣⲥⲁϩ	V	ⲣⲥⲁϩ
ⲣⲥⲁⲃⲃⲁⲧⲟⲛ	V	ⲣⲥⲁⲃⲃⲁⲧⲟⲛ
ⲣⲥⲁⲣⲝ	V	ⲣⲥⲁⲣⲝ
ⲣⲥⲕⲩⲗⲏ	V	ⲣⲥⲕⲩⲗⲏ
ⲣⲥⲙⲟⲧ	V	ⲣⲥⲙⲟⲧ
ⲣⲥⲛⲁⲩ	V	ⲣⲥⲛⲁⲩ
ⲣⲥⲟϭ	V	ⲣⲥⲟϭ
ⲣⲥⲟⲫⲟⲥ	N	ⲣⲥⲟⲫⲟⲥ
ⲣⲥⲧⲩⲗⲟⲥ	V	ⲣⲥⲧⲩⲗⲟⲥ
ⲣⲥⲧ	V	ⲣⲥⲧ
ⲣⲧⲁⲃ	N	ⲣⲧⲁⲃ
ⲣⲧⲁⲅⲁⲡⲏ	V	ⲣⲧⲁⲅⲁⲡⲏ
ⲣⲧⲁⲛⲟⲙⲓⲁ	V	ⲣⲧⲁⲛⲟⲙⲓⲁ
ⲣⲧⲏⲡⲟⲥ	V	ⲣⲧⲏⲡⲟⲥ
ⲣⲧⲣⲟⲫⲏ	V	ⲣⲧⲣⲟⲫⲏ
ⲣⲧⲩⲡⲟⲥ	V	ⲣⲧⲩⲡⲟⲥ
ⲣⲧⲱⲛ	V	ⲣⲧⲱⲛ
ⲣⲫⲟⲛⲟⲥ	V	ⲣⲫⲟⲛⲟⲥ
ⲣⲭⲁⲩⲛⲟⲥ	N	ⲣⲭⲁⲩⲛⲟⲥ
ⲣⲭⲏⲣⲁ	V	ⲣⲭⲏⲣⲁ
ⲣⲭⲟⲗⲏ	V	ⲣⲭⲟⲗⲏ
ⲣⲭⲣⲉⲓⲁ	V	ⲣⲭⲣⲉⲓⲁ
ⲣⲭⲣⲏⲥⲧⲟⲥ	N	ⲣⲭⲣⲏⲥⲧⲟⲥ
ⲣⲭⲣⲓⲁ	N	ⲣⲭⲣⲓⲁ
ⲣⲭⲣⲓⲁ	V	ⲣⲭⲣⲓⲁ
ⲣⲱϣⲉ	N	ⲣⲱϣⲉ
ⲣⲱϣⲉ	V	ⲣⲱϣⲉ
ⲣⲱϩⲉ	V	ⲣⲱϩⲉ
ⲣⲱϩⲧ	V	ⲣⲱϩⲧ
ⲣⲱⲕϩ	V	ⲣⲱⲕϩ
ⲣⲱⲙⲉ	N	ⲣⲱⲙⲉ
ⲣⲱⲟⲩ	N	ⲣⲱⲟⲩ
ⲣⲱⲧ	N	ⲣⲱⲧ
ⲣⲱⲧ	V	ⲣⲱⲧ
ⲣⲱ	ADV	ⲣⲱ
ⲣⲱ	N	ⲣⲟ
ⲣⲱ	PTC	ⲣⲱ
ⲣ	N	ⲣ
ⲣ	V	ⲉⲓⲣⲉ
ⲥϥ	V	ⲥϥ
ⲥϩⲁⲓ	V	ⲥϩⲁⲓ
ⲥϩⲓⲙⲉ	N	ⲥϩⲓⲙⲉ
ⲥϩⲟⲩⲟⲣⲧ	VSTAT	ⲥⲁϩⲟⲩ
ⲥϩⲟⲩⲣ	V	ⲥϩⲟⲩⲣ
ⲥϩⲟⲩⲱⲣ	V	ⲥⲁϩⲟⲩ
ⲥϭⲏⲣ	N	ⲥϭⲏⲣ
ⲥϭⲏⲣ	V	ⲥϭⲏⲣ
ⲥϭⲣⲁϩⲧ	N	ⲥϭⲣⲁϩⲧ
ⲥϭⲣⲁϩⲧ	VSTAT	ⲥϭⲣⲁϩⲧ
ⲥϯⲃⲱⲱⲛ	N	ⲥϯⲃⲱⲱⲛ
ⲥϯⲛⲟⲩϥⲉ	N	ⲥϯⲛⲟⲩϥⲉ
ⲥϯⲛⲟⲩⲃⲉ	N	ⲥϯⲛⲟⲩⲃⲉ
ⲥϯⲭⲟⲥ	N	ⲥϯⲭⲟⲥ
ⲥⲁϣϥⲉ	N	ⲥⲁϣϥⲉ
ⲥⲁϣϥ	N	ⲥⲁϣϥ
ⲥⲁϣϥ	NUM	ⲥⲁϣϥ
ⲥⲁϣⲉ	VSTAT	ⲥⲓϣⲉ
ⲥⲁϣⲧ	VSTAT	ⲥⲱϩⲉ
ⲥⲁϩⲏⲩ	VSTAT	ⲥⲟⲟϩⲉ
ⲥⲁϩⲛⲉ	N	ⲥⲁϩⲛⲉ
ⲥⲁϩⲟⲩ	N	ⲥⲁϩⲟⲩ
ⲥⲁϩⲟⲩ	V	ⲥⲁϩⲟⲩ
ⲥⲁϩⲱ	V	ⲥⲟⲟϩⲉ
ⲥⲁϩ	N	ⲥⲁϩ
ⲥⲁϩ	V	ⲥϩⲁⲓ
ⲥⲁⲁⲛϣ	V	ⲥⲁⲁⲛϣ
ⲥⲁⲁⲧ	V	ⲥⲱⲧ
ⲥⲁⲃⲁⲕⲁⲧⲉ	N	ⲥⲁⲃⲁⲕⲁⲧⲉ
ⲥⲁⲃⲁⲱⲑ	NPROP	ⲥⲁⲃⲁⲱⲑ
ⲥⲁⲃⲁ	NPROP	ⲥⲁⲃⲁ
ⲥⲁⲃⲃⲁⲧⲟⲛ	N	ⲥⲁⲃⲃⲁⲧⲟⲛ
ⲥⲁⲃⲃⲁⲧⲱⲛ	N	ⲥⲁⲃⲃⲁⲧⲱⲛ
ⲥⲁⲃⲉⲉⲩ	N	ⲥⲁⲃⲉ
ⲥⲁⲃⲉⲗⲗⲓⲟⲥ	N	ⲥⲁⲃⲉⲗⲗⲓⲟⲥ
ⲥⲁⲃⲉ	N	ⲥⲁⲃⲉ
ⲥⲁⲃⲏ	N	ⲥⲁⲃⲏ
ⲥⲁⲃⲟⲗ	ADV	ⲥⲁⲃⲟⲗ
ⲥⲁⲇⲁⲛⲁⲥ	N	ⲥⲁⲇⲁⲛⲁⲥ
ⲥⲁⲇⲇⲟⲩⲕⲁⲓⲟⲥ	NPROP	ⲥⲁⲇⲇⲟⲩⲕⲁⲓⲟⲥ
ⲥⲁⲇⲱⲕ	NPROP	ⲥⲁⲇⲱⲕ
ⲥⲁⲉⲓⲛ	N	ⲥⲁⲉⲓⲛ
ⲥⲁⲓⲛ	N	ⲥⲁⲓⲛ
ⲥⲁⲕⲓⲁ	N	ⲥⲁⲕⲓⲁ
ⲥⲁⲗⲁⲑⲓⲏⲗ	NPROP	ⲥⲁⲗⲁⲑⲓⲏⲗ
ⲥⲁⲗⲁⲙⲁⲛⲇⲣⲁ	N	ⲥⲁⲗⲁⲙⲁⲛⲇⲣⲁ
ⲥⲁⲗⲙⲱⲛ	NPROP	ⲥⲁⲗⲙⲱⲛ
ⲥⲁⲗⲡⲓⲅⲅⲟⲥ	N	ⲥⲁⲗⲡⲓⲅⲅⲟⲥ
ⲥⲁⲗⲡⲓⲅⲝ	N	ⲥⲁⲗⲡⲓⲅⲝ
ⲥⲁⲗⲡⲓⲍⲉ	V	ⲥⲁⲗⲡⲓⲍⲉ
ⲥⲁⲗⲱⲙⲏ	N	ⲥⲁⲗⲱⲙⲏ
ⲥⲁⲗⲱⲙⲏ	NPROP	ⲥⲁⲗⲱⲙⲏ
ⲥⲁⲙⲁⲣⲓⲧⲏⲥ	N	ⲥⲁⲙⲁⲣⲓⲧⲏⲥ
ⲥⲁⲙⲯⲱⲛ	NPROP	ⲥⲁⲙⲯⲱⲛ
ⲥⲁⲛϣ	V	ⲥⲁⲛϣ
ⲥⲁⲛϩⲟⲩⲛ	N	ⲥⲁⲛϩⲟⲩⲛ
ⲥⲁⲛⲃⲟⲗ	N	ⲥⲁⲛⲃⲟⲗ
ⲥⲁⲛⲇⲁⲗⲓⲟⲛ	N	ⲥⲁⲛⲇⲁⲗⲓⲟⲛ
ⲥⲁⲛⲟⲩϣ	V	ⲥⲁⲁⲛϣ
ⲥⲁⲟⲩⲗ	NPROP	ⲥⲁⲟⲩⲗ
ⲥⲁⲡⲓⲥⲁ	ADV	ⲥⲁⲡⲓⲥⲁ
ⲥⲁⲡⲡⲉⲓⲣⲓⲛⲟⲛ	N	ⲥⲁⲡⲡⲉⲓⲣⲓⲛⲟⲛ
ⲥⲁⲡⲡⲓⲣⲟⲛ	N	ⲥⲁⲡⲡⲓⲣⲟⲛ
ⲥⲁⲡⲡⲓⲣⲟⲥ	N	ⲥⲁⲡⲡⲓⲣⲟⲥ
ⲥⲁⲣⲁⲅⲉⲛⲟⲥ	N	ⲥⲁⲣⲁⲅⲉⲛⲟⲥ
ⲥⲁⲣⲁⲅⲏⲛⲟⲥ	N	ⲥⲁⲣⲁⲅⲏⲛⲟⲥ
ⲥⲁⲣⲁⲡⲓⲟⲛ	NPROP	ⲥⲁⲣⲁⲡⲓⲟⲛ
ⲥⲁⲣⲁⲡⲓⲱⲛ	NPROP	ⲥⲁⲣⲁⲡⲓⲱⲛ
ⲥⲁⲣⲁⲫⲉⲓⲛ	N	ⲥⲁⲣⲁⲫⲉⲓⲛ
ⲥⲁⲣⲁⲫⲓⲛ	NPROP	ⲥⲁⲣⲁⲫⲓⲛ
ⲥⲁⲣⲁ	NPROP	ⲥⲁⲣⲁ
ⲥⲁⲣⲇⲓⲟⲛ	N	ⲥⲁⲣⲇⲓⲟⲛ
ⲥⲁⲣⲇⲟⲛⲓⲗⲉ	NPROP	ⲥⲁⲣⲇⲟⲛⲓⲗⲉ
ⲥⲁⲣⲕⲁⲛⲏ	N	ⲥⲁⲣⲕⲁⲛⲏ
ⲥⲁⲣⲕⲓⲕⲏ	N	ⲥⲁⲣⲕⲓⲕⲏ
ⲥⲁⲣⲕⲓⲕⲟⲛ	N	ⲥⲁⲣⲕⲓⲕⲟⲛ
ⲥⲁⲣⲕⲓⲕⲟⲥ	N	ⲥⲁⲣⲕⲓⲕⲟⲥ
ⲥⲁⲣⲕⲓⲕⲱⲥ	ADV	ⲥⲁⲣⲕⲓⲕⲱⲥ
ⲥⲁⲣⲝ	N	ⲥⲁⲣⲝ
ⲥⲁⲣⲣⲁ	NPROP	ⲥⲁⲣⲣⲁ
ⲥⲁⲧⲁⲛⲁⲥ	NPROP	ⲥⲁⲧⲁⲛⲁⲥ
ⲥⲁⲧⲉⲉⲣⲉ	N	ⲥⲁⲧⲉⲉⲣⲉ
ⲥⲁⲧⲉ	N	ⲥⲁⲧⲉ
ⲥⲁⲧ	N	ⲥⲁⲧ
ⲥⲁⲫⲏⲛⲓⲍⲉ	V	ⲥⲁⲫⲏⲛⲓⲍⲉ
ⲥⲁⲭⲑⲁⲛⲉⲓ	V	ⲥⲁⲭⲑⲁⲛⲉⲓ
ⲥⲁ	N	ⲥⲁ
ⲥⲁ	PREP	ⲥⲁ
ⲥⲃⲃⲉ	N	ⲥⲃⲃⲉ
ⲥⲃⲃⲉ	V	ⲥⲃⲃⲉ
ⲥⲃⲃⲏⲧ	V	ⲥⲃⲃⲏⲧ
ⲥⲃⲃⲏⲩ	V	ⲥⲃⲃⲏⲩ
ⲥⲃⲏⲓⲧⲉ	N	ⲥⲃⲏⲓⲧⲉ
ⲥⲃⲟⲉⲓ	N	ⲥⲃⲟⲉⲓ
ⲥⲃⲟⲓ	N	ⲥⲃⲟⲓ
ⲥⲃⲟⲟⲩⲉ	N	ⲥⲁⲃⲉ
ⲥⲃⲟⲩⲓ	N	ⲥⲁⲃⲉ
ⲥⲃⲟ	N	ⲥⲃⲟ
ⲥⲃⲧⲉ	V	ⲥⲃⲧⲉ
ⲥⲃⲧⲱⲧ	V	ⲥⲟⲃⲧⲉ
ⲥⲃⲧⲱⲧ	VSTAT	ⲥⲟⲃⲧⲉ
ⲥⲃⲱ	N	ⲥⲃⲱ
ⲥⲉϣϥ	V	ⲥⲱϣϥ
ⲥⲉϩ	V	ⲥϩⲁⲓ
ⲥⲉϭⲣⲁϩⲧ	VSTAT	ⲥⲉϭⲣⲁϩⲧ
ⲥⲉⲃⲉⲥⲑⲁⲓ	V	ⲥⲉⲃⲉⲥⲑⲁⲓ
ⲥⲉⲃⲏⲣⲓⲟⲛ	N	ⲥⲉⲃⲏⲣⲓⲟⲛ
ⲥⲉⲇⲉⲕⲓⲁⲥ	NPROP	ⲥⲉⲇⲉⲕⲓⲁⲥ
ⲥⲉⲉⲡⲉ	N	ⲥⲉⲉⲡⲉ
ⲥⲉⲉⲡⲉ	V	ⲥⲉⲉⲡⲉ
ⲥⲉⲓⲛⲑⲏ	N	ⲥⲉⲓⲛⲑⲏ
ⲥⲉⲓ	V	ⲥⲉⲓ
ⲥⲉⲗⲉⲩⲕⲓⲁ	NPROP	ⲥⲉⲗⲉⲩⲕⲓⲁ
ⲥⲉⲗⲏⲛⲓⲁⲍⲉ	V	ⲥⲉⲗⲏⲛⲓⲁⲍⲉ
ⲥⲉⲗⲓⲥ	N	ⲥⲉⲗⲓⲥ
ⲥⲉⲙⲛⲏ	N	ⲥⲉⲙⲛⲏ
ⲥⲉⲙⲛⲟⲛ	N	ⲥⲉⲙⲛⲟⲛ
ⲥⲉⲙⲛⲟⲥ	N	ⲥⲉⲙⲛⲟⲥ
ⲥⲉⲙⲡⲟⲇⲓⲟⲛ	N	ⲥⲉⲙⲡⲟⲇⲓⲟⲛ
ⲥⲉⲛϩ	V	ⲥⲉⲛϩ
ⲥⲉⲛⲁⲗⲁⲥⲉ	V	ⲥⲉⲛⲁⲗⲁⲥⲉ
ⲥⲉⲛⲛⲁⲭⲏⲣⲉⲓⲙ	NPROP	ⲥⲉⲛⲛⲁⲭⲏⲣⲉⲓⲙ
ⲥⲉⲛⲛⲁⲭⲏⲣⲓⲙ	NPROP	ⲥⲉⲛⲛⲁⲭⲏⲣⲓⲙ
ⲥⲉⲛⲟⲩⲑⲓⲟⲥ	NPROP	ⲥⲉⲛⲟⲩⲑⲓⲟⲥ
ⲥⲉⲛⲟⲩⲑⲓⲟⲩ	NPROP	ⲥⲉⲛⲟⲩⲑⲓⲟⲩ
ⲥⲉⲛⲧⲉ	N	ⲥⲉⲛⲧⲉ
ⲥⲉⲡⲥⲡ	V	ⲥⲟⲡⲥⲡ
ⲥⲉⲡⲥⲱⲡⲉ	V	ⲥⲟⲡⲥⲡ
ⲥⲉⲡⲥⲱⲡ	V	ⲥⲟⲡⲥⲡ
ⲥⲉⲡ	N	ⲥⲉⲡ
ⲥⲉⲡ	V	ⲥⲉⲡ
ⲥⲉⲣⲁⲡⲓⲛ	NPROP	ⲥⲉⲣⲁⲡⲓⲛ
ⲥⲉⲣⲁⲡⲓⲥ	NPROP	ⲥⲉⲣⲁⲡⲓⲥ
ⲥⲉⲣⲁⲫⲓⲛ	NPROP	ⲥⲉⲣⲁⲫⲓⲛ
ⲥⲉⲣⲁ	N	ⲥⲉⲣⲁ
ⲥⲉⲧⲡ	V	ⲥⲱⲧⲡ
ⲥⲉⲩϩ	V	ⲥⲱⲟⲩϩ
ⲥⲉⲩⲏⲣⲓⲁⲛⲟⲥ	NPROP	ⲥⲉⲩⲏⲣⲓⲁⲛⲟⲥ
ⲥⲉⲩⲏⲣⲟⲥ	NPROP	ⲥⲉⲩⲏⲣⲟⲥ
ⲥⲉ	N	ⲥⲉ
ⲥⲉ	NUM	ⲥⲉ
ⲥⲉ	PPERO	ⲛⲧⲟⲟⲩ
ⲥⲉ	PPERS	ⲛⲧⲟⲟⲩ
ⲥⲉ	PTC	ⲥⲉ
ⲥⲉ	V	ⲥⲉ
ⲥⲏϣ	VSTAT	ⲥⲱϣ
ⲥⲏϥⲉ	N	ⲥⲏϥⲉ
ⲥⲏϩ	VSTAT	ⲥϩⲁⲓ
ⲥⲏϭ	VSTAT	ⲥⲱϭ
ⲥⲏⲅⲱⲣ	NPROP	ⲥⲏⲅⲱⲣ
ⲥⲏⲏⲡⲉ	V	ⲥⲏⲏⲡⲉ
ⲥⲏⲙⲁⲛⲉ	V	ⲥⲏⲙⲁⲛⲉ
ⲥⲏⲙⲉⲓⲟⲛ	N	ⲥⲏⲙⲉⲓⲟⲛ
ⲥⲏⲙⲓⲟⲛ	N	ⲥⲏⲙⲓⲟⲛ
ⲥⲏⲣ	VSTAT	ⲥⲱⲣ
ⲥⲏⲧ	N	ⲥⲏⲧ
ⲥⲏⲧ	NOUN	ⲥⲏⲧ
ⲥⲏⲩ	N	ⲥⲏⲩ
ⲥⲓϣⲉ	N	ⲥⲓϣⲉ
ⲥⲓⲃⲧ	N	ⲥⲓⲃⲧ
ⲥⲓⲅⲏ	N	ⲥⲓⲅⲏ
ⲥⲓⲅⲛⲟⲛ	N	ⲥⲓⲅⲛⲟⲛ
ⲥⲓⲅⲛⲟⲩⲫⲩⲗⲁⲝ	N	ⲥⲓⲅⲛⲟⲩⲫⲩⲗⲁⲝ
ⲥⲓⲇⲱⲛ	N	ⲥⲓⲇⲱⲛ
ⲥⲓⲕⲉ	N	ⲥⲓⲕⲉ
ⲥⲓⲕⲓⲙⲁ	NPROP	ⲥⲓⲕⲓⲙⲁ
ⲥⲓⲙⲱⲛⲓⲁⲛⲟⲥ	N	ⲥⲓⲙⲱⲛⲓⲁⲛⲟⲥ
ⲥⲓⲙⲱⲛ	NPROP	ⲥⲓⲙⲱⲛ
ⲥⲓⲛⲁ	NPROP	ⲥⲓⲛⲁ
ⲥⲓⲛⲃⲗϫⲉ	NPROP	ⲥⲓⲛⲃⲗϫⲉ
ⲥⲓⲛⲇⲱⲛⲓⲟⲛ	N	ⲥⲓⲛⲇⲱⲛⲓⲟⲛ
ⲥⲓⲛⲇⲱⲛ	N	ⲥⲓⲛⲇⲱⲛ
ⲥⲓⲛⲟⲩⲑⲓⲟⲥ	NPROP	ⲥⲓⲛⲟⲩⲑⲓⲟⲥ
ⲥⲓⲛⲟⲩⲑⲓⲟⲩ	NPROP	ⲥⲓⲛⲟⲩⲑⲓⲟⲩ
ⲥⲓⲛⲟⲩⲥⲓⲁ	N	ⲥⲓⲛⲟⲩⲥⲓⲁ
ⲥⲓⲟⲟⲩⲛⲉ	N	ⲥⲓⲟⲟⲩⲛⲉ
ⲥⲓⲟⲟⲩⲛ	N	ⲥⲓⲟⲟⲩⲛ
ⲥⲓⲟⲟⲩⲧ	NPROP	ⲥⲓⲟⲟⲩⲧ
ⲥⲓⲟⲩⲣ	N	ⲥⲓⲟⲩⲣ
ⲥⲓⲟⲩ	N	ⲥⲓⲟⲩ
ⲥⲓⲡⲡⲓⲟⲛ	N	ⲥⲓⲡⲡⲓⲟⲛ
ⲥⲓⲥⲙⲟⲥ	N	ⲥⲓⲥⲙⲟⲥ
ⲥⲓⲧⲉ	NUM	ⲥⲓⲧⲉ
ⲥⲓⲭⲁⲛⲉⲥⲑⲁⲓ	V	ⲥⲓⲭⲁⲛⲉⲥⲑⲁⲓ
ⲥⲓⲭⲁⲛⲉ	V	ⲥⲓⲭⲁⲛⲉ
ⲥⲓⲱⲛ	NPROP	ⲥⲓⲱⲛ
ⲥⲓ	V	ⲥⲓ
ⲥⲕⲁⲓ	N	ⲥⲕⲁⲓ
ⲥⲕⲁⲓ	V	ⲥⲕⲁⲓ
ⲥⲕⲁⲗⲁ	N	ⲥⲕⲁⲗⲁ
ⲥⲕⲁⲛⲇⲁⲗⲓⲍⲉ	V	ⲥⲕⲁⲛⲇⲁⲗⲓⲍⲉ
ⲥⲕⲁⲛⲇⲁⲗⲓⲥⲍⲉⲥⲑⲉ	V	ⲥⲕⲁⲛⲇⲁⲗⲓⲥⲍⲉⲥⲑⲉ
ⲥⲕⲁⲛⲇⲁⲗⲟⲛ	N	ⲥⲕⲁⲛⲇⲁⲗⲟⲛ
ⲥⲕⲁⲛⲇⲁⲗⲟⲥ	N	ⲥⲕⲁⲛⲇⲁⲗⲟⲥ
ⲥⲕⲁⲫⲏ	N	ⲥⲕⲁⲫⲏ
ⲥⲕⲁⲫⲟⲥ	N	ⲥⲕⲁⲫⲟⲥ
ⲥⲕⲉⲛⲏ	N	ⲥⲕⲉⲛⲏ
ⲥⲕⲉⲡⲁⲍⲉ	V	ⲥⲕⲉⲡⲁⲍⲉ
ⲥⲕⲉⲡⲁⲥⲧⲏⲥ	N	ⲥⲕⲉⲡⲁⲥⲧⲏⲥ
ⲥⲕⲉⲡⲉ	N	ⲥⲕⲉⲡⲉ
ⲥⲕⲉⲡⲓ	N	ⲥⲕⲉⲡⲓ
ⲥⲕⲉⲡⲧⲉⲓ	V	ⲥⲕⲉⲡⲧⲉⲓ
ⲥⲕⲉⲡⲧⲉ	V	ⲥⲕⲉⲡⲧⲉ
ⲥⲕⲉⲡⲧⲓⲛ	V	ⲥⲕⲉⲡⲧⲓⲛ
ⲥⲕⲉⲡⲧⲱⲣ	N	ⲥⲕⲉⲡⲧⲱⲣ
ⲥⲕⲉⲡⲱⲗⲁⲧⲱⲣ	N	ⲥⲕⲉⲡⲱⲗⲁⲧⲱⲣ
ⲥⲕⲉⲣⲕⲱⲣⲉ	V	ⲥⲕⲟⲣⲕⲣ
ⲥⲕⲉⲣⲕⲱⲣ	V	ⲥⲕⲟⲣⲕⲣ
ⲥⲕⲉⲩⲉ	N	ⲥⲕⲉⲩⲟⲥ
ⲥⲕⲉⲩⲏ	N	ⲥⲕⲉⲩⲏ
ⲥⲕⲉⲩⲟⲥ	N	ⲥⲕⲉⲩⲟⲥ
ⲥⲕⲉⲯⲓⲥ	N	ⲥⲕⲉⲯⲓⲥ
ⲥⲕⲏⲇⲁⲗⲏ	N	ⲥⲕⲏⲇⲁⲗⲏ
ⲥⲕⲏⲛⲏ	N	ⲥⲕⲏⲛⲏ
ⲥⲕⲏⲛⲟⲡⲏⲅⲓⲁ	N	ⲥⲕⲏⲛⲟⲡⲏⲅⲓⲁ
ⲥⲕⲏⲡⲏ	N	ⲥⲕⲏⲡⲏ
ⲥⲕⲓⲃⲩⲧⲱⲣ	N	ⲥⲕⲓⲃⲩⲧⲱⲣ
ⲥⲕⲓⲣⲧⲁ	V	ⲥⲕⲓⲣⲧⲁ
ⲥⲕⲗⲁⲇⲟⲥ	N	ⲥⲕⲗⲁⲇⲟⲥ
ⲥⲕⲗⲏⲣⲓⲁ	N	ⲥⲕⲗⲏⲣⲓⲁ
ⲥⲕⲟⲡⲟⲥ	N	ⲥⲕⲟⲡⲟⲥ
ⲥⲕⲟⲣⲕⲉⲣ	V	ⲥⲕⲟⲣⲕⲉⲣ
ⲥⲕⲟⲣⲕⲣ	V	ⲥⲕⲟⲣⲕⲣ
ⲥⲕⲣⲕⲣ	V	ⲥⲕⲟⲣⲕⲣ
ⲥⲕⲣⲱⲫⲁ	N	ⲥⲕⲣⲱⲫⲁ
ⲥⲕⲩⲑⲏⲥ	N	ⲥⲕⲩⲑⲏⲥ
ⲥⲕⲩⲗⲗⲉⲓ	V	ⲥⲕⲩⲗⲗⲉⲓ
ⲥⲕⲩⲗⲙⲟⲥ	N	ⲥⲕⲩⲗⲙⲟⲥ
ⲥⲕⲩⲛⲏ	N	ⲥⲕⲩⲛⲏ
ⲥⲕⲩⲛⲱⲙⲁ	N	ⲥⲕⲩⲛⲱⲙⲁ
ⲥⲗⲁⲁⲧⲉ	V	ⲥⲗⲁⲁⲧⲉ
ⲥⲗⲡ	V	ⲥⲗⲡ
ⲥⲗⲥⲱⲗ	V	ⲥⲟⲗⲥⲗ
ⲥⲙⲁⲙⲁⲁⲧ	VSTAT	ⲥⲙⲟⲩ
ⲥⲙⲁⲣⲁⲅⲇⲟⲥ	N	ⲥⲙⲁⲣⲁⲅⲇⲟⲥ
ⲥⲙⲉⲗⲓⲛ	N	ⲥⲙⲉⲗⲓⲛ
ⲥⲙⲉⲛⲥⲉⲛⲧⲉ	V	ⲥⲙⲉⲛⲥⲉⲛⲧⲉ
ⲥⲙⲉⲛⲥⲛⲧⲉ	V	ⲥⲙⲉⲛⲥⲛⲧⲉ
ⲥⲙⲏ	N	ⲥⲙⲏ
ⲥⲙⲓⲗⲁⲝ	N	ⲥⲙⲓⲗⲁⲝ
ⲥⲙⲓⲛⲉ	V	ⲥⲙⲓⲛⲉ
ⲥⲙⲙⲉ	N	ⲥⲙⲙⲉ
ⲥⲙⲙⲉ	V	ⲥⲙⲙⲉ
ⲥⲙⲛⲥⲉⲛⲧⲉ	V	ⲥⲙⲛⲥⲉⲛⲧⲉ
ⲥⲙⲛⲧϥ	V	ⲥⲙⲓⲛⲉ
ⲥⲙⲛ	V	ⲥⲙⲓⲛⲉ
ⲥⲙⲟⲛⲧ	VSTAT	ⲥⲙⲓⲛⲉ
ⲥⲙⲟⲧ	N	ⲥⲙⲟⲧ
ⲥⲙⲟⲩ	N	ⲥⲙⲟⲩ
ⲥⲙⲟⲩ	V	ⲥⲙⲟⲩ
ⲥⲙ	V	ⲥⲙ
ⲥⲛⲁⲩϩ	N	ⲥⲛⲁⲩϩ
ⲥⲛⲁⲩ	N	ⲥⲛⲁⲩ
ⲥⲛⲁⲩ	NUM	ⲥⲛⲁⲩ
ⲥⲛⲏⲟⲩ	N	ⲥⲟⲛ
ⲥⲛⲏⲩ	N	ⲥⲟⲛ
ⲥⲛⲟϥ	N	ⲥⲛⲟϥ
ⲥⲛⲧⲁⲍⲉ	V	ⲥⲛⲧⲁⲍⲉ
ⲥⲛⲧⲉ	N	ⲥⲛⲧⲉ
ⲥⲛⲧⲉ	NUM	ⲥⲛⲧⲉ
ⲥⲛⲧ	V	ⲥⲛⲧ
ⲥⲛⲱⲱϥ	N	ⲥⲛⲟϥ
ⲥⲟοⲩⲛ	V	ⲥⲟοⲩⲛ
ⲥⲟϣϥ	V	ⲥⲟϣϥ
ⲥⲟϣϥ	VSTAT	ⲥⲟϣϥ
ⲥⲟϣⲕ	V	ⲥⲱϣ
ⲥⲟϣ	V	ⲥⲱϣ
ⲥⲟϩⲉ	V	ⲥⲟϩⲉ
ⲥⲟϭⲛ	N	ⲥⲟϭⲛ
ⲥⲟϭ	N	ⲥⲟϭ
ⲥⲟⲃϩ	VSTAT	ⲥⲱⲃϩ
ⲥⲟⲃⲕ	V	ⲥⲟⲃⲕ
ⲥⲟⲃⲧⲉ	N	ⲥⲟⲃⲧⲉ
ⲥⲟⲃⲧⲉ	V	ⲥⲟⲃⲧⲉ
ⲥⲟⲃⲧ	N	ⲥⲟⲃⲧ
ⲥⲟⲇⲟⲙⲁ	NPROP	ⲥⲟⲇⲟⲙⲁ
ⲥⲟⲇⲟⲙⲓⲧⲏⲥ	N	ⲥⲟⲇⲟⲙⲓⲧⲏⲥ
ⲥⲟⲉⲓⲧ	N	ⲥⲟⲉⲓⲧ
ⲥⲟⲕ	V	ⲥⲱⲕ
ⲥⲟⲗⲟⲙⲱⲛ	NPROP	ⲥⲟⲗⲟⲙⲱⲛ
ⲥⲟⲗⲥⲉⲗ	V	ⲥⲟⲗⲥⲉⲗ
ⲥⲟⲗⲥⲗ	V	ⲥⲟⲗⲥⲗ
ⲥⲟⲗⲱⲙⲱⲛ	NPROP	ⲥⲟⲗⲱⲙⲱⲛ
ⲥⲟⲛϩⲉ	V	ⲥⲱⲛϩ
ⲥⲟⲛϩ	V	ⲥⲱⲛϩ
ⲥⲟⲛϩ	VSTAT	ⲥⲱⲛϩ
ⲥⲟⲛⲧⲉ	N	ⲥⲟⲛⲧⲉ
ⲥⲟⲛⲧ	V	ⲥⲱⲛⲧ
ⲥⲟⲛ	N	ⲥⲟⲛ
ⲥⲟⲟϥ	VSTAT	ⲥⲱⲱϥ
ⲥⲟⲟϩⲉ	V	ⲥⲟⲟϩⲉ
ⲥⲟⲟⲛⲉ	N	ⲥⲟⲟⲛⲉ
ⲥⲟⲟⲧ	V	ⲥⲟⲧ
ⲥⲟⲟⲩϩⲉϩⲟⲩⲛ	VSTAT	ⲥⲟⲟⲩϩⲉϩⲟⲩⲛ
ⲥⲟⲟⲩϩⲉ	N	ⲥⲟⲟⲩϩⲉ
ⲥⲟⲟⲩϩⲛ	V	ⲥⲟⲟⲩϩⲛ
ⲥⲟⲟⲩϩⲥ	N	ⲥⲟⲟⲩϩⲥ
ⲥⲟⲟⲩϩ	V	ⲥⲱⲟⲩϩ
ⲥⲟⲟⲩϩ	VSTAT	ⲥⲱⲟⲩϩ
ⲥⲟⲟⲩⲛϣⲟ	N	ⲥⲟⲟⲩⲛϣⲟ
ⲥⲟⲟⲩⲛ	N	ⲥⲟⲟⲩⲛ
ⲥⲟⲟⲩⲛ	V	ⲥⲟⲟⲩⲛ
ⲥⲟⲟⲩⲧⲛ	V	ⲥⲟⲟⲩⲧⲛ
ⲥⲟⲟⲩ	N	ⲥⲟⲟⲩ
ⲥⲟⲟ	V	ⲥⲱ
ⲥⲟⲡⲥ	V	ⲥⲟⲡⲥ
ⲥⲟⲡ	N	ⲥⲟⲡ
ⲥⲟⲣⲙⲉⲥ	N	ⲥⲟⲣⲙⲉⲥ
ⲥⲟⲣⲙⲉ	V	ⲥⲟⲣⲙⲉ
ⲥⲟⲣⲙ	V	ⲥⲟⲣⲙ
ⲥⲟⲣⲧ	N	ⲥⲟⲣⲧ
ⲥⲟⲣ	V	ⲥⲱⲣ
ⲥⲟⲧⲃⲉϥ	N	ⲥⲟⲧⲃⲉϥ
ⲥⲟⲧⲉ	N	ⲥⲟⲧⲉ
ⲥⲟⲧⲙϥ	V	ⲥⲱⲧⲙ
ⲥⲟⲧⲙⲉϥ	V	ⲥⲱⲧⲙ
ⲥⲟⲧⲙⲉ	V	ⲥⲱⲧⲙ
ⲥⲟⲧⲙ	V	ⲥⲱⲧⲙ
ⲥⲟⲧⲡ	V	ⲥⲱⲧⲡ
ⲥⲟⲧⲡ	VSTAT	ⲥⲱⲧⲡ
ⲥⲟⲧ	V	ⲥⲱⲧ
ⲥⲟⲩⲁⲛ	NPROP	ⲥⲟⲩⲁⲛ
ⲥⲟⲩⲁ	N	ⲥⲟⲩⲁ
ⲥⲟⲩⲇⲁⲣⲓⲟⲛ	N	ⲥⲟⲩⲇⲁⲣⲓⲟⲛ
ⲥⲟⲩⲉⲛ	V	ⲥⲟⲟⲩⲛ
ⲥⲟⲩⲗⲱⲗ	VSTAT	ⲥⲟⲩⲟⲗⲟⲩⲗ
ⲥⲟⲩⲛⲛⲟⲥ	NPROP	ⲥⲟⲩⲛⲛⲟⲥ
ⲥⲟⲩⲛⲧ	N	ⲥⲟⲩⲛⲧ
ⲥⲟⲩⲛ	V	ⲥⲟⲟⲩⲛ
ⲥⲟⲩⲟⲛ	V	ⲥⲟⲟⲩⲛ
ⲥⲟⲩⲟ	N	ⲥⲟⲩⲟ
ⲥⲟⲩⲣⲉⲥ	NPROP	ⲥⲟⲩⲣⲉⲥ
ⲥⲟⲩⲣⲉ	N	ⲥⲟⲩⲣⲉ
ⲥⲟⲩⲥⲁⲛⲛⲁ	NPROP	ⲥⲟⲩⲥⲁⲛⲛⲁ
ⲥⲟⲩⲧⲛ	V	ⲥⲟⲟⲩⲧⲛ
ⲥⲟⲩⲧⲱⲛ	V	ⲥⲟⲩⲧⲱⲛ
ⲥⲟⲩⲧⲱⲛ	VSTAT	ⲥⲟⲟⲩⲧⲛ
ⲥⲟⲩⲱⲛ	V	ⲥⲟⲟⲩⲛ
ⲥⲟⲩ	N	ⲥⲟⲩ
ⲥⲟⲩ	PPERO	ⲛⲧⲟⲟⲩ
ⲥⲟⲫⲓⲁ	N	ⲥⲟⲫⲓⲁ
ⲥⲟⲫⲓⲍⲉ	V	ⲥⲟⲫⲓⲍⲉ
ⲥⲟⲫⲓⲥⲧⲏⲥ	N	ⲥⲟⲫⲓⲥⲧⲏⲥ
ⲥⲟⲫⲟⲥ	N	ⲥⲟⲫⲟⲥ
ⲥⲟ	N	ⲥⲟ
ⲥⲟ	NUM	ⲥⲟ
ⲥⲡⲁⲑⲁⲣⲓⲟⲥ	N	ⲥⲡⲁⲑⲁⲣⲓⲟⲥ
ⲥⲡⲁⲧⲁⲗⲁ	V	ⲥⲡⲁⲧⲁⲗⲁ
ⲥⲡⲁⲧⲁⲗⲟⲥ	N	ⲥⲡⲁⲧⲁⲗⲟⲥ
ⲥⲡⲉⲕⲟⲩⲗⲁⲧⲱⲣ	N	ⲥⲡⲉⲕⲟⲩⲗⲁⲧⲱⲣ
ⲥⲡⲉⲗⲁⲓⲟⲛ	N	ⲥⲡⲉⲗⲁⲓⲟⲛ
ⲥⲡⲉⲣⲙⲁ	N	ⲥⲡⲉⲣⲙⲁ
ⲥⲡⲏⲗⲁⲓⲟⲛ	N	ⲥⲡⲏⲗⲁⲓⲟⲛ
ⲥⲡⲓⲛⲑⲏⲣ	N	ⲥⲡⲓⲛⲑⲏⲣ
ⲥⲡⲓⲣⲁ	N	ⲥⲡⲓⲣⲁ
ⲥⲡⲓⲣ	N	ⲥⲡⲓⲣ
ⲥⲡⲗⲁⲅⲭⲛⲟⲛ	N	ⲥⲡⲗⲁⲅⲭⲛⲟⲛ
ⲥⲡⲗⲁⲭⲛⲟⲛ	N	ⲥⲡⲗⲁⲭⲛⲟⲛ
ⲥⲡⲗⲏⲛ	N	ⲥⲡⲗⲏⲛ
ⲥⲡⲟⲅⲅⲟⲥ	N	ⲥⲡⲟⲅⲅⲟⲥ
ⲥⲡⲟⲛⲇⲏ	N	ⲥⲡⲟⲛⲇⲏ
ⲥⲡⲟⲛⲇⲓⲗⲟⲛ	N	ⲥⲡⲟⲛⲇⲓⲗⲟⲛ
ⲥⲡⲟⲛⲧⲓⲗⲟⲛ	N	ⲥⲡⲟⲛⲧⲓⲗⲟⲛ
ⲥⲡⲟⲣⲁ	N	ⲥⲡⲟⲣⲁ
ⲥⲡⲟⲧⲟⲩ	N	ⲥⲡⲟⲧⲟⲩ
ⲥⲡⲟⲩⲇⲁⲍⲉ	V	ⲥⲡⲟⲩⲇⲁⲍⲉ
ⲥⲡⲟⲩⲇⲁⲓⲟⲥ	N	ⲥⲡⲟⲩⲇⲁⲓⲟⲥ
ⲥⲡⲟⲩⲇⲏ	N	ⲥⲡⲟⲩⲇⲏ
ⲥⲡⲥⲱⲡⲉ	V	ⲥⲟⲡⲥⲡ
ⲥⲡⲥⲱⲡ	V	ⲥⲟⲡⲥⲡ
ⲥⲡ	V	ⲥⲡ
ⲥⲣϥⲉ	V	ⲥⲣϥⲉ
ⲥⲣⲁϩⲧ	N	ⲥⲣⲁϩⲧ
ⲥⲣⲉϥⲣⲓϥⲉ	N	ⲥⲣⲉϥⲣⲓϥⲉ
ⲥⲣⲙⲣⲱⲙ	V	ⲥⲣⲟⲙⲣⲙ
ⲥⲣⲟϥⲣϥ	V	ⲥⲣⲟϥⲣϥ
ⲥⲣⲟϥⲣⲉϥ	V	ⲥⲣⲟϥⲣⲉϥ
ⲥⲣⲟϥⲧ	V	ⲥⲣⲟϥⲧ
ⲥⲣ	V	ⲥⲟⲩⲣ
ⲥⲧⲁⲁⲧⲉ	V	ⲥⲧⲁⲁⲧⲉ
ⲥⲧⲁⲅⲱⲛ	N	ⲥⲧⲁⲅⲱⲛ
ⲥⲧⲁⲇⲓⲟⲛ	N	ⲥⲧⲁⲇⲓⲟⲛ
ⲥⲧⲁⲕⲧⲏ	N	ⲥⲧⲁⲕⲧⲏ
ⲥⲧⲁⲥⲓⲁⲍⲉ	V	ⲥⲧⲁⲥⲓⲁⲍⲉ
ⲥⲧⲁⲥⲓⲁⲥⲧⲏⲥ	N	ⲥⲧⲁⲥⲓⲁⲥⲧⲏⲥ
ⲥⲧⲁⲥⲓⲥ	N	ⲥⲧⲁⲥⲓⲥ
ⲥⲧⲁⲩⲗⲟⲛ	N	ⲥⲧⲁⲩⲗⲟⲛ
ⲥⲧⲁⲩⲣⲟⲥ	N	ⲥⲧⲁⲩⲣⲟⲥ
ⲥⲧⲁⲩⲣⲟⲩ	V	ⲥⲧⲁⲩⲣⲟⲩ
ⲥⲧⲁⲫⲩⲗⲏ	N	ⲥⲧⲁⲫⲩⲗⲏ
ⲥⲧⲉⲓⲣⲁ	N	ⲥⲧⲉⲓⲣⲁ
ⲥⲧⲉⲛⲱⲥⲓⲥ	N	ⲥⲧⲉⲛⲱⲥⲓⲥ
ⲥⲧⲉⲣⲉⲟⲙⲁ	N	ⲥⲧⲉⲣⲉⲟⲙⲁ
ⲥⲧⲉⲣⲉⲩⲙⲁ	N	ⲥⲧⲉⲣⲉⲩⲙⲁ
ⲥⲧⲉⲣⲉⲱⲙⲁ	N	ⲥⲧⲉⲣⲉⲱⲙⲁ
ⲥⲧⲉⲫⲁⲛⲁ	N	ⲥⲧⲉⲫⲁⲛⲁ
ⲥⲧⲉⲫⲁⲛⲁ	NPROP	ⲥⲧⲉⲫⲁⲛⲁ
ⲥⲧⲉⲫⲁⲛⲟⲥ	NPROP	ⲥⲧⲉⲫⲁⲛⲟⲥ
ⲥⲧⲉⲫⲁⲛⲟⲩⲫⲟⲣⲟⲥ	N	ⲥⲧⲉⲫⲁⲛⲟⲩⲫⲟⲣⲟⲥ
ⲥⲧⲉⲫⲁⲛⲟⲩ	V	ⲥⲧⲉⲫⲁⲛⲟⲩ
ⲥⲧⲏⲗⲏ	N	ⲥⲧⲏⲗⲏ
ⲥⲧⲏⲗⲟⲅⲣⲁⲫⲓⲁ	N	ⲥⲧⲏⲗⲟⲅⲣⲁⲫⲓⲁ
ⲥⲧⲏⲣⲉⲟⲙⲁ	N	ⲥⲧⲏⲣⲉⲟⲙⲁ
ⲥⲧⲏⲣⲉⲱⲙⲁ	N	ⲥⲧⲏⲣⲉⲱⲙⲁ
ⲥⲧⲏⲫⲁⲛⲟⲥ	NPROP	ⲥⲧⲏⲫⲁⲛⲟⲥ
ⲥⲧⲏⲫⲁⲛⲟⲩ	V	ⲥⲧⲏⲫⲁⲛⲟⲩ
ⲥⲧⲓⲅⲙⲏ	N	ⲥⲧⲓⲅⲙⲏ
ⲥⲧⲓⲍⲉ	V	ⲥⲧⲓⲍⲉ
ⲥⲧⲓⲗⲓⲧⲉⲩⲉ	V	ⲥⲧⲓⲗⲓⲧⲉⲩⲉ
ⲥⲧⲓⲭⲉⲣⲟⲛ	N	ⲥⲧⲓⲭⲉⲣⲟⲛ
ⲥⲧⲓⲭⲟⲥ	N	ⲥⲧⲓⲭⲟⲥ
ⲥⲧⲟⲁ	N	ⲥⲧⲟⲁ
ⲥⲧⲟⲓⲭⲉⲓⲟⲛ	N	ⲥⲧⲟⲓⲭⲉⲓⲟⲛ
ⲥⲧⲟⲓⲭⲉⲓ	V	ⲥⲧⲟⲓⲭⲉⲓ
ⲥⲧⲟⲓⲭⲓⲟⲛ	N	ⲥⲧⲟⲓⲭⲓⲟⲛ
ⲥⲧⲟⲓ	N	ⲥⲧⲟⲓ
ⲥⲧⲟⲗⲁⲣⲭⲏⲥ	N	ⲥⲧⲟⲗⲁⲣⲭⲏⲥ
ⲥⲧⲟⲗⲏ	N	ⲥⲧⲟⲗⲏ
ⲥⲧⲟⲗⲓⲍⲉ	V	ⲥⲧⲟⲗⲓⲍⲉ
ⲥⲧⲟⲗⲟⲧⲟⲥ	N	ⲥⲧⲟⲗⲟⲧⲟⲥ
ⲥⲧⲟⲙⲁⲭⲟⲥ	N	ⲥⲧⲟⲙⲁⲭⲟⲥ
ⲥⲧⲟⲟⲩ	V	ⲥⲧⲟⲟⲩ
ⲥⲧⲟ	V	ⲧⲥⲧⲟ
ⲥⲧⲣⲁⲧⲉⲓⲁ	N	ⲥⲧⲣⲁⲧⲉⲓⲁ
ⲥⲧⲣⲁⲧⲉⲩⲉ	V	ⲥⲧⲣⲁⲧⲉⲩⲉ
ⲥⲧⲣⲁⲧⲉⲩⲙⲁ	N	ⲥⲧⲣⲁⲧⲉⲩⲙⲁ
ⲥⲧⲣⲁⲧⲏⲅⲟⲥ	N	ⲥⲧⲣⲁⲧⲏⲅⲟⲥ
ⲥⲧⲣⲁⲧⲏⲗⲁⲧⲏⲥ	N	ⲥⲧⲣⲁⲧⲏⲗⲁⲧⲏⲥ
ⲥⲧⲣⲁⲧⲓⲁ	N	ⲥⲧⲣⲁⲧⲓⲁ
ⲥⲧⲣⲁⲧⲟⲛⲓⲕⲟⲥ	NPROP	ⲥⲧⲣⲁⲧⲟⲛⲓⲕⲟⲥ
ⲥⲧⲣⲁⲧⲟⲛ	N	ⲥⲧⲣⲁⲧⲟⲛ
ⲥⲧⲣⲁⲧⲟⲡⲉⲇⲁⲣⲭⲟⲥ	N	ⲥⲧⲣⲁⲧⲟⲡⲉⲇⲁⲣⲭⲟⲥ
ⲥⲧⲣⲁⲧⲟⲡⲉⲧⲁⲣⲭⲟⲥ	N	ⲥⲧⲣⲁⲧⲟⲡⲉⲧⲁⲣⲭⲟⲥ
ⲥⲧⲣⲁⲧⲩⲗⲁⲧⲏⲥ	N	ⲥⲧⲣⲁⲧⲩⲗⲁⲧⲏⲥ
ⲥⲧⲣⲁⲧⲱⲡⲉⲧⲱⲛ	N	ⲥⲧⲣⲁⲧⲱⲡⲉⲧⲱⲛ
ⲥⲧⲣⲁⲧⲱⲣ	N	ⲥⲧⲣⲁⲧⲱⲣ
ⲥⲧⲣⲉⲃⲗⲟⲩ	V	ⲥⲧⲣⲉⲃⲗⲟⲩ
ⲥⲧⲣⲟⲅⲓⲗⲗⲟⲥ	N	ⲥⲧⲣⲟⲅⲓⲗⲗⲟⲥ
ⲥⲧⲣⲱⲙⲁ	N	ⲥⲧⲣⲱⲙⲁ
ⲥⲧⲩⲗⲏ	N	ⲥⲧⲩⲗⲏ
ⲥⲧⲩⲗⲗⲏ	N	ⲥⲧⲩⲗⲗⲏ
ⲥⲧⲩⲗⲗⲟⲥ	N	ⲥⲧⲩⲗⲗⲟⲥ
ⲥⲧⲩⲗⲟⲥ	N	ⲥⲧⲩⲗⲟⲥ
ⲥⲧⲩⲣⲁⲝ	N	ⲥⲧⲩⲣⲁⲝ
ⲥⲧⲩⲫⲏ	N	ⲥⲧⲩⲫⲏ
ⲥⲧⲩⲭⲉⲓ	V	ⲥⲧⲩⲭⲉⲓ
ⲥⲧⲱⲧ	N	ⲥⲧⲱⲧ
ⲥⲧⲱⲧ	V	ⲥⲧⲱⲧ
ⲥⲩⲅⲅⲉⲛⲉⲓⲁ	N	ⲥⲩⲅⲅⲉⲛⲉⲓⲁ
ⲥⲩⲅⲅⲉⲛⲏⲥ	N	ⲥⲩⲅⲅⲉⲛⲏⲥ
ⲥⲩⲅⲏ	N	ⲥⲩⲅⲏ
ⲥⲩⲅⲕⲗⲏⲧⲟⲥ	N	ⲥⲩⲅⲕⲗⲏⲧⲟⲥ
ⲥⲩⲅⲕⲣⲓⲙⲁ	N	ⲥⲩⲅⲕⲣⲓⲙⲁ
ⲥⲩⲅⲟⲥ	N	ⲥⲩⲅⲟⲥ
ⲥⲩⲗⲁ	V	ⲥⲩⲗⲁ
ⲥⲩⲗⲉⲩⲉ	V	ⲥⲩⲗⲉⲩⲉ
ⲥⲩⲙⲁⲛⲉ	V	ⲥⲩⲙⲁⲛⲉ
ⲥⲩⲙⲃⲟⲗⲏ	N	ⲥⲩⲙⲃⲟⲗⲏ
ⲥⲩⲙⲃⲟⲗⲟⲛ	N	ⲥⲩⲙⲃⲟⲗⲟⲛ
ⲥⲩⲙⲃⲟⲗⲟⲥ	N	ⲥⲩⲙⲃⲟⲗⲟⲥ
ⲥⲩⲙⲃⲟⲩⲗⲉⲩⲉ	V	ⲥⲩⲙⲃⲟⲩⲗⲉⲩⲉ
ⲥⲩⲙⲃⲟⲩⲗⲓⲁ	N	ⲥⲩⲙⲃⲟⲩⲗⲓⲁ
ⲥⲩⲙⲃⲟⲩⲗⲓⲟⲛ	N	ⲥⲩⲙⲃⲟⲩⲗⲓⲟⲛ
ⲥⲩⲙⲙⲁⲭⲟⲥ	N	ⲥⲩⲙⲙⲁⲭⲟⲥ
ⲥⲩⲙⲙⲉⲧⲟⲭⲟⲥ	N	ⲥⲩⲙⲙⲉⲧⲟⲭⲟⲥ
ⲥⲩⲙⲡⲟⲥⲓⲟⲛ	N	ⲥⲩⲙⲡⲟⲥⲓⲟⲛ
ⲥⲩⲙⲫⲁⲛⲉⲍⲉ	V	ⲥⲩⲙⲫⲁⲛⲉⲍⲉ
ⲥⲩⲙⲫⲉⲣⲉⲓ	V	ⲥⲩⲙⲫⲉⲣⲉⲓ
ⲥⲩⲙⲫⲟⲛⲉⲓ	V	ⲥⲩⲙⲫⲟⲛⲉⲓ
ⲥⲩⲙⲫⲟⲣⲁ	N	ⲥⲩⲙⲫⲟⲣⲁ
ⲥⲩⲙⲫⲱⲛⲉⲓ	V	ⲥⲩⲙⲫⲱⲛⲉⲓ
ⲥⲩⲙⲫⲱⲛⲓⲁ	N	ⲥⲩⲙⲫⲱⲛⲓⲁ
ⲥⲩⲙⲫⲱⲛⲟⲛ	N	ⲥⲩⲙⲫⲱⲛⲟⲛ
ⲥⲩⲛϩⲉⲇⲣⲓⲟⲛ	N	ⲥⲩⲛϩⲉⲇⲣⲓⲟⲛ
ⲥⲩⲛϩⲉⲇⲣⲓⲟⲛ	NPROP	ⲥⲩⲛϩⲉⲇⲣⲓⲟⲛ
ⲥⲩⲛϩⲓⲥⲧⲁ	V	ⲥⲩⲛϩⲓⲥⲧⲁ
ⲥⲩⲛϩⲟⲇⲟⲥ	N	ⲥⲩⲛϩⲟⲇⲟⲥ
ⲥⲩⲛⲁⲅⲉ	V	ⲥⲩⲛⲁⲅⲉ
ⲥⲩⲛⲁⲅⲱⲅⲏ	N	ⲥⲩⲛⲁⲅⲱⲅⲏ
ⲥⲩⲛⲁⲓⲛⲉⲓ	V	ⲥⲩⲛⲁⲓⲛⲉⲓ
ⲥⲩⲛⲁⲛⲧⲏⲙⲁ	N	ⲥⲩⲛⲁⲛⲧⲏⲙⲁ
ⲥⲩⲛⲁⲝⲓⲥ	N	ⲥⲩⲛⲁⲝⲓⲥ
ⲥⲩⲛⲁⲣⲡⲁⲅⲏ	N	ⲥⲩⲛⲁⲣⲡⲁⲅⲏ
ⲥⲩⲛⲃⲟⲏⲑⲉⲓ	V	ⲥⲩⲛⲃⲟⲏⲑⲉⲓ
ⲥⲩⲛⲃⲟⲏⲑⲓⲁ	N	ⲥⲩⲛⲃⲟⲏⲑⲓⲁ
ⲥⲩⲛⲃⲟⲗⲏ	N	ⲥⲩⲛⲃⲟⲗⲏ
ⲥⲩⲛⲅⲛⲱⲙⲏ	N	ⲥⲩⲛⲅⲛⲱⲙⲏ
ⲥⲩⲛⲅⲣⲁⲫⲉⲩⲥ	N	ⲥⲩⲛⲅⲣⲁⲫⲉⲩⲥ
ⲥⲩⲛⲇⲟⲛⲓⲟⲛ	N	ⲥⲩⲛⲇⲟⲛⲓⲟⲛ
ⲥⲩⲛⲉⲓⲇⲏⲥⲓⲥ	N	ⲥⲩⲛⲉⲓⲇⲏⲥⲓⲥ
ⲥⲩⲛⲉⲩⲇⲟⲕⲉⲓ	V	ⲥⲩⲛⲉⲩⲇⲟⲕⲉⲓ
ⲥⲩⲛⲉⲭⲉ	V	ⲥⲩⲛⲉⲭⲉ
ⲥⲩⲛⲍⲏⲧⲉⲓ	V	ⲥⲩⲛⲍⲏⲧⲉⲓ
ⲥⲩⲛⲍⲏⲧⲏⲧⲏⲥ	N	ⲥⲩⲛⲍⲏⲧⲏⲧⲏⲥ
ⲥⲩⲛⲍⲩⲅⲟⲥ	N	ⲥⲩⲛⲍⲩⲅⲟⲥ
ⲥⲩⲛⲏⲇⲏⲥⲓⲥ	N	ⲥⲩⲛⲏⲇⲏⲥⲓⲥ
ⲥⲩⲛⲏⲑⲉⲓⲁ	N	ⲥⲩⲛⲏⲑⲉⲓⲁ
ⲥⲩⲛⲏⲑⲓⲁ	N	ⲥⲩⲛⲏⲑⲓⲁ
ⲥⲩⲛⲏⲗⲑⲁⲓ	V	ⲥⲩⲛⲏⲗⲑⲁⲓ
ⲥⲩⲛⲏⲛⲉⲓ	V	ⲥⲩⲛⲏⲛⲉⲓ
ⲥⲩⲛⲑⲉⲥⲓⲥ	N	ⲥⲩⲛⲑⲉⲥⲓⲥ
ⲥⲩⲛⲑⲏⲧⲟⲛ	N	ⲥⲩⲛⲑⲏⲧⲟⲛ
ⲥⲩⲛⲓⲇⲏⲥⲓⲥ	N	ⲥⲩⲛⲓⲇⲏⲥⲓⲥ
ⲥⲩⲛⲓⲑⲓⲁ	N	ⲥⲩⲛⲓⲑⲓⲁ
ⲥⲩⲛⲕⲁⲑⲉⲇⲣⲟⲥ	N	ⲥⲩⲛⲕⲁⲑⲉⲇⲣⲟⲥ
ⲥⲩⲛⲕⲉⲣⲁ	V	ⲥⲩⲛⲕⲉⲣⲁ
ⲥⲩⲛⲕⲗⲏⲣⲟⲛⲟⲙⲟⲥ	N	ⲥⲩⲛⲕⲗⲏⲣⲟⲛⲟⲙⲟⲥ
ⲥⲩⲛⲕⲗⲏⲧⲓⲕⲏ	NPROP	ⲥⲩⲛⲕⲗⲏⲧⲓⲕⲏ
ⲥⲩⲛⲕⲗⲏⲧⲓⲕⲟⲥ	N	ⲥⲩⲛⲕⲗⲏⲧⲓⲕⲟⲥ
ⲥⲩⲛⲕⲗⲏⲧⲟⲥ	N	ⲥⲩⲛⲕⲗⲏⲧⲟⲥ
ⲥⲩⲛⲟⲩⲥⲓⲁ	N	ⲥⲩⲛⲟⲩⲥⲓⲁ
ⲥⲩⲛⲧⲁⲅⲏ	N	ⲥⲩⲛⲧⲁⲅⲏ
ⲥⲩⲛⲧⲁⲅⲙⲁ	N	ⲥⲩⲛⲧⲁⲅⲙⲁ
ⲥⲩⲛⲧⲁⲍⲉ	V	ⲥⲩⲛⲧⲁⲍⲉ
ⲥⲩⲛⲧⲁⲕⲏ	N	ⲥⲩⲛⲧⲁⲕⲏ
ⲥⲩⲛⲧⲉⲗⲉⲓⲁ	N	ⲥⲩⲛⲧⲉⲗⲉⲓⲁ
ⲥⲩⲛⲧⲉⲗⲓⲁ	N	ⲥⲩⲛⲧⲉⲗⲓⲁ
ⲥⲩⲛⲧⲉⲭⲉ	V	ⲥⲩⲛⲧⲉⲭⲉ
ⲥⲩⲛⲧⲉⲭⲓⲁ	N	ⲥⲩⲛⲧⲉⲭⲓⲁ
ⲥⲩⲛⲧⲏⲭⲓⲁ	N	ⲥⲩⲛⲧⲏⲭⲓⲁ
ⲥⲩⲛⲧⲓⲙⲁⲍⲉ	V	ⲥⲩⲛⲧⲓⲙⲁⲍⲉ
ⲥⲩⲛⲧⲩⲭⲉ	V	ⲥⲩⲛⲧⲩⲭⲉ
ⲥⲩⲛⲭⲱⲣⲉⲓ	V	ⲥⲩⲛⲭⲱⲣⲉⲓ
ⲥⲩⲛⲭⲱⲣⲏⲥⲓⲥ	N	ⲥⲩⲛⲭⲱⲣⲏⲥⲓⲥ
ⲥⲩⲣⲁ	V	ⲥⲩⲣⲁ
ⲥⲩⲣⲉ	V	ⲥⲩⲣⲉ
ⲥⲩⲣⲓⲁ	NPROP	ⲥⲩⲣⲓⲁ
ⲥⲩⲥⲧⲁⲥⲓⲥ	N	ⲥⲩⲥⲧⲁⲥⲓⲥ
ⲥⲩⲥⲧⲣⲟⲫⲉⲓ	V	ⲥⲩⲥⲧⲣⲟⲫⲉⲓ
ⲥⲫⲉⲛⲇⲟⲛⲏ	N	ⲥⲫⲉⲛⲇⲟⲛⲏ
ⲥⲫⲉⲣⲁ	N	ⲥⲫⲉⲣⲁ
ⲥⲫⲗⲁⲅⲛⲟⲛ	N	ⲥⲫⲗⲁⲅⲛⲟⲛ
ⲥⲫⲟⲛⲅⲟⲥ	N	ⲥⲫⲟⲛⲅⲟⲥ
ⲥⲫⲟⲛⲇⲩⲗⲟⲥ	N	ⲥⲫⲟⲛⲇⲩⲗⲟⲥ
ⲥⲫⲣⲁⲅⲓⲍⲉ	V	ⲥⲫⲣⲁⲅⲓⲍⲉ
ⲥⲫⲣⲁⲅⲓⲥ	N	ⲥⲫⲣⲁⲅⲓⲥ
ⲥⲭⲉⲇⲟⲛ	ADV	ⲥⲭⲉⲇⲟⲛ
ⲥⲭⲉⲇⲱⲛ	ADV	ⲥⲭⲉⲇⲱⲛ
ⲥⲭⲏⲙⲁ	N	ⲥⲭⲏⲙⲁ
ⲥⲭⲓⲍⲁ	N	ⲥⲭⲓⲍⲁ
ⲥⲭⲓⲥⲁ	N	ⲥⲭⲓⲥⲁ
ⲥⲭⲓⲥⲙⲁ	N	ⲥⲭⲓⲥⲙⲁ
ⲥⲭⲟⲓⲛⲓⲟⲛ	N	ⲥⲭⲟⲓⲛⲓⲟⲛ
ⲥⲭⲟⲓⲛⲟⲥ	N	ⲥⲭⲟⲓⲛⲟⲥ
ⲥⲭⲟⲗⲁⲍⲉ	V	ⲥⲭⲟⲗⲁⲍⲉ
ⲥⲭⲟⲗⲁⲥⲧⲓⲕⲟⲥ	N	ⲥⲭⲟⲗⲁⲥⲧⲓⲕⲟⲥ
ⲥⲱϣϥ	V	ⲥⲱϣϥ
ⲥⲱϣⲉⲙ	V	ⲥⲱϣⲉⲙ
ⲥⲱϣⲉ	N	ⲥⲱϣⲉ
ⲥⲱϣⲙ	V	ⲥⲱϣⲙ
ⲥⲱϣⲧ	V	ⲥⲱϣⲧ
ⲥⲱϣ	N	ⲥⲱϣ
ⲥⲱϣ	V	ⲥⲱϣ
ⲥⲱϩⲉ	V	ⲥⲱϩⲉ
ⲥⲱϩⲡ	V	ⲥⲱϩⲡ
ⲥⲱϩⲣ	V	ⲥⲱϩⲣ
ⲥⲱϩ	N	ⲥⲱϩ
ⲥⲱⲃϩ	V	ⲥⲱⲃϩ
ⲥⲱⲃⲁϩ	N	ⲥⲱⲃⲁϩ
ⲥⲱⲃⲉ	V	ⲥⲱⲃⲉ
ⲥⲱⲇⲓⲟⲛ	N	ⲥⲱⲇⲓⲟⲛ
ⲥⲱⲕⲣⲁⲧⲏⲥ	NPROP	ⲥⲱⲕⲣⲁⲧⲏⲥ
ⲥⲱⲕ	V	ⲥⲱⲕ
ⲥⲱⲙⲁⲁⲩⲱ	N	ⲥⲱⲙⲁⲁⲩⲱ
ⲥⲱⲙⲁⲕⲁⲓⲁⲓⲙⲁⲭⲣⲓⲥⲧⲟⲩ	N	ⲥⲱⲙⲁⲕⲁⲓⲁⲓⲙⲁⲭⲣⲓⲥⲧⲟⲩ
ⲥⲱⲙⲁⲕⲁⲓⲁⲓⲙⲁ	N	ⲥⲱⲙⲁⲕⲁⲓⲁⲓⲙⲁ
ⲥⲱⲙⲁⲙⲛ	N	ⲥⲱⲙⲁⲙⲛ
ⲥⲱⲙⲁⲧⲓⲍⲉ	V	ⲥⲱⲙⲁⲧⲓⲍⲉ
ⲥⲱⲙⲁⲧⲓⲕⲏ	N	ⲥⲱⲙⲁⲧⲓⲕⲏ
ⲥⲱⲙⲁⲧⲓⲕⲟⲛ	N	ⲥⲱⲙⲁⲧⲓⲕⲟⲛ
ⲥⲱⲙⲁⲧⲓⲕⲟⲥ	N	ⲥⲱⲙⲁⲧⲓⲕⲟⲥ
ⲥⲱⲙⲁ	N	ⲥⲱⲙⲁ
ⲥⲱⲛϩ	V	ⲥⲱⲛϩ
ⲥⲱⲛⲉ	N	ⲥⲱⲛⲉ
ⲥⲱⲛⲧ	N	ⲥⲱⲛⲧ
ⲥⲱⲛⲧ	V	ⲥⲱⲛⲧ
ⲥⲱⲛ	N	ⲥⲱⲛ
ⲥⲱⲟⲩϩⲉϩⲟⲩⲛ	V	ⲥⲱⲟⲩϩⲉϩⲟⲩⲛ
ⲥⲱⲟⲩϩ	V	ⲥⲱⲟⲩϩ
ⲥⲱⲟⲩ	V	ⲥⲱⲟⲩ
ⲥⲱⲣⲉⲙ	V	ⲥⲱⲣⲉⲙ
ⲥⲱⲣⲙ	V	ⲥⲱⲣⲙ
ⲥⲱⲣ	V	ⲥⲱⲣ
ⲥⲱⲥⲑⲉⲛⲏⲥ	N	ⲥⲱⲥⲑⲉⲛⲏⲥ
ⲥⲱⲧϥ	V	ⲥⲱⲧϥ
ⲥⲱⲧⲉ	V	ⲥⲱⲧⲉ
ⲥⲱⲧⲏⲣⲓⲁ	N	ⲥⲱⲧⲏⲣⲓⲁ
ⲥⲱⲧⲏⲣⲓⲭⲟⲥ	NPROP	ⲥⲱⲧⲏⲣⲓⲭⲟⲥ
ⲥⲱⲧⲏⲣ	N	ⲥⲱⲧⲏⲣ
ⲥⲱⲧⲙ	V	ⲥⲱⲧⲙ
ⲥⲱⲧⲡ	N	ⲥⲱⲧⲡ
ⲥⲱⲧⲡ	V	ⲥⲱⲧⲡ
ⲥⲱⲧ	V	ⲥⲱⲧ
ⲥⲱⲫⲟⲥ	N	ⲥⲱⲫⲟⲥ
ⲥⲱⲱϥ	N	ⲥⲱⲱϥ
ⲥⲱⲱϥ	V	ⲥⲱⲱϥ
ⲥⲱⲱⲡ	N	ⲥⲱⲱⲡ
ⲥⲱ	V	ⲥⲱ
ⲥⲱ	VIMP	ⲥⲱ
ⲥ	PPERO	ⲛⲧⲟⲥ
ⲥ	PPERS	ⲛⲧⲟⲥ
ⲧϩⲛⲉ	V	ⲧϩⲛⲉ
ⲧϩⲟ	V	ⲧϩⲟ
ⲧϩⲧⲱϩ	VSTAT	ⲧⲁϩⲧϩ
ⲧϭⲁⲉⲓⲟ	V	ⲧϭⲁⲉⲓⲟ
ⲧϭⲁⲓⲉ	V	ⲧϭⲁⲉⲓⲟ
ⲧϭⲁⲓⲏⲩ	V	ⲧϭⲁⲓⲏⲩ
ⲧϭⲁⲓⲏⲩ	VSTAT	ⲧϭⲁⲓⲏⲩ
ⲧϭⲁⲓⲟ	V	ⲧϭⲁⲉⲓⲟ
ⲧⲁϣⲉⲟⲉⲓϣ	N	ⲧⲁϣⲉⲟⲉⲓϣ
ⲧⲁϣⲉⲟⲉⲓϣ	V	ⲧⲁϣⲉⲟⲉⲓϣ
ⲧⲁϣⲉ	V	ⲧⲁϣⲟ
ⲧⲁϣⲟ	V	ⲧⲁϣⲟ
ⲧⲁϥ	N	ⲧⲁϥ
ⲧⲁϩⲉ	V	ⲧⲁϩⲟ
ⲧⲁϩⲉ	VSTAT	ⲧⲁϩⲟ
ⲧⲁϩⲏⲩ	VSTAT	ⲧⲁϩⲟ
ⲧⲁϩⲙⲉ	V	ⲧⲱϩⲙ
ⲧⲁϩⲙⲉ	VSTAT	ⲧⲱϩⲙ
ⲧⲁϩⲙ	V	ⲧⲱϩⲙ
ⲧⲁϩⲙ	VSTAT	ⲧⲱϩⲙ
ⲧⲁϩⲛⲟ	V	ⲧⲁϩⲛⲟ
ⲧⲁϩⲟ	V	ⲧⲁϩⲟ
ⲧⲁϩⲥ	V	ⲧⲱϩⲥ
ⲧⲁϩⲭ	V	ⲧⲁϩⲭ
ⲧⲁϩⲱⲙ	NPROP	ⲧⲁϩⲱⲙ
ⲧⲁϩⲱ	V	ⲧⲁϩⲱ
ⲧⲁϩ	V	ⲧⲱϩ
ⲧⲁϫⲣⲉ	V	ⲧⲁϫⲣⲟ
ⲧⲁϫⲣⲏⲩ	VSTAT	ⲧⲁϫⲣⲟ
ⲧⲁϫⲣⲟ	V	ⲧⲁϫⲣⲟ
ⲧⲁϭⲥⲉ	N	ⲧⲁϭⲥⲉ
ⲧⲁⲁⲧⲉ	V	ⲧⲁⲁⲧⲉ
ⲧⲁⲁ	V	ϯ
ⲧⲁⲅⲙⲁ	N	ⲧⲁⲅⲙⲁ
ⲧⲁⲉⲓⲏⲩ	VSTAT	ⲧⲁⲉⲓⲟ
ⲧⲁⲉⲓⲟⲛⲧⲉⲑⲉ	CONJ	ⲧⲁⲉⲓⲟⲛⲧⲉⲑⲉ
ⲧⲁⲉⲓⲟⲛⲧⲉⲧϩⲉ	CONJ	ⲧⲁⲉⲓⲟⲛⲧⲉⲧϩⲉ
ⲧⲁⲉⲓⲟ	N	ⲧⲁⲉⲓⲟ
ⲧⲁⲉⲓⲟ	V	ⲧⲁⲉⲓⲟ
ⲧⲁⲓⲉ	V	ⲧⲁⲉⲓⲟ
ⲧⲁⲓⲏⲩ	VSTAT	ⲧⲁⲉⲓⲟ
ⲧⲁⲓⲟⲛⲧⲉⲑⲉ	ADV	ⲧⲁⲓⲟⲛⲧⲉⲑⲉ
ⲧⲁⲓⲟⲛⲧⲉⲧϩⲉ	CONJ	ⲧⲁⲓⲟⲛⲧⲉⲧϩⲉ
ⲧⲁⲓⲟⲩ	N	ⲧⲁⲓⲟⲩ
ⲧⲁⲓⲟ	V	ⲧⲁⲓⲟ
ⲧⲁⲓⲧⲉⲑⲉⲛ	PREP	ⲧⲁⲓⲧⲉⲑⲉⲛ
ⲧⲁⲓⲧⲉⲑⲉ	ADV	ⲧⲁⲓⲧⲉⲑⲉ
ⲧⲁⲓ	PDEM	ⲡⲁⲓ
ⲧⲁⲕⲉ	V	ⲧⲁⲕⲟ
ⲧⲁⲕⲏⲩ	VSTAT	ⲧⲁⲕⲟ
ⲧⲁⲕⲟ	N	ⲧⲁⲕⲟ
ⲧⲁⲕⲟ	V	ⲧⲁⲕⲟ
ⲧⲁⲗϭⲉ	V	ⲧⲁⲗϭⲟ
ⲧⲁⲗϭⲟ	N	ⲧⲁⲗϭⲟ
ⲧⲁⲗϭⲟ	V	ⲧⲁⲗϭⲟ
ⲧⲁⲗⲁⲓⲡⲟⲣⲉⲓ	V	ⲧⲁⲗⲁⲓⲡⲟⲣⲉⲓ
ⲧⲁⲗⲁⲓⲡⲟⲣⲟⲥ	N	ⲧⲁⲗⲁⲓⲡⲟⲣⲟⲥ
ⲧⲁⲗⲁⲓⲡⲱⲣⲉⲓ	V	ⲧⲁⲗⲁⲓⲡⲱⲣⲉⲓ
ⲧⲁⲗⲁⲓⲡⲱⲣⲓⲁ	N	ⲧⲁⲗⲁⲓⲡⲱⲣⲓⲁ
ⲧⲁⲗⲁⲓⲡⲱⲣⲟⲥ	N	ⲧⲁⲗⲁⲓⲡⲱⲣⲟⲥ
ⲧⲁⲗⲉⲓⲑⲁ	NPROP	ⲧⲁⲗⲉⲓⲑⲁ
ⲧⲁⲗⲉⲡⲟⲣⲉⲓ	V	ⲧⲁⲗⲉⲡⲟⲣⲉⲓ
ⲧⲁⲗⲉⲡⲱⲣⲉⲓ	V	ⲧⲁⲗⲉⲡⲱⲣⲉⲓ
ⲧⲁⲗⲉ	V	ⲧⲁⲗⲉ
ⲧⲁⲗⲏⲩ	VSTAT	ⲧⲁⲗⲟ
ⲧⲁⲗⲟⲉϩⲣⲁⲓ	V	ⲧⲁⲗⲟⲉϩⲣⲁⲓ
ⲧⲁⲗⲟ	V	ⲧⲁⲗⲟ
ⲧⲁⲙⲁⲥⲕⲟⲥ	NPROP	ⲧⲁⲙⲁⲥⲕⲟⲥ
ⲧⲁⲙⲉⲓⲉ	V	ⲧⲁⲙⲓⲟ
ⲧⲁⲙⲉⲓⲟⲛ	N	ⲧⲁⲙⲉⲓⲟⲛ
ⲧⲁⲙⲉⲓⲟ	V	ⲧⲁⲙⲓⲟ
ⲧⲁⲙⲉ	V	ⲧⲁⲙⲟ
ⲧⲁⲙⲓⲉ	V	ⲧⲁⲙⲓⲟ
ⲧⲁⲙⲓⲟ	V	ⲧⲁⲙⲓⲟ
ⲧⲁⲙⲙⲁ	NPROP	ⲧⲁⲙⲙⲁ
ⲧⲁⲙⲙⲉ	V	ⲧⲁⲙⲙⲉ
ⲧⲁⲙⲟⲓ	N	ⲧⲁⲙⲟ
ⲧⲁⲙⲟ	N	ⲧⲁⲙⲟ
ⲧⲁⲙⲟ	V	ⲧⲁⲙⲟ
ⲧⲁⲙⲟ	VIMP	ⲧⲁⲙⲟ
ⲧⲁⲙⲱ	V	ⲧⲁⲙⲟ
ⲧⲁⲛϩⲉⲧ	V	ⲧⲁⲛϩⲟⲩⲧ
ⲧⲁⲛϩⲉ	V	ⲧⲁⲛϩⲟ
ⲧⲁⲛϩⲟⲩⲧ	V	ⲧⲁⲛϩⲟⲩⲧ
ⲧⲁⲛϩⲟ	V	ⲧⲁⲛϩⲟ
ⲧⲁⲛϯⲟⲭⲓⲁ	NPROP	ⲧⲁⲛϯⲟⲭⲓⲁ
ⲧⲁⲛⲇⲓⲟⲭⲓⲁ	NPROP	ⲧⲁⲛⲇⲓⲟⲭⲓⲁ
ⲧⲁⲛⲓⲥⲧⲏⲥ	N	ⲧⲁⲛⲓⲥⲧⲏⲥ
ⲧⲁⲛⲟⲩⲃⲓⲥ	NPROP	ⲧⲁⲛⲟⲩⲃⲓⲥ
ⲧⲁⲛⲧⲓⲟⲭⲓⲁ	NPROP	ⲧⲁⲛⲧⲓⲟⲭⲓⲁ
ⲧⲁⲝⲓⲥ	N	ⲧⲁⲝⲓⲥ
ⲧⲁⲝⲓⲱⲧⲏⲥ	N	ⲧⲁⲝⲓⲱⲧⲏⲥ
ⲧⲁⲟⲩⲉ	V	ⲧⲁⲩⲟ
ⲧⲁⲟⲩⲟ	V	ⲧⲁⲩⲟ
ⲧⲁⲡⲣⲟ	N	ⲧⲁⲡⲣⲟ
ⲧⲁⲣⲁⲥⲥⲉ	V	ⲧⲁⲣⲁⲥⲥⲉ
ⲧⲁⲣⲁⲭⲏ	N	ⲧⲁⲣⲁⲭⲏ
ⲧⲁⲣⲁⲭⲟⲥ	N	ⲧⲁⲣⲁⲭⲟⲥ
ⲧⲁⲣⲉ	AFUTCONJ	ⲧⲁⲣⲉ
ⲧⲁⲣⲓⲭⲓⲟⲛ	N	ⲧⲁⲣⲓⲭⲓⲟⲛ
ⲧⲁⲣⲕⲟ	V	ⲧⲁⲣⲕⲟ
ⲧⲁⲣⲙⲟⲥ	N	ⲧⲁⲣⲙⲟⲥ
ⲧⲁⲣⲥⲟⲥ	NPROP	ⲧⲁⲣⲥⲟⲥ
ⲧⲁⲣⲧⲁⲣⲟⲛ	N	ⲧⲁⲣⲧⲁⲣⲟⲛ
ⲧⲁⲣⲧⲁⲣⲟⲥ	N	ⲧⲁⲣⲧⲁⲣⲟⲥ
ⲧⲁⲣ	AFUTCONJ	ⲧⲁⲣ
ⲧⲁⲣe	AFUTCONJ	ⲧⲁⲣe
ⲧⲁⲥⲥⲉ	V	ⲧⲁⲥⲥⲉ
ⲧⲁⲥⲭⲓⲥⲁ	N	ⲧⲁⲥⲭⲓⲥⲁ
ⲧⲁⲩⲉⲥϩⲃⲏⲓⲧⲉ	V	ⲧⲁⲩⲉⲥϩⲃⲏⲓⲧⲉ
ⲧⲁⲩⲉ	V	ⲧⲁⲩⲟ
ⲧⲁⲩⲟⲩⲟ	V	ⲧⲁⲩⲟ
ⲧⲁⲩⲟ	V	ⲧⲁⲩⲟ
ⲧⲁⲩⲣⲟⲥ	N	ⲧⲁⲩⲣⲟⲥ
ⲧⲁⲫⲟⲥ	N	ⲧⲁⲫⲟⲥ
ⲧⲁⲭⲁ	ADV	ⲧⲁⲭⲁ
ⲧⲁⲭⲏ	ADV	ⲧⲁⲭⲏ
ⲧⲁⲭⲩ	N	ⲧⲁⲭⲩ
ⲧⲁ	ACONJ_PPERS	ⲛⲧⲉ_ⲁⲛⲟⲕ
ⲧⲁ	PPERS	ⲧⲁ
ⲧⲁ	PPOS	ⲡⲁ
ⲧⲃⲁ	N	ⲧⲃⲁ
ⲧⲃⲁ	NUM	ⲧⲃⲁ
ⲧⲃⲃⲉ	V	ⲧⲃⲃⲟ
ⲧⲃⲃⲏⲩ	VSTAT	ⲧⲃⲃⲟ
ⲧⲃⲃⲟ	N	ⲧⲃⲃⲟ
ⲧⲃⲃⲟ	V	ⲧⲃⲃⲟ
ⲧⲃⲏⲣ	N	ⲧⲃⲏⲣ
ⲧⲃⲛⲏ	N	ⲧⲃⲛⲏ
ⲧⲃⲛⲟⲟⲩⲉ	N	ⲧⲃⲛⲏ
ⲧⲃⲧ	N	ⲧⲃⲧ
ⲧⲉϣ	V	ⲧⲉϣ
ⲧⲉϣ-ⲡⲣⲉⲥⲃⲩⲧⲉⲣⲟⲥ	N	ⲧⲉϣ-ⲡⲣⲉⲥⲃⲩⲧⲉⲣⲟⲥ
ⲧⲉϥ	PPOS	ⲡⲉϥ
ⲧⲉϩⲙ	V	ⲧⲉϩⲙ
ⲧⲉϩⲛⲉ	V	ⲧⲉϩⲛⲉ
ⲧⲉϩⲥ	V	ⲧⲉϩⲥ
ⲧⲉϩⲧⲱϩ	VSTAT	ⲧⲁϩⲧϩ
ⲧⲉⲃⲥ	V	ⲧⲱⲃⲥ
ⲧⲉⲃⲧ	N	ⲧⲉⲃⲧ
ⲧⲉⲓϩⲉ	ADV	ⲧⲉⲓϩⲉ
ⲧⲉⲓⲙⲓⲛⲉ	N	ⲧⲉⲓⲙⲓⲛⲉ
ⲧⲉⲓ	ART	ⲧⲉⲓ
ⲧⲉⲓ	PDEM	ⲡⲉⲓ
ⲧⲉⲓ	V	ⲧⲉⲓ
ⲧⲉⲕⲁⲧⲏⲥ	N	ⲧⲉⲕⲁⲧⲏⲥ
ⲧⲉⲕⲙ	V	ⲧⲱⲕⲙ
ⲧⲉⲕ	PPOS	ⲡⲉⲕ
ⲧⲉⲗϯⲗⲉ	N	ⲧⲉⲗϯⲗⲉ
ⲧⲉⲗⲉⲓⲁ	N	ⲧⲉⲗⲉⲓⲁ
ⲧⲉⲗⲉⲓⲟⲛ	N	ⲧⲉⲗⲉⲓⲟⲛ
ⲧⲉⲗⲉⲓⲟⲥ	N	ⲧⲉⲗⲉⲓⲟⲥ
ⲧⲉⲗⲉⲱⲥ	ADV	ⲧⲉⲗⲉⲱⲥ
ⲧⲉⲗⲏⲗ	V	ⲧⲉⲗⲏⲗ
ⲧⲉⲗⲓ	V	ⲧⲉⲗⲓ
ⲧⲉⲗⲟⲥ	N	ⲧⲉⲗⲟⲥ
ⲧⲉⲗⲱⲛⲏⲥ	N	ⲧⲉⲗⲱⲛⲏⲥ
ⲧⲉⲗⲱⲛⲓⲟⲛ	N	ⲧⲉⲗⲱⲛⲓⲟⲛ
ⲧⲉⲛⲛⲟⲟⲩⲥ	V	ⲧⲉⲛⲛⲟⲟⲩⲥ
ⲧⲉⲛⲛⲟⲟⲩ	V	ⲧⲉⲛⲛⲟⲟⲩ
ⲧⲉⲛⲟⲩ	ADV	ⲧⲉⲛⲟⲩ
ⲧⲉⲛⲧⲏⲩⲧⲛ	V	ⲧⲉⲛⲧⲏⲩⲧⲛ
ⲧⲉⲛⲧⲱⲛⲧ	V	ⲧⲟⲛⲧⲛ
ⲧⲉⲛ	PPOS	ⲡⲉⲛ
ⲧⲉⲣⲉⲃⲓⲛⲑⲟⲥ	N	ⲧⲉⲣⲉⲃⲓⲛⲑⲟⲥ
ⲧⲉⲣⲟⲙⲡⲉ	ADV	ⲧⲉⲣⲟⲙⲡⲉ
ⲧⲉⲣⲯⲓⲥ	N	ⲧⲉⲣⲯⲓⲥ
ⲧⲉⲣⲱⲧⲁϣⲁⲛⲥ	NPROP	ⲧⲉⲣⲱⲧⲁϣⲁⲛⲥ
ⲧⲉⲣⲱⲧ	NPROP	ⲧⲉⲣⲱⲧ
ⲧⲉⲥⲉⲣⲁⲕⲟⲥⲧⲉ	N	ⲧⲉⲥⲉⲣⲁⲕⲟⲥⲧⲉ
ⲧⲉⲥⲥⲁⲣⲉⲥⲕⲁⲓⲇⲉⲕⲁⲧⲏ	N	ⲧⲉⲥⲥⲁⲣⲉⲥⲕⲁⲓⲇⲉⲕⲁⲧⲏ
ⲧⲉⲥ	PPOS	ⲡⲉⲥ
ⲧⲉⲧⲁⲣⲧⲏⲥ	N	ⲧⲉⲧⲁⲣⲧⲏⲥ
ⲧⲉⲧⲁⲣⲧⲟⲛ	N	ⲧⲉⲧⲁⲣⲧⲟⲛ
ⲧⲉⲧⲛ	PPERS	ⲛⲧⲱⲧⲛ
ⲧⲉⲧⲛ	PPOS	ⲡⲉⲧⲛ
ⲧⲉⲧⲣⲁⲅⲱⲛⲟⲛ	N	ⲧⲉⲧⲣⲁⲅⲱⲛⲟⲛ
ⲧⲉⲧⲣⲁⲡⲩⲗⲟⲛ	N	ⲧⲉⲧⲣⲁⲡⲩⲗⲟⲛ
ⲧⲉⲧⲣⲁⲡⲩⲗⲱⲛ	N	ⲧⲉⲧⲣⲁⲡⲩⲗⲱⲛ
ⲧⲉⲧⲣⲁⲣⲭⲏⲥ	N	ⲧⲉⲧⲣⲁⲣⲭⲏⲥ
ⲧⲉⲧⲣⲁⲥ	N	ⲧⲉⲧⲣⲁⲥ
ⲧⲉⲧ	N	ⲧⲉⲧ
ⲧⲉⲧ	PPERS	ⲧⲉⲧ
ⲧⲉⲩⲧⲉⲣⲟⲛⲟⲙⲓⲟⲛ	N	ⲧⲉⲩⲧⲉⲣⲟⲛⲟⲙⲓⲟⲛ
ⲧⲉⲩ	PPOS	ⲡⲉⲩ
ⲧⲉⲭⲛⲉ	N	ⲧⲉⲭⲛⲉ
ⲧⲉⲭⲛⲏ	N	ⲧⲉⲭⲛⲏ
ⲧⲉⲭⲛⲓⲧⲏⲥ	N	ⲧⲉⲭⲛⲓⲧⲏⲥ
ⲧⲉⲱⲥ	ADV	ⲧⲉⲱⲥ
ⲧⲉ	ART	ⲡ
ⲧⲉ	COP	ⲡⲉ
ⲧⲉ	PPERO	ⲛⲧⲟ
ⲧⲉ	PPERS	ⲛⲧⲟ
ⲧⲉ	UNKNOWN	ⲧⲉ
ⲧⲏϣ	VSTAT	ⲧⲱϣ
ⲧⲏⲃⲧ	N	ⲧⲏⲃⲧ
ⲧⲏⲏⲃⲉ	N	ⲧⲏⲏⲃⲉ
ⲧⲏⲕⲛϩⲏⲧ	VSTAT	ⲧⲏⲕⲛϩⲏⲧ
ⲧⲏⲕ	VSTAT	ⲧⲱⲕ
ⲧⲏⲙⲟⲥ	N	ⲧⲏⲙⲟⲥ
ⲧⲏⲙ	ADV	ⲧⲏⲙ
ⲧⲏⲙ	VSTAT	ⲧⲏⲙ
ⲧⲏⲛϩ	N	ⲧⲏⲛϩ
ⲧⲏⲛⲟⲩ	ADV	ⲧⲏⲛⲟⲩ
ⲧⲏⲛⲟⲩ	N	ⲧⲏⲛⲟⲩ
ⲧⲏⲣϥ	N	ⲧⲏⲣϥ
ⲧⲏⲣⲉⲓ	V	ⲧⲏⲣⲉⲓ
ⲧⲏⲣⲏⲃ	NPROP	ⲧⲏⲣⲏⲃ
ⲧⲏⲣⲓ	V	ⲧⲏⲣⲓ
ⲧⲏⲣ	IMOD	ⲧⲏⲣ
ⲧⲏⲣ	Q	ⲧⲏⲣ
ⲧⲏⲧⲛ	V	ⲧⲏⲧⲛ
ⲧⲏⲩⲗⲟ	N	ⲧⲏⲩⲗⲟ
ⲧⲏⲩⲧⲛ	PPERO	ⲛⲧⲱⲧⲛ
ⲧⲏⲩ	N	ⲧⲏⲩ
ⲧⲏ	N	ⲧⲏ
ⲧⲓϩⲉ	ADV	ⲧⲓϩⲉ
ⲧⲓⲙⲁⲓⲟⲥ	NPROP	ⲧⲓⲙⲁⲓⲟⲥ
ⲧⲓⲙⲁ	V	ⲧⲓⲙⲁ
ⲧⲓⲙⲉ	N	ⲧⲓⲙⲉ
ⲧⲓⲙⲏ	N	ⲧⲓⲙⲏ
ⲧⲓⲙⲓⲛⲉ	N	ⲧⲓⲙⲓⲛⲉ
ⲧⲓⲙⲓⲱⲧⲁⲧⲟⲥ	N	ⲧⲓⲙⲓⲱⲧⲁⲧⲟⲥ
ⲧⲓⲙⲓⲱⲧⲏⲥ	N	ⲧⲓⲙⲓⲱⲧⲏⲥ
ⲧⲓⲙⲟⲑⲉⲟⲥ	NPROP	ⲧⲓⲙⲟⲑⲉⲟⲥ
ⲧⲓⲙⲟⲣⲉⲓⲁ	N	ⲧⲓⲙⲟⲣⲉⲓⲁ
ⲧⲓⲙⲟⲣⲉⲓ	V	ⲧⲓⲙⲟⲣⲉⲓ
ⲧⲓⲙⲟⲣⲓⲁ	N	ⲧⲓⲙⲟⲣⲓⲁ
ⲧⲓⲙⲟⲣⲓ	V	ⲧⲓⲙⲟⲣⲓ
ⲧⲓⲙⲱⲣⲉⲓⲁ	N	ⲧⲓⲙⲱⲣⲉⲓⲁ
ⲧⲓⲙⲱⲣⲉⲓ	V	ⲧⲓⲙⲱⲣⲉⲓ
ⲧⲓⲙⲱⲣⲓⲁ	N	ⲧⲓⲙⲱⲣⲓⲁ
ⲧⲓⲙⲱⲣⲓ	V	ⲧⲓⲙⲱⲣⲓ
ⲧⲓⲟⲩ	N	ⲧⲓⲟⲩ
ⲧⲓⲟⲩ	NUM	ⲧⲓⲟⲩ
ⲧⲓⲡⲉ	N	ⲧⲓⲡⲉ
ⲧⲓⲣⲱⲛ	N	ⲧⲓⲣⲱⲛ
ⲧⲓⲧⲗⲟⲥ	N	ⲧⲓⲧⲗⲟⲥ
ⲧⲓ	N	ⲧⲓ
ⲧⲕⲁⲥ	N	ⲧⲕⲁⲥ
ⲧⲕⲱⲟⲩ	NPROP	ⲧⲕⲱⲟⲩ
ⲧⲗϯⲗⲉ	N	ⲧⲗϯⲗⲉ
ⲧⲗⲧⲓⲗⲉ	N	ⲧⲗⲧⲓⲗⲉ
ⲧⲙⲁⲉⲓⲏⲩ	VSTAT	ⲧⲙⲁⲉⲓⲟ
ⲧⲙⲁⲉⲓⲟ	V	ⲧⲙⲁⲉⲓⲟ
ⲧⲙⲁⲓⲏⲩ	VSTAT	ⲧⲙⲁⲉⲓⲟ
ⲧⲙⲁⲓⲟⲕ	V	ⲧⲙⲁⲉⲓⲟ
ⲧⲙⲁⲓⲟ	V	ⲧⲙⲁⲓⲟ
ⲧⲙⲉ	N	ⲧⲙⲉ
ⲧⲙⲏ	N	ⲧⲙⲏ
ⲧⲙⲙⲟⲩⲣ	V	ⲧⲙⲙⲟⲩⲣ
ⲧⲙⲙⲟ	N	ⲧⲙⲙⲟ
ⲧⲙⲙⲟ	V	ⲧⲙⲙⲟ
ⲧⲙⲟ	V	ⲧⲙⲙⲟ
ⲧⲙ	NEG	ⲧⲙ
ⲧⲙ	V	ⲧⲙ
ⲧⲛϩ	N	ⲧⲛϩ
ⲧⲛⲛⲉⲩ	V	ⲧⲛⲛⲉⲩ
ⲧⲛⲛⲟⲟⲩ	V	ⲧⲛⲛⲟⲟⲩ
ⲧⲛⲛⲟ	V	ⲧⲛⲛⲟ
ⲧⲛⲧⲛ	V	ⲧⲛⲧⲛ
ⲧⲛⲧⲱⲛ	V	ⲧⲟⲛⲧⲛ
ⲧⲛⲧⲱⲛ	VSTAT	ⲧⲟⲛⲧⲛ
ⲧⲛ	PPERO	ⲁⲛⲟⲛ
ⲧⲛ	PPERO	ⲛⲧⲱⲧⲛ
ⲧⲛ	PPERS	ⲁⲛⲟⲛ
ⲧⲟϣ	N	ⲧⲱϣ
ⲧⲟϣ	V	ⲧⲱϣ
ⲧⲟϭⲉ	V	ⲧⲱⲱϭⲉ
ⲧⲟϭ	V	ⲧⲱⲱϭⲉ
ⲧⲟⲃⲥ	V	ⲧⲱⲃⲥ
ⲧⲟⲉⲓⲥ	N	ⲧⲟⲉⲓⲥ
ⲧⲟⲉⲓⲧ	N	ⲧⲟⲉⲓⲧ
ⲧⲟⲉⲓⲧ	V	ⲧⲟⲉⲓⲧ
ⲧⲟⲓⲥ	N	ⲧⲟⲓⲥ
ⲧⲟⲕⲙⲁⲇⲓⲕⲟⲥ	N	ⲧⲟⲕⲙⲁⲇⲓⲕⲟⲥ
ⲧⲟⲕⲙⲁⲧⲓⲕⲟⲛ	N	ⲧⲟⲕⲙⲁⲧⲓⲕⲟⲛ
ⲧⲟⲕⲙ	VSTAT	ⲧⲱⲕⲙ
ⲧⲟⲕⲝⲟⲧⲟⲥ	N	ⲧⲟⲕⲝⲟⲧⲟⲥ
ⲧⲟⲕ	VSTAT	ⲧⲱⲕ
ⲧⲟⲗⲉⲙⲁⲓⲟⲥ	NPROP	ⲧⲟⲗⲉⲙⲁⲓⲟⲥ
ⲧⲟⲗⲉⲙⲉⲟⲥ	NPROP	ⲧⲟⲗⲉⲙⲉⲟⲥ
ⲧⲟⲗⲉⲙⲟⲛ	N	ⲧⲟⲗⲉⲙⲟⲛ
ⲧⲟⲗⲙⲁ	V	ⲧⲟⲗⲙⲁ
ⲧⲟⲗⲙⲉⲥⲓⲁ	N	ⲧⲟⲗⲙⲉⲥⲓⲁ
ⲧⲟⲗⲙⲏⲣⲓⲁ	N	ⲧⲟⲗⲙⲏⲣⲓⲁ
ⲧⲟⲗⲙⲏⲣⲟⲥ	N	ⲧⲟⲗⲙⲏⲣⲟⲥ
ⲧⲟⲗⲙ	N	ⲧⲟⲗⲙ
ⲧⲟⲗⲟⲓⲡⲟⲛ	N	ⲧⲟⲗⲟⲓⲡⲟⲛ
ⲧⲟⲗⲟⲙⲁⲓⲟⲥ	NPROP	ⲧⲟⲗⲟⲙⲁⲓⲟⲥ
ⲧⲟⲗⲟⲙⲁ	V	ⲧⲟⲗⲟⲙⲁ
ⲧⲟⲗⲟⲙⲉⲟⲥ	NPROP	ⲧⲟⲗⲟⲙⲉⲟⲥ
ⲧⲟⲙⲁⲣⲓⲟⲛ	N	ⲧⲟⲙⲁⲣⲓⲟⲛ
ⲧⲟⲙⲉⲥⲧⲓⲕⲟⲥ	N	ⲧⲟⲙⲉⲥⲧⲓⲕⲟⲥ
ⲧⲟⲙⲟⲥ	N	ⲧⲟⲙⲟⲥ
ⲧⲟⲙⲥ	V	ⲧⲱⲙⲥ
ⲧⲟⲙⲥ	VSTAT	ⲧⲱⲙⲥ
ⲧⲟⲛⲟⲩ	ADV	ⲧⲟⲛⲟⲩ
ⲧⲟⲛⲧⲉⲛ	V	ⲧⲟⲛⲧⲉⲛ
ⲧⲟⲛⲧⲛ	V	ⲧⲟⲛⲧⲛ
ⲧⲟⲝⲟⲧⲏⲥ	N	ⲧⲟⲝⲟⲧⲏⲥ
ⲧⲟⲟⲃⲉ	VSTAT	ⲧⲱⲱⲃⲉ
ⲧⲟⲟⲃ	V	ⲧⲱⲱⲃⲉ
ⲧⲟⲟⲧⲟⲩ	N	ⲧⲟⲟⲧⲟⲩ
ⲧⲟⲟⲧ	N	ⲧⲱⲣⲉ
ⲧⲟⲟⲧ	PREP	ⲧⲟⲟⲧ
ⲧⲟⲟⲩⲉ	N	ⲧⲟⲟⲩⲉ
ⲧⲟⲟⲩ	N	ⲧⲟⲟⲩ
ⲧⲟⲡⲁⲇⲓⲟⲛ	N	ⲧⲟⲡⲁⲇⲓⲟⲛ
ⲧⲟⲡⲟⲡⲓⲟⲥ	N	ⲧⲟⲡⲟⲡⲓⲟⲥ
ⲧⲟⲡⲟⲥ	N	ⲧⲟⲡⲟⲥ
ⲧⲟⲡ	N	ⲧⲟⲡ
ⲧⲟⲣϩ	VSTAT	ⲧⲱⲣϩ
ⲧⲟⲣⲡ	V	ⲧⲱⲣⲡ
ⲧⲟⲧⲉ	ADV	ⲧⲟⲧⲉ
ⲧⲟⲩϩⲱ	NPROP	ⲧⲟⲩϩⲱ
ⲧⲟⲩϫⲉ	V	ⲧⲟⲩϫⲟ
ⲧⲟⲩϫⲏⲩ	VSTAT	ⲧⲟⲩϫⲟ
ⲧⲟⲩϫⲟ	V	ⲧⲟⲩϫⲟ
ⲧⲟⲩⲉϩⲥⲟⲓ	N	ⲧⲟⲩⲉϩⲥⲟⲓ
ⲧⲟⲩⲉⲓⲏ	N	ⲧⲟⲟⲩ
ⲧⲟⲩⲉⲓⲟ	V	ⲧⲟⲩⲉⲓⲟ
ⲧⲟⲩⲓⲏ	N	ⲧⲟⲩⲓⲏ
ⲧⲟⲩⲓⲟ	V	ⲧⲟⲩⲓⲟ
ⲧⲟⲩⲛⲉⲉⲓⲁⲁⲧ	V	ⲧⲟⲩⲛⲉⲓⲁ
ⲧⲟⲩⲛⲉⲉⲓⲁⲁ	V	ⲧⲟⲩⲛⲉⲓⲁ
ⲧⲟⲩⲛⲉⲓⲁⲧ	V	ⲧⲟⲩⲛⲉⲓⲁ
ⲧⲟⲩⲛⲉⲥ	V	ⲧⲟⲩⲛⲟⲥ
ⲧⲟⲩⲛⲟⲥ	V	ⲧⲟⲩⲛⲟⲥ
ⲧⲟⲩⲛ	V	ⲧⲟⲩⲛ
ⲧⲟⲩⲟⲟⲧⲉ	N	ⲧⲟⲩⲱⲧ
ⲧⲟⲩⲟⲧⲉ	N	ⲧⲟⲩⲱⲧ
ⲧⲟⲩⲣⲏⲥ	N	ⲧⲟⲩⲣⲏⲥ
ⲧⲟⲩⲧⲟ	FM	ⲧⲟⲩⲧⲟ
ⲧⲟⲩⲱⲧ	N	ⲧⲟⲩⲱⲧ
ⲧⲟⲩⲱ	PREP	ⲧⲟⲩⲱ
ⲧⲟⲩ	PPOS	ⲡⲟⲩ
ⲧⲟ	N	ⲧⲟ
ⲧⲟ	VSTAT	ⲧⲟ
ⲧⲟ ⲧⲉⲱⲥ	ADV	ⲧⲟ ⲧⲉⲱⲥ
ⲧⲡⲉ	N	ⲧⲡⲉ
ⲧⲣⲁⲡⲉⲍⲁ	N	ⲧⲣⲁⲡⲉⲍⲁ
ⲧⲣⲉ	ACAUS	ⲧⲣⲉ
ⲧⲣⲓⲁⲇⲓⲕⲟⲛ	N	ⲧⲣⲓⲁⲇⲓⲕⲟⲛ
ⲧⲣⲓⲁⲥ	N	ⲧⲣⲓⲁⲥ
ⲧⲣⲓⲃⲏ	N	ⲧⲣⲓⲃⲏ
ⲧⲣⲓⲃⲟⲗⲗⲟⲥ	N	ⲧⲣⲓⲃⲟⲗⲗⲟⲥ
ⲧⲣⲓⲃⲟⲩⲛⲟⲥ	N	ⲧⲣⲓⲃⲟⲩⲛⲟⲥ
ⲧⲣⲓⲅⲉⲛⲉⲑⲗⲟⲥ	N	ⲧⲣⲓⲅⲉⲛⲉⲑⲗⲟⲥ
ⲧⲣⲓⲅⲉⲛⲏⲥ	N	ⲧⲣⲓⲅⲉⲛⲏⲥ
ⲧⲣⲓⲇⲩⲛⲁⲙⲓⲥ	N	ⲧⲣⲓⲇⲩⲛⲁⲙⲓⲥ
ⲧⲣⲓⲇⲩⲛⲁⲙⲟⲥ	N	ⲧⲣⲓⲇⲩⲛⲁⲙⲟⲥ
ⲧⲣⲓⲕⲟⲛ	N	ⲧⲣⲓⲕⲟⲛ
ⲧⲣⲓⲙⲏⲥⲓⲟⲛ	N	ⲧⲣⲓⲙⲏⲥⲓⲟⲛ
ⲧⲣⲓⲡⲟⲥ	N	ⲧⲣⲓⲡⲟⲥ
ⲧⲣⲓⲥϩⲁⲅⲓⲉ	N	ⲧⲣⲓⲥϩⲁⲅⲓⲉ
ⲧⲣⲓⲥⲁⲣⲥⲏⲥ	N	ⲧⲣⲓⲥⲁⲣⲥⲏⲥ
ⲧⲣⲓⲥⲙⲁⲕⲁⲣⲓⲟⲥ	N	ⲧⲣⲓⲥⲙⲁⲕⲁⲣⲓⲟⲥ
ⲧⲣⲓⲥⲙⲉⲅⲓⲥⲧⲉ	N	ⲧⲣⲓⲥⲙⲉⲅⲓⲥⲧⲉ
ⲧⲣⲓⲥⲙⲉⲅⲓⲥⲧⲟⲥ	N	ⲧⲣⲓⲥⲙⲉⲅⲓⲥⲧⲟⲥ
ⲧⲣⲓⲧⲏⲥ	N	ⲧⲣⲓⲧⲏⲥ
ⲧⲣⲓⲧⲟⲛ	N	ⲧⲣⲓⲧⲟⲛ
ⲧⲣⲟⲙⲟⲥ	N	ⲧⲣⲟⲙⲟⲥ
ⲧⲣⲟⲡⲉⲟⲛ	N	ⲧⲣⲟⲡⲉⲟⲛ
ⲧⲣⲟⲡⲟⲥ	N	ⲧⲣⲟⲡⲟⲥ
ⲧⲣⲟⲫⲏ	N	ⲧⲣⲟⲫⲏ
ⲧⲣⲟⲭⲟⲥ	N	ⲧⲣⲟⲭⲟⲥ
ⲧⲣⲣⲉ	V	ⲧⲣⲣⲉ
ⲧⲣⲩⲫⲁ	V	ⲧⲣⲩⲫⲁ
ⲧⲣⲩⲫⲏ	N	ⲧⲣⲩⲫⲏ
ⲧⲣⲩⲫⲩⲣⲓⲟⲛ	N	ⲧⲣⲩⲫⲩⲣⲓⲟⲛ
ⲧⲣⲱⲫⲏ	N	ⲧⲣⲱⲫⲏ
ⲧⲣ	ACAUS	ⲧⲣ
ⲧⲥⲁⲃⲉⲓⲁ	V	ⲧⲥⲁⲃⲟ
ⲧⲥⲁⲃⲉ	V	ⲧⲥⲁⲃⲉ
ⲧⲥⲁⲃⲓⲁ	V	ⲧⲥⲁⲃⲟ
ⲧⲥⲁⲃⲟ	V	ⲧⲥⲁⲃⲟ
ⲧⲥⲁⲃⲱ	V	ⲧⲥⲁⲃⲟ
ⲧⲥⲁⲉⲓⲟ	V	ⲧⲥⲁⲉⲓⲟ
ⲧⲥⲁⲓⲟ	V	ⲧⲥⲁⲓⲟ
ⲧⲥⲁⲛⲉ	V	ⲧⲥⲁⲛⲟ
ⲧⲥⲁⲛⲟⲥ	V	ⲧⲥⲁⲛⲟ
ⲧⲥⲁⲛⲟ	V	ⲧⲥⲁⲛⲟ
ⲧⲥⲃ	V	ⲧⲥⲃ
ⲧⲥⲉⲃⲉ	V	ⲧⲥⲉⲃⲉ
ⲧⲥⲉⲓⲁ	V	ⲧⲥⲟ
ⲧⲥⲉⲓⲟ	V	ⲧⲥⲉⲓⲟ
ⲧⲥⲉⲛⲕⲟ	V	ⲧⲥⲉⲛⲕⲟ
ⲧⲥⲉ	V	ⲧⲥⲟ
ⲧⲥⲓⲉ	V	ⲧⲥⲓⲉ
ⲧⲥⲓⲟ	V	ⲧⲥⲓⲟ
ⲧⲥⲛⲕⲟ	V	ⲧⲥⲛⲕⲟ
ⲧⲥⲟ	V	ⲧⲥⲟ
ⲧⲥⲧⲉ	V	ⲧⲥⲧⲉ
ⲧⲥⲧⲏⲩ	VSTAT	ⲧⲥⲧⲟ
ⲧⲥⲧⲟ	V	ⲧⲥⲧⲟ
ⲧⲩⲡⲟⲥ	N	ⲧⲩⲡⲟⲥ
ⲧⲩⲡⲟⲩ	V	ⲧⲩⲡⲟⲩ
ⲧⲩⲣⲁⲛⲛⲟⲥ	N	ⲧⲩⲣⲁⲛⲛⲟⲥ
ⲧⲩⲣⲁⲛⲟⲥ	NPROP	ⲧⲩⲣⲁⲛⲟⲥ
ⲧⲩⲣⲟⲥ	NPROP	ⲧⲩⲣⲟⲥ
ⲧⲩⲫⲱⲛ	N	ⲧⲩⲫⲱⲛ
ⲧⲩⲭⲏ	N	ⲧⲩⲭⲏ
ⲧⲱϣ	V	ⲧⲱϣ
ⲧⲱϩⲙ	N	ⲧⲱϩⲙ
ⲧⲱϩⲙ	V	ⲧⲱϩⲙ
ⲧⲱϩ	N	ⲧⲱϩ
ⲧⲱϩ	V	ⲧⲱϩ
ⲧⲱϭⲉ	V	ⲧⲱϭⲉ
ⲧⲱϭⲛ	V	ⲧⲱϭⲛ
ⲧⲱϭⲥ	V	ⲧⲱϭⲥ
ⲧⲱϭ	V	ⲧⲱϭ
ⲧⲱⲃϩ	V	ⲧⲱⲃϩ
ⲧⲱⲃⲉ	V	ⲧⲱⲃⲉ
ⲧⲱⲃⲥ	V	ⲧⲱⲃⲥ
ⲧⲱⲇⲓⲕⲁⲓⲧⲏⲥ	N	ⲧⲱⲇⲓⲕⲁⲓⲧⲏⲥ
ⲧⲱⲕⲓⲙⲁⲥⲓⲁ	N	ⲧⲱⲕⲓⲙⲁⲥⲓⲁ
ⲧⲱⲕⲙ	V	ⲧⲱⲕⲙ
ⲧⲱⲕⲛϩⲏⲧ	V	ⲧⲱⲕⲛϩⲏⲧ
ⲧⲱⲕⲥ	V	ⲧⲱⲕⲥ
ⲧⲱⲕ	V	ⲧⲱⲕ
ⲧⲱⲗⲙ	V	ⲧⲱⲗⲙ
ⲧⲱⲗⲱⲙⲁ	V	ⲧⲱⲗⲱⲙⲁ
ⲧⲱⲙⲛⲧ	V	ⲧⲱⲙⲛⲧ
ⲧⲱⲙⲣⲱ	V	ⲧⲱⲙⲣⲟ
ⲧⲱⲙⲥ	V	ⲧⲱⲙⲥ
ⲧⲱⲙⲧ	V	ⲧⲱⲙⲧ
ⲧⲱⲙ	N	ⲧⲱⲙ
ⲧⲱⲙ	V	ⲧⲱⲙ
ⲧⲱⲛⲉ	ADV	ⲧⲱⲛⲉ
ⲧⲱⲛⲟⲩ	ADV	ⲧⲱⲛⲟⲩ
ⲧⲱⲛ	ADV	ⲧⲱⲛ
ⲧⲱⲛ	N	ⲧⲱⲛ
ⲧⲱⲛ	PINT	ⲧⲱⲛ
ⲧⲱⲟⲩⲛ	V	ⲧⲱⲟⲩⲛ
ⲧⲱⲡⲟⲥ	N	ⲧⲱⲡⲟⲥ
ⲧⲱⲡ	N	ⲧⲱⲡ
ⲧⲱⲣⲡ	V	ⲧⲱⲣⲡ
ⲧⲱⲥ	V	ⲧⲱⲥ
ⲧⲱⲧⲛϩⲏⲧ	V	ⲧⲱⲧⲛϩⲏⲧ
ⲧⲱⲧ	N	ⲧⲱⲧ
ⲧⲱⲧ	V	ⲧⲱⲧ
ⲧⲱⲱⲃⲉ	V	ⲧⲱⲱⲃⲉ
ⲧⲱⲱⲙⲉ	V	ⲧⲱⲱⲙⲉ
ⲧ	ART	ⲡ
ⲧ	NPROP	ⲧ
ⲧ	PPERO	ⲁⲛⲟⲕ
ⲧ	UNKNOWN	ⲧ
ⲧ	V	ⲧ
ⲩϣⲏ	N	ⲩϣⲏ
ⲩϣⲟⲟⲩⲉ	N	ⲟⲩϣⲏ
ⲩϩⲟⲟⲣ	N	ⲟⲩϩⲟⲟⲣ
ⲩϩⲟⲣ	N	ⲩϩⲟⲣ
ⲩⲃⲣⲓⲥ	N	ⲩⲃⲣⲓⲥ
ⲩⲓⲟⲥ	N	ⲩⲓⲟⲥ
ⲩⲛⲟⲩ	ADV	ⲩⲛⲟⲩ
ⲩⲛⲟⲩ	N	ⲩⲛⲟⲩ
ⲩⲛⲧⲁ	EXIST	ⲟⲩⲛⲧⲁ
ⲩⲛⲧⲉ	EXIST	ⲟⲩⲛⲧⲁ
ⲩⲛⲧ	EXIST	ⲟⲩⲛⲧⲁ
ⲩⲛ	EXIST	ⲟⲩⲛ
ⲩⲟⲉⲓϣ	N	ⲟⲩⲟⲉⲓϣ
ⲩⲟⲩⲟⲉⲓ	N	ⲩⲟⲩⲟⲉⲓ
ⲩⲡⲟⲭⲟⲛⲇⲣⲓⲟⲥ	N	ⲩⲡⲟⲭⲟⲛⲇⲣⲓⲟⲥ
ⲩ	ART	ⲟⲩ
ⲩ	PPERO	ⲛⲧⲟⲟⲩ
ⲩ	PPERS	ⲛⲧⲟⲟⲩ
ⲫⲁⲕⲓⲁⲣⲓⲟⲛ	N	ⲫⲁⲕⲓⲁⲣⲓⲟⲛ
ⲫⲁⲛⲉⲣⲓⲟⲥ	N	ⲫⲁⲛⲉⲣⲓⲟⲥ
ⲫⲁⲛⲉⲣⲟⲛ	ADV	ⲫⲁⲛⲉⲣⲟⲛ
ⲫⲁⲛⲉⲣⲟⲩ	V	ⲫⲁⲛⲉⲣⲟⲩ
ⲫⲁⲛⲉⲣⲱⲥⲓⲥ	N	ⲫⲁⲛⲉⲣⲱⲥⲓⲥ
ⲫⲁⲛⲓⲁ	N	ⲫⲁⲛⲓⲁ
ⲫⲁⲛⲟⲥ	N	ⲫⲁⲛⲟⲥ
ⲫⲁⲛⲟⲩⲏⲗ	NPROP	ⲫⲁⲛⲟⲩⲏⲗ
ⲫⲁⲛⲧⲁⲥⲓⲁ	N	ⲫⲁⲛⲧⲁⲥⲓⲁ
ⲫⲁⲛⲧⲁⲥⲙⲁ	N	ⲫⲁⲛⲧⲁⲥⲙⲁ
ⲫⲁⲣⲁⲅⲝ	N	ⲫⲁⲣⲁⲅⲝ
ⲫⲁⲣⲁⲱ	NPROP	ⲫⲁⲣⲁⲱ
ⲫⲁⲣⲉⲥ	NPROP	ⲫⲁⲣⲉⲥ
ⲫⲁⲣⲓⲥⲁⲓⲟⲥ	N	ⲫⲁⲣⲓⲥⲁⲓⲟⲥ
ⲫⲁⲣⲓⲥⲥⲁⲓⲟⲥ	N	ⲫⲁⲣⲓⲥⲥⲁⲓⲟⲥ
ⲫⲁⲣⲓⲥⲥⲁⲓⲟⲥ	NPROP	ⲫⲁⲣⲓⲥⲥⲁⲓⲟⲥ
ⲫⲁⲣⲙⲁⲅⲟⲛ	N	ⲫⲁⲣⲙⲁⲅⲟⲛ
ⲫⲁⲣⲙⲁⲅⲟⲥ	N	ⲫⲁⲣⲙⲁⲅⲟⲥ
ⲫⲁⲣⲙⲁⲕⲓⲁ	N	ⲫⲁⲣⲙⲁⲕⲓⲁ
ⲫⲁⲣⲣⲓⲥⲁⲓⲟⲥ	N	ⲫⲁⲣⲣⲓⲥⲁⲓⲟⲥ
ⲫⲁⲥⲓⲥ	N	ⲫⲁⲥⲓⲥ
ⲫⲁⲧⲏⲣ	N	ⲫⲁⲧⲏⲣ
ⲫⲁⲩⲗⲟⲥ	N	ⲫⲁⲩⲗⲟⲥ
ⲫⲁⲩⲥⲧⲟⲥ	NPROP	ⲫⲁⲩⲥⲧⲟⲥ
ⲫⲉⲅⲅⲟⲕⲁⲧⲟⲭⲟⲥ	N	ⲫⲉⲅⲅⲟⲕⲁⲧⲟⲭⲟⲥ
ⲫⲉⲙⲁⲛⲁⲣⲓⲟⲛ	N	ⲫⲉⲙⲁⲛⲁⲣⲓⲟⲛ
ⲫⲉⲛⲉⲥⲑⲁⲓ	V	ⲫⲉⲛⲉⲥⲑⲁⲓ
ⲫⲉⲣⲉⲍⲁⲓⲟⲥ	N	ⲫⲉⲣⲉⲍⲁⲓⲟⲥ
ⲫⲉⲥⲏⲥ	N	ⲫⲉⲥⲏⲥ
ⲫⲏⲗⲓⲝ	NPROP	ⲫⲏⲗⲓⲝ
ⲫⲑⲟⲛⲉⲓ	V	ⲫⲑⲟⲛⲉⲓ
ⲫⲑⲟⲛⲏⲣⲓⲁ	N	ⲫⲑⲟⲛⲏⲣⲓⲁ
ⲫⲑⲟⲛⲏⲣⲟⲥ	N	ⲫⲑⲟⲛⲏⲣⲟⲥ
ⲫⲑⲟⲛⲓ	V	ⲫⲑⲟⲛⲓ
ⲫⲑⲟⲛⲟⲥ	N	ⲫⲑⲟⲛⲟⲥ
ⲫⲓⲁⲗⲏ	N	ⲫⲓⲁⲗⲏ
ⲫⲓⲃ	NPROP	ⲫⲓⲃ
ⲫⲓⲗⲁⲣⲭⲏⲥ	N	ⲫⲓⲗⲁⲣⲭⲏⲥ
ⲫⲓⲗⲉⲥⲧⲁⲧⲟⲥ	N	ⲫⲓⲗⲉⲥⲧⲁⲧⲟⲥ
ⲫⲓⲗⲓⲕⲣⲓⲛⲏⲥ	N	ⲫⲓⲗⲓⲕⲣⲓⲛⲏⲥ
ⲫⲓⲗⲓⲡⲡⲟⲥ	NPROP	ⲫⲓⲗⲓⲡⲡⲟⲥ
ⲫⲓⲗⲟⲇⲱⲛⲓ̈ⲁ	N	ⲫⲓⲗⲟⲇⲱⲛⲓ̈ⲁ
ⲫⲓⲗⲟⲑⲉⲟⲥ	NPROP	ⲫⲓⲗⲟⲑⲉⲟⲥ
ⲫⲓⲗⲟⲑⲉⲥ	NPROP	ⲫⲓⲗⲟⲑⲉⲥ
ⲫⲓⲗⲟⲕⲁⲗⲉⲓ	V	ⲫⲓⲗⲟⲕⲁⲗⲉⲓ
ⲫⲓⲗⲟⲕⲁⲗⲓⲁ	N	ⲫⲓⲗⲟⲕⲁⲗⲓⲁ
ⲫⲓⲗⲟⲕⲁⲗⲟⲥ	N	ⲫⲓⲗⲟⲕⲁⲗⲟⲥ
ⲫⲓⲗⲟⲛⲓⲕⲏ	V	ⲫⲓⲗⲟⲛⲓⲕⲏ
ⲫⲓⲗⲟⲡⲟⲛⲓⲁ	N	ⲫⲓⲗⲟⲡⲟⲛⲓⲁ
ⲫⲓⲗⲟⲡⲟⲛⲟⲥ	N	ⲫⲓⲗⲟⲡⲟⲛⲟⲥ
ⲫⲓⲗⲟⲥⲟⲫⲉⲓ	V	ⲫⲓⲗⲟⲥⲟⲫⲉⲓ
ⲫⲓⲗⲟⲥⲟⲫⲓⲁ	N	ⲫⲓⲗⲟⲥⲟⲫⲓⲁ
ⲫⲓⲗⲟⲥⲟⲫⲟⲥ	N	ⲫⲓⲗⲟⲥⲟⲫⲟⲥ
ⲫⲓⲛⲉⲉⲥ	NPROP	ⲫⲓⲛⲉⲉⲥ
ⲫⲗⲉⲯ	N	ⲫⲗⲉⲯ
ⲫⲗⲩⲁⲣⲟⲥ	N	ⲫⲗⲩⲁⲣⲟⲥ
ⲫⲟⲃⲟⲥ	N	ⲫⲟⲃⲟⲥ
ⲫⲟⲓⲃⲁⲙⲙⲱⲛ	NPROP	ⲫⲟⲓⲃⲁⲙⲙⲱⲛ
ⲫⲟⲓⲛⲓⲕⲏ	NPROP	ⲫⲟⲓⲛⲓⲕⲏ
ⲫⲟⲓⲛⲓⲝ	N	ⲫⲟⲓⲛⲓⲝ
ⲫⲟⲛⲉⲩⲥ	N	ⲫⲟⲛⲉⲩⲥ
ⲫⲟⲛⲟⲥ	N	ⲫⲟⲛⲟⲥ
ⲫⲟⲣⲉⲓ	V	ⲫⲟⲣⲉⲓ
ⲫⲟⲣⲓ	V	ⲫⲟⲣⲓ
ⲫⲟⲣⲟⲥ	N	ⲫⲟⲣⲟⲥ
ⲫⲣⲁⲅⲉⲗⲗⲓⲟⲛ	N	ⲫⲣⲁⲅⲉⲗⲗⲓⲟⲛ
ⲫⲣⲁⲅⲉⲗⲗⲟⲩ	V	ⲫⲣⲁⲅⲉⲗⲗⲟⲩ
ⲫⲣⲁⲅⲙⲟⲥ	N	ⲫⲣⲁⲅⲙⲟⲥ
ⲫⲣⲁⲥⲓⲥ	N	ⲫⲣⲁⲥⲓⲥ
ⲫⲣⲟⲛⲉⲓ	V	ⲫⲣⲟⲛⲉⲓ
ⲫⲣⲟⲛⲏⲥⲓⲥ	N	ⲫⲣⲟⲛⲏⲥⲓⲥ
ⲫⲩⲗⲁⲅⲙⲁ	N	ⲫⲩⲗⲁⲅⲙⲁ
ⲫⲩⲗⲁⲕⲏ	N	ⲫⲩⲗⲁⲕⲏ
ⲫⲩⲗⲁⲕⲧⲏⲣⲓⲟⲛ	N	ⲫⲩⲗⲁⲕⲧⲏⲣⲓⲟⲛ
ⲫⲩⲗⲁⲝ	N	ⲫⲩⲗⲁⲝ
ⲫⲩⲗⲏ	N	ⲫⲩⲗⲏ
ⲫⲩⲗⲓⲝ	NPROP	ⲫⲩⲗⲓⲝ
ⲫⲩⲗⲟⲡⲟⲛⲟⲥ	N	ⲫⲩⲗⲟⲡⲟⲛⲟⲥ
ⲫⲩⲥⲉⲓ	ADV	ⲫⲩⲥⲉⲓ
ⲫⲩⲥⲉⲱⲥ	N	ⲫⲩⲥⲉⲱⲥ
ⲫⲩⲥⲓⲕⲏ	N	ⲫⲩⲥⲓⲕⲏ
ⲫⲩⲥⲓⲕⲟⲛ	N	ⲫⲩⲥⲓⲕⲟⲛ
ⲫⲩⲥⲓⲥ	N	ⲫⲩⲥⲓⲥ
ⲫⲩⲥⲓ	ADV	ⲫⲩⲥⲓ
ⲫⲱϭⲉ	V	ⲫⲱϭⲉ
ⲫⲱⲃ	N	ⲫⲱⲃ
ⲫⲱⲛⲏ	N	ⲫⲱⲛⲏ
ⲫⲱⲣⲉⲓ	V	ⲫⲱⲣⲉⲓ
ⲫⲱⲣⲓⲥⲙⲁ	N	ⲫⲱⲣⲓⲥⲙⲁ
ⲫⲱⲥⲧⲏⲣ	N	ⲫⲱⲥⲧⲏⲣ
ⲫⲱⲥⲫⲟⲣ̣ⲟⲥ	N	ⲫⲱⲥⲫⲟⲣ̣ⲟⲥ
ⲭⲁⲉⲓⲣⲉ	PTC	ⲭⲁⲉⲓⲣⲉ
ⲭⲁⲏⲗ	NPROP	ⲭⲁⲏⲗ
ⲭⲁⲓⲣⲉⲓⲛ	V	ⲭⲁⲓⲣⲉⲓⲛ
ⲭⲁⲓⲣⲉⲧⲉ	PTC	ⲭⲁⲓⲣⲉⲧⲉ
ⲭⲁⲓⲣⲉ	PTC	ⲭⲁⲓⲣⲉ
ⲭⲁⲓⲣⲉ	V	ⲭⲁⲓⲣⲉ
ⲭⲁⲓⲣⲉ	VIMP	ⲭⲁⲓⲣⲉ
ⲭⲁⲗⲁⲍⲁ	N	ⲭⲁⲗⲁⲍⲁ
ⲭⲁⲗⲁⲛⲏ	NPROP	ⲭⲁⲗⲁⲛⲏ
ⲭⲁⲗⲁ	V	ⲭⲁⲗⲁ
ⲭⲁⲗⲃⲁⲛⲏ	N	ⲭⲁⲗⲃⲁⲛⲏ
ⲭⲁⲗⲇⲁⲓⲟⲥ	N	ⲭⲁⲗⲇⲁⲓⲟⲥ
ⲭⲁⲗⲓⲛⲟⲥ	N	ⲭⲁⲗⲓⲛⲟⲥ
ⲭⲁⲗⲓⲛⲟⲩ	V	ⲭⲁⲗⲓⲛⲟⲩ
ⲭⲁⲗⲕⲉⲇⲱⲛ	NPROP	ⲭⲁⲗⲕⲉⲇⲱⲛ
ⲭⲁⲗⲕⲏⲇⲱⲛ	NPROP	ⲭⲁⲗⲕⲏⲇⲱⲛ
ⲭⲁⲗⲕⲓⲛ	N	ⲭⲁⲗⲕⲓⲛ
ⲭⲁⲗⲕⲓⲟⲛ	N	ⲭⲁⲗⲕⲓⲟⲛ
ⲭⲁⲗⲕⲩⲇⲱⲛ	NPROP	ⲭⲁⲗⲕⲩⲇⲱⲛ
ⲭⲁⲙⲁⲓⲗⲉⲱⲛ	N	ⲭⲁⲙⲁⲓⲗⲉⲱⲛ
ⲭⲁⲙⲱⲥ	N	ⲭⲁⲙⲱⲥ
ⲭⲁⲛⲁⲁⲛ	NPROP	ⲭⲁⲛⲁⲁⲛ
ⲭⲁⲛⲁⲛⲁⲓⲁ	NPROP	ⲭⲁⲛⲁⲛⲁⲓⲁ
ⲭⲁⲛⲁⲛⲁⲓⲟⲥ	N	ⲭⲁⲛⲁⲛⲁⲓⲟⲥ
ⲭⲁⲛⲁⲛⲓⲧⲓⲥ	N	ⲭⲁⲛⲁⲛⲓⲧⲓⲥ
ⲭⲁⲟⲥ	N	ⲭⲁⲟⲥ
ⲭⲁⲣⲁⲕⲧⲏⲣ	N	ⲭⲁⲣⲁⲕⲧⲏⲣ
ⲭⲁⲣⲓⲍⲉⲥⲑⲉ	V	ⲭⲁⲣⲓⲍⲉⲥⲑⲉ
ⲭⲁⲣⲓⲍⲉ	V	ⲭⲁⲣⲓⲍⲉ
ⲭⲁⲣⲓⲥⲙⲁ	N	ⲭⲁⲣⲓⲥⲙⲁ
ⲭⲁⲣⲓⲥ	N	ⲭⲁⲣⲓⲥ
ⲭⲁⲣⲓⲧⲥⲱⲛ	N	ⲭⲁⲣⲓⲧⲥⲱⲛ
ⲭⲁⲣⲧⲏⲥ	N	ⲭⲁⲣⲧⲏⲥ
ⲭⲉⲓⲙⲁⲣⲣⲟⲥ	N	ⲭⲉⲓⲙⲁⲣⲣⲟⲥ
ⲭⲉⲓⲙⲏⲧⲓ	V	ⲭⲉⲓⲙⲏⲧⲓ
ⲭⲉⲓⲣⲟⲅⲣⲁⲫⲟⲛ	N	ⲭⲉⲓⲣⲟⲅⲣⲁⲫⲟⲛ
ⲭⲉⲓⲣⲟⲧⲟⲛⲉⲓ	V	ⲭⲉⲓⲣⲟⲧⲟⲛⲉⲓ
ⲭⲉⲓⲣⲟⲧⲟⲛⲓⲁ	N	ⲭⲉⲓⲣⲟⲧⲟⲛⲓⲁ
ⲭⲉⲣⲟⲩⲃⲓⲙ	N	ⲭⲉⲣⲟⲩⲃⲓⲙ
ⲭⲉⲣⲟⲩⲃⲓⲛ	N	ⲭⲉⲣⲟⲩⲃⲓⲛ
ⲭⲉⲧⲧⲁⲓⲟⲥ	N	ⲭⲉⲧⲧⲁⲓⲟⲥ
ⲭⲏⲣⲁ	N	ⲭⲏⲣⲁ
ⲭⲏⲣⲉⲩⲉ	V	ⲭⲏⲣⲉⲩⲉ
ⲭⲓⲗⲓⲁⲣⲭⲟⲥ	N	ⲭⲓⲗⲓⲁⲣⲭⲟⲥ
ⲭⲓⲙⲁⲣⲣⲁⲓⲥ	N	ⲭⲓⲙⲁⲣⲣⲁⲓⲥ
ⲭⲓⲙⲱⲛ	N	ⲭⲓⲙⲱⲛ
ⲭⲓⲣⲟⲇⲟⲛⲓⲁ	N	ⲭⲓⲣⲟⲇⲟⲛⲓⲁ
ⲭⲓⲱⲛⲟⲥ	N	ⲭⲓⲱⲛⲟⲥ
ⲭⲓⲱⲛ	N	ⲭⲓⲱⲛ
ⲭⲗⲁⲙⲩⲥ	N	ⲭⲗⲁⲙⲩⲥ
ⲭⲗⲉⲩⲁⲍⲉ	V	ⲭⲗⲉⲩⲁⲍⲉ
ⲭⲗⲟⲏ	NPROP	ⲭⲗⲟⲏ
ⲭⲟⲓⲁⲭ	NPROP	ⲭⲟⲓⲁⲭ
ⲭⲟⲓⲕⲟⲥ	N	ⲭⲟⲓⲕⲟⲥ
ⲭⲟⲓⲣⲟⲅⲩⲗⲓⲟⲛ	N	ⲭⲟⲓⲣⲟⲅⲩⲗⲓⲟⲛ
ⲭⲟⲗⲏ	N	ⲭⲟⲗⲏ
ⲭⲟⲛⲉⲩⲧⲟⲛ	N	ⲭⲟⲛⲉⲩⲧⲟⲛ
ⲭⲟⲣⲁ	N	ⲭⲟⲣⲁ
ⲭⲟⲣⲇⲏ	N	ⲭⲟⲣⲇⲏ
ⲭⲟⲣⲉⲅⲉⲓ	V	ⲭⲟⲣⲉⲅⲉⲓ
ⲭⲟⲣⲉⲕⲓ	V	ⲭⲟⲣⲉⲕⲓ
ⲭⲟⲣⲉⲩⲉ	V	ⲭⲟⲣⲉⲩⲉ
ⲭⲟⲣⲏⲅⲓⲁ	N	ⲭⲟⲣⲏⲅⲓⲁ
ⲭⲟⲣⲏⲙⲁ	N	ⲭⲟⲣⲏⲙⲁ
ⲭⲟⲣⲓⲟⲛ	N	ⲭⲟⲣⲓⲟⲛ
ⲭⲟⲣⲟⲥ	N	ⲭⲟⲣⲟⲥ
ⲭⲟⲣⲧⲟⲥ	N	ⲭⲟⲣⲧⲟⲥ
ⲭⲟⲣⲩⲅⲉⲓ	V	ⲭⲟⲣⲩⲅⲉⲓ
ⲭⲟⲣⲩⲙⲁ	N	ⲭⲟⲣⲩⲙⲁ
ⲭⲟⲩⲥ	N	ⲭⲟⲩⲥ
ⲭⲣⲁⲓⲟⲥ	N	ⲭⲣⲁⲓⲟⲥ
ⲭⲣⲁⲥⲑⲁⲓ	V	ⲭⲣⲁⲥⲑⲁⲓ
ⲭⲣⲉⲓⲁ	N	ⲭⲣⲉⲓⲁ
ⲭⲣⲉⲓⲥⲧⲓⲁⲛⲟⲥ	N	ⲭⲣⲉⲓⲥⲧⲓⲁⲛⲟⲥ
ⲭⲣⲉⲱⲥⲧⲉⲓ	V	ⲭⲣⲉⲱⲥⲧⲉⲓ
ⲭⲣⲉⲱⲥⲧⲓⲕⲟⲛ	N	ⲭⲣⲉⲱⲥⲧⲓⲕⲟⲛ
ⲭⲣⲏⲙⲁϯⲕⲟⲛ	N	ⲭⲣⲏⲙⲁϯⲕⲟⲛ
ⲭⲣⲏⲙⲁⲧⲓⲍⲉ	V	ⲭⲣⲏⲙⲁⲧⲓⲍⲉ
ⲭⲣⲏⲙⲁⲧⲓⲕⲟⲛ	N	ⲭⲣⲏⲙⲁⲧⲓⲕⲟⲛ
ⲭⲣⲏⲙⲁ	N	ⲭⲣⲏⲙⲁ
ⲭⲣⲏⲥϯⲁⲛⲟⲥ	N	ⲭⲣⲏⲥϯⲁⲛⲟⲥ
ⲭⲣⲏⲥⲓⲙⲟⲛ	N	ⲭⲣⲏⲥⲓⲙⲟⲛ
ⲭⲣⲏⲥⲓⲙⲱⲛ	N	ⲭⲣⲏⲥⲓⲙⲱⲛ
ⲭⲣⲏⲥⲙⲟⲥ	N	ⲭⲣⲏⲥⲙⲟⲥ
ⲭⲣⲏⲥⲧⲏⲣⲓⲟⲛ	N	ⲭⲣⲏⲥⲧⲏⲣⲓⲟⲛ
ⲭⲣⲏⲥⲧⲓⲁⲛⲟⲥ	N	ⲭⲣⲏⲥⲧⲓⲁⲛⲟⲥ
ⲭⲣⲏⲥⲧⲟⲥ	N	ⲭⲣⲏⲥⲧⲟⲥ
ⲭⲣⲏⲱⲥⲧⲓ	V	ⲭⲣⲏⲱⲥⲧⲓ
ⲭⲣⲓⲁ	N	ⲭⲣⲓⲁ
ⲭⲣⲓⲥϯⲁⲛⲟⲥ	N	ⲭⲣⲓⲥϯⲁⲛⲟⲥ
ⲭⲣⲓⲥⲓⲙⲱⲛ	N	ⲭⲣⲓⲥⲓⲙⲱⲛ
ⲭⲣⲓⲥⲙⲁ	N	ⲭⲣⲓⲥⲙⲁ
ⲭⲣⲓⲥⲧⲓⲁⲛⲏ	NPROP	ⲭⲣⲓⲥⲧⲓⲁⲛⲏ
ⲭⲣⲓⲥⲧⲓⲁⲛⲟⲥ	N	ⲭⲣⲓⲥⲧⲓⲁⲛⲟⲥ
ⲭⲣⲓⲥⲧⲟⲥ	N	ⲭⲣⲓⲥⲧⲟⲥ
ⲭⲣⲓⲥⲧⲟⲥ	NPROP	ⲭⲣⲓⲥⲧⲟⲥ
ⲭⲣⲥ	NPROP	ⲭⲣⲥ
ⲭⲣⲓⲥⲧⲟⲫⲟⲣⲟⲥ	NPROP	ⲭⲣⲓⲥⲧⲟⲫⲟⲣⲟⲥ
ⲭⲣⲟⲛⲟⲥ	N	ⲭⲣⲟⲛⲟⲥ
ⲭⲣⲩⲥⲓⲥ	N	ⲭⲣⲩⲥⲓⲥ
ⲭⲣⲩⲥⲟⲗⲓⲛⲑⲟⲥ	N	ⲭⲣⲩⲥⲟⲗⲓⲛⲑⲟⲥ
ⲭⲣⲩⲥⲟⲡⲗⲁⲥⲱⲥ	N	ⲭⲣⲩⲥⲟⲡⲗⲁⲥⲱⲥ
ⲭⲣⲩⲱⲥⲧⲉ	V	ⲭⲣⲩⲱⲥⲧⲉ
ⲭⲣⲱⲙⲁ	N	ⲭⲣⲱⲙⲁ
ⲭⲣⲱ	V	ⲭⲣⲱ
ⲭⲱⲣⲁⲩⲗⲏⲥ	N	ⲭⲱⲣⲁⲩⲗⲏⲥ
ⲭⲱⲣⲁ	N	ⲭⲱⲣⲁ
ⲭⲱⲣⲉⲩⲉ	V	ⲭⲱⲣⲉⲩⲉ
ⲭⲱⲣⲏⲃ	NPROP	ⲭⲱⲣⲏⲃ
ⲭⲱⲣⲏⲅⲉⲓ	V	ⲭⲱⲣⲏⲅⲉⲓ
ⲭⲱⲣⲏⲅⲓⲁ	N	ⲭⲱⲣⲏⲅⲓⲁ
ⲭⲱⲣⲏⲙⲁ	N	ⲭⲱⲣⲏⲙⲁ
ⲭⲱⲣⲓⲛ	V	ⲭⲱⲣⲓⲛ
ⲭⲱⲣⲓⲟⲛ	N	ⲭⲱⲣⲓⲟⲛ
ⲭⲱⲣⲓⲥ	PREP	ⲭⲱⲣⲓⲥ
ⲭⲱⲣⲓ	V	ⲭⲱⲣⲓ
ⲯⲁⲗⲉⲓ	V	ⲯⲁⲗⲉⲓ
ⲯⲁⲗⲗⲉⲓ	V	ⲯⲁⲗⲗⲉⲓ
ⲯⲁⲗⲗⲏ	V	ⲯⲁⲗⲗⲏ
ⲯⲁⲗⲗⲓ	V	ⲯⲁⲗⲗⲓ
ⲯⲁⲗⲙⲟⲥ	N	ⲯⲁⲗⲙⲟⲥ
ⲯⲁⲗⲙⲱⲇⲓⲁ	N	ⲯⲁⲗⲙⲱⲇⲓⲁ
ⲯⲁⲗⲙⲱⲇⲟⲥ	N	ⲯⲁⲗⲙⲱⲇⲟⲥ
ⲯⲁⲗⲧⲏⲣⲓⲟⲛ	N	ⲯⲁⲗⲧⲏⲣⲓⲟⲛ
ⲯⲁⲗⲧⲏⲥ	N	ⲯⲁⲗⲧⲏⲥ
ⲯⲉⲩⲇⲟⲡⲁⲣⲑⲉⲛⲟⲥ	N	ⲯⲉⲩⲇⲟⲡⲁⲣⲑⲉⲛⲟⲥ
ⲯⲉⲩⲇⲟⲡⲣⲟⲫⲏⲧⲏⲥ	N	ⲯⲉⲩⲇⲟⲡⲣⲟⲫⲏⲧⲏⲥ
ⲯⲉⲩⲇⲟⲭⲣⲓⲥⲧⲟⲥ	N	ⲯⲉⲩⲇⲟⲭⲣⲓⲥⲧⲟⲥ
ⲯⲏⲫⲓⲥⲙⲁ	N	ⲯⲏⲫⲓⲥⲙⲁ
ⲯⲏⲫⲟⲥ	N	ⲯⲏⲫⲟⲥ
ⲯⲓⲕⲟⲥⲧⲁⲧⲏⲥ	N	ⲯⲓⲕⲟⲥⲧⲁⲧⲏⲥ
ⲯⲓⲥ	N	ⲯⲓⲥ
ⲯⲓⲧⲉ	N	ⲯⲓⲧⲉ
ⲯⲓⲧⲉ	NUM	ⲯⲓⲧⲉ
ⲯⲩⲫⲓⲥⲙⲁ	N	ⲯⲩⲫⲓⲥⲙⲁ
ⲯⲩⲫⲟⲥ	N	ⲯⲩⲫⲟⲥ
ⲯⲩⲭⲏ	N	ⲯⲩⲭⲏ
ⲯⲩⲭⲓⲕⲏ	N	ⲯⲩⲭⲓⲕⲏ
ⲯⲩⲭⲓⲕⲟⲛ	N	ⲯⲩⲭⲓⲕⲟⲛ
ⲯⲩⲭⲓⲕⲟⲥ	N	ⲯⲩⲭⲓⲕⲟⲥ
ⲯⲩⲭⲟⲟⲩⲉ	N	ⲯⲩⲭⲏ
ⲱϣⲉⲃⲟⲗ	V	ⲱϣⲉⲃⲟⲗ
ⲱϣ	V	ⲱϣ
ⲱϥⲉ	V	ⲱϥⲉ
ⲱϩⲉ	N	ⲱϩⲉ
ⲱϩⲉ	V	ⲱϩⲉ
ⲱϩⲥⲉ	V	ⲱϩⲥⲉ
ⲱϩⲥ	N	ⲱϩⲥ
ⲱϩⲥ	V	ⲱϩⲥ
ⲱϩⲧ	V	ⲱϩⲧ
ⲱϫⲛ	V	ⲱϫⲛ
ⲱϭⲃ	V	ⲱϭⲃ
ⲱϭⲉⲃ	V	ⲱϭⲉⲃ
ⲱϭⲉ	V	ⲱϭⲉ
ⲱϭⲧ	V	ⲱϭⲧ
ⲱⲃϣ	V	ⲱⲃϣ
ⲱⲇⲏ	N	ⲱⲇⲏ
ⲱⲕⲉⲁⲛⲟⲥ	N	ⲱⲕⲉⲁⲛⲟⲥ
ⲱⲕⲙ	V	ⲱⲕⲙ
ⲱⲕⲛⲉⲓ	V	ⲱⲕⲛⲉⲓ
ⲱⲕ	V	ⲱⲕ
ⲱⲗⲉⲙ	V	ⲱⲗⲉⲙ
ⲱⲗⲙ	V	ⲱⲗⲙ
ⲱⲗ	V	ⲱⲗ
ⲱⲙⲟⲫⲟⲣⲟⲥ	N	ⲱⲙⲟⲫⲟⲣⲟⲥ
ⲱⲙⲥ	V	ⲱⲙⲥ
ⲱⲛϣ	V	ⲱⲛϣ
ⲱⲛϩ	N	ⲱⲛϩ
ⲱⲛϩ	V	ⲱⲛϩ
ⲱⲛⲁϩ	N	ⲱⲛⲁϩ
ⲱⲛⲉⲙⲙⲉ	N	ⲱⲛⲉⲙⲙⲉ
ⲱⲛⲉ	N	ⲱⲛⲉ
ⲱⲛⲏ	N	ⲱⲛⲏ
ⲱⲟⲟⲡ	V	ϣⲱⲡⲉ
ⲱⲡ	V	ⲱⲡ
ⲱⲣϫ	N	ⲱⲣϫ
ⲱⲣϫ	V	ⲱⲣϫ
ⲱⲣⲉϫ	V	ⲱⲣⲉϫ
ⲱⲣⲓⲅⲉⲛⲏⲥ	NPROP	ⲱⲣⲓⲅⲉⲛⲏⲥ
ⲱⲣⲕ	V	ⲱⲣⲕ
ⲱⲣⲙ	V	ⲱⲣⲙ
ⲱⲥϭ	V	ⲱⲥϭ
ⲱⲥⲁⲛⲛⲁ	PTC	ⲱⲥⲁⲛⲛⲁ
ⲱⲥⲏⲉ	NPROP	ⲱⲥⲏⲉ
ⲱⲥⲕ	V	ⲱⲥⲕ
ⲱⲧⲡ	V	ⲱⲧⲡ
ⲱⲫⲉⲗⲉⲓ	V	ⲱⲫⲉⲗⲉⲓ
ⲱⲫⲉⲗⲓⲁ	N	ⲱⲫⲉⲗⲓⲁ
ⲱⲫⲓⲕⲓⲟⲛ	N	ⲱⲫⲓⲕⲓⲟⲛ
ⲱ	PTC	ⲱ
ⲻ	PUNCT	ⲻ
⳾	PUNCT	⳾
⸖	N	⸖
,	PUNCT	,
.	PUNCT	.
.	UNKNOWN	.
..	UNKNOWN	..
:	PUNCT	:
?	PUNCT	?
[ⲛ]ⲟⲏⲧⲟⲛ	N	[ⲛ]ⲟⲏⲧⲟⲛ
[	PUNCT	[
]	PUNCT	]
cⲟⲛ	N	cⲟⲛ
ⲓⲱⲃⲁⲃ	NPROP	ⲓⲱⲃⲁⲃ
ⲭⲉⲛⲉⲣⲉⲑ	NPROP	ⲭⲉⲛⲉⲣⲉⲑ
ⲫⲉⲛⲁⲉⲛⲇⲱⲣ	NPROP	ⲫⲉⲛⲁⲉⲛⲇⲱⲣ
ⲣⲁⲃⲁⲁ	NPROP	ⲣⲁⲃⲁⲁ
ⲍⲏⲫ	NPROP	ⲍⲏⲫ
ⲥⲩⲙⲟⲱⲛ	NPROP	ⲥⲩⲙⲟⲱⲛ
ⲙⲣⲣⲱⲛ	NPROP	ⲙⲣⲣⲱⲛ
ⲁⲃⲓⲥ	NPROP	ⲁⲃⲓⲥ
ⲁⲥⲱⲣ	NPROP	ⲁⲥⲱⲣ
ⲭⲁⲛⲁⲛⲁⲓⲟⲥ	NPROP	ⲭⲁⲛⲁⲛⲁⲓⲟⲥ
ⲁⲙⲟⲣⲣⲁⲓⲟⲥ	NPROP	ⲁⲙⲟⲣⲣⲁⲓⲟⲥ
ⲓⲉⲃⲟⲩⲥⲁⲓⲟⲥ	NPROP	ⲓⲉⲃⲟⲩⲥⲁⲓⲟⲥ
ⲭⲉⲧⲧⲁⲓⲟⲥ	NPROP	ⲭⲉⲧⲧⲁⲓⲟⲥ
ⲙⲁⲥⲉⲭⲉⲙ	NPROP	ⲙⲁⲥⲉⲭⲉⲙ
ⲫⲉⲣⲉⲍⲁⲓⲟⲥ	NPROP	ⲫⲉⲣⲉⲍⲁⲓⲟⲥ
ⲙⲁⲣⲥⲉⲙⲱⲙⲁⲛ	NPROP	ⲙⲁⲣⲥⲉⲙⲱⲙⲁⲛ
ⲁⲗⲗⲏⲗⲟⲩⲓⲁ	FW	ⲁⲗⲗⲏⲗⲟⲩⲓⲁ
ⲁⲗⲫ	NPROP	ⲁⲗⲫ
ⲃⲉⲑ	NPROP	ⲃⲉⲑ
ⲅⲓⲙⲁⲗ	NPROP	ⲅⲓⲙⲁⲗ
ⲇⲉⲗⲑ	NPROP	ⲇⲉⲗⲑ
ⲍ	NUM	ⲍ
ⲍⲁⲓ	NPROP	ⲍⲁⲓ
ⲏⲑ	NPROP	ⲏⲑ
ⲧⲏⲑ	NPROP	ⲧⲏⲑ
ⲓⲱⲑ	NPROP	ⲓⲱⲑ
ⲭⲁⲫ	NPROP	ⲭⲁⲫ
ⲗⲁⲃⲇ	NPROP	ⲗⲁⲃⲇ
ⲙⲏⲙ	NPROP	ⲙⲏⲙ
ⲥⲁⲙⲭ	NPROP	ⲥⲁⲙⲭ
ⲫⲏ	NPROP	ⲫⲏ
ⲥⲁⲇⲏ	NPROP	ⲥⲁⲇⲏ
ⲕⲱⲫ	NPROP	ⲕⲱⲫ
ⲑⲁⲩ	NPROP	ⲑⲁⲩ