 	 
 ·	 ·
,	,
.	.
..	..
...	...
....	....
.....	.....
......	......
.........	.........
..........	..........
.....ⲟ...	.....ⲟ...
:	:
?	?
[	[
[ ]	[ ]
[..........]	[..........]
[.........]	[.........]
[........]	[........]
[.......]	[.......]
[.....]	[.....]
[.....]ⲡⲣ[..][....]ⲥ	[.....]ⲡⲣ[..][....]ⲥ
[.....]ⲩⲟ	[.....]ⲩⲟ
[....]	[....]
[....]ϫⲉ	[....]ϫⲉ
[....]ⲥ	[....]ⲥ
[....]ⲥⲧⲁ	[....]ⲥⲧⲁ
[...]	[...]
[...]ϥ̣	[...]ϥ̣
[...]ⲛ	[...]ⲛ
[...]ⲟⲧⲡ	[...]ⲟⲧⲡ
[...]ⲩ	[...]ⲩ
[..]	[..]
[..]ⲁⲩ	[..]ⲁⲩ
[..]ⲙⲉ	[..]ⲙⲉ
[..]ⲥⲃⲱ	[..]ⲥⲃⲱ
[.]	[.]
[.]ⲉ	[.]ⲉ
[.]ⲙ	[.]ⲙ
[.]ⲛ	[.]ⲛ
[…..]	[…..]
[…..]ⲉⲁ	[…..]ⲉⲁ
[…]	[…]
[ⲉⲃⲟ]ⲗ	[ⲉⲃⲟ]ⲗ
]	]
cⲟⲛ	cⲟⲛ
s	s
·	·
·ⲻ	·ⲻ
̣ⲏ	̣ⲏ
̣ⲙⲛⲧⲣⲉⲙⲡ	̣ⲙⲛⲧⲣⲉⲙⲡ
Φαμενωθ	Φαμενωθ
β	β
γ	γ
θἰνδικτίονος	θἰνδικτίονος
ο	ο
υἱός	υἱός
ϣ	ϣ
ϣoⲙⲛⲧ	ϣoⲙⲛⲧ
ϣϣⲉ	ϣϣⲉ
ϣϥⲉ	ϣϥⲉ
ϣϫⲁϩⲙ	ϣϫⲁϩⲙ
ϣϫⲉ	ϣϫⲉ
ϣϫⲥⲟϭ	ϣϫ|ⲥⲟϭ
ϣϭⲙϭⲟⲙ	ϣϭⲙϭⲟⲙ
ϣϭⲟⲙ	ϣ|ϭⲟⲙ
ϣⲁ	ϣⲁ
ϣⲁϩ	ϣⲁϩ
ϣⲁϩⲉ	ϣⲁϩⲉ
ϣⲁϩⲟⲩⲛ	ϣⲁϩⲟⲩⲛ
ϣⲁϩⲣⲁⲓ	ϣⲁϩⲣⲁⲓ
ϣⲁϫⲉ	ϣⲁϫⲉ
ϣⲁⲁ	ϣⲁⲁ
ϣⲁⲁⲣ	ϣⲁⲁⲣ
ϣⲁⲁⲧ	ϣⲁⲁⲧ
ϣⲁⲃⲟⲗ	ϣⲁⲃⲟⲗ
ϣⲁⲉⲓ	ϣⲁⲉⲓ
ϣⲁⲓ	ϣⲁⲓ
ϣⲁⲕⲧ	ϣⲁⲕⲧ
ϣⲁⲗ	ϣⲁⲗ
ϣⲁⲛ	ϣⲁⲛ
ϣⲁⲛⲧ	ϣⲁⲛⲧ
ϣⲁⲛⲧⲉ	ϣⲁⲛⲧⲉ
ϣⲁⲣ	ϣⲁⲣ
ϣⲁⲣⲉ	ϣⲁⲣⲉ
ϣⲁⲣⲟ	ϣⲁⲣⲟ
ϣⲁⲣⲡ	ϣⲁⲣⲡ
ϣⲁⲣⲱ	ϣⲁⲣⲱ
ϣⲁⲧ	ϣⲁⲧ
ϣⲁⲧⲟⲩ	ϣⲁⲧⲟⲩ
ϣⲃ	ϣⲃ
ϣⲃⲃⲓⲱ	ϣⲃⲃⲓⲱ
ϣⲃⲉⲉⲣ	ϣⲃⲉⲉⲣ
ϣⲃⲉⲓⲱ	ϣⲃⲉⲓⲱ
ϣⲃⲏⲣ	ϣⲃⲏⲣ
ϣⲃⲏⲣⲡⲣⲉⲥⲃⲩⲧⲉⲣⲟⲥ	ϣⲃⲏⲣ|ⲡⲣⲉⲥⲃⲩⲧⲉⲣⲟⲥ
ϣⲃⲛⲛⲉ	ϣⲃⲛⲛⲉ
ϣⲃⲣ	ϣⲃⲣ
ϣⲃⲣϩⲙϩⲁⲗ	ϣⲃⲣ|ϩⲙϩⲁⲗ
ϣⲃⲣⲕⲗⲏⲣⲟⲛⲟⲙⲟⲥ	ϣⲃⲣ|ⲕⲗⲏⲣⲟⲛⲟⲙⲟⲥ
ϣⲃⲣⲗⲓⲧⲟⲩⲣⲅⲟⲥ	ϣⲃⲣ|ⲗⲓⲧⲟⲩⲣⲅⲟⲥ
ϣⲃⲣⲙⲁⲧⲟⲓ	ϣⲃⲣ|ⲙⲁⲧⲟⲓ
ϣⲃⲣⲣϩⲱⲃ	ϣⲃⲣ|ⲣ|ϩⲱⲃ
ϣⲃⲣⲧⲉⲭⲛⲓⲧⲏⲥ	ϣⲃⲣ|ⲧⲉⲭⲛⲓⲧⲏⲥ
ϣⲃⲧ	ϣⲃⲧ
ϣⲉ	ϣⲉ
ϣⲉϩⲙⲉ	ϣⲉ|ϩⲙⲉ
ϣⲉⲉⲣⲉ	ϣⲉⲉⲣⲉ
ϣⲉⲗⲉⲉⲧ	ϣⲉⲗⲉⲉⲧ
ϣⲉⲛⲟⲩⲧⲉ	ϣⲉⲛⲟⲩⲧⲉ
ϣⲉⲟⲉⲓϣ	ϣⲉⲟⲉⲓϣ
ϣⲉⲡ	ϣⲉⲡ
ϣⲉⲡϣⲡ	ϣⲉⲡϣⲡ
ϣⲉⲡϣⲱⲡ	ϣⲉⲡ|ϣⲱⲡ
ϣⲉⲧϣⲱⲧ	ϣⲉⲧϣⲱⲧ
ϣⲏ	ϣⲏ
ϣⲏϣ	ϣⲏϣ
ϣⲏⲓ	ϣⲏⲓ
ϣⲏⲙ	ϣⲏⲙ
ϣⲏⲛ	ϣⲏⲛ
ϣⲏⲡ	ϣⲏⲡ
ϣⲏⲣⲉ	ϣⲏⲣⲉ
ϣⲏⲣⲡⲥϩⲁⲓ	ϣⲏⲣⲡ|ⲥϩⲁⲓ
ϣⲏⲧ	ϣⲏⲧ
ϣⲏⲩⲉ	ϣⲏⲩⲉ
ϣⲓ	ϣⲓ
ϣⲓⲃⲉ	ϣⲓⲃⲉ
ϣⲓⲏⲧ	ϣⲓⲏⲧ
ϣⲓⲕⲉ	ϣⲓⲕⲉ
ϣⲓⲛⲉ	ϣⲓⲛⲉ
ϣⲓⲡⲉ	ϣⲓⲡⲉ
ϣⲓⲧⲉ	ϣⲓⲧⲉ
ϣⲕⲁⲕ	ϣⲕⲁⲕ
ϣⲗϩⲗ	ϣⲗϩⲗ
ϣⲗⲏⲗ	ϣⲗⲏⲗ
ϣⲗⲟϥ	ϣⲗⲟϥ
ϣⲗⲧⲙ	ϣⲗⲧⲙ
ϣⲙϣⲉ	ϣⲙϣⲉ
ϣⲙⲙⲟ	ϣⲙⲙⲟ
ϣⲙⲛⲧϣⲉⲥⲉⲧⲏ	ϣⲙⲛⲧ|ϣⲉ|ⲥⲉ|ⲧⲏ
ϣⲙⲟⲩⲛ	ϣⲙⲟⲩⲛ
ϣⲙⲟⲩⲛⲉ	ϣⲙⲟⲩⲛⲉ
ϣⲙⲧ	ϣⲙⲧ
ϣⲛ	ϣⲛ
ϣⲛⲉ	ϣⲛⲉ
ϣⲛⲏⲩ	ϣⲛⲏⲩ
ϣⲛⲧ	ϣⲛⲧ
ϣⲟ	ϣⲟ
ϣⲟϣⲟⲩ	ϣⲟϣⲟⲩ
ϣⲟϫⲛⲉ	ϣⲟϫⲛⲉ
ϣⲟϫⲧ	ϣⲟϫⲧ
ϣⲟⲃⲉ	ϣⲟⲃⲉ
ϣⲟⲃⲧ	ϣⲟⲃⲧ
ϣⲟⲉⲓϣ	ϣⲟⲉⲓϣ
ϣⲟⲕϩ	ϣⲟⲕϩ
ϣⲟⲗϣⲗ	ϣⲟⲗϣⲗ
ϣⲟⲗϩ	ϣⲟⲗϩ
ϣⲟⲙⲛⲧ	ϣⲟⲙⲛⲧ
ϣⲟⲙⲧ	ϣⲟⲙⲧ
ϣⲟⲙⲧⲉ	ϣⲟⲙⲧⲉ
ϣⲟⲛⲧⲉ	ϣⲟⲛⲧⲉ
ϣⲟⲟⲡ	ϣⲟⲟⲡ
ϣⲟⲟⲩ	ϣⲟⲟⲩ
ϣⲟⲟⲩⲉ	ϣⲟⲟⲩⲉ
ϣⲟⲡ	ϣⲟⲡ
ϣⲟⲣϣⲣ	ϣⲟⲣϣⲣ
ϣⲟⲣⲡ	ϣⲟⲣⲡ
ϣⲟⲧ	ϣⲟⲧ
ϣⲟⲧⲙ	ϣⲟⲧⲙ
ϣⲟⲩ	ϣⲟⲩ
ϣⲟⲩϣⲟⲩ	ϣⲟⲩϣⲟⲩ
ϣⲟⲩϣⲧ	ϣⲟⲩϣⲧ
ϣⲟⲩϣⲧⲙⲣⲱϥ	ϣⲟⲩ|ϣⲧⲙ|ⲣⲱ|ϥ
ϣⲟⲩϣⲱⲱⲧ	ϣⲟⲩ|ϣⲱⲱⲧ
ϣⲟⲩϩⲏⲛⲉ	ϣⲟⲩϩⲏⲛⲉ
ϣⲟⲩⲉⲓⲧ	ϣⲟⲩⲉⲓⲧ
ϣⲟⲩⲟ	ϣⲟⲩⲟ
ϣⲟⲩⲣⲏ	ϣⲟⲩⲣⲏ
ϣⲟⲩⲧⲙ	ϣⲟⲩⲧⲙ
ϣⲟⲩⲱ	ϣⲟⲩⲱ
ϣⲟⲩⲱϩ	ϣⲟⲩⲱϩ
ϣⲟⲩⲱⲟⲩ	ϣⲟⲩⲱⲟⲩ
ϣⲡ	ϣⲡ
ϣⲡϩⲓⲥⲉ	ϣⲡ|ϩⲓⲥⲉ
ϣⲡϩⲙⲟⲧ	ϣⲡ|ϩⲙⲟⲧ
ϣⲡⲏⲣⲉ	ϣⲡⲏⲣⲉ
ϣⲡⲛϣⲱⲡ	ϣⲡ|ⲛ|ϣⲱⲡ
ϣⲣⲡ	ϣⲣⲡ
ϣⲥ	ϣⲥ
ϣⲥⲛⲉ	ϣⲥⲛⲉ
ϣⲧⲁⲙ	ϣⲧⲁⲙ
ϣⲧⲉⲕⲟ	ϣⲧⲉⲕⲟ
ϣⲧⲏⲛ	ϣⲧⲏⲛ
ϣⲧⲙ	ϣⲧⲙ
ϣⲧⲟⲣⲧⲣ	ϣⲧⲟⲣⲧⲣ
ϣⲧⲣⲧⲱⲣ	ϣⲧⲣⲧⲱⲣ
ϣⲧⲱⲟⲩⲛ	ϣ|ⲧⲱⲟⲩⲛ
ϣⲱ	ϣⲱ
ϣⲱϣ	ϣⲱϣ
ϣⲱϣⲧ	ϣⲱϣⲧ
ϣⲱϥ	ϣⲱϥ
ϣⲱϥⲧ	ϣⲱϥⲧ
ϣⲱϫⲡ	ϣⲱϫⲡ
ϣⲱϭⲉ	ϣⲱϭⲉ
ϣⲱⲗ	ϣⲱⲗ
ϣⲱⲙ	ϣⲱⲙ
ϣⲱⲙⲉ	ϣⲱⲙⲉ
ϣⲱⲛ	ϣⲱⲛ
ϣⲱⲛϥ	ϣⲱⲛϥ
ϣⲱⲛⲃ	ϣⲱⲛⲃ
ϣⲱⲛⲉ	ϣⲱⲛⲉ
ϣⲱⲡ	ϣⲱⲡ
ϣⲱⲡⲉ	ϣⲱⲡⲉ
ϣⲱⲡⲉ`	ϣⲱⲡⲉ`
ϣⲱⲣⲡ	ϣⲱⲣⲡ
ϣⲱⲥ	ϣⲱⲥ
ϣⲱⲥⲙ	ϣⲱⲥⲙ
ϣⲱⲧⲉ	ϣⲱⲧⲉ
ϣⲱⲱⲡⲉ	ϣⲱⲱⲡⲉ
ϣⲱⲱⲧ	ϣⲱⲱⲧ
ϥ	ϥ
ϥⲁⲓⲕⲗⲟⲙ	ϥⲁⲓ|ⲕⲗⲟⲙ
ϥⲉϭ	ϥⲉϭ
ϥⲉⲓ	ϥⲉⲓ
ϥⲉⲓⲣⲟⲟⲩϣ	ϥⲉⲓ|ⲣⲟⲟⲩϣ
ϥⲓ	ϥⲓ
ϥⲓⲉⲓⲁⲧ	ϥⲓ|ⲉⲓⲁⲧ
ϥⲓⲣⲟⲟⲩϣ	ϥⲓ|ⲣⲟⲟⲩϣ
ϥⲓⲧ	ϥⲓⲧ
ϥⲛⲧ	ϥⲛⲧ
ϥⲟ	ϥⲟ
ϥⲟⲧ	ϥⲟⲧ
ϥⲧⲟⲟⲩ	ϥⲧⲟⲟⲩ
ϥⲧⲟⲟⲩϣⲉ	ϥⲧⲟⲟⲩ|ϣⲉ
ϥⲧⲟⲩ	ϥⲧⲟⲩ
ϥⲱ	ϥⲱ
ϥⲱϭⲉ	ϥⲱϭⲉ
ϥⲱⲧⲉ	ϥⲱⲧⲉ
ϩ...	ϩ...
ϩⲁ	ϩⲁ
ϩⲁϩ	ϩⲁϩ
ϩⲁϩⲟⲧⲉ	ϩⲁ|ϩⲟⲧⲉ
ϩⲁϩⲧⲉ	ϩⲁϩⲧⲉ
ϩⲁϩⲧⲉⲛ	ϩⲁϩⲧⲉⲛ
ϩⲁϩⲧⲏ	ϩⲁϩⲧⲏ
ϩⲁϩⲧⲛ	ϩⲁϩⲧⲛ
ϩⲁϫϩⲉϫ	ϩⲁϫϩⲉϫ
ϩⲁⲁⲩ	ϩⲁⲁⲩ
ϩⲁⲃⲟⲗ	ϩⲁⲃⲟⲗ
ϩⲁⲅⲓⲟⲥ	ϩⲁⲅⲓⲟⲥ
ϩⲁⲉ	ϩⲁⲉ
ϩⲁⲉⲓ	ϩⲁⲉⲓ
ϩⲁⲉⲓⲃⲉⲥ	ϩⲁⲉⲓⲃⲉⲥ
ϩⲁⲉⲟⲩ	ϩⲁⲉⲟⲩ
ϩⲁⲏ	ϩⲁⲏ
ϩⲁⲑⲏ	ϩⲁⲑⲏ
ϩⲁⲓ	ϩⲁⲓ
ϩⲁⲓⲃⲉⲥ	ϩⲁⲓⲃⲉⲥ
ϩⲁⲓⲣⲉⲥⲓⲥ	ϩⲁⲓⲣⲉⲥⲓⲥ
ϩⲁⲓⲣⲉⲧⲓⲕⲟⲥ	ϩⲁⲓⲣⲉⲧⲓⲕⲟⲥ
ϩⲁⲗ	ϩⲁⲗ
ϩⲁⲗⲁⲁⲧⲉ	ϩⲁⲗⲁⲁⲧⲉ
ϩⲁⲗⲁⲥⲥⲁ	ϩⲁⲗⲁⲥⲥⲁ
ϩⲁⲗⲁⲧⲉ	ϩⲁⲗⲁⲧⲉ
ϩⲁⲗⲏⲧ	ϩⲁⲗⲏⲧ
ϩⲁⲗⲩⲥⲓⲥ	ϩⲁⲗⲩⲥⲓⲥ
ϩⲁⲙ	ϩⲁⲙ
ϩⲁⲙϣⲉ	ϩⲁⲙϣⲉ
ϩⲁⲙⲏⲛ	ϩⲁⲙⲏⲛ
ϩⲁⲙⲕⲗⲗⲉ	ϩⲁⲙⲕⲗⲗⲉ
ϩⲁⲙⲟⲓ	ϩⲁⲙⲟⲓ
ϩⲁⲛⲉ	ϩⲁⲛⲉ
ϩⲁⲡ	ϩⲁⲡ
ϩⲁⲡⲥ	ϩⲁⲡⲥ
ϩⲁⲣϣϩⲏⲧ	ϩⲁⲣϣ|ϩⲏⲧ
ϩⲁⲣⲁⲧ	ϩⲁⲣⲁⲧ
ϩⲁⲣⲉϩ	ϩⲁⲣⲉϩ
ϩⲁⲣⲓϩⲁⲣⲟ	ϩⲁⲣⲓϩⲁⲣⲟ
ϩⲁⲣⲙⲁ	ϩⲁⲣⲙⲁ
ϩⲁⲣⲟ	ϩⲁⲣⲟ
ϩⲁⲣⲱ	ϩⲁⲣⲱ
ϩⲁⲧ	ϩⲁⲧ
ϩⲁⲧⲉ	ϩⲁⲧⲉ
ϩⲁⲧⲏ	ϩⲁⲧⲏ
ϩⲁⲧⲏⲩ	ϩⲁ|ⲧⲏⲩ
ϩⲁⲧⲙ	ϩⲁⲧⲙ
ϩⲁⲧⲛ	ϩⲁⲧⲛ
ϩⲃⲃⲉ	ϩⲃⲃⲉ
ϩⲃⲏⲟⲩⲉ	ϩⲃⲏⲟⲩⲉ
ϩⲃⲏⲩⲉ	ϩⲃⲏⲩⲉ
ϩⲃⲟⲣⲃⲣ	ϩⲃⲟⲣⲃⲣ
ϩⲃⲟⲩⲣ	ϩⲃⲟⲩⲣ
ϩⲃⲥ	ϩⲃⲥ
ϩⲃⲥⲱ	ϩⲃⲥⲱ
ϩⲉ	ϩⲉ
ϩⲉϫϩⲱϫ	ϩⲉϫϩⲱϫ
ϩⲉⲃⲱⲱⲛ	ϩⲉ|ⲃⲱⲱⲛ
ϩⲉⲑⲛⲓⲕⲟⲥ	ϩⲉⲑⲛⲓⲕⲟⲥ
ϩⲉⲑⲛⲟⲥ	ϩⲉⲑⲛⲟⲥ
ϩⲉⲓⲣ	ϩⲉⲓⲣ
ϩⲉⲕⲉ	ϩⲉⲕⲉ
ϩⲉⲗⲗⲏⲛ	ϩⲉⲗⲗⲏⲛ
ϩⲉⲗⲡⲓⲍⲉ	ϩⲉⲗⲡⲓⲍⲉ
ϩⲉⲗⲡⲓⲥ	ϩⲉⲗⲡⲓⲥ
ϩⲉⲛ	ϩⲉⲛ
ϩⲉⲛⲁⲧⲟⲛ	ϩⲉⲛⲁⲧⲟⲛ
ϩⲉⲛⲉⲉⲧⲉ	ϩⲉⲛⲉⲉⲧⲉ
ϩⲉⲛⲉⲉⲧⲏ	ϩⲉⲛⲉⲉⲧⲏ
ϩⲉⲛⲟⲩϥⲉ	ϩⲉ|ⲛⲟⲩϥⲉ
ϩⲉⲡ	ϩⲉⲡ
ϩⲉⲣⲙⲁⲛ	ϩⲉⲣⲙⲁⲛ
ϩⲉⲣⲙⲉⲛⲉⲩⲉ	ϩⲉⲣⲙⲉⲛⲉⲩⲉ
ϩⲉⲣⲙⲏⲛⲉⲓⲁ	ϩⲉⲣⲙⲏⲛⲉⲓⲁ
ϩⲉⲣⲙⲏⲛⲉⲩⲉ	ϩⲉⲣⲙⲏⲛⲉⲩⲉ
ϩⲉⲣⲙⲏⲥ	ϩⲉⲣⲙⲏⲥ
ϩⲏ	ϩⲏ
ϩⲏ[..]ⲉ	ϩⲏ[..]ⲉ
ϩⲏϭⲉ	ϩⲏϭⲉ
ϩⲏⲃⲥ	ϩⲏⲃⲥ
ϩⲏⲅⲉⲙⲱⲛ	ϩⲏⲅⲉⲙⲱⲛ
ϩⲏⲇⲟⲛⲏ	ϩⲏⲇⲟⲛⲏ
ϩⲏⲏⲛⲉ	ϩⲏⲏⲛⲉ
ϩⲏⲏⲧⲉ	ϩⲏⲏⲧⲉ
ϩⲏⲕⲉ	ϩⲏⲕⲉ
ϩⲏⲗⲉⲓ	ϩⲏⲗⲉⲓ
ϩⲏⲗⲉⲓⲁⲥ	ϩⲏⲗⲉⲓⲁⲥ
ϩⲏⲙ	ϩⲏⲙ
ϩⲏⲛ	ϩⲏⲛ
ϩⲏⲛⲉ	ϩⲏⲛⲉ
ϩⲏⲡ	ϩⲏⲡ
ϩⲏⲣⲱⲇⲏⲥ	ϩⲏⲣⲱⲇⲏⲥ
ϩⲏⲣⲱⲇⲓⲁⲛⲟⲥ	ϩⲏⲣⲱⲇⲓⲁⲛⲟⲥ
ϩⲏⲣⲱⲇⲓⲁⲥ	ϩⲏⲣⲱⲇⲓⲁⲥ
ϩⲏⲧ	ϩⲏⲧ
ϩⲏⲧⲛ	ϩⲏⲧⲛ
ϩⲏⲩ	ϩⲏⲩ
ϩⲓ	ϩⲓ
ϩⲓϩⲏ	ϩⲓϩⲏ
ϩⲓϩⲟⲩⲛ	ϩⲓϩⲟⲩⲛ
ϩⲓϩⲣⲁ	ϩⲓϩⲣⲁ
ϩⲓϫⲙ	ϩⲓϫⲙ
ϩⲓϫⲛ	ϩⲓϫⲛ
ϩⲓϫⲱ	ϩⲓϫⲱ
ϩⲓⲁⲃⲉ	ϩⲓⲁⲃⲉ
ϩⲓⲁⲉⲓⲃⲉ	ϩⲓⲁⲉⲓⲃⲉ
ϩⲓⲃⲟⲗ	ϩⲓⲃⲟⲗ
ϩⲓⲃⲱ	ϩⲓⲃⲱ
ϩⲓⲇⲓⲱⲧⲏⲥ	ϩⲓⲇⲓⲱⲧⲏⲥ
ϩⲓⲉⲓⲃ	ϩⲓⲉⲓⲃ
ϩⲓⲉⲓⲧ	ϩⲓⲉⲓⲧ
ϩⲓⲉⲣⲉⲩⲥ	ϩⲓⲉⲣⲉⲩⲥ
ϩⲓⲉⲣⲓⲭⲱ	ϩⲓⲉⲣⲓⲭⲱ
ϩⲓⲉⲣⲟⲥⲟⲗⲩⲙⲁ	ϩⲓⲉⲣⲟⲥⲟⲗⲩⲙⲁ
ϩⲓⲉⲣⲟⲩⲥⲁⲗⲏⲙ	ϩⲓⲉⲣⲟⲩⲥⲁⲗⲏⲙ
ϩⲓⲏ	ϩⲓⲏ
ϩⲓⲕⲁⲛⲟⲥ	ϩⲓⲕⲁⲛⲟⲥ
ϩⲓⲕⲱⲛ	ϩⲓⲕⲱⲛ
ϩⲓⲙⲉ	ϩⲓⲙⲉ
ϩⲓⲛⲁⲓ	ϩⲓⲛⲁⲓ
ϩⲓⲛⲏⲃ	ϩⲓⲛⲏⲃ
ϩⲓⲟⲙⲉ	ϩⲓⲟⲙⲉ
ϩⲓⲟⲛⲉ	ϩⲓⲟⲛⲉ
ϩⲓⲟⲟⲩⲉ	ϩⲓⲟⲟⲩⲉ
ϩⲓⲟⲩⲉ	ϩⲓⲟⲩⲉ
ϩⲓⲡⲉⲥⲏⲧ	ϩⲓⲡⲉⲥⲏⲧ
ϩⲓⲣ	ϩⲓⲣ
ϩⲓⲣⲙ	ϩⲓⲣⲙ
ϩⲓⲣⲛ	ϩⲓⲣⲛ
ϩⲓⲥⲉ	ϩⲓⲥⲉ
ϩⲓⲧⲉ	ϩⲓⲧⲉ
ϩⲓⲧⲙ	ϩⲓⲧⲙ
ϩⲓⲧⲛ	ϩⲓⲧⲛ
ϩⲓⲧⲟⲟⲧ	ϩⲓⲧⲟⲟⲧ
ϩⲓⲧⲟⲩⲛ	ϩⲓⲧⲟⲩⲛ
ϩⲓⲧⲟⲩⲱ	ϩⲓⲧⲟⲩⲱ
ϩⲓⲧⲟⲩⲱⲱ	ϩⲓⲧⲟⲩⲱⲱ
ϩⲓⲱ	ϩⲓⲱ
ϩⲓⲱⲧ	ϩⲓⲱⲧ
ϩⲓⲱⲱ	ϩⲓⲱⲱ
ϩⲓⲱⲱⲧ	ϩⲓⲱⲱⲧ
ϩⲕⲁⲉⲓⲧ	ϩⲕⲁⲉⲓⲧ
ϩⲕⲟ	ϩⲕⲟ
ϩⲗⲗⲟ	ϩⲗⲗⲟ
ϩⲗⲗⲟⲓ	ϩⲗⲗⲟⲓ
ϩⲗⲗⲱ	ϩⲗⲗⲱ
ϩⲗⲟϭ	ϩⲗⲟϭ
ϩⲗⲟⲟⲗⲉ	ϩⲗⲟⲟⲗⲉ
ϩⲗⲟⲡⲗⲡ	ϩⲗⲟⲡⲗⲡ
ϩⲗⲡⲗⲱⲡ	ϩⲗⲡⲗⲱⲡ
ϩⲙ	ϩⲙ
ϩⲙϩⲁⲗ	ϩⲙϩⲁⲗ
ϩⲙϩⲙ	ϩⲙϩⲙ
ϩⲙϫ	ϩⲙϫ
ϩⲙⲉ	ϩⲙⲉ
ϩⲙⲟⲙ	ϩⲙⲟⲙ
ϩⲙⲟⲟ	ϩⲙⲟⲟ
ϩⲙⲟⲟⲥ	ϩⲙⲟⲟⲥ
ϩⲙⲟⲧ	ϩⲙⲟⲧ
ϩⲙⲟⲩ	ϩⲙⲟⲩ
ϩⲙⲥ	ϩⲙⲥ
ϩⲛ	ϩⲛ
ϩⲛⲁ	ϩⲛⲁ
ϩⲛⲁⲁⲩ	ϩⲛⲁⲁⲩ
ϩⲛⲁⲩ	ϩⲛⲁⲩ
ϩⲛⲏ	ϩⲛⲏ
ϩⲛⲟ	ϩⲛⲟ
ϩⲟ	ϩⲟ
ϩⲟϥ	ϩⲟϥ
ϩⲟϫϩϫ	ϩⲟϫϩϫ
ϩⲟⲃⲥ	ϩⲟⲃⲥ
ϩⲟⲉⲓⲙ	ϩⲟⲉⲓⲙ
ϩⲟⲉⲓⲛⲉ	ϩⲟⲉⲓⲛⲉ
ϩⲟⲉⲓⲧⲉ	ϩⲟⲉⲓⲧⲉ
ϩⲟⲓ	ϩⲟⲓ
ϩⲟⲓⲛⲉ	ϩⲟⲓⲛⲉ
ϩⲟⲓⲧⲉ	ϩⲟⲓⲧⲉ
ϩⲟⲗϭ	ϩⲟⲗϭ
ϩⲟⲗⲟⲕⲟⲧⲧⲓⲛⲟⲥ	ϩⲟⲗⲟⲕⲟⲧⲧⲓⲛⲟⲥ
ϩⲟⲗⲱⲥ	ϩⲟⲗⲱⲥ
ϩⲟⲙⲛⲧ	ϩⲟⲙⲛⲧ
ϩⲟⲙⲟⲓⲱⲥ	ϩⲟⲙⲟⲓⲱⲥ
ϩⲟⲙⲟⲗⲟⲅⲉⲓ	ϩⲟⲙⲟⲗⲟⲅⲉⲓ
ϩⲟⲙⲟⲗⲟⲅⲉⲓⲁ	ϩⲟⲙⲟⲗⲟⲅⲉⲓⲁ
ϩⲟⲙⲧ	ϩⲟⲙⲧ
ϩⲟⲛ	ϩⲟⲛ
ϩⲟⲟⲕⲉ	ϩⲟⲟⲕⲉ
ϩⲟⲟⲗⲉ	ϩⲟⲟⲗⲉ
ϩⲟⲟⲣ	ϩⲟⲟⲣ
ϩⲟⲟⲩ	ϩⲟⲟⲩ
ϩⲟⲟⲩϣ	ϩⲟⲟⲩϣ
ϩⲟⲟⲩⲧ	ϩⲟⲟⲩⲧ
ϩⲟⲡ	ϩⲟⲡ
ϩⲟⲡⲗⲟⲛ	ϩⲟⲡⲗⲟⲛ
ϩⲟⲡⲟⲩ	ϩⲟⲡⲟⲩ
ϩⲟⲣ	ϩⲟⲣ
ϩⲟⲣϣ	ϩⲟⲣϣ
ϩⲟⲣⲡ	ϩⲟⲣⲡ
ϩⲟⲥⲉ	ϩⲟⲥⲉ
ϩⲟⲥⲟⲛ	ϩⲟⲥⲟⲛ
ϩⲟⲧϩⲧ	ϩⲟⲧϩⲧ
ϩⲟⲧⲁⲛ	ϩⲟⲧⲁⲛ
ϩⲟⲧⲃⲉ	ϩⲟⲧⲃⲉ
ϩⲟⲧⲉ	ϩⲟⲧⲉ
ϩⲟⲧⲡ	ϩⲟⲧⲡ
ϩⲟⲩo	ϩⲟⲩo
ϩⲟⲩϩⲉ	ϩⲟⲩϩⲉ
ϩⲟⲩⲉ	ϩⲟⲩⲉ
ϩⲟⲩⲉⲓⲧⲉ	ϩⲟⲩⲉⲓⲧⲉ
ϩⲟⲩⲙⲓⲥⲉ	ϩⲟⲩⲙⲓⲥⲉ
ϩⲟⲩⲛ	ϩⲟⲩⲛ
ϩⲟⲩⲟ	ϩⲟⲩⲟ
ϩⲣϣⲓⲣⲉ	ϩⲣϣⲓⲣⲉ
ϩⲣⲁ	ϩⲣⲁ
ϩⲣⲁϫⲣⲉϫ	ϩⲣⲁϫⲣⲉϫ
ϩⲣⲁⲃⲃⲉⲓ	ϩⲣⲁⲃⲃⲉⲓ
ϩⲣⲁⲃⲃⲟⲩⲛⲉⲓ	ϩⲣⲁⲃⲃⲟⲩⲛⲉⲓ
ϩⲣⲁⲓ	ϩⲣⲁⲓ
ϩⲣⲁⲙⲛⲟⲥ	ϩⲣⲁⲙⲛⲟⲥ
ϩⲣⲁⲭⲏⲗ	ϩⲣⲁⲭⲏⲗ
ϩⲣⲃ	ϩⲣⲃ
ϩⲣⲉ	ϩⲣⲉ
ϩⲣⲉⲃⲉⲕⲕⲁ	ϩⲣⲉⲃⲉⲕⲕⲁ
ϩⲣⲏϭ	ϩⲣⲏϭ
ϩⲣⲟϣ	ϩⲣⲟϣ
ϩⲣⲟⲕⲉⲩⲉ	ϩⲣⲟⲕⲉⲩⲉ
ϩⲣⲟⲟⲩ	ϩⲣⲟⲟⲩ
ϩⲣⲟⲩ	ϩⲣⲟⲩ
ϩⲣⲟⲩⲃⲃⲁⲉⲓ	ϩⲣⲟⲩⲃⲃⲁⲉⲓ
ϩⲣⲟⲩⲫⲟⲥ	ϩⲣⲟⲩⲫⲟⲥ
ϩⲣⲱ	ϩⲣⲱ
ϩⲣⲱⲙⲁⲓⲟⲥ	ϩⲣⲱⲙⲁⲓⲟⲥ
ϩⲣⲱⲙⲁⲛⲓⲁ	ϩⲣⲱⲙⲁⲛⲓⲁ
ϩⲣⲱⲙⲁⲛⲟⲥ	ϩⲣⲱⲙⲁⲛⲟⲥ
ϩⲧⲏ	ϩⲧⲏ
ϩⲧⲟ	ϩⲧⲟ
ϩⲧⲟⲟⲩ	ϩⲧⲟⲟⲩ
ϩⲧⲟⲟⲩⲉ	ϩⲧⲟⲟⲩⲉ
ϩⲧⲟⲣ	ϩⲧⲟⲣ
ϩⲩⲗⲏ	ϩⲩⲗⲏ
ϩⲩⲙⲛⲟⲥ	ϩⲩⲙⲛⲟⲥ
ϩⲩⲡⲁⲣⲭⲟⲛⲧⲁ	ϩⲩⲡⲁⲣⲭⲟⲛⲧⲁ
ϩⲩⲡⲉⲣⲉⲥⲓⲁ	ϩⲩⲡⲉⲣⲉⲥⲓⲁ
ϩⲩⲡⲉⲣⲉⲭⲓⲟⲥ	ϩⲩⲡⲉⲣⲉⲭⲓⲟⲥ
ϩⲩⲡⲏⲣⲉⲧⲏⲥ	ϩⲩⲡⲏⲣⲉⲧⲏⲥ
ϩⲩⲡⲏⲣⲉⲭⲓⲟⲥ	ϩⲩⲡⲏⲣⲉⲭⲓⲟⲥ
ϩⲩⲡⲟⲕⲣⲓⲛⲉ	ϩⲩⲡⲟⲕⲣⲓⲛⲉ
ϩⲩⲡⲟⲕⲣⲓⲥⲓⲥ	ϩⲩⲡⲟⲕⲣⲓⲥⲓⲥ
ϩⲩⲡⲟⲕⲣⲓⲧⲏⲥ	ϩⲩⲡⲟⲕⲣⲓⲧⲏⲥ
ϩⲩⲡⲟⲙⲓⲛⲉ	ϩⲩⲡⲟⲙⲓⲛⲉ
ϩⲩⲡⲟⲙⲟⲛⲏ	ϩⲩⲡⲟⲙⲟⲛⲏ
ϩⲩⲡⲟⲥⲧⲁⲥⲓⲥ	ϩⲩⲡⲟⲥⲧⲁⲥⲓⲥ
ϩⲩⲡⲟⲧⲁⲅⲏ	ϩⲩⲡⲟⲧⲁⲅⲏ
ϩⲩⲡⲟⲧⲁⲥⲥⲉ	ϩⲩⲡⲟⲧⲁⲥⲥⲉ
ϩⲱ	ϩⲱ
ϩⲱϫⲉ	ϩⲱϫⲉ
ϩⲱϫⲡ	ϩⲱϫⲡ
ϩⲱϭⲃ	ϩⲱϭⲃ
ϩⲱⲃ	ϩⲱⲃ
ϩⲱⲃⲥ	ϩⲱⲃⲥ
ϩⲱⲗϭ	ϩⲱⲗϭ
ϩⲱⲙ	ϩⲱⲙ
ϩⲱⲛ	ϩⲱⲛ
ϩⲱⲟⲩ	ϩⲱⲟⲩ
ϩⲱⲡ	ϩⲱⲡ
ϩⲱⲣⲡ	ϩⲱⲣⲡ
ϩⲱⲣⲥⲓⲏⲥⲓ	ϩⲱⲣⲥⲓⲏⲥⲓ
ϩⲱⲥ	ϩⲱⲥ
ϩⲱⲥⲟⲛ	ϩⲱⲥⲟⲛ
ϩⲱⲥⲧⲉ	ϩⲱⲥⲧⲉ
ϩⲱⲧ	ϩⲱⲧ
ϩⲱⲧⲃ	ϩⲱⲧⲃ
ϩⲱⲧⲡ	ϩⲱⲧⲡ
ϩⲱⲱ	ϩⲱⲱ
ϩⲱⲱⲥ	ϩⲱⲱⲥ
ϫ[ⲉ]	ϫ[ⲉ]
ϫⲁϩⲙ	ϫⲁϩⲙ
ϫⲁϫⲉ	ϫⲁϫⲉ
ϫⲁϫⲉⲉⲩ	ϫⲁϫⲉⲉⲩ
ϫⲁⲉⲓⲉ	ϫⲁⲉⲓⲉ
ϫⲁⲓⲃⲉⲕⲉ	ϫⲁⲓⲃⲉⲕⲉ
ϫⲁⲓⲉ	ϫⲁⲓⲉ
ϫⲁⲙⲏ	ϫⲁⲙⲏ
ϫⲁⲥ	ϫⲁⲥ
ϫⲁⲥⲓϩⲏⲧ	ϫⲁⲥⲓ|ϩⲏⲧ
ϫⲁⲩⲙⲟⲉⲓⲧ	ϫⲁⲩ|ⲙⲟⲉⲓⲧ
ϫⲃⲃⲉⲥ	ϫⲃⲃⲉⲥ
ϫⲉ	ϫⲉ
ϫⲉⲕ	ϫⲉⲕ
ϫⲉⲕⲁⲁⲥ	ϫⲉⲕⲁⲁⲥ
ϫⲉⲕⲁⲥ	ϫⲉⲕⲁⲥ
ϫⲉⲕⲙ	ϫⲉⲕⲙ
ϫⲉⲛⲁ	ϫⲉⲛⲁ
ϫⲉⲛⲉⲡⲱⲣ	ϫⲉⲛⲉⲡⲱⲣ
ϫⲉⲛⲟⲩ	ϫⲉⲛⲟⲩ
ϫⲉⲣⲉ	ϫⲉⲣⲉ
ϫⲉⲣⲟ	ϫⲉⲣⲟ
ϫⲉⲣⲱ	ϫⲉⲣⲱ
ϫⲉⲩ	ϫⲉⲩ
ϫⲏ	ϫⲏ
ϫⲏϭⲉ	ϫⲏϭⲉ
ϫⲏⲏⲥ	ϫⲏⲏⲥ
ϫⲏⲕ	ϫⲏⲕ
ϫⲏⲣ	ϫⲏⲣ
ϫⲓ	ϫⲓ
ϫⲓϣⲁϫⲉ	ϫⲓ|ϣⲁϫⲉ
ϫⲓϣⲓⲡⲉ	ϫⲓ|ϣⲓⲡⲉ
ϫⲓϣⲕⲁⲕ	ϫⲓ|ϣⲕⲁⲕ
ϫⲓϣⲟϫⲛⲉ	ϫⲓ|ϣⲟϫⲛⲉ
ϫⲓϥⲟϭⲥ	ϫⲓϥⲟϭⲥ
ϫⲓϩⲁⲓ	ϫⲓ|ϩⲁⲓ
ϫⲓϩⲁⲡ	ϫⲓ|ϩⲁⲡ
ϫⲓϩⲓⲙⲉ	ϫⲓ|ϩⲓⲙⲉ
ϫⲓϩⲟ	ϫⲓ|ϩⲟ
ϫⲓϩⲣⲁ	ϫⲓ|ϩⲣⲁ
ϫⲓϩⲣⲁϥ	ϫⲓ|ϩⲣⲁ|ϥ
ϫⲓϫⲉⲉⲩⲉ	ϫⲓϫⲉⲉⲩⲉ
ϫⲓϫⲣⲟⲡ	ϫⲓ|ϫⲣⲟⲡ
ϫⲓϫⲱⲓ	ϫⲓϫⲱⲓ
ϫⲓϭⲟⲗ	ϫⲓ|ϭⲟⲗ
ϫⲓϯⲡⲉ	ϫⲓ|ϯⲡⲉ
ϫⲓⲉⲟⲟⲩ	ϫⲓ|ⲉⲟⲟⲩ
ϫⲓⲕⲃⲁ	ϫⲓ|ⲕⲃⲁ
ϫⲓⲕⲱⲧ	ϫⲓ|ⲕⲱⲧ
ϫⲓⲙ	ϫⲓⲙ
ϫⲓⲛ	ϫⲓⲛ
ϫⲓⲛϫⲏ	ϫⲓⲛϫⲏ
ϫⲓⲛϭⲟⲛⲥ	ϫⲓ|ⲛ|ϭⲟⲛⲥ
ϫⲓⲛⲧⲁ	ϫⲓⲛⲧⲁ
ϫⲓⲟⲟⲣ	ϫⲓⲟⲟⲣ
ϫⲓⲟⲩⲁ	ϫⲓ|ⲟⲩⲁ
ϫⲓⲟⲩⲉ	ϫⲓⲟⲩⲉ
ϫⲓⲥⲃⲱ	ϫⲓ|ⲥⲃⲱ
ϫⲓⲥⲉ	ϫⲓⲥⲉ
ϫⲓⲥⲕⲉⲩⲏ	ϫⲓ|ⲥⲕⲉⲩⲏ
ϫⲓⲥⲙⲟⲩ	ϫⲓ|ⲥⲙⲟⲩ
ϫⲓⲥⲟⲟⲩⲉ	ϫⲓⲥⲟⲟⲩⲉ
ϫⲓⲧ	ϫⲓⲧ
ϫⲓⲧⲉ	ϫⲓⲧⲉ
ϫⲕ	ϫⲕ
ϫⲛ	ϫⲛ
ϫⲛⲁϩ	ϫⲛⲁϩ
ϫⲛⲁⲁⲩ	ϫⲛⲁⲁⲩ
ϫⲛⲉ	ϫⲛⲉ
ϫⲛⲟⲩ	ϫⲛⲟⲩ
ϫⲟ	ϫⲟ
ϫⲟϥϫϥ	ϫⲟϥϫϥ
ϫⲟⲉⲓ	ϫⲟⲉⲓ
ϫⲟⲉⲓⲥ	ϫⲟⲉⲓⲥ
ϫⲟⲉⲓⲧ	ϫⲟⲉⲓⲧ
ϫⲟⲓ	ϫⲟⲓ
ϫⲟⲓⲥ	ϫⲟⲓⲥ
ϫⲟⲕⲙ	ϫⲟⲕⲙ
ϫⲟⲕⲣ	ϫⲟⲕⲣ
ϫⲟⲛⲧ	ϫⲟⲛⲧ
ϫⲟⲟ	ϫⲟⲟ
ϫⲟⲟⲣ	ϫⲟⲟⲣ
ϫⲟⲟⲩ	ϫⲟⲟⲩ
ϫⲟⲟⲩⲥⲉ	ϫⲟⲟⲩⲥⲉ
ϫⲟⲟⲩⲧ	ϫⲟⲟⲩⲧ
ϫⲟⲡϫⲡ	ϫⲟⲡϫⲡ
ϫⲟⲥ	ϫⲟⲥ
ϫⲟⲥⲉ	ϫⲟⲥⲉ
ϫⲟⲩⲣⲏ	ϫⲟⲩⲣⲏ
ϫⲟⲩⲧ	ϫⲟⲩⲧ
ϫⲟⲩⲧⲏ	ϫⲟⲩⲧⲏ
ϫⲟⲩⲧⲥⲁϣϥⲉ	ϫⲟⲩⲧ|ⲥⲁϣϥⲉ
ϫⲟⲩⲱⲧ	ϫⲟⲩⲱⲧ
ϫⲡ	ϫⲡ
ϫⲡⲉ	ϫⲡⲉ
ϫⲡⲓ	ϫⲡⲓ
ϫⲡⲓⲉ	ϫⲡⲓⲉ
ϫⲡⲓⲟ	ϫⲡⲓⲟ
ϫⲡⲟ	ϫⲡⲟ
ϫⲣⲟ	ϫⲣⲟ
ϫⲣⲟⲡ	ϫⲣⲟⲡ
ϫⲧⲉ	ϫⲧⲉ
ϫⲱ	ϫⲱ
ϫⲱϥ	ϫⲱϥ
ϫⲱϩ	ϫⲱϩ
ϫⲱϩⲙ	ϫⲱϩⲙ
ϫⲱⲕ	ϫⲱⲕ
ϫⲱⲕⲙ	ϫⲱⲕⲙ
ϫⲱⲗϩ	ϫⲱⲗϩ
ϫⲱⲗϫ	ϫⲱⲗϫ
ϫⲱⲗⲕ	ϫⲱⲗⲕ
ϫⲱⲛⲧ	ϫⲱⲛⲧ
ϫⲱⲧⲙ	ϫⲱⲧⲙ
ϫⲱⲱⲙⲉ	ϫⲱⲱⲙⲉ
ϫⲱⲱⲣ	ϫⲱⲱⲣ
ϫⲱⲱⲣⲉ	ϫⲱⲱⲣⲉ
ϭⲁⲃ	ϭⲁⲃ
ϭⲁⲗ	ϭⲁⲗ
ϭⲁⲗⲉ	ϭⲁⲗⲉ
ϭⲁⲗⲱ	ϭⲁⲗⲱ
ϭⲁⲗⲱⲟⲩ	ϭⲁⲗⲱⲟⲩ
ϭⲁⲙⲟⲩⲗ	ϭⲁⲙⲟⲩⲗ
ϭⲁⲛⲁϩ	ϭⲁⲛⲁϩ
ϭⲃⲃⲉ	ϭⲃⲃⲉ
ϭⲉ	ϭⲉ
ϭⲉϣϭⲱϣ	ϭⲉϣϭⲱϣ
ϭⲉⲉⲧ	ϭⲉⲉⲧ
ϭⲉⲗⲡ	ϭⲉⲗⲡ
ϭⲉⲡ	ϭⲉⲡ
ϭⲉⲡⲏ	ϭⲉⲡⲏ
ϭⲉⲣⲟⲟⲃ	ϭⲉⲣⲟⲟⲃ
ϭⲉⲣⲱⲃ	ϭⲉⲣⲱⲃ
ϭⲏⲡ	ϭⲏⲡ
ϭⲓϫ	ϭⲓϫ
ϭⲓⲛ	ϭⲓⲛ
ϭⲓⲛϣⲁϫⲉ	ϭⲓⲛ|ϣⲁϫⲉ
ϭⲓⲛϣⲱⲗⲙ	ϭⲓⲛ|ϣⲱⲗⲙ
ϭⲓⲛϭⲗⲱ	ϭⲓⲛϭⲗⲱ
ϭⲓⲛⲁϩⲉⲣⲁⲧ	ϭⲓⲛ|ⲁϩⲉⲣⲁⲧ
ϭⲓⲛⲉ	ϭⲓⲛⲉ
ϭⲓⲛⲙⲟⲟϣⲉ	ϭⲓⲛ|ⲙⲟⲟϣⲉ
ϭⲓⲛⲛⲁⲩ	ϭⲓⲛ|ⲛⲁⲩ
ϭⲓⲛⲛⲥⲱⲧⲙ	ϭⲓⲛ|ⲛ|ⲥⲱⲧⲙ
ϭⲓⲛⲟⲩⲃⲁⲗ	ϭⲓⲛⲟⲩⲃⲁⲗ
ϭⲓⲛⲟⲩⲟⲟⲙ	ϭⲓⲛ|ⲟⲩⲟⲟⲙ
ϭⲓⲛⲟⲩⲱⲙ	ϭⲓⲛ|ⲟⲩⲱⲙ
ϭⲓⲛⲡⲟⲗⲩⲙⲉⲓ	ϭⲓⲛ|ⲡⲟⲗⲩⲙⲉⲓ
ϭⲓⲛⲥⲱⲧⲙ	ϭⲓⲛ|ⲥⲱⲧⲙ
ϭⲓⲛⲱⲛⲁϩ	ϭⲓⲛ|ⲱⲛⲁϩ
ϭⲓⲥ	ϭⲓⲥ
ϭⲗⲙⲗⲱⲙ	ϭⲗⲙⲗⲱⲙ
ϭⲗⲟϭ	ϭⲗⲟϭ
ϭⲗⲟⲙⲗⲙ	ϭⲗⲟⲙⲗⲙ
ϭⲗⲟⲟϭⲉ	ϭⲗⲟⲟϭⲉ
ϭⲗⲱϭ	ϭⲗⲱϭ
ϭⲙϣⲓⲛⲉ	ϭⲙ|ϣⲓⲛⲉ
ϭⲙϭⲟⲙ	ϭⲙϭⲟⲙ
ϭⲙⲏⲟⲩ	ϭⲙⲏⲟⲩ
ϭⲙⲏⲩ	ϭⲙⲏⲩ
ϭⲛ	ϭⲛ
ϭⲛⲁⲣⲓⲕⲉ	ϭⲛ|ⲁⲣⲓⲕⲉ
ϭⲛⲁⲧ	ϭⲛⲁⲧ
ϭⲛⲉⲓⲇⲱⲗⲟⲛ	ϭⲛ|ⲉⲓⲇⲱⲗⲟⲛ
ϭⲛⲧ	ϭⲛⲧ
ϭⲟϫⲃ	ϭⲟϫⲃ
ϭⲟⲓⲗⲉ	ϭⲟⲓⲗⲉ
ϭⲟⲗ	ϭⲟⲗ
ϭⲟⲗⲡ	ϭⲟⲗⲡ
ϭⲟⲙ	ϭⲟⲙ
ϭⲟⲛⲥ	ϭⲟⲛⲥ
ϭⲟⲛⲧ	ϭⲟⲛⲧ
ϭⲟⲟⲃ	ϭⲟⲟⲃ
ϭⲟⲟⲗ	ϭⲟⲟⲗ
ϭⲟⲟⲗⲉ	ϭⲟⲟⲗⲉ
ϭⲟⲟⲙ	ϭⲟⲟⲙ
ϭⲟⲟⲙⲉ	ϭⲟⲟⲙⲉ
ϭⲟⲟⲩϭ	ϭⲟⲟⲩϭ
ϭⲟⲡ	ϭⲟⲡ
ϭⲟⲡⲧ	ϭⲟⲡⲧ
ϭⲟⲣϭⲥ	ϭⲟⲣϭⲥ
ϭⲟⲥⲙ	ϭⲟⲥⲙ
ϭⲟⲧ	ϭⲟⲧ
ϭⲟⲧⲡ	ϭⲟⲧⲡ
ϭⲣⲉϩⲧ	ϭⲣⲉϩⲧ
ϭⲣⲏⲡⲉ	ϭⲣⲏⲡⲉ
ϭⲣⲟϭ	ϭⲣⲟϭ
ϭⲣⲟⲟⲙⲡⲉ	ϭⲣⲟⲟⲙⲡⲉ
ϭⲣⲱϭ	ϭⲣⲱϭ
ϭⲣⲱⲱϭ	ϭⲣⲱⲱϭ
ϭⲱ	ϭⲱ
ϭⲱϣⲧ	ϭⲱϣⲧ
ϭⲱⲃ	ϭⲱⲃ
ϭⲱⲃⲉ	ϭⲱⲃⲉ
ϭⲱⲗⲡ	ϭⲱⲗⲡ
ϭⲱⲙ	ϭⲱⲙ
ϭⲱⲛⲧ	ϭⲱⲛⲧ
ϭⲱⲡⲉ	ϭⲱⲡⲉ
ϭⲱⲣϭ	ϭⲱⲣϭ
ϭⲱⲧⲡ	ϭⲱⲧⲡ
ϯ	ϯ
ϯϣⲓⲡⲉ	ϯ|ϣⲓⲡⲉ
ϯϩⲁϩ	ϯ|ϩⲁϩ
ϯϩⲁⲡ	ϯ|ϩⲁⲡ
ϯϩⲉ	ϯϩⲉ
ϯϩⲏⲩ	ϯ|ϩⲏⲩ
ϯϩⲓⲥⲉ	ϯ|ϩⲓⲥⲉ
ϯϩⲓⲱⲱϥ	ϯ|ϩⲓⲱⲱϥ
ϯϩⲣⲟⲟⲩ	ϯ|ϩⲣⲟⲟⲩ
ϯϩⲧⲏ	ϯ|ϩⲧⲏ
ϯϭⲟⲙ	ϯ|ϭⲟⲙ
ϯϭⲣⲟⲟⲙⲡⲉ	ϯ|ϭⲣⲟⲟⲙⲡⲉ
ϯⲁⲁⲥ	ϯ|ⲁⲁⲥ
ϯⲁⲏⲥ	ϯ|ⲁⲏⲥ
ϯⲃⲥ	ϯⲃⲥ
ϯⲃⲱⲱⲛ	ϯ|ⲃⲱⲱⲛ
ϯⲉⲓⲃⲧ	ϯ|ⲉⲓⲃⲧ
ϯⲉⲟⲟⲩ	ϯ|ⲉⲟⲟⲩ
ϯⲑⲉ	ϯ|ⲧ|ϩⲉ
ϯⲕⲗⲯ	ϯ|ⲕⲗⲯ
ϯⲗⲟⲅⲟⲥ	ϯ|ⲗⲟⲅⲟⲥ
ϯⲙⲁⲉⲓⲛ	ϯ|ⲙⲁⲉⲓⲛ
ϯⲙⲉ	ϯⲙⲉ
ϯⲙⲉⲉⲩⲉ	ϯ|ⲙⲉⲉⲩⲉ
ϯⲙⲏ	ϯⲙⲏ
ϯⲙⲧⲟⲛ	ϯ|ⲙⲧⲟⲛ
ϯⲛⲁⲁⲕⲉ	ϯ|ⲛⲁⲁⲕⲉ
ϯⲛⲟⲩϭⲥ	ϯ|ⲛⲟⲩϭⲥ
ϯⲛⲧⲟⲗⲏ	ϯ|ⲛⲧⲟⲗⲏ
ϯⲟⲥⲉ	ϯ|ⲟⲥⲉ
ϯⲟⲩ	ϯⲟⲩ
ϯⲟⲩⲃⲉ	ϯ|ⲟⲩⲃⲉ
ϯⲟⲩⲱ	ϯ|ⲟⲩⲱ
ϯⲡⲉ	ϯⲡⲉ
ϯⲡⲉⲩⲟⲓ	ϯⲡⲉⲩⲟⲓ
ϯⲡⲓ	ϯ|ⲡⲓ
ϯⲣⲁⲛ	ϯ|ⲣⲁⲛ
ϯⲣⲙⲉⲓⲏ	ϯ|ⲣⲙⲉⲓⲏ
ϯⲥⲃⲱ	ϯ|ⲥⲃⲱ
ϯⲥⲙⲏ	ϯ|ⲥⲙⲏ
ϯⲥⲟ	ϯ|ⲥⲟ
ϯⲥⲟⲟⲩⲛ	ϯ|ⲥⲟⲟⲩⲛ
ϯⲧⲟⲟⲧ	ϯ|ⲧⲟⲟⲧ
ϯⲧⲣⲁⲡⲉⲍⲁ	ϯ|ⲧⲣⲁⲡⲉⲍⲁ
ϯⲧⲱⲛ	ϯ|ⲧⲱⲛ
ϯⲭⲁⲣⲓⲥ	ϯ|ⲭⲁⲣⲓⲥ
—	—
†	†
…ⲛ	…ⲛ
⁛	⁛
☧	☧
⟦…ⲓⲁⲛ	⟦…ⲓⲁⲛ
ⲁ	ⲁ
ⲁϣ	ⲁϣ
ⲁϣϣⲕⲁⲕ	ⲁϣ|ϣⲕⲁⲕ
ⲁϣⲁϩⲟⲙ	ⲁϣ|ⲁϩⲟⲙ
ⲁϣⲁⲓ	ⲁϣⲁⲓ
ⲁϣⲉ	ⲁϣⲉ
ⲁϣⲏ	ⲁϣⲏ
ⲁϣⲱ	ⲁϣⲱ
ⲁϥ	ⲁϥ
ⲁϥⲣⲁϩⲁⲙ	ⲁϥⲣⲁϩⲁⲙ
ⲁϩⲉ	ⲁϩⲉ
ⲁϩⲉⲣ	ⲁϩⲉⲣ
ⲁϩⲉⲣⲁⲧ	ⲁϩⲉ|ⲣⲁⲧ
ⲁϩⲉⲣⲁⲧⲉ	ⲁϩⲉⲣⲁⲧⲉ
ⲁϩⲏⲩ	ⲁϩⲏⲩ
ⲁϩⲟ	ⲁϩⲟ
ⲁϩⲟⲩ	ⲁϩⲟⲩ
ⲁϩⲣⲟ	ⲁϩⲣⲟ
ⲁϩⲣⲱ	ⲁϩⲣⲱ
ⲁϫⲓ	ⲁϫⲓ
ⲁϫⲓⲏⲡⲉ	ⲁϫⲓ|ⲏⲡⲉ
ⲁϫⲙ	ⲁϫⲙ
ⲁϫⲛ	ⲁϫⲛ
ⲁϫⲛⲧ	ⲁϫⲛⲧ
ⲁϭⲟⲗⲧⲉ	ⲁϭⲟⲗⲧⲉ
ⲁϭⲣⲏⲛ	ⲁϭⲣⲏⲛ
ⲁⲁ	ⲁⲁ
ⲁⲃ	ⲁⲃ
ⲁⲃⲃⲁ	ⲁⲃⲃⲁ
ⲁⲃⲉⲗ	ⲁⲃⲉⲗ
ⲁⲃⲓⲁⲑⲁⲣ	ⲁⲃⲓⲁⲑⲁⲣ
ⲁⲃⲣⲁϩⲁⲙ	ⲁⲃⲣⲁϩⲁⲙ
ⲁⲅⲁⲑⲁⲣⲥⲓ	ⲁⲅⲁⲑⲁⲣⲥⲓ
ⲁⲅⲁⲑⲟⲛ	ⲁⲅⲁⲑⲟⲛ
ⲁⲅⲁⲑⲟⲥ	ⲁⲅⲁⲑⲟⲥ
ⲁⲅⲁⲡⲏ	ⲁⲅⲁⲡⲏ
ⲁⲅⲅⲉⲗⲓⲕⲏ	ⲁⲅⲅⲉⲗⲓⲕⲏ
ⲁⲅⲅⲉⲗⲓⲟⲛ	ⲁⲅⲅⲉⲗⲓⲟⲛ
ⲁⲅⲅⲉⲗⲟⲥ	ⲁⲅⲅⲉⲗⲟⲥ
ⲁⲅⲅⲏⲛ	ⲁⲅⲅⲏⲛ
ⲁⲅⲅⲓⲟⲛ	ⲁⲅⲅⲓⲟⲛ
ⲁⲅⲉⲗⲏ	ⲁⲅⲉⲗⲏ
ⲁⲅⲟⲣⲁ	ⲁⲅⲟⲣⲁ
ⲁⲅⲱⲛ	ⲁⲅⲱⲛ
ⲁⲅⲱⲛⲓⲍⲉ	ⲁⲅⲱⲛⲓⲍⲉ
ⲁⲅⲱⲣⲁ	ⲁⲅⲱⲣⲁ
ⲁⲇⲁⲙ	ⲁⲇⲁⲙ
ⲁⲇⲓⲕⲟⲥ	ⲁⲇⲓⲕⲟⲥ
ⲁⲇⲱⲛⲁⲓ	ⲁⲇⲱⲛⲁⲓ
ⲁⲉⲓⲧ	ⲁⲉⲓⲧ
ⲁⲏⲣ	ⲁⲏⲣ
ⲁⲏⲥ	ⲁⲏⲥ
ⲁⲑⲁ	ⲁⲑⲁ
ⲁⲑⲉⲧⲉⲓ	ⲁⲑⲉⲧⲉⲓ
ⲁⲑⲉⲧⲓ	ⲁⲑⲉⲧⲓ
ⲁⲑⲏⲧ	ⲁⲑⲏⲧ
ⲁⲓ	ⲁⲓ
ⲁⲓⲥⲑⲁⲛⲉ	ⲁⲓⲥⲑⲁⲛⲉ
ⲁⲓⲥⲑⲏⲥⲓⲥ	ⲁⲓⲥⲑⲏⲥⲓⲥ
ⲁⲓⲧⲉⲓ	ⲁⲓⲧⲉⲓ
ⲁⲓⲧⲏⲙⲁ	ⲁⲓⲧⲏⲙⲁ
ⲁⲓⲧⲓ	ⲁⲓⲧⲓ
ⲁⲓⲧⲓⲁ	ⲁⲓⲧⲓⲁ
ⲁⲓⲭⲁ	ⲁⲓⲭⲁ
ⲁⲓⲭⲙⲁⲗⲱⲥⲓⲁ	ⲁⲓⲭⲙⲁⲗⲱⲥⲓⲁ
ⲁⲓⲱⲛ	ⲁⲓⲱⲛ
ⲁⲕⲁⲑⲁⲣⲥⲓⲁ	ⲁⲕⲁⲑⲁⲣⲥⲓⲁ
ⲁⲕⲁⲑⲁⲣⲧⲟⲛ	ⲁⲕⲁⲑⲁⲣⲧⲟⲛ
ⲁⲕⲁⲑⲁⲣⲧⲟⲥ	ⲁⲕⲁⲑⲁⲣⲧⲟⲥ
ⲁⲕⲧⲓⲛ	ⲁⲕⲧⲓⲛ
ⲁⲕⲩⲗⲁ	ⲁⲕⲩⲗⲁ
ⲁⲗ	ⲁⲗ
ⲁⲗⲁⲃⲁⲥⲧⲣⲟⲛ	ⲁⲗⲁⲃⲁⲥⲧⲣⲟⲛ
ⲁⲗⲁⲗⲉⲓⲁ	ⲁⲗⲁⲗⲉⲓⲁ
ⲁⲗⲁⲗⲓⲁ	ⲁⲗⲁⲗⲓⲁ
ⲁⲗⲉ	ⲁⲗⲉ
ⲁⲗⲉⲕⲧⲱⲣ	ⲁⲗⲉⲕⲧⲱⲣ
ⲁⲗⲉⲝⲁⲛⲇⲣⲟⲥ	ⲁⲗⲉⲝⲁⲛⲇⲣⲟⲥ
ⲁⲗⲏⲑⲱⲥ	ⲁⲗⲏⲑⲱⲥ
ⲁⲗⲗⲁ	ⲁⲗⲗⲁ
ⲁⲗⲗⲟ	ⲁⲗⲗⲟ
ⲁⲗⲟⲙ	ⲁⲗⲟⲙ
ⲁⲗⲟⲟⲩⲉ	ⲁⲗⲟⲟⲩⲉ
ⲁⲗⲫⲁⲓⲟⲥ	ⲁⲗⲫⲁⲓⲟⲥ
ⲁⲗⲱ	ⲁⲗⲱ
ⲁⲗⲱⲧⲛ	ⲁⲗⲱⲧⲛ
ⲁⲙ	ⲁⲙ
ⲁⲙⲁϩⲧⲉ	ⲁⲙⲁϩⲧⲉ
ⲁⲙⲉⲗⲓⲁ	ⲁⲙⲉⲗⲓⲁ
ⲁⲙⲏⲉⲓⲛ	ⲁⲙⲏⲉⲓⲛ
ⲁⲙⲏⲓ	ⲁⲙⲏⲓ
ⲁⲙⲏⲓⲛ	ⲁⲙⲏⲓⲛ
ⲁⲙⲛⲧⲉ	ⲁⲙⲛⲧⲉ
ⲁⲙⲟⲩ	ⲁⲙⲟⲩ
ⲁⲙⲱⲛⲁ	ⲁⲙⲱⲛⲁ
ⲁⲛ	ⲁⲛ
ⲁⲛϫⲱϫ	ⲁⲛϫⲱϫ
ⲁⲛⲁϣ	ⲁⲛⲁϣ
ⲁⲛⲁϥ	ⲁⲛⲁϥ
ⲁⲛⲁⲅⲕⲁⲍⲉ	ⲁⲛⲁⲅⲕⲁⲍⲉ
ⲁⲛⲁⲅⲕⲁⲓⲟⲛ	ⲁⲛⲁⲅⲕⲁⲓⲟⲛ
ⲁⲛⲁⲅⲕⲏ	ⲁⲛⲁⲅⲕⲏ
ⲁⲛⲁⲅⲛⲱⲥⲧⲏⲥ	ⲁⲛⲁⲅⲛⲱⲥⲧⲏⲥ
ⲁⲛⲁⲑⲉⲙⲁ	ⲁⲛⲁⲑⲉⲙⲁ
ⲁⲛⲁⲕⲣⲓⲛⲉ	ⲁⲛⲁⲕⲣⲓⲛⲉ
ⲁⲛⲁⲥⲧⲁⲥⲓⲥ	ⲁⲛⲁⲥⲧⲁⲥⲓⲥ
ⲁⲛⲁⲩ	ⲁⲛⲁⲩ
ⲁⲛⲁⲩϣ	ⲁⲛⲁⲩϣ
ⲁⲛⲁⲭⲱⲣⲉⲓ	ⲁⲛⲁⲭⲱⲣⲉⲓ
ⲁⲛⲁⲭⲱⲣⲏⲧⲏⲥ	ⲁⲛⲁⲭⲱⲣⲏⲧⲏⲥ
ⲁⲛⲅ	ⲁⲛⲅ
ⲁⲛⲇⲓⲗⲟⲅⲓⲁ	ⲁⲛⲇⲓⲗⲟⲅⲓⲁ
ⲁⲛⲇⲣⲉⲁⲥ	ⲁⲛⲇⲣⲉⲁⲥ
ⲁⲛⲉⲭⲉ	ⲁⲛⲉⲭⲉ
ⲁⲛⲍⲏⲃⲉ	ⲁⲛⲍⲏⲃⲉ
ⲁⲛⲓ	ⲁⲛⲓ
ⲁⲛⲛⲁ	ⲁⲛⲛⲁ
ⲁⲛⲟⲕ	ⲁⲛⲟⲕ
ⲁⲛⲟⲙⲓⲁ	ⲁⲛⲟⲙⲓⲁ
ⲁⲛⲟⲙⲟⲥ	ⲁⲛⲟⲙⲟⲥ
ⲁⲛⲟⲛ	ⲁⲛⲟⲛ
ⲁⲛⲟⲭⲏ	ⲁⲛⲟⲭⲏ
ⲁⲛⲧ	ⲁⲛⲧ
ⲁⲛⲧⲓ	ⲁⲛⲧⲓ
ⲁⲛⲧⲓⲕⲓⲙⲉⲛⲟⲥ	ⲁⲛⲧⲓⲕⲓⲙⲉⲛⲟⲥ
ⲁⲛⲧⲓⲗⲟⲅⲓⲁ	ⲁⲛⲧⲓⲗⲟⲅⲓⲁ
ⲁⲛⲧⲓⲭⲣⲓⲥⲧⲟⲥ	ⲁⲛⲧⲓⲭⲣⲓⲥⲧⲟⲥ
ⲁⲛⲧⲱⲛⲓⲟⲥ	ⲁⲛⲧⲱⲛⲓⲟⲥ
ⲁⲛⲩⲥⲧⲏⲥ	ⲁⲛⲩⲥⲧⲏⲥ
ⲁⲝⲓⲱⲙⲁ	ⲁⲝⲓⲱⲙⲁ
ⲁⲡⲁ	ⲁⲡⲁ
ⲁⲡⲁⲛⲧⲁ	ⲁⲡⲁⲛⲧⲁ
ⲁⲡⲁⲣⲛⲁ	ⲁⲡⲁⲣⲛⲁ
ⲁⲡⲁⲣⲭⲏ	ⲁⲡⲁⲣⲭⲏ
ⲁⲡⲁⲧⲁ	ⲁⲡⲁⲧⲁ
ⲁⲡⲁⲧⲏ	ⲁⲡⲁⲧⲏ
ⲁⲡⲉ	ⲁⲡⲉ
ⲁⲡⲉⲓⲗⲉⲓ	ⲁⲡⲉⲓⲗⲉⲓ
ⲁⲡⲉⲭⲉ	ⲁⲡⲉⲭⲉ
ⲁⲡⲏⲩⲉ	ⲁⲡⲏⲩⲉ
ⲁⲡⲓⲗⲏ	ⲁⲡⲓⲗⲏ
ⲁⲡⲓⲥⲧⲟⲥ	ⲁⲡⲓⲥⲧⲟⲥ
ⲁⲡⲟⲇⲏⲙⲉⲓ	ⲁⲡⲟⲇⲏⲙⲉⲓ
ⲁⲡⲟⲗⲁⲩⲉ	ⲁⲡⲟⲗⲁⲩⲉ
ⲁⲡⲟⲗⲁⲩⲥⲓⲥ	ⲁⲡⲟⲗⲁⲩⲥⲓⲥ
ⲁⲡⲟⲗⲗⲱ	ⲁⲡⲟⲗⲗⲱ
ⲁⲡⲟⲗⲗⲱⲛ	ⲁⲡⲟⲗⲗⲱⲛ
ⲁⲡⲟⲗⲟⲅⲓⲁ	ⲁⲡⲟⲗⲟⲅⲓⲁ
ⲁⲡⲟⲥⲧⲁⲥⲥⲉ	ⲁⲡⲟⲥⲧⲁⲥⲥⲉ
ⲁⲡⲟⲥⲧⲁⲧⲏⲥ	ⲁⲡⲟⲥⲧⲁⲧⲏⲥ
ⲁⲡⲟⲥⲧⲟⲗⲟⲥ	ⲁⲡⲟⲥⲧⲟⲗⲟⲥ
ⲁⲡⲟⲧ	ⲁⲡⲟⲧ
ⲁⲡⲟⲧⲁⲥⲥⲉ	ⲁⲡⲟⲧⲁⲥⲥⲉ
ⲁⲡⲟⲫⲁⲥⲓⲥ	ⲁⲡⲟⲫⲁⲥⲓⲥ
ⲁⲡⲥ	ⲁⲡⲥ
ⲁⲣ	ⲁⲣ
ⲁⲣⲁ	ⲁⲣⲁ
ⲁⲣⲉⲥ	ⲁⲣⲉⲥ
ⲁⲣⲉⲥⲕⲉ	ⲁⲣⲉⲥⲕⲉ
ⲁⲣⲉⲧⲏ	ⲁⲣⲉⲧⲏ
ⲁⲣⲏϫ	ⲁⲣⲏϫ
ⲁⲣⲏⲩ	ⲁⲣⲏⲩ
ⲁⲣⲓ	ⲁⲣⲓ
ⲁⲣⲓⲑⲩⲥⲓⲁⲍⲉ	ⲁⲣⲓ|ⲑⲩⲥⲓⲁⲍⲉ
ⲁⲣⲓⲕⲉ	ⲁⲣⲓⲕⲉ
ⲁⲣⲓⲙⲁⲑⲁⲓⲟⲥ	ⲁⲣⲓⲙⲁⲑⲁⲓⲟⲥ
ⲁⲣⲓⲥⲧⲟⲛ	ⲁⲣⲓⲥⲧⲟⲛ
ⲁⲣⲛⲁ	ⲁⲣⲛⲁ
ⲁⲣⲟⲟⲩⲉ	ⲁⲣⲟⲟⲩⲉ
ⲁⲣⲧⲉⲙⲓⲥ	ⲁⲣⲧⲉⲙⲓⲥ
ⲁⲣⲭⲁⲓⲟⲥ	ⲁⲣⲭⲁⲓⲟⲥ
ⲁⲣⲭⲉⲓ	ⲁⲣⲭⲉⲓ
ⲁⲣⲭⲉⲟⲥ	ⲁⲣⲭⲉⲟⲥ
ⲁⲣⲭⲉⲥⲑⲁⲓ	ⲁⲣⲭⲉⲥⲑⲁⲓ
ⲁⲣⲭⲏ	ⲁⲣⲭⲏ
ⲁⲣⲭⲏⲉⲡⲓⲥⲕⲟⲡⲟⲥ	ⲁⲣⲭⲏⲉⲡⲓⲥⲕⲟⲡⲟⲥ
ⲁⲣⲭⲏⲗⲏⲥⲧⲏⲥ	ⲁⲣⲭⲏⲗⲏⲥⲧⲏⲥ
ⲁⲣⲭⲓ	ⲁⲣⲭⲓ
ⲁⲣⲭⲓⲉⲣⲉⲩⲥ	ⲁⲣⲭⲓⲉⲣⲉⲩⲥ
ⲁⲣⲭⲓⲙⲁⲛⲇⲣⲓⲧⲏⲥ	ⲁⲣⲭⲓⲙⲁⲛⲇⲣⲓⲧⲏⲥ
ⲁⲣⲭⲓⲥⲩⲛⲁⲅⲱⲅⲟⲥ	ⲁⲣⲭⲓⲥⲩⲛⲁⲅⲱⲅⲟⲥ
ⲁⲣⲭⲓⲧⲉⲕⲧⲱⲛ	ⲁⲣⲭⲓⲧⲉⲕⲧⲱⲛ
ⲁⲣⲭⲓⲧⲗⲕ	ⲁⲣⲭⲓⲧⲗⲕ
ⲁⲣⲭⲱⲛ	ⲁⲣⲭⲱⲛ
ⲁⲥ	ⲁⲥ
ⲁⲥⲉⲃⲏⲥ	ⲁⲥⲉⲃⲏⲥ
ⲁⲥⲑⲉⲛⲏⲥ	ⲁⲥⲑⲉⲛⲏⲥ
ⲁⲥⲓⲁ	ⲁⲥⲓⲁ
ⲁⲥⲕⲉⲓ	ⲁⲥⲕⲉⲓ
ⲁⲥⲕⲏⲥⲓⲥ	ⲁⲥⲕⲏⲥⲓⲥ
ⲁⲥⲟⲩ	ⲁⲥⲟⲩ
ⲁⲥⲡⲁⲍⲉ	ⲁⲥⲡⲁⲍⲉ
ⲁⲥⲡⲁⲥⲙⲟⲥ	ⲁⲥⲡⲁⲥⲙⲟⲥ
ⲁⲥⲡⲉ	ⲁⲥⲡⲉ
ⲁⲥⲭⲏⲙⲟⲛⲉⲓ	ⲁⲥⲭⲏⲙⲟⲛⲉⲓ
ⲁⲧ	ⲁⲧ
ⲁⲧϣⲁⲩ	ⲁⲧ|ϣⲁⲩ
ⲁⲧϣⲉⲗⲉⲉⲧ	ⲁⲧ|ϣⲉⲗⲉⲉⲧ
ⲁⲧϩⲏⲧ	ⲁⲧ|ϩⲏⲧ
ⲁⲧϩⲟⲧⲉ	ⲁⲧ|ϩⲟⲧⲉ
ⲁⲧϭⲟⲙ	ⲁⲧ|ϭⲟⲙ
ⲁⲧⲏⲡⲉ	ⲁⲧ|ⲏⲡⲉ
ⲁⲧⲑⲁⲃ	ⲁⲧ|ⲑⲁⲃ
ⲁⲧⲕⲁⲣⲡⲟⲥ	ⲁⲧ|ⲕⲁⲣⲡⲟⲥ
ⲁⲧⲕⲓⲙ	ⲁⲧ|ⲕⲓⲙ
ⲁⲧⲙⲟⲩⲛⲅ	ⲁⲧ|ⲙⲟⲩⲛⲕ
ⲁⲧⲙⲡϣⲁ	ⲁⲧⲙⲡϣⲁ
ⲁⲧⲛⲁ	ⲁⲧ|ⲛⲁ
ⲁⲧⲛⲁϩⲧⲉ	ⲁⲧ|ⲛⲁϩⲧⲉ
ⲁⲧⲛⲟⲃⲉ	ⲁⲧ|ⲛⲟⲃⲉ
ⲁⲧⲛⲟⲩⲧⲉ	ⲁⲧ|ⲛⲟⲩⲧⲉ
ⲁⲧⲟⲩⲱ	ⲁⲧ|ⲟⲩⲱ
ⲁⲧⲣⲟⲟⲩϣ	ⲁⲧ|ⲣⲟⲟⲩϣ
ⲁⲧⲥⲃⲃⲉ	ⲁⲧ|ⲥⲃⲃⲉ
ⲁⲧⲥⲃⲱ	ⲁⲧ|ⲥⲃⲱ
ⲁⲧⲥⲟⲟⲩⲛ	ⲁⲧ|ⲥⲟⲟⲩⲛ
ⲁⲧⲥⲱⲧⲙ	ⲁⲧ|ⲥⲱⲧⲙ
ⲁⲧⲧⲁⲕⲟ	ⲁⲧ|ⲧⲁⲕⲟ
ⲁⲩ	ⲁⲩ
ⲁⲩⲉⲓⲛ	ⲁⲩⲉⲓⲛ
ⲁⲩⲉⲓⲥ	ⲁⲩⲉⲓⲥ
ⲁⲩⲉⲧ	ⲁⲩⲉⲧ
ⲁⲩⲏⲧ	ⲁⲩⲏⲧ
ⲁⲩⲗⲏ	ⲁⲩⲗⲏ
ⲁⲩⲝⲁⲛⲉ	ⲁⲩⲝⲁⲛⲉ
ⲁⲩⲧⲟⲩ	ⲁⲩⲧⲟⲩ
ⲁⲩⲱ	ⲁⲩⲱ
ⲁⲫⲑⲟⲛⲓⲁ	ⲁⲫⲑⲟⲛⲓⲁ
ⲁⲫⲟⲣⲙⲏ	ⲁⲫⲟⲣⲙⲏ
ⲁⲭⲁⲓⲁ	ⲁⲭⲁⲓⲁ
ⲁⲭⲁⲓⲕⲟⲥ	ⲁⲭⲁⲓⲕⲟⲥ
ⲁⲯⲩⲭⲟⲛ	ⲁⲯⲩⲭⲟⲛ
ⲃϣⲉ	ⲃϣⲉ
ⲃⲁϣⲟⲣ	ⲃⲁϣⲟⲣ
ⲃⲁⲁⲃⲉ	ⲃⲁⲁⲃⲉ
ⲃⲁⲃⲉ	ⲃⲁⲃⲉ
ⲃⲁⲃⲉⲣⲱⲙⲉ	ⲃⲁⲃⲉ|ⲣⲱⲙⲉ
ⲃⲁⲗ	ⲃⲁⲗ
ⲃⲁⲗⲗⲁ	ⲃⲁⲗⲗⲁ
ⲃⲁⲗⲗⲁⲧⲓⲟⲛ	ⲃⲁⲗⲗⲁⲧⲓⲟⲛ
ⲃⲁⲡⲧⲓⲍⲉ	ⲃⲁⲡⲧⲓⲍⲉ
ⲃⲁⲡⲧⲓⲥⲙⲁ	ⲃⲁⲡⲧⲓⲥⲙⲁ
ⲃⲁⲡⲧⲓⲥⲧⲏⲥ	ⲃⲁⲡⲧⲓⲥⲧⲏⲥ
ⲃⲁⲣⲁⲃⲃⲁⲥ	ⲃⲁⲣⲁⲃⲃⲁⲥ
ⲃⲁⲣⲁⲭⲓⲁⲥ	ⲃⲁⲣⲁⲭⲓⲁⲥ
ⲃⲁⲣⲃⲁⲣⲟⲥ	ⲃⲁⲣⲃⲁⲣⲟⲥ
ⲃⲁⲣⲑⲟⲗⲟⲙⲁⲓⲟⲥ	ⲃⲁⲣⲑⲟⲗⲟⲙⲁⲓⲟⲥ
ⲃⲁⲣⲛⲁⲃⲁⲥ	ⲃⲁⲣⲛⲁⲃⲁⲥ
ⲃⲁⲣⲟⲥ	ⲃⲁⲣⲟⲥ
ⲃⲁⲣⲧⲓⲙⲁⲓⲟⲥ	ⲃⲁⲣⲧⲓⲙⲁⲓⲟⲥ
ⲃⲁⲥⲁⲛⲓⲍⲉ	ⲃⲁⲥⲁⲛⲓⲍⲉ
ⲃⲁⲥⲓⲗⲉⲓⲧⲏⲥ	ⲃⲁⲥⲓⲗⲉⲓⲧⲏⲥ
ⲃⲁⲥⲓⲙⲟⲥ	ⲃⲁⲥⲓⲙⲟⲥ
ⲃⲁⲥⲕⲁⲛⲟⲥ	ⲃⲁⲥⲕⲁⲛⲟⲥ
ⲃⲁⲧⲟⲥ	ⲃⲁⲧⲟⲥ
ⲃⲁⲩⲕⲁⲗⲓⲟⲛ	ⲃⲁⲩⲕⲁⲗⲓⲟⲛ
ⲃⲃⲗⲗⲁϥ	ⲃⲃⲗⲗⲁϥ
ⲃⲃⲟⲗ	ⲃⲃⲟⲗ
ⲃⲃⲣⲣⲉ	ⲃⲃⲣⲣⲉ
ⲃⲉⲉⲗⲍⲉⲃⲟⲩⲗ	ⲃⲉⲉⲗⲍⲉⲃⲟⲩⲗ
ⲃⲉⲕⲉ	ⲃⲉⲕⲉ
ⲃⲉⲛⲓⲁⲙⲓⲛ	ⲃⲉⲛⲓⲁⲙⲓⲛ
ⲃⲏⲃ	ⲃⲏⲃ
ⲃⲏⲇⲥⲁⲓⲇⲁⲛ	ⲃⲏⲇⲥⲁⲓⲇⲁⲛ
ⲃⲏⲑⲁⲛⲓⲁ	ⲃⲏⲑⲁⲛⲓⲁ
ⲃⲏⲑⲥⲁⲓⲇⲁ	ⲃⲏⲑⲥⲁⲓⲇⲁ
ⲃⲏⲕ	ⲃⲏⲕ
ⲃⲏⲗ	ⲃⲏⲗ
ⲃⲏⲙⲁ	ⲃⲏⲙⲁ
ⲃⲏⲥⲁⲣⲓⲟⲛ	ⲃⲏⲥⲁⲣⲓⲟⲛ
ⲃⲏⲧ	ⲃⲏⲧ
ⲃⲏⲧⲫⲁⲅⲏ	ⲃⲏⲧⲫⲁⲅⲏ
ⲃⲓⲕⲧⲱⲣ	ⲃⲓⲕⲧⲱⲣ
ⲃⲓⲟⲥ	ⲃⲓⲟⲥ
ⲃⲓⲣ	ⲃⲓⲣ
ⲃⲗ	ⲃⲗ
ⲃⲗⲃⲓⲗⲉ	ⲃⲗⲃⲓⲗⲉ
ⲃⲗⲗⲉ	ⲃⲗⲗⲉ
ⲃⲗⲗⲏ	ⲃⲗⲗⲏ
ⲃⲛⲧ	ⲃⲛⲧ
ⲃⲟⲁⲛⲏⲣⲅⲉⲥ	ⲃⲟⲁⲛⲏⲣⲅⲉⲥ
ⲃⲟⲏⲑⲉⲓ	ⲃⲟⲏⲑⲉⲓ
ⲃⲟⲏⲑⲉⲓⲁ	ⲃⲟⲏⲑⲉⲓⲁ
ⲃⲟⲏⲑⲓⲁ	ⲃⲟⲏⲑⲓⲁ
ⲃⲟⲏⲑⲟⲥ	ⲃⲟⲏⲑⲟⲥ
ⲃⲟⲗ	ⲃⲟⲗ
ⲃⲟⲗⲃⲗ	ⲃⲟⲗⲃⲗ
ⲃⲟⲙⲱⲥ	ⲃⲟⲙⲱⲥ
ⲃⲟⲟⲛⲉ	ⲃⲟⲟⲛⲉ
ⲃⲟⲧⲉ	ⲃⲟⲧⲉ
ⲃⲟⲩⲗⲉⲩⲧⲏⲥ	ⲃⲟⲩⲗⲉⲩⲧⲏⲥ
ⲃⲣⲣⲉ	ⲃⲣⲣⲉ
ⲃⲱ	ⲃⲱ
ⲃⲱϣ	ⲃⲱϣ
ⲃⲱⲕ	ⲃⲱⲕ
ⲃⲱⲗ	ⲃⲱⲗ
ⲅ	ⲅ
ⲅⲁⲃⲣⲓⲏⲗ	ⲅⲁⲃⲣⲓⲏⲗ
ⲅⲁⲍⲟⲫⲩⲗⲁⲕⲓⲟⲛ	ⲅⲁⲍⲟⲫⲩⲗⲁⲕⲓⲟⲛ
ⲅⲁⲓⲟⲥ	ⲅⲁⲓⲟⲥ
ⲅⲁⲗⲁⲧⲓⲁ	ⲅⲁⲗⲁⲧⲓⲁ
ⲅⲁⲗⲓⲗⲁⲓⲁ	ⲅⲁⲗⲓⲗⲁⲓⲁ
ⲅⲁⲗⲓⲗⲁⲓⲟⲥ	ⲅⲁⲗⲓⲗⲁⲓⲟⲥ
ⲅⲁⲙⲟⲥ	ⲅⲁⲙⲟⲥ
ⲅⲁⲣ	ⲅⲁⲣ
ⲅⲉϩⲉⲛⲛⲁ	ⲅⲉϩⲉⲛⲛⲁ
ⲅⲉⲑⲥⲏⲙⲁⲛⲉⲓ	ⲅⲉⲑⲥⲏⲙⲁⲛⲉⲓ
ⲅⲉⲛⲉⲁ	ⲅⲉⲛⲉⲁ
ⲅⲉⲛⲏⲙⲁ	ⲅⲉⲛⲏⲙⲁ
ⲅⲉⲛⲛⲁⲓⲟⲥ	ⲅⲉⲛⲛⲁⲓⲟⲥ
ⲅⲉⲛⲛⲏⲥⲁⲣⲉⲧ	ⲅⲉⲛⲛⲏⲥⲁⲣⲉⲧ
ⲅⲉⲛⲟⲥ	ⲅⲉⲛⲟⲥ
ⲅⲉⲣⲁⲥⲏⲛⲟⲥ	ⲅⲉⲣⲁⲥⲏⲛⲟⲥ
ⲅⲛⲏⲥⲓⲟⲥ	ⲅⲛⲏⲥⲓⲟⲥ
ⲅⲛⲱⲙⲏ	ⲅⲛⲱⲙⲏ
ⲅⲟⲗⲅⲟⲑⲁ	ⲅⲟⲗⲅⲟⲑⲁ
ⲅⲣⲁⲙⲙⲁⲧⲉⲩⲥ	ⲅⲣⲁⲙⲙⲁⲧⲉⲩⲥ
ⲅⲣⲁⲫⲏ	ⲅⲣⲁⲫⲏ
ⲅ⳿	ⲅ⳿
ⲇⲁⲓⲙⲟⲛⲓⲟⲛ	ⲇⲁⲓⲙⲟⲛⲓⲟⲛ
ⲇⲁⲓⲙⲱⲛ	ⲇⲁⲓⲙⲱⲛ
ⲇⲁⲓⲙⲱⲛⲓⲟⲛ	ⲇⲁⲓⲙⲱⲛⲓⲟⲛ
ⲇⲁⲗⲙⲁⲛⲟⲩⲑⲁ	ⲇⲁⲗⲙⲁⲛⲟⲩⲑⲁ
ⲇⲁⲛⲓⲏⲗ	ⲇⲁⲛⲓⲏⲗ
ⲇⲁⲩⲉⲓⲇ	ⲇⲁⲩⲉⲓⲇ
ⲇⲉ	ⲇⲉ
ⲇⲉⲃⲃⲱⲣⲁ	ⲇⲉⲃⲃⲱⲣⲁ
ⲇⲉⲓⲕⲁⲓⲟⲥ	ⲇⲉⲓⲕⲁⲓⲟⲥ
ⲇⲉⲓⲡⲛⲟⲛ	ⲇⲉⲓⲡⲛⲟⲛ
ⲇⲉⲕⲁⲡⲟⲗⲓⲥ	ⲇⲉⲕⲁⲡⲟⲗⲓⲥ
ⲇⲉⲩⲧⲉⲣⲁⲥ	ⲇⲉⲩⲧⲉⲣⲁⲥ
ⲇⲓⲁⲃⲟⲗⲟⲥ	ⲇⲓⲁⲃⲟⲗⲟⲥ
ⲇⲓⲁⲑⲏⲕⲏ	ⲇⲓⲁⲑⲏⲕⲏ
ⲇⲓⲁⲕⲟⲛⲉⲓ	ⲇⲓⲁⲕⲟⲛⲉⲓ
ⲇⲓⲁⲕⲟⲛⲓ	ⲇⲓⲁⲕⲟⲛⲓ
ⲇⲓⲁⲕⲟⲛⲓⲁ	ⲇⲓⲁⲕⲟⲛⲓⲁ
ⲇⲓⲁⲕⲟⲛⲟⲥ	ⲇⲓⲁⲕⲟⲛⲟⲥ
ⲇⲓⲁⲕⲣⲓⲛⲉ	ⲇⲓⲁⲕⲣⲓⲛⲉ
ⲇⲓⲁⲕⲣⲓⲥⲓⲥ	ⲇⲓⲁⲕⲣⲓⲥⲓⲥ
ⲇⲓⲁⲕⲱⲛ	ⲇⲓⲁⲕⲱⲛ
ⲇⲓⲁⲕⲱⲛⲉⲓ	ⲇⲓⲁⲕⲱⲛⲉⲓ
ⲇⲓⲁⲧⲁⲅⲙⲁ	ⲇⲓⲁⲧⲁⲅⲙⲁ
ⲇⲓⲕⲁⲓⲟⲛ	ⲇⲓⲕⲁⲓⲟⲛ
ⲇⲓⲕⲁⲓⲟⲥ	ⲇⲓⲕⲁⲓⲟⲥ
ⲇⲓⲕⲁⲓⲟⲥⲩⲛⲏ	ⲇⲓⲕⲁⲓⲟⲥⲩⲛⲏ
ⲇⲓⲕⲁⲓⲱⲙⲁ	ⲇⲓⲕⲁⲓⲱⲙⲁ
ⲇⲓⲕⲁⲓⲱⲥ	ⲇⲓⲕⲁⲓⲱⲥ
ⲇⲓⲕⲁⲥⲧⲏⲥ	ⲇⲓⲕⲁⲥⲧⲏⲥ
ⲇⲓⲟⲕⲗⲏϯⲁⲛⲟⲥ	ⲇⲓⲟⲕⲗⲏϯⲁⲛⲟⲥ
ⲇⲓⲟⲕⲗⲏϯⲁⲛⲟⲥ	ⲇⲓⲟⲕⲗⲏϯⲁⲛⲟⲥ
ⲇⲓⲡⲛⲟⲛ	ⲇⲓⲡⲛⲟⲛ
ⲇⲓⲥⲧⲁⲍⲉ	ⲇⲓⲥⲧⲁⲍⲉ
ⲇⲓⲱⲅⲙⲟⲥ	ⲇⲓⲱⲅⲙⲟⲥ
ⲇⲓⲱⲕⲉ	ⲇⲓⲱⲕⲉ
ⲇⲟⲇⲏⲥ	ⲇⲟⲇⲏⲥ
ⲇⲟⲕⲉⲓ	ⲇⲟⲕⲉⲓ
ⲇⲟⲕⲓⲙⲁⲍⲉ	ⲇⲟⲕⲓⲙⲁⲍⲉ
ⲇⲟⲩⲗⲟⲥ	ⲇⲟⲩⲗⲟⲥ
ⲇⲩⲛⲁⲧⲟⲥ	ⲇⲩⲛⲁⲧⲟⲥ
ⲇⲱⲣⲟⲛ	ⲇⲱⲣⲟⲛ
ⲉ	ⲉ
ⲉ......ⲙ....	ⲉ......ⲙ....
ⲉ[.....]	ⲉ[.....]
ⲉϣ	ⲉϣ
ⲉϣϣⲉ	ⲉϣϣⲉ
ⲉϣϩⲱⲡ	ⲉϣ|ϩⲱⲡ
ⲉϣϫⲉ	ⲉϣϫⲉ
ⲉϣⲁⲣⲉ	ⲉϣⲁⲣⲉ
ⲉϣⲁⲩ	ⲉϣⲁⲩ
ⲉϣⲗⲟⲩⲗⲁⲓ	ⲱϣ|ⲗⲟⲩⲗⲁⲓ
ⲉϣⲱⲡⲉ	ⲉϣⲱⲡⲉ
ⲉϥ	ⲉϥ
ⲉϥϣⲁⲛ	ⲉϥϣⲁⲛ
ⲉϥⲉ	ⲉϥⲉ
ⲉϥⲓ	ⲉϥⲓ
ⲉϩⲁⲣⲉ	ⲉϩⲁⲣⲉ
ⲉϩⲉ	ⲉϩⲉ
ⲉϩⲛⲁ	ⲉϩⲛⲁ
ⲉϩⲟⲟⲩ	ⲉϩⲟⲟⲩ
ⲉϩⲟⲩ	ⲉ|ϩⲟⲩ
ⲉϩⲟⲩⲉ	ⲉϩⲟⲩⲉ
ⲉϩⲟⲩⲛ	ⲉϩⲟⲩⲛ
ⲉϩⲣⲁ	ⲉϩⲣⲁ
ⲉϩⲣⲁⲓ	ⲉϩⲣⲁⲓ
ⲉϩⲣⲛ	ⲉϩⲣⲛ
ⲉϫ	ⲉϫ
ⲉϫ[.....]	ⲉϫ[.....]
ⲉϫⲏⲩ	ⲉϫⲏⲩ
ⲉϫⲙ	ⲉϫⲙ
ⲉϫⲛ	ⲉϫⲛ
ⲉϫⲱ	ⲉϫⲱ
ⲉⲃ[........]	ⲉⲃ[........]
ⲉⲃⲓⲁⲧⲉ	ⲉⲃⲓⲁⲧⲉ
ⲉⲃⲓⲏⲛ	ⲉⲃⲓⲏⲛ
ⲉⲃⲓⲟⲟⲩⲉ	ⲉⲃⲓⲟⲟⲩⲉ
ⲉⲃⲓⲱ	ⲉⲃⲓⲱ
ⲉⲃⲟⲗ	ⲉⲃⲟⲗ
ⲉⲃⲟⲗ ⲟⲩ	ⲉⲃⲟⲗ ⲟⲩ
ⲉⲃⲟⲧ	ⲉⲃⲟⲧ
ⲉⲅⲅⲩⲏ	ⲉⲅⲅⲩⲏ
ⲉⲅⲕⲣⲁⲧⲉⲩⲉ	ⲉⲅⲕⲣⲁⲧⲉⲩⲉ
ⲉⲇⲉⲙ	ⲉⲇⲉⲙ
ⲉⲉⲧ	ⲉⲉⲧ
ⲉⲓ	ⲉⲓ
ⲉⲓϣⲁⲛ	ⲉⲓϣⲁⲛ
ⲉⲓϥⲧ	ⲉⲓϥⲧ
ⲉⲓⲁ	ⲉⲓⲁ
ⲉⲓⲁⲗ	ⲉⲓⲁⲗ
ⲉⲓⲁⲧ	ⲉⲓⲁⲧ
ⲉⲓⲃ	ⲉⲓⲃ
ⲉⲓⲃⲉ	ⲉⲓⲃⲉ
ⲉⲓⲇⲟⲥ	ⲉⲓⲇⲟⲥ
ⲉⲓⲇⲱⲗⲟⲛ	ⲉⲓⲇⲱⲗⲟⲛ
ⲉⲓⲉ	ⲉⲓⲉ
ⲉⲓⲉⲓⲃ	ⲉⲓⲉⲓⲃ
ⲉⲓⲉⲣϩ	ⲉⲓⲉⲣϩ
ⲉⲓⲏⲥⲟⲩ	ⲉⲓⲏⲥⲟⲩ
ⲉⲓⲕⲏ	ⲉⲓⲕⲏ
ⲉⲓⲙⲁ	ⲉⲓⲙⲁ
ⲉⲓⲙⲉ	ⲉⲓⲙⲉ
ⲉⲓⲙⲏⲧⲉⲓ	ⲉⲓⲙⲏⲧⲉⲓ
ⲉⲓⲙⲏⲧⲓ	ⲉⲓⲙⲏⲧⲓ
ⲉⲓⲛⲉ	ⲉⲓⲛⲉ
ⲉⲓⲟⲙ	ⲉⲓⲟⲙ
ⲉⲓⲟⲟⲩⲉ	ⲉⲓⲟⲟⲩⲉ
ⲉⲓⲟⲣϩ	ⲉⲓⲟⲣϩ
ⲉⲓⲟⲧⲉ	ⲉⲓⲟⲧⲉ
ⲉⲓⲣⲁⲥⲙⲟⲥ	ⲉⲓⲣⲁⲥⲙⲟⲥ
ⲉⲓⲣⲉ	ⲉⲓⲣⲉ
ⲉⲓⲣⲏⲛⲏ	ⲉⲓⲣⲏⲛⲏ
ⲉⲓⲣⲏⲛⲓⲕⲟⲛ	ⲉⲓⲣⲏⲛⲓⲕⲟⲛ
ⲉⲓⲥ	ⲉⲓⲥ
ⲉⲓⲧⲁ	ⲉⲓⲧⲁ
ⲉⲓⲧⲉ	ⲉⲓⲧⲉ
ⲉⲓⲱ	ⲉⲓⲱ
ⲉⲓⲱⲣϩ	ⲉⲓⲱⲣϩ
ⲉⲓⲱⲧ	ⲉⲓⲱⲧ
ⲉⲕ	ⲉⲕ
ⲉⲕϣⲁⲛ	ⲉⲕϣⲁⲛ
ⲉⲕⲉ	ⲉⲕⲉ
ⲉⲕⲓⲃⲉ	ⲉⲕⲓⲃⲉ
ⲉⲕⲕⲗⲏⲥⲓⲁ	ⲉⲕⲕⲗⲏⲥⲓⲁ
ⲉⲕⲥⲧⲁⲥⲓⲥ	ⲉⲕⲥⲧⲁⲥⲓⲥ
ⲉⲗⲁⲭⲓⲥⲧⲟⲛ	ⲉⲗⲁⲭⲓⲥⲧⲟⲛ
ⲉⲗⲁⲭⲓⲥⲧⲟⲥ	ⲉⲗⲁⲭⲓⲥⲧⲟⲥ
ⲉⲗⲉⲩⲑⲉⲣⲟⲥ	ⲉⲗⲉⲩⲑⲉⲣⲟⲥ
ⲉⲗⲓⲥⲁⲃⲉⲧ	ⲉⲗⲓⲥⲁⲃⲉⲧ
ⲉⲗⲟ	ⲉⲗⲟ
ⲉⲗⲟⲟⲗⲉ	ⲉⲗⲟⲟⲗⲉ
ⲉⲗⲱ	ⲉⲗⲱ
ⲉⲗⲱⲉⲓ	ⲉⲗⲱⲉⲓ
ⲉⲙⲁⲧⲉ	ⲉⲙⲁⲧⲉ
ⲉⲙⲁⲩ	ⲉⲙⲁⲩ
ⲉⲙⲕ	ⲉⲙⲕ
ⲉⲙⲙⲟⲛ	ⲉⲙⲙⲟⲛ
ⲉⲙⲛⲧ	ⲉⲙⲛⲧ
ⲉⲙⲡϣⲁ	ⲉⲙⲡϣⲁ
ⲉⲙⲧⲟⲛ	ⲉⲙⲧⲟⲛ
ⲉⲛ	ⲉⲛ
ⲉⲛϣⲁⲛ	ⲉⲛϣⲁⲛ
ⲉⲛⲇⲁⲓⲙⲱⲛⲓⲟⲛ	ⲉⲛⲇⲁⲓⲙⲱⲛⲓⲟⲛ
ⲉⲛⲉ	ⲉⲛⲉ
ⲉⲛⲉϩ	ⲉⲛⲉϩ
ⲉⲛⲉⲣⲅⲉⲓ	ⲉⲛⲉⲣⲅⲉⲓ
ⲉⲛⲉⲣⲅⲏⲙⲁ	ⲉⲛⲉⲣⲅⲏⲙⲁ
ⲉⲛⲉⲣⲅⲓⲁ	ⲉⲛⲉⲣⲅⲓⲁ
ⲉⲛⲛ	ⲉⲛⲛ
ⲉⲛⲛⲁ	ⲉⲛⲛⲁ
ⲉⲛⲟⲭⲟⲥ	ⲉⲛⲟⲭⲟⲥ
ⲉⲛⲧ	ⲉⲛⲧ
ⲉⲛⲧⲏϭ	ⲉⲛⲧⲏϭ
ⲉⲛⲧⲟⲗⲏ	ⲉⲛⲧⲟⲗⲏ
ⲉⲛⲱⲭⲗⲉⲓ	ⲉⲛⲱⲭⲗⲉⲓ
ⲉⲝⲁⲡⲁⲧⲁ	ⲉⲝⲁⲡⲁⲧⲁ
ⲉⲝⲉⲇⲣⲁ	ⲉⲝⲉⲇⲣⲁ
ⲉⲝⲉⲥⲧⲉⲓ	ⲉⲝⲉⲥⲧⲉⲓ
ⲉⲝⲉⲥⲧⲓ	ⲉⲝⲉⲥⲧⲓ
ⲉⲝⲏⲅⲉⲥⲓⲥ	ⲉⲝⲏⲅⲉⲥⲓⲥ
ⲉⲝⲟⲙⲟⲗⲟⲅⲓ	ⲉⲝⲟⲙⲟⲗⲟⲅⲓ
ⲉⲝⲟⲩⲥⲓⲁ	ⲉⲝⲟⲩⲥⲓⲁ
ⲉⲟⲟⲩ	ⲉⲟⲟⲩ
ⲉⲡ	ⲉⲡ
ⲉⲡⲁϩⲟⲩ	ⲉⲡⲁϩⲟⲩ
ⲉⲡⲁⲓⲛⲟⲩ	ⲉⲡⲁⲓⲛⲟⲩ
ⲉⲡⲁⲣⲭⲟⲥ	ⲉⲡⲁⲣⲭⲟⲥ
ⲉⲡⲉ	ⲉⲡⲉ
ⲉⲡⲉⲓ	ⲉⲡⲉⲓ
ⲉⲡⲉⲓⲇⲏ	ⲉⲡⲉⲓⲇⲏ
ⲉⲡⲉⲥⲏⲧ	ⲉⲡⲉⲥⲏⲧ
ⲉⲡⲓⲇⲏ	ⲉⲡⲓⲇⲏ
ⲉⲡⲓⲑⲁⲛⲁⲧⲏⲥ	ⲉⲡⲓⲑⲁⲛⲁⲧⲏⲥ
ⲉⲡⲓⲑⲩⲙⲉⲓ	ⲉⲡⲓⲑⲩⲙⲉⲓ
ⲉⲡⲓⲑⲩⲙⲓⲁ	ⲉⲡⲓⲑⲩⲙⲓⲁ
ⲉⲡⲓⲕⲁⲗⲉⲓ	ⲉⲡⲓⲕⲁⲗⲉⲓ
ⲉⲡⲓⲥⲕⲟⲡⲟⲥ	ⲉⲡⲓⲥⲕⲟⲡⲟⲥ
ⲉⲡⲓⲥⲧⲏ	ⲉⲡⲓⲥⲧⲏ
ⲉⲡⲓⲥⲧⲏⲙⲉⲓ	ⲉⲡⲓⲥⲧⲏⲙⲉⲓ
ⲉⲡⲓⲥⲧⲏⲙⲏ	ⲉⲡⲓⲥⲧⲏⲙⲏ
ⲉⲡⲓⲥⲧⲟⲗⲏ	ⲉⲡⲓⲥⲧⲟⲗⲏ
ⲉⲡⲓⲧⲓⲙⲁ	ⲉⲡⲓⲧⲓⲙⲁ
ⲉⲡⲟⲓⲕⲓⲟⲛ 	ⲉⲡⲟⲓⲕⲓⲟⲛ 
ⲉⲡⲣⲁ	ⲉⲡⲣⲁ
ⲉⲡⲫⲁⲑⲁ	ⲉⲡⲫⲁⲑⲁ
ⲉⲣ	ⲉⲣ
ⲉⲣ..ⲧ…	ⲉⲣ..ⲧ…
ⲉⲣϣⲁⲛ	ⲉⲣϣⲁⲛ
ⲉⲣⲁ	ⲉⲣⲁ
ⲉⲣⲁⲧ	ⲉⲣⲁⲧ
ⲉⲣⲉ	ⲉⲣⲉ
ⲉⲣⲏⲙⲟⲥ	ⲉⲣⲏⲙⲟⲥ
ⲉⲣⲏⲧ	ⲉⲣⲏⲧ
ⲉⲣⲏⲩ	ⲉⲣⲏⲩ
ⲉⲣⲗⲁⲁⲩ	ⲉⲣ|ⲗⲁⲁⲩ
ⲉⲣⲛ	ⲉⲣⲛ
ⲉⲣⲟ	ⲉⲣⲟ
ⲉⲣⲱ	ⲉⲣⲱ
ⲉⲣⲱⲧⲉ	ⲉⲣⲱⲧⲉ
ⲉⲥ	ⲉⲥ
ⲉⲥϣⲁⲛ	ⲉⲥϣⲁⲛ
ⲉⲥⲉ	ⲉⲥⲉ
ⲉⲥⲏⲧ	ⲉⲥⲏⲧ
ⲉⲥⲑⲁⲛⲉ	ⲉⲥⲑⲁⲛⲉ
ⲉⲥⲑⲏⲧⲏⲣⲓⲟⲛ	ⲉⲥⲑⲏⲧⲏⲣⲓⲟⲛ
ⲉⲥⲟⲟⲩ	ⲉⲥⲟⲟⲩ
ⲉⲧ	ⲉⲧ
ⲉⲧⲃ	ⲉⲧⲃ
ⲉⲧⲃⲃⲏ	ⲉⲧⲃⲃⲏ
ⲉⲧⲃⲉ	ⲉⲧⲃⲉ
ⲉⲧⲃⲏⲏ	ⲉⲧⲃⲏⲏ
ⲉⲧⲃⲏⲏⲧ	ⲉⲧⲃⲏⲏⲧ
ⲉⲧⲃⲏⲧ	ⲉⲧⲃⲏⲧ
ⲉⲧⲉ	ⲉⲧⲉ
ⲉⲧⲉⲓ	ⲉⲧⲉⲓ
ⲉⲧⲉⲛⲟⲩ	ⲉⲧⲉⲛⲟⲩ
ⲉⲧⲉⲣⲉ	ⲉⲧⲉⲣⲉ
ⲉⲧⲉⲧⲛϣⲁⲛ	ⲉⲧⲉⲧⲛϣⲁⲛ
ⲉⲧⲉⲧⲛⲉ	ⲉⲧⲉⲧⲛⲉ
ⲉⲧⲓ	ⲉⲧⲓ
ⲉⲧⲛ	ⲉⲧⲛ
ⲉⲧⲟⲟⲧ	ⲉⲧⲟⲟⲧ
ⲉⲧⲟⲧ	ⲉⲧⲟⲧ
ⲉⲧⲣⲉ	ⲉⲧⲣⲉ
ⲉⲧⲱ	ⲉⲧⲱ
ⲉⲩ	ⲉⲩ
ⲉⲩϣⲁⲛ	ⲉⲩϣⲁⲛ
ⲉⲩϩⲁ	ⲉⲩϩⲁ
ⲉⲩϩⲁⲓⲟⲥ	ⲉⲩϩⲁⲓⲟⲥ
ⲉⲩⲁⲅⲅⲉⲗⲓⲍⲉ	ⲉⲩⲁⲅⲅⲉⲗⲓⲍⲉ
ⲉⲩⲁⲅⲅⲉⲗⲓⲟⲛ	ⲉⲩⲁⲅⲅⲉⲗⲓⲟⲛ
ⲉⲩⲅⲉⲛⲏⲥ	ⲉⲩⲅⲉⲛⲏⲥ
ⲉⲩⲉ	ⲉⲩⲉ
ⲉⲩⲕⲁⲓⲣⲓⲁ	ⲉⲩⲕⲁⲓⲣⲓⲁ
ⲉⲩⲛⲟⲩ	ⲉⲩⲛⲟⲩ
ⲉⲩⲣⲓⲡⲟⲥ	ⲉⲩⲣⲓⲡⲟⲥ
ⲉⲩⲥⲭⲩⲙⲟⲥⲩⲛⲏ	ⲉⲩⲥⲭⲩⲙⲟⲥⲩⲛⲏ
ⲉⲩⲫⲣⲁⲛⲉ	ⲉⲩⲫⲣⲁⲛⲉ
ⲉⲩⲫⲣⲟⲥⲩⲛⲏ	ⲉⲩⲫⲣⲟⲥⲩⲛⲏ
ⲉⲩⲭⲁⲣⲓⲥⲧⲟⲩ	ⲉⲩⲭⲁⲣⲓⲥⲧⲟⲩ
ⲉⲫⲉⲥⲟⲥ	ⲉⲫⲉⲥⲟⲥ
ⲉⲫⲣⲉⲙ	ⲉⲫⲣⲉⲙ
ⲍⲁⲗⲉϩ	ⲍⲁⲗⲉϩ
ⲍⲁⲭⲁⲣⲓⲁⲥ	ⲍⲁⲭⲁⲣⲓⲁⲥ
ⲍⲉⲃⲉⲇⲁⲓⲟⲥ	ⲍⲉⲃⲉⲇⲁⲓⲟⲥ
ⲍⲉⲗⲫⲁ	ⲍⲉⲗⲫⲁ
ⲍⲱⲟⲛ	ⲍⲱⲟⲛ
ⲏ	ⲏ
ⲏⲇⲏ	ⲏⲇⲏ
ⲏⲉⲓ	ⲏⲉⲓ
ⲏⲓ	ⲏⲓ
ⲏⲡ	ⲏⲡ
ⲏⲡⲉ	ⲏⲡⲉ
ⲏⲣⲡ	ⲏⲣⲡ
ⲏⲥⲁⲓⲁⲥ	ⲏⲥⲁⲓⲁⲥ
ⲏⲥⲁⲩ	ⲏⲥⲁⲩ
ⲏⲩⲉ	ⲏⲩⲉ
ⲑ	ⲑ
ⲑⲁⲃ	ⲑⲁⲃ
ⲑⲁⲇⲇⲁⲓⲟⲥ	ⲑⲁⲇⲇⲁⲓⲟⲥ
ⲑⲁⲗⲁⲥⲥⲁ	ⲑⲁⲗⲁⲥⲥⲁ
ⲑⲃⲃⲓⲉ	ⲑⲃⲃⲓⲉ
ⲑⲃⲃⲓⲟ	ⲑⲃⲃⲓⲟ
ⲑⲉⲁⲧⲣⲟⲛ	ⲑⲉⲁⲧⲣⲟⲛ
ⲑⲉⲟⲇⲟⲣⲟⲥ	ⲑⲉⲟⲇⲟⲣⲟⲥ
ⲑⲉⲟⲇⲱⲣ	ⲑⲉⲟⲇⲱⲣ
ⲑⲉⲟⲧⲟⲕⲟⲥ	ⲑⲉⲟⲧⲟⲕⲟⲥ
ⲑⲉⲟⲫⲓⲗⲟⲥ	ⲑⲉⲟⲫⲓⲗⲟⲥ
ⲑⲉⲣⲁⲡⲟⲩ	ⲑⲉⲣⲁⲡⲟⲩ
ⲑⲉⲱⲇⲱⲣⲟⲥ	ⲑⲉⲱⲇⲱⲣⲟⲥ
ⲑⲉⲱⲫⲓⲗⲟⲥ	ⲑⲉⲱⲫⲓⲗⲟⲥ
ⲑⲏⲣⲓⲟⲛ	ⲑⲏⲣⲓⲟⲛ
ⲑⲗⲓⲃⲉ	ⲑⲗⲓⲃⲉ
ⲑⲗⲓⲑⲗⲓⲯⲓⲥ	ⲑⲗⲓⲑⲗⲓⲯⲓⲥ
ⲑⲗⲓⲯⲓⲥ	ⲑⲗⲓⲯⲓⲥ
ⲑⲗⲟ	ⲑⲗⲟ
ⲑⲙⲕⲟ	ⲑⲙⲕⲟ
ⲑⲙⲟ	ⲑⲙⲟ
ⲑⲛⲟⲛ	ⲑⲛⲟⲛ
ⲑⲡⲟ	ⲑⲡⲟ
ⲑⲣⲟⲛⲟⲥ	ⲑⲣⲟⲛⲟⲥ
ⲑⲩⲥⲓⲁ	ⲑⲩⲥⲓⲁ
ⲑⲩⲥⲓⲁⲍⲉ	ⲑⲩⲥⲓⲁⲍⲉ
ⲑⲩⲥⲓⲁⲥⲧⲏⲣⲓⲟⲛ	ⲑⲩⲥⲓⲁⲥⲧⲏⲣⲓⲟⲛ
ⲑⲱⲙⲁⲥ	ⲑⲱⲙⲁⲥ
ⲓ	ⲓ
ⲓⲁ	ⲓⲁ
ⲓⲁⲉⲓⲣⲟⲥ	ⲓⲁⲉⲓⲣⲟⲥ
ⲓⲁⲕⲱⲃ	ⲓⲁⲕⲱⲃ
ⲓⲁⲕⲱⲃⲟⲥ	ⲓⲁⲕⲱⲃⲟⲥ
ⲓⲇⲟⲩⲙⲁⲓⲁ	ⲓⲇⲟⲩⲙⲁⲓⲁ
ⲓⲉⲍⲉⲕⲓⲏⲗ	ⲓⲉⲍⲉⲕⲓⲏⲗ
ⲓⲉⲣⲉⲙⲓⲁⲥ	ⲓⲉⲣⲉⲙⲓⲁⲥ
ⲓⲉⲣⲟ	ⲓⲉⲣⲟ
ⲓⲏⲥⲟⲩⲥ	ⲓⲏⲥⲟⲩⲥ
ⲓⲛⲁ	ⲓⲛⲁ
ⲓⲛⲇⲓⲕⲧⲓⲟⲛⲟⲥ	ⲓⲛⲇⲓⲕⲧⲓⲟⲛⲟⲥ
ⲓⲟⲣⲇⲁⲛⲏⲥ	ⲓⲟⲣⲇⲁⲛⲏⲥ
ⲓⲟⲩⲇⲁ	ⲓⲟⲩⲇⲁ
ⲓⲟⲩⲇⲁⲓ	ⲓⲟⲩⲇⲁⲓ
ⲓⲟⲩⲇⲁⲓⲁ	ⲓⲟⲩⲇⲁⲓⲁ
ⲓⲟⲩⲇⲁⲥ	ⲓⲟⲩⲇⲁⲥ
ⲓⲟⲩⲗⲉ	ⲓⲟⲩⲗⲉ
ⲓⲥⲁⲁⲕ	ⲓⲥⲁⲁⲕ
ⲓⲥⲁⲕ	ⲓⲥⲁⲕ
ⲓⲥⲕⲁⲣⲓⲱⲧⲏⲥ	ⲓⲥⲕⲁⲣⲓⲱⲧⲏⲥ
ⲓⲥⲙⲁⲏⲗ	ⲓⲥⲙⲁⲏⲗ
ⲓⲥⲣⲁⲏⲗ	ⲓⲥⲣⲁⲏⲗ
ⲓⲱϩⲁⲛⲏⲥ	ⲓⲱϩⲁⲛⲏⲥ
ⲓⲱϩⲁⲛⲛⲏⲥ	ⲓⲱϩⲁⲛⲛⲏⲥ
ⲓⲱⲁⲛⲛⲏⲥ	ⲓⲱⲁⲛⲛⲏⲥ
ⲓⲱⲥⲏ	ⲓⲱⲥⲏ
ⲓⲱⲥⲏⲫ	ⲓⲱⲥⲏⲫ
ⲓⲱⲥⲓⲁⲥ	ⲓⲱⲥⲓⲁⲥ
ⲕ	ⲕ
ⲕⲁ	ⲕⲁ
ⲕⲁϣ	ⲕⲁϣ
ⲕⲁϣⲁⲃⲉⲗ	ⲕⲁϣⲁⲃⲉⲗ
ⲕⲁϩ	ⲕⲁϩ
ⲕⲁϩⲏⲩ	ⲕⲁ|ϩⲏⲩ
ⲕⲁϫⲣⲟⲡ	ⲕⲁ|ϫⲣⲟⲡ
ⲕⲁⲁ	ⲕⲁⲁ
ⲕⲁⲁⲧ	ⲕⲁⲁⲧ
ⲕⲁⲃⲟⲗ	ⲕⲁ|ⲃⲟⲗ
ⲕⲁⲉⲓⲛ	ⲕⲁⲉⲓⲛ
ⲕⲁⲉⲩⲱ	ⲕⲁⲉⲩⲱ
ⲕⲁⲑⲁⲣⲓⲍⲉ	ⲕⲁⲑⲁⲣⲓⲍⲉ
ⲕⲁⲑⲁⲣⲟⲥ	ⲕⲁⲑⲁⲣⲟⲥ
ⲕⲁⲑⲉⲇⲣⲁ	ⲕⲁⲑⲉⲇⲣⲁ
ⲕⲁⲑⲏⲅⲉⲓ	ⲕⲁⲑⲏⲅⲉⲓ
ⲕⲁⲓ	ⲕⲁⲓ
ⲕⲁⲓⲣⲟⲥ	ⲕⲁⲓⲣⲟⲥ
ⲕⲁⲕⲉ	ⲕⲁⲕⲉ
ⲕⲁⲕⲓⲁ	ⲕⲁⲕⲓⲁ
ⲕⲁⲕⲟ	ⲕⲁⲕⲟ
ⲕⲁⲕⲱⲥ	ⲕⲁⲕⲱⲥ
ⲕⲁⲗⲱⲥ	ⲕⲁⲗⲱⲥ
ⲕⲁⲙⲁ	ⲕⲁ|ⲙⲁ
ⲕⲁⲛ	ⲕⲁⲛ
ⲕⲁⲛⲁⲛⲁⲓⲟⲥ	ⲕⲁⲛⲁⲛⲁⲓⲟⲥ
ⲕⲁⲛⲱⲛ	ⲕⲁⲛⲱⲛ
ⲕⲁⲡⲁⲣⲛⲁⲟⲩⲙ	ⲕⲁⲡⲁⲣⲛⲁⲟⲩⲙ
ⲕⲁⲡⲛⲟⲥ	ⲕⲁⲡⲛⲟⲥ
ⲕⲁⲣⲡⲟⲥ	ⲕⲁⲣⲡⲟⲥ
ⲕⲁⲣⲱ	ⲕⲁ|ⲣⲱ
ⲕⲁⲣⲱϥ	ⲕⲁⲣⲱϥ
ⲕⲁⲥⲓⲁⲛⲟⲥ	ⲕⲁⲥⲓⲁⲛⲟⲥ
ⲕⲁⲧⲁ	ⲕⲁⲧⲁ
ⲕⲁⲧⲁⲕⲗⲩⲥⲙⲟⲥ	ⲕⲁⲧⲁⲕⲗⲩⲥⲙⲟⲥ
ⲕⲁⲧⲁⲕⲣⲓⲙⲁ	ⲕⲁⲧⲁⲕⲣⲓⲙⲁ
ⲕⲁⲧⲁⲗⲁⲗⲓⲁ	ⲕⲁⲧⲁⲗⲁⲗⲓⲁ
ⲕⲁⲧⲁⲛⲧⲁ	ⲕⲁⲧⲁⲛⲧⲁ
ⲕⲁⲧⲁⲡⲉⲧⲁⲥⲙⲁ	ⲕⲁⲧⲁⲡⲉⲧⲁⲥⲙⲁ
ⲕⲁⲧⲁⲡⲟⲛϯⲍⲉ	ⲕⲁⲧⲁⲡⲟⲛϯⲍⲉ
ⲕⲁⲧⲁⲣⲅⲉⲓ	ⲕⲁⲧⲁⲣⲅⲉⲓ
ⲕⲁⲧⲁⲣⲟ	ⲕⲁⲧⲁⲣⲟ
ⲕⲁⲧⲁⲫⲣⲟⲛⲉⲓ	ⲕⲁⲧⲁⲫⲣⲟⲛⲉⲓ
ⲕⲁⲧⲏⲅⲟⲣⲉⲓ	ⲕⲁⲧⲏⲅⲟⲣⲉⲓ
ⲕⲁⲧⲏⲅⲟⲣⲓ	ⲕⲁⲧⲏⲅⲟⲣⲓ
ⲕⲁⲧⲟⲟⲧ	ⲕⲁ|ⲧⲟⲟⲧ
ⲕⲁⲧⲟⲣⲑⲟⲩ	ⲕⲁⲧⲟⲣⲑⲟⲩ
ⲕⲁⲫⲁⲣⲛⲁⲟⲩⲙ	ⲕⲁⲫⲁⲣⲛⲁⲟⲩⲙ
ⲕⲃⲁ	ⲕⲃⲁ
ⲕⲉ	ⲕⲉ
ⲕⲉⲉⲥ	ⲕⲉⲉⲥ
ⲕⲉⲗⲉⲩⲉ	ⲕⲉⲗⲉⲩⲉ
ⲕⲉⲛⲧⲏⲛⲁⲣⲓⲟⲛ	ⲕⲉⲛⲧⲏⲛⲁⲣⲓⲟⲛ
ⲕⲉⲛⲧⲩⲣⲓⲱⲛ	ⲕⲉⲛⲧⲩⲣⲓⲱⲛ
ⲕⲉⲣⲱⲛ	ⲕⲉⲣⲱⲛ
ⲕⲉⲥⲁⲣⲓⲁ	ⲕⲉⲥⲁⲣⲓⲁ
ⲕⲉⲧ	ⲕⲉⲧ
ⲕⲉⲧⲉ	ⲕⲉⲧⲉ
ⲕⲉⲩⲁ	ⲕⲉⲩⲁ
ⲕⲏ	ⲕⲏ
ⲕⲏϩ	ⲕⲏϩ
ⲕⲏⲃ	ⲕⲏⲃ
ⲕⲏⲕ	ⲕⲏⲕ
ⲕⲏⲕⲁϩⲏⲩ	ⲕⲏⲕ|ⲁϩⲏⲩ
ⲕⲏⲛⲥⲟⲥ	ⲕⲏⲛⲥⲟⲥ
ⲕⲏⲣⲩⲥⲥⲉ	ⲕⲏⲣⲩⲥⲥⲉ
ⲕⲏⲫⲁⲥ	ⲕⲏⲫⲁⲥ
ⲕⲓⲑⲁⲣⲁ	ⲕⲓⲑⲁⲣⲁ
ⲕⲓⲑⲁⲣⲓⲍⲉ	ⲕⲓⲑⲁⲣⲓⲍⲉ
ⲕⲓⲙ	ⲕⲓⲙ
ⲕⲓⲙⲕⲓⲙ	ⲕⲓⲙⲕⲓⲙ
ⲕⲓⲛⲇⲩⲛⲉⲩⲉ	ⲕⲓⲛⲇⲩⲛⲉⲩⲉ
ⲕⲗϫ	ⲕⲗϫ
ⲕⲗϫⲉ	ⲕⲗϫⲉ
ⲕⲗⲁϥⲧ	ⲕⲗⲁϥⲧ
ⲕⲗⲁⲇⲟⲥ	ⲕⲗⲁⲇⲟⲥ
ⲕⲗⲏⲣⲓⲕⲟⲥ	ⲕⲗⲏⲣⲓⲕⲟⲥ
ⲕⲗⲏⲣⲟⲛⲟⲙⲉⲓ	ⲕⲗⲏⲣⲟⲛⲟⲙⲉⲓ
ⲕⲗⲏⲣⲟⲛⲟⲙⲓⲁ	ⲕⲗⲏⲣⲟⲛⲟⲙⲓⲁ
ⲕⲗⲏⲣⲟⲛⲟⲙⲟⲥ	ⲕⲗⲏⲣⲟⲛⲟⲙⲟⲥ
ⲕⲗⲏⲣⲟⲥ	ⲕⲗⲏⲣⲟⲥ
ⲕⲗⲗⲉ	ⲕⲗⲗⲉ
ⲕⲗⲟⲙ	ⲕⲗⲟⲙ
ⲕⲗⲟⲟⲗⲉ	ⲕⲗⲟⲟⲗⲉ
ⲕⲛⲧⲉ	ⲕⲛⲧⲉ
ⲕⲟⲇⲣⲁⲛⲧⲏⲥ	ⲕⲟⲇⲣⲁⲛⲧⲏⲥ
ⲕⲟⲓⲛⲟⲛⲟⲥ	ⲕⲟⲓⲛⲟⲛⲟⲥ
ⲕⲟⲓⲛⲱⲛⲓⲁ	ⲕⲟⲓⲛⲱⲛⲓⲁ
ⲕⲟⲓⲛⲱⲛⲟⲥ	ⲕⲟⲓⲛⲱⲛⲟⲥ
ⲕⲟⲕⲕⲟⲥ	ⲕⲟⲕⲕⲟⲥ
ⲕⲟⲗⲁⲍⲉ	ⲕⲟⲗⲁⲍⲉ
ⲕⲟⲗⲁⲥⲓⲥ	ⲕⲟⲗⲁⲥⲓⲥ
ⲕⲟⲗⲗⲏⲅⲓⲟⲛ	ⲕⲟⲗⲗⲏⲅⲓⲟⲛ
ⲕⲟⲙϣ	ⲕⲟⲙϣ
ⲕⲟⲙⲉⲥ	ⲕⲟⲙⲉⲥ
ⲕⲟⲛϯⲧⲟⲛ	ⲕⲟⲛϯⲧⲟⲛ
ⲕⲟⲛⲥ	ⲕⲟⲛⲥ
ⲕⲟⲟϩ	ⲕⲟⲟϩ
ⲕⲟⲟⲣⲉ	ⲕⲟⲟⲣⲉ
ⲕⲟⲟⲥⲧ	ⲕⲟⲟⲥⲧ
ⲕⲟⲟⲩ	ⲕⲟⲟⲩ
ⲕⲟⲟⲩⲉ	ⲕⲟⲟⲩⲉ
ⲕⲟⲡⲣⲓⲁ	ⲕⲟⲡⲣⲓⲁ
ⲕⲟⲣⲃⲁⲛ	ⲕⲟⲣⲃⲁⲛ
ⲕⲟⲣⲓⲛⲑⲟⲥ	ⲕⲟⲣⲓⲛⲑⲟⲥ
ⲕⲟⲥⲙⲟⲕⲣⲁⲧⲱⲣ	ⲕⲟⲥⲙⲟⲕⲣⲁⲧⲱⲣ
ⲕⲟⲥⲙⲟⲥ	ⲕⲟⲥⲙⲟⲥ
ⲕⲟⲧ	ⲕⲟⲧ
ⲕⲟⲧⲥ	ⲕⲟⲧⲥ
ⲕⲟⲩⲉⲓ	ⲕⲟⲩⲉⲓ
ⲕⲟⲩⲓ	ⲕⲟⲩⲓ
ⲕⲟⲩⲙ	ⲕⲟⲩⲙ
ⲕⲣⲁⲛⲓⲟⲛ	ⲕⲣⲁⲛⲓⲟⲛ
ⲕⲣⲁⲧⲟⲥ	ⲕⲣⲁⲧⲟⲥ
ⲕⲣⲓⲕⲟⲥ	ⲕⲣⲓⲕⲟⲥ
ⲕⲣⲓⲙⲁ	ⲕⲣⲓⲙⲁ
ⲕⲣⲓⲛⲉ	ⲕⲣⲓⲛⲉ
ⲕⲣⲓⲥⲓⲥ	ⲕⲣⲓⲥⲓⲥ
ⲕⲣⲓⲥⲡⲟⲥ	ⲕⲣⲓⲥⲡⲟⲥ
ⲕⲣⲓⲧⲏⲥ	ⲕⲣⲓⲧⲏⲥ
ⲕⲣⲙⲣⲙ	ⲕⲣⲙⲣⲙ
ⲕⲣⲟ	ⲕⲣⲟ
ⲕⲣⲟϥ	ⲕⲣⲟϥ
ⲕⲣⲟⲛⲟⲥ	ⲕⲣⲟⲛⲟⲥ
ⲕⲧⲉ	ⲕⲧⲉ
ⲕⲧⲉⲓⲁⲧ	ⲕⲧ|ⲉⲓⲁⲧ
ⲕⲧⲟ	ⲕⲧⲟ
ⲕⲩⲙⲃⲁⲗⲟⲛ	ⲕⲩⲙⲃⲁⲗⲟⲛ
ⲕⲩⲣⲏⲛⲁⲓⲟⲥ	ⲕⲩⲣⲏⲛⲁⲓⲟⲥ
ⲕⲩⲣⲓⲁⲕⲏ	ⲕⲩⲣⲓⲁⲕⲏ
ⲕⲩⲣⲓⲁⲕⲟⲛ	ⲕⲩⲣⲓⲁⲕⲟⲛ
ⲕⲩⲣⲓⲝ	ⲕⲩⲣⲓⲝ
ⲕⲩⲣⲓⲟⲥ	ⲕⲩⲣⲓⲟⲥ
ⲕⲱ	ⲕⲱ
ⲕⲱϩ	ⲕⲱϩ
ⲕⲱϩⲧ	ⲕⲱϩⲧ
ⲕⲱⲃ	ⲕⲱⲃ
ⲕⲱⲗϩ	ⲕⲱⲗϩ
ⲕⲱⲗⲩ	ⲕⲱⲗⲩ
ⲕⲱⲗⲩⲉ	ⲕⲱⲗⲩⲉ
ⲕⲱⲙϣ	ⲕⲱⲙϣ
ⲕⲱⲙⲏ	ⲕⲱⲙⲏ
ⲕⲱⲛⲥ	ⲕⲱⲛⲥ
ⲕⲱⲥⲙⲓⲕⲟⲛ	ⲕⲱⲥⲙⲓⲕⲟⲛ
ⲕⲱⲧ	ⲕⲱⲧ
ⲕⲱⲧⲉ	ⲕⲱⲧⲉ
ⲕⲱⲱⲃⲉ	ⲕⲱⲱⲃⲉ
ⲗϩⲏⲙ	ⲗϩⲏⲙ
ⲗⲁⲁⲩ	ⲗⲁⲁⲩ
ⲗⲁⲕⲙ	ⲗⲁⲕⲙ
ⲗⲁⲙⲁ	ⲗⲁⲙⲁ
ⲗⲁⲟⲥ	ⲗⲁⲟⲥ
ⲗⲁⲥ	ⲗⲁⲥ
ⲗⲁⲩⲟ	ⲗⲁⲩⲟ
ⲗⲉϫⲗⲱϫ	ⲗⲉϫⲗⲱϫ
ⲗⲉⲅⲉⲱⲛ	ⲗⲉⲅⲉⲱⲛ
ⲗⲉⲅⲓⲱⲛ	ⲗⲉⲅⲓⲱⲛ
ⲗⲉⲗⲟⲩ	ⲗⲉⲗⲟⲩ
ⲗⲉⲟⲩⲉⲓ	ⲗⲉⲟⲩⲉⲓ
ⲗⲏⲡⲉⲓ	ⲗⲏⲡⲉⲓ
ⲗⲏⲡⲏ	ⲗⲏⲡⲏ
ⲗⲏⲥⲧⲏⲥ	ⲗⲏⲥⲧⲏⲥ
ⲗⲓⲁ	ⲗⲓⲁ
ⲗⲓⲃⲁⲛⲟⲥ	ⲗⲓⲃⲁⲛⲟⲥ
ⲗⲓⲧⲟⲩⲣⲅⲓⲁ	ⲗⲓⲧⲟⲩⲣⲅⲓⲁ
ⲗⲗⲉⲡⲧⲟⲛ	ⲗⲗⲉⲡⲧⲟⲛ
ⲗⲗⲏⲃ	ⲗⲗⲏⲃ
ⲗⲟ	ⲗⲟ
ⲗⲟϭ	ⲗⲟϭ
ⲗⲟⲃⲉ	ⲗⲟⲃⲉ
ⲗⲟⲅⲟⲥ	ⲗⲟⲅⲟⲥ
ⲗⲟⲑ	ⲗⲟⲑ
ⲗⲟⲓϩⲉ	ⲗⲟⲓϩⲉ
ⲗⲟⲓϭⲉ	ⲗⲟⲓϭⲉ
ⲗⲟⲙⲥ	ⲗⲟⲙⲥ
ⲗⲟⲩⲕⲓⲁⲛⲟⲥ	ⲗⲟⲩⲕⲓⲁⲛⲟⲥ
ⲗⲩⲡⲉⲓ	ⲗⲩⲡⲉⲓ
ⲗⲩⲡⲏ	ⲗⲩⲡⲏ
ⲗⲩⲭⲛⲓⲁ	ⲗⲩⲭⲛⲓⲁ
ⲗⲱϫϩ	ⲗⲱϫϩ
ⲗⲱⲕ	ⲗⲱⲕ
ⲗⲱⲧ	ⲗⲱⲧ
ⲙ	ⲙ
ⲙ[ ]	ⲙ[ ]
ⲙ[.....]ⲟⲓ	ⲙ[.....]ⲟⲓ
ⲙϩⲁⲁⲩ	ⲙϩⲁⲁⲩ
ⲙϩⲁⲟⲩ	ⲙϩⲁⲟⲩ
ⲙⲁ	ⲙⲁ
ⲙⲁϣⲉ	ⲙⲁϣⲉ
ⲙⲁϩ	ⲙⲁϩ
ⲙⲁⲁ	ⲙⲁⲁ
ⲙⲁⲁϫⲉ	ⲙⲁⲁϫⲉ
ⲙⲁⲁⲃ	ⲙⲁⲁⲃ
ⲙⲁⲁⲃⲉ	ⲙⲁⲁⲃⲉ
ⲙⲁⲁⲃⲧⲏ	ⲙⲁⲁⲃ|ⲧⲏ
ⲙⲁⲁⲩ	ⲙⲁⲁⲩ
ⲙⲁⲅⲇⲁⲗⲏⲛⲏ	ⲙⲁⲅⲇⲁⲗⲏⲛⲏ
ⲙⲁⲅⲉⲓⲣⲟⲥ	ⲙⲁⲅⲉⲓⲣⲟⲥ
ⲙⲁⲉⲓⲉ	ⲙⲁⲉⲓⲉ
ⲙⲁⲉⲓⲛ	ⲙⲁⲉⲓⲛ
ⲙⲁⲑⲁⲓⲟⲥ	ⲙⲁⲑⲁⲓⲟⲥ
ⲙⲁⲑⲏⲧⲏⲥ	ⲙⲁⲑⲏⲧⲏⲥ
ⲙⲁⲑⲙⲥⲟ	ⲙⲁ|ⲑⲙⲥⲟ
ⲙⲁⲓ	ⲙⲁⲓ
ⲙⲁⲓⲛ	ⲙⲁⲓⲛ
ⲙⲁⲓⲛⲟⲃⲉ	ⲙⲁⲓ|ⲛⲟⲃⲉ
ⲙⲁⲓⲛⲟⲩⲧⲉ	ⲙⲁⲓ|ⲛⲟⲩⲧⲉ
ⲙⲁⲓⲣⲱⲙⲉ	ⲙⲁⲓ|ⲣⲱⲙⲉ
ⲙⲁⲓⲥⲃⲱ	ⲙⲁⲓ|ⲥⲃⲱ
ⲙⲁⲓⲧⲟⲉ	ⲙⲁⲓ|ⲧⲟⲉ
ⲙⲁⲕϩ	ⲙⲁⲕϩ
ⲙⲁⲕⲁⲣⲓⲁ	ⲙⲁⲕⲁⲣⲓⲁ
ⲙⲁⲕⲁⲣⲓⲍⲉ	ⲙⲁⲕⲁⲣⲓⲍⲉ
ⲙⲁⲕⲁⲣⲓⲟⲥ	ⲙⲁⲕⲁⲣⲓⲟⲥ
ⲙⲁⲕⲉⲇⲟⲛⲓⲁ	ⲙⲁⲕⲉⲇⲟⲛⲓⲁ
ⲙⲁⲕⲉⲗⲗⲟⲥ	ⲙⲁⲕⲉⲗⲗⲟⲥ
ⲙⲁⲗⲁⲕⲟⲥ	ⲙⲁⲗⲁⲕⲟⲥ
ⲙⲁⲗⲓⲥⲧⲁ	ⲙⲁⲗⲓⲥⲧⲁ
ⲙⲁⲗⲗⲟⲛ	ⲙⲁⲗⲗⲟⲛ
ⲙⲁⲙⲙⲱⲛⲁⲥ	ⲙⲁⲙⲙⲱⲛⲁⲥ
ⲙⲁⲛⲓⲁⲕⲏⲥ	ⲙⲁⲛⲓⲁⲕⲏⲥ
ⲙⲁⲟⲩⲁⲁ	ⲙⲁⲟⲩⲁⲁ
ⲙⲁⲣ	ⲙⲁⲣ
ⲙⲁⲣⲁⲛ	ⲙⲁⲣⲁⲛ
ⲙⲁⲣⲉ	ⲙⲁⲣⲉ
ⲙⲁⲣⲓⲁ	ⲙⲁⲣⲓⲁ
ⲙⲁⲣⲛ	ⲙⲁⲣⲛ
ⲙⲁⲣⲟ	ⲙⲁⲣⲟ
ⲙⲁⲣⲧⲩⲣⲓⲁ	ⲙⲁⲣⲧⲩⲣⲓⲁ
ⲙⲁⲣⲧⲩⲣⲟⲥ	ⲙⲁⲣⲧⲩⲣⲟⲥ
ⲙⲁⲥⲉ	ⲙⲁⲥⲉ
ⲙⲁⲥⲡⲟⲣⲕ	ⲙⲁⲥⲡⲟⲣⲕ
ⲙⲁⲥⲧⲏⲝ	ⲙⲁⲥⲧⲏⲝ
ⲙⲁⲥⲧⲓⲅⲝ	ⲙⲁⲥⲧⲓⲅⲝ
ⲙⲁⲥⲧⲓⲅⲟⲩ	ⲙⲁⲥⲧⲓⲅⲟⲩ
ⲙⲁⲧⲉ	ⲙⲁⲧⲉ
ⲙⲁⲧⲟⲓ	ⲙⲁⲧⲟⲓ
ⲙⲁⲩⲁ	ⲙⲁⲩⲁ
ⲙⲁⲩⲁⲁ	ⲙⲁⲩⲁⲁ
ⲙⲁⲩⲁⲁⲧ	ⲙⲁⲩⲁⲁⲧ
ⲙⲁⲩⲁⲧ	ⲙⲁⲩⲁⲧ
ⲙⲉ	ⲙⲉ
ⲙⲉϣϣⲉ	ⲙⲉϣ|ϣⲉ
ⲙⲉϣⲁ	ⲙⲉϣⲁ
ⲙⲉϣⲁⲕ	ⲙⲉϣⲁⲕ
ⲙⲉϣⲉ	ⲙⲉϣⲉ
ⲙⲉϣⲧ	ⲙⲉϣⲧ
ⲙⲉϩ	ⲙⲉϩ
ⲙⲉϩϣⲟⲙⲛⲧ	ⲙⲉϩ|ϣⲟⲙⲛⲧ
ⲙⲉϩϣⲟⲙⲧⲉ	ⲙⲉϩ|ϣⲟⲙⲧⲉ
ⲙⲉϩϣⲟⲙⲧⲥⲱⲱⲡ	ⲙⲉϩ|ϣⲟⲙⲧ|ⲥⲱⲱⲡ
ⲙⲉϩϥⲧⲟⲟⲩ	ⲙⲉϩ|ϥⲧⲟⲟⲩ
ⲙⲉϩⲥⲁϣϥ	ⲙⲉϩ|ⲥⲁϣϥ
ⲙⲉϩⲥⲉⲡⲥⲛⲁⲩ	ⲙⲉϩ|ⲥⲉⲡ|ⲥⲛⲁⲩ
ⲙⲉϩⲥⲛⲁⲩ	ⲙⲉϩ|ⲥⲛⲁⲩ
ⲙⲉϩⲥⲛⲧⲉ	ⲙⲉϩ|ⲥⲛⲧⲉ
ⲙⲉⲅⲓⲥⲧⲁⲛⲟⲥ	ⲙⲉⲅⲓⲥⲧⲁⲛⲟⲥ
ⲙⲉⲉⲣⲉ	ⲙⲉⲉⲣⲉ
ⲙⲉⲉⲩⲉ	ⲙⲉⲉⲩⲉ
ⲙⲉⲕⲙⲟⲩⲕ	ⲙⲉⲕⲙⲟⲩⲕ
ⲙⲉⲗϩ	ⲙⲉⲗϩ
ⲙⲉⲗⲉⲧⲁ	ⲙⲉⲗⲉⲧⲁ
ⲙⲉⲗⲟⲥ	ⲙⲉⲗⲟⲥ
ⲙⲉⲗⲭⲓⲥⲉⲇⲉⲕ	ⲙⲉⲗⲭⲓⲥⲉⲇⲉⲕ
ⲙⲉⲛ	ⲙⲉⲛ
ⲙⲉⲣⲁⲧⲉ	ⲙⲉⲣⲁⲧⲉ
ⲙⲉⲣⲉ	ⲙⲉⲣⲉ
ⲙⲉⲣⲉϩ	ⲙⲉⲣⲉϩ
ⲙⲉⲣⲉⲟⲩⲱϩ	ⲙⲉⲣⲉ|ⲟⲩⲱϩ
ⲙⲉⲣⲓⲥ	ⲙⲉⲣⲓⲥ
ⲙⲉⲣⲓⲧ	ⲙⲉⲣⲓⲧ
ⲙⲉⲣⲟⲥ	ⲙⲉⲣⲟⲥ
ⲙⲉⲣⲟⲩⲥ	ⲙⲉⲣⲟⲩⲥ
ⲙⲉⲥⲟⲩⲁⲫⲓ	ⲙⲉⲥⲟⲩⲁⲫⲓ
ⲙⲉⲥⲧⲉ	ⲙⲉⲥⲧⲉ
ⲙⲉⲥⲧⲱ	ⲙⲉⲥⲧⲱ
ⲙⲉⲧⲁⲛⲟⲉⲓ	ⲙⲉⲧⲁⲛⲟⲉⲓ
ⲙⲉⲧⲁⲛⲟⲓ	ⲙⲉⲧⲁⲛⲟⲓ
ⲙⲉⲧⲁⲛⲟⲓⲁ	ⲙⲉⲧⲁⲛⲟⲓⲁ
ⲙⲉⲧⲉⲭⲉ	ⲙⲉⲧⲉⲭⲉ
ⲙⲉⲩⲉ	ⲙⲉⲩⲉ
ⲙⲉⲩⲧ	ⲙⲉⲩⲧ
ⲙⲏ	ⲙⲏ
ⲙⲏⲏϣⲉ	ⲙⲏⲏϣⲉ
ⲙⲏⲏⲛⲉ	ⲙⲏⲏⲛⲉ
ⲙⲏⲏⲧⲉ	ⲙⲏⲏⲧⲉ
ⲙⲏⲙⲟⲟⲩ	ⲙⲏ|ⲙⲟⲟⲩ
ⲙⲏⲛ	ⲙⲏⲛ
ⲙⲏⲛⲉ	ⲙⲏⲛⲉ
ⲙⲏⲡⲟⲧⲉ	ⲙⲏⲡⲟⲧⲉ
ⲙⲏⲡⲱⲥ	ⲙⲏⲡⲱⲥ
ⲙⲏⲣ	ⲙⲏⲣ
ⲙⲏⲧ	ⲙⲏⲧ
ⲙⲏⲧⲉ	ⲙⲏⲧⲉ
ⲙⲏⲧⲓ	ⲙⲏⲧⲓ
ⲙⲓϣⲉ	ⲙⲓϣⲉ
ⲙⲓⲗⲓⲟⲛ	ⲙⲓⲗⲓⲟⲛ
ⲙⲓⲛⲉ	ⲙⲓⲛⲉ
ⲙⲓⲥⲉ	ⲙⲓⲥⲉ
ⲙⲕⲁϩ	ⲙⲕⲁϩ
ⲙⲗⲁϩ	ⲙⲗⲁϩ
ⲙⲙⲁ	ⲙⲙⲁ
ⲙⲙⲁⲁⲩ	ⲙⲙⲁⲁⲩ
ⲙⲙⲁⲧⲉ	ⲙⲙⲁⲧⲉ
ⲙⲙⲁⲩ	ⲙⲙⲁⲩ
ⲙⲙⲉ	ⲙⲙⲉ
ⲙⲙⲏⲛⲉ	ⲙⲙⲏⲛⲉ
ⲙⲙⲓⲛ	ⲙⲙⲓⲛ
ⲙⲙⲓⲛⲙⲙⲟ	ⲙⲙⲓⲛⲙⲙⲟ
ⲙⲙⲓⲛⲙⲙⲱ	ⲙⲙⲓⲛⲙⲙⲱ
ⲙⲙⲛ	ⲙⲙⲛ
ⲙⲙⲛⲛⲥⲁ	ⲙⲙⲛⲛⲥⲁ
ⲙⲙⲛⲧ	ⲙⲙⲛⲧ
ⲙⲙⲛⲧⲁ	ⲙⲙⲛⲧⲁ
ⲙⲙⲛⲧⲉ	ⲙⲙⲛⲧⲉ
ⲙⲙⲛⲧⲏ	ⲙⲙⲛⲧⲏ
ⲙⲙⲟ	ⲙⲙⲟ
ⲙⲙⲟⲛ	ⲙⲙⲟⲛ
ⲙⲙⲟⲟⲩ	ⲙⲙⲟⲟⲩ
ⲙⲙⲟⲩ	ⲙⲙⲟⲩ
ⲙⲙⲱ	ⲙⲙⲱ
ⲙⲛ	ⲙⲛ
ⲙⲛⲛⲥⲁ	ⲙⲛⲛⲥⲁ
ⲙⲛⲛⲥⲱ	ⲙⲛⲛⲥⲱ
ⲙⲛⲟⲩⲧ	ⲙⲛⲟⲩⲧ
ⲙⲛⲧ	ⲙⲛⲧ
ⲙⲛⲧ|ϣⲙⲏⲛ	ⲙⲛⲧ|ϣⲙⲏⲛ
ⲙⲛⲧ|ϣⲙⲏⲛⲉ	ⲙⲛⲧ|ϣⲙⲏⲛⲉ
ⲙⲛⲧϣⲁ	ⲙⲛⲧϣⲁ
ⲙⲛⲧϣⲁϥⲧⲉ	ⲙⲛⲧ|ϣⲁϥⲧⲉ
ⲙⲛⲧϣⲁⲛϩⲧⲏ	ⲙⲛⲧ|ϣⲁⲛ|ϩⲧⲏ
ⲙⲛⲧϣⲁⲛϩⲧⲏϥ	ⲙⲛⲧ|ϣⲁ|ⲛ|ϩⲧⲏ|ϥ
ⲙⲛⲧϣⲁⲩ	ⲙⲛⲧ|ϣⲁⲩ
ⲙⲛⲧϣⲃⲏⲣ	ⲙⲛⲧ|ϣⲃⲏⲣ
ⲙⲛⲧϣⲙⲙⲟ	ⲙⲛⲧ|ϣⲙⲙⲟ
ⲙⲛⲧϩⲁϩ	ⲙⲛⲧ|ϩⲁϩ
ⲙⲛⲧϩⲁⲡⲗⲟⲩⲥ	ⲙⲛⲧ|ϩⲁⲡⲗⲟⲩⲥ
ⲙⲛⲧϩⲁⲣϣϩⲏⲧ	ⲙⲛⲧ|ϩⲁⲣϣ|ϩⲏⲧ
ⲙⲛⲧϩⲏⲕⲉ	ⲙⲛⲧ|ϩⲏⲕⲉ
ⲙⲛⲧϩⲗⲗⲟ	ⲙⲛⲧ|ϩⲗⲗⲟ
ⲙⲛⲧϩⲗⲗⲱ	ⲙⲛⲧ|ϩⲗⲗⲱ
ⲙⲛⲧϩⲙϩⲁⲗ	ⲙⲛⲧ|ϩⲙϩⲁⲗ
ⲙⲛⲧϫⲁϫⲉ	ⲙⲛⲧ|ϫⲁϫⲉ
ⲙⲛⲧϫⲁⲥⲓϩⲏⲧ	ⲙⲛⲧ|ϫⲁⲥⲓ|ϩⲏⲧ
ⲙⲛⲧϫⲱⲱⲣⲉ	ⲙⲛⲧ|ϫⲱⲱⲣⲉ
ⲙⲛⲧϭⲁⲃϩⲏⲧ	ⲙⲛⲧ|ϭⲁⲃ|ϩⲏⲧ
ⲙⲛⲧϭⲁⲉⲓⲉ	ⲙⲛⲧ|ϭⲁⲉⲓⲉ
ⲙⲛⲧϭⲁⲓⲉ	ⲙⲛⲧ|ϭⲁⲓⲉ
ⲙⲛⲧϭⲱⲃ	ⲙⲛⲧ|ϭⲱⲃ
ⲙⲛⲧⲁ	ⲙⲛⲧⲁ
ⲙⲛⲧⲁϥⲧⲉ	ⲙⲛⲧ|ⲁϥⲧⲉ
ⲙⲛⲧⲁⲅⲁⲑⲟⲥ	ⲙⲛⲧ|ⲁⲅⲁⲑⲟⲥ
ⲙⲛⲧⲁⲑⲏⲧ	ⲙⲛⲧ|ⲁⲧ|ϩⲏⲧ
ⲙⲛⲧⲁⲕⲁⲑⲁⲣⲧⲟⲥ	ⲙⲛⲧ|ⲁⲕⲁⲑⲁⲣⲧⲟⲥ
ⲙⲛⲧⲁⲙⲉⲗⲏⲥ	ⲙⲛⲧ|ⲁⲙⲉⲗⲏⲥ
ⲙⲛⲧⲁⲡⲓⲥⲧⲟⲥ	ⲙⲛⲧ|ⲁⲡⲓⲥⲧⲟⲥ
ⲙⲛⲧⲁⲡⲟⲥⲧⲟⲗⲟⲥ	ⲙⲛⲧ|ⲁⲡⲟⲥⲧⲟⲗⲟⲥ
ⲙⲛⲧⲁⲡⲟⲥⲧⲟⲥ	ⲙⲛⲧ|ⲁⲡⲟⲥⲧⲟⲥ
ⲙⲛⲧⲁⲡⲟⲧⲁⲕⲧⲓⲕⲟⲥ	ⲙⲛⲧ|ⲁⲡⲟⲧⲁⲕⲧⲓⲕⲟⲥ
ⲙⲛⲧⲁⲣⲅⲟⲥ	ⲙⲛⲧ|ⲁⲣⲅⲟⲥ
ⲙⲛⲧⲁⲥⲉ	ⲙⲛⲧ|ⲁⲥⲉ
ⲙⲛⲧⲁⲧϣⲁⲩ	ⲙⲛⲧ|ⲁⲧ|ϣⲁⲩ
ⲙⲛⲧⲁⲧϩⲏⲧ	ⲙⲛⲧ|ⲁⲧ|ϩⲏⲧ
ⲙⲛⲧⲁⲧϩⲛⲁⲁⲩ	ⲙⲛⲧ|ⲁⲧ|ϩⲛⲁⲁⲩ
ⲙⲛⲧⲁⲧⲁⲙⲁϩⲧⲉ	ⲙⲛⲧ|ⲁⲧ|ⲁⲙⲁϩⲧⲉ
ⲙⲛⲧⲁⲧⲙⲟⲩ	ⲙⲛⲧ|ⲁⲧ|ⲙⲟⲩ
ⲙⲛⲧⲁⲧⲛⲁϩⲧⲉ	ⲙⲛⲧ|ⲁⲧ|ⲛⲁϩⲧⲉ
ⲙⲛⲧⲁⲧⲛⲟⲩⲧⲉ	ⲙⲛⲧ|ⲁⲧ|ⲛⲟⲩⲧⲉ
ⲙⲛⲧⲁⲧⲟⲡⲕ	ⲙⲛⲧ|ⲁⲧ|ⲟⲡ|ⲕ
ⲙⲛⲧⲁⲧⲥⲃⲃⲉ	ⲙⲛⲧ|ⲁⲧ|ⲥⲃⲃⲉ
ⲙⲛⲧⲁⲧⲥⲃⲱ	ⲙⲛⲧ|ⲁⲧ|ⲥⲃⲱ
ⲙⲛⲧⲁⲧⲥⲓ	ⲙⲛⲧ|ⲁⲧ|ⲥⲓ
ⲙⲛⲧⲁⲧⲥⲟⲟⲩⲛ	ⲙⲛⲧ|ⲁⲧ|ⲥⲟⲟⲩⲛ
ⲙⲛⲧⲁⲧⲥⲱⲧⲙ	ⲙⲛⲧ|ⲁⲧ|ⲥⲱⲧⲙ
ⲙⲛⲧⲁⲧⲧⲁⲕⲟ	ⲙⲛⲧ|ⲁⲧ|ⲧⲁⲕⲟ
ⲙⲛⲧⲁⲩⲑⲁⲇⲏⲥ	ⲙⲛⲧ|ⲁⲩⲑⲁⲧⲏⲥ
ⲙⲛⲧⲃⲁⲃⲉ	ⲙⲛⲧⲃⲁⲃⲉ
ⲙⲛⲧⲃⲁⲃⲉⲣⲱⲙⲉ	ⲙⲛⲧ|ⲃⲁⲃⲉ|ⲣⲱⲙⲉ
ⲙⲛⲧⲃⲗⲗⲉ	ⲙⲛⲧ|ⲃⲗⲗⲉ
ⲙⲛⲧⲉⲣⲟ	ⲙⲛⲧ|ⲉⲣⲟ
ⲙⲛⲧⲏ	ⲙⲛⲧ|ⲏ
ⲙⲛⲧⲕⲁⲑⲁⲣⲟⲥ	ⲙⲛⲧ|ⲕⲁⲑⲁⲣⲟⲥ
ⲙⲛⲧⲕⲟⲥⲙⲓⲕⲟⲛ	ⲙⲛⲧ|ⲕⲟⲥⲙⲓⲕⲟⲛ
ⲙⲛⲧⲕⲟⲩⲓ	ⲙⲛⲧ|ⲕⲟⲩⲓ
ⲙⲛⲧⲕⲱⲥⲙⲓⲕⲟⲛ	ⲙⲛⲧ|ⲕⲱⲥⲙⲓⲕⲟⲛ
ⲙⲛⲧⲗⲏⲥⲧⲏⲥ	ⲙⲛⲧ|ⲗⲏⲥⲧⲏⲥ
ⲙⲛⲧⲙⲁⲓ	ⲙⲛⲧ|ⲙⲁⲓ
ⲙⲛⲧⲙⲁⲓϩⲟⲙⲛⲧ	ⲙⲛⲧ|ⲙⲁⲓϩⲟ|ⲙⲛⲧ
ⲙⲛⲧⲙⲁⲓⲛⲟⲩⲧⲉ	ⲙⲛⲧ|ⲙⲁⲓ|ⲛⲟⲩⲧⲉ
ⲙⲛⲧⲙⲁⲓⲣⲱⲙⲉ	ⲙⲛⲧ|ⲙⲁⲓ|ⲣⲱⲙⲉ
ⲙⲛⲧⲙⲁⲓⲧⲟ	ⲙⲛⲧ|ⲙⲁⲓⲧⲟ
ⲙⲛⲧⲙⲁⲓⲭⲣⲏⲙⲁ	ⲙⲛⲧ|ⲙⲁⲓ|ⲭⲣⲏⲙⲁ
ⲙⲛⲧⲙⲛⲧⲣⲉ	ⲙⲛⲧ|ⲙⲛⲧⲣⲉ
ⲙⲛⲧⲙⲟⲛⲁⲭⲟⲥ	ⲙⲛⲧ|ⲙⲟⲛⲁⲭⲟⲥ
ⲙⲛⲧⲛⲁ	ⲙⲛⲧ|ⲛⲁ
ⲙⲛⲧⲛⲁϣⲧϩⲏⲧ	ⲙⲛⲧ|ⲛⲁϣⲧ|ϩⲏⲧ
ⲙⲛⲧⲛⲟϭ	ⲙⲛⲧ|ⲛⲟϭ
ⲙⲛⲧⲛⲟⲉⲓⲕ	ⲙⲛⲧ|ⲛⲟⲉⲓⲕ
ⲙⲛⲧⲛⲟⲩϫ	ⲙⲛⲧ|ⲛⲟⲩϫ
ⲙⲛⲧⲛⲟⲩⲧⲉ	ⲙⲛⲧ|ⲛⲟⲩⲧⲉ
ⲙⲛⲧⲡⲁⲣⲑⲉⲛⲟⲥ	ⲙⲛⲧ|ⲡⲁⲣⲑⲉⲛⲟⲥ
ⲙⲛⲧⲡⲣⲟⲇⲟⲧⲏⲥ	ⲙⲛⲧ|ⲡⲣⲟⲇⲟⲧⲏⲥ
ⲙⲛⲧⲣⲉ	ⲙⲛⲧⲣⲉ
ⲙⲛⲧⲣⲉϥϣⲙϣⲉ	ⲙⲛⲧ|ⲣⲉϥ|ϣⲙϣⲉ
ⲙⲛⲧⲣⲉϥϣⲙϣⲉⲛⲟⲩⲧⲉ	ⲙⲛⲧ|ⲣⲉϥ|ϣⲙϣⲉ|ⲛⲟⲩⲧⲉ
ⲙⲛⲧⲣⲉϥϣⲡϩⲙⲟⲧ	ⲙⲛⲧ|ⲣⲉϥ|ϣⲡ|ϩⲙⲟⲧ
ⲙⲛⲧⲣⲉϥϥⲓ	ⲙⲛⲧ|ⲣⲉϥ|ϥⲓ
ⲙⲛⲧⲣⲉϥϩⲉⲧⲃⲯⲩⲭⲏ	ⲙⲛⲧ|ⲣⲉϥ|ϩⲉⲧⲃ|ⲯⲩⲭⲏ
ⲙⲛⲧⲣⲉϥϩⲓⲗⲁ	ⲙⲛⲧ|ⲣⲉϥ|ϩⲓⲗⲁ
ⲙⲛⲧⲣⲉϥϩⲱⲧⲃ	ⲙⲛⲧ|ⲣⲉϥ|ϩⲱⲧⲃ
ⲙⲛⲧⲣⲉϥϫⲓϩⲟ	ⲙⲛⲧ|ⲣⲉϥ|ϫⲓϩⲟ
ⲙⲛⲧⲣⲉϥϫⲓⲛϭⲟⲛⲥ	ⲙⲛⲧ|ⲣⲉϥ|ϫⲓ|ⲛ|ϭⲟⲛⲥ
ⲙⲛⲧⲣⲉϥϫⲓⲟⲩⲁ	ⲙⲛⲧ|ⲣⲉϥ|ϫⲓⲟⲩⲁ
ⲙⲛⲧⲣⲉϥϫⲓⲟⲩⲉ	ⲙⲛⲧ|ⲣⲉϥ|ϫⲓⲟⲩⲉ
ⲙⲛⲧⲣⲉϥϫⲱϩⲙ	ⲙⲛⲧ|ⲣⲉϥ|ϫⲱϩⲙ
ⲙⲛⲧⲣⲉϥϭⲛ	ⲙⲛⲧⲣⲉϥϭⲛ
ⲙⲛⲧⲣⲉϥϯϭⲱⲛⲧ	ⲙⲛⲧ|ⲣⲉϥ|ϯ|ϭⲱⲛⲧ
ⲙⲛⲧⲣⲉϥⲁⲣⲉⲥⲕⲉ	ⲙⲛⲧ|ⲣⲉϥ|ⲁⲣⲉⲥⲕⲉ
ⲙⲛⲧⲣⲉϥⲣϩⲓⲕ	ⲙⲛⲧ|ⲣⲉϥ|ⲣϩⲓⲕ
ⲙⲛⲧⲣⲉϥⲣϩⲟⲧⲉ	ⲙⲛⲧ|ⲣⲉϥ|ⲣ|ϩⲟⲧⲉ
ⲙⲛⲧⲣⲉϥⲧⲱϩ	ⲙⲛⲧ|ⲣⲉϥ|ⲧⲱϩ
ⲙⲛⲧⲣⲉϥⲧⲱⲣⲡ	ⲙⲛⲧ|ⲣⲉϥ|ⲧⲱⲣⲡ
ⲙⲛⲧⲣⲙϩⲉ	ⲙⲛⲧ|ⲣⲙϩⲉ
ⲙⲛⲧⲣⲙⲙⲁⲟ	ⲙⲛⲧ|ⲣⲙⲙⲁⲟ
ⲙⲛⲧⲣⲙⲛϩⲏⲧ	ⲙⲛⲧ|ⲣⲙ|ⲛ|ϩⲏⲧ
ⲙⲛⲧⲣⲙⲛⲧϩⲏⲧ	ⲙⲛⲧ|ⲣ|ⲙⲛⲧ|ϩⲏⲧ
ⲙⲛⲧⲣⲙⲣⲁϣ	ⲙⲛⲧ|ⲣⲙ|ⲣⲁϣ
ⲙⲛⲧⲣⲣⲟ	ⲙⲛⲧ|ⲣⲣⲟ
ⲙⲛⲧⲣⲱⲙⲉ	ⲙⲛⲧ|ⲣⲱⲙⲉ
ⲙⲛⲧⲥⲁϣϥⲉ	ⲙⲛⲧ|ⲥⲁϣϥⲉ
ⲙⲛⲧⲥⲁⲃⲉ	ⲙⲛⲧ|ⲥⲁⲃⲉ
ⲙⲛⲧⲥⲁⲛⲕⲟⲧⲥ	ⲙⲛⲧ|ⲥⲁ|ⲛ|ⲕⲟⲧⲥ
ⲙⲛⲧⲥⲛⲟⲟⲩⲥ	ⲙⲛⲧ|ⲥⲛⲟⲟⲩⲥ
ⲙⲛⲧⲥⲟϭ	ⲙⲛⲧ|ⲥⲟϭ
ⲙⲛⲧⲥⲧⲙⲏⲧ	ⲙⲛⲧ|ⲥⲧⲙⲏⲧ
ⲙⲛⲧⲥⲧⲣⲁⲧⲏⲗⲁⲧⲏⲥ	ⲙⲛⲧ|ⲥⲧⲣⲁⲧⲏⲗⲁⲧⲏⲥ
ⲙⲛⲧⲥⲩⲛⲕⲗⲏⲧⲓⲕⲟⲥ	ⲙⲛⲧⲥⲩⲛⲕⲗⲏⲧⲓⲕⲟⲥ
ⲙⲛⲧⲧⲉⲗⲓⲟⲥ	ⲙⲛⲧ|ⲧⲉⲗⲓⲟⲥ
ⲙⲛⲧⲭⲣⲏⲥⲧⲟⲥ	ⲙⲛⲧ|ⲭⲣⲏⲥⲧⲟⲥ
ⲙⲛⲧⲯⲓⲥ	ⲙⲛⲧ|ⲯⲓⲥ
ⲙⲛⲧⲯⲓⲧⲉ	ⲙⲛⲧ|ⲯⲓⲧⲉ
ⲙⲟϣⲧ	ⲙⲟϣⲧ
ⲙⲟϩⲕⲥ	ⲙⲟϩⲕⲥ
ⲙⲟϫ	ⲙⲟϫ
ⲙⲟϫϩ	ⲙⲟϫϩ
ⲙⲟϫⲧ	ⲙⲟϫⲧ
ⲙⲟⲅⲓⲥ	ⲙⲟⲅⲓⲥ
ⲙⲟⲉⲓϩⲉ	ⲙⲟⲉⲓϩⲉ
ⲙⲟⲉⲓⲧ	ⲙⲟⲉⲓⲧ
ⲙⲟⲓϩⲉ	ⲙⲟⲓϩⲉ
ⲙⲟⲕϩ	ⲙⲟⲕϩ
ⲙⲟⲕϩⲥ	ⲙⲟⲕϩⲥ
ⲙⲟⲕⲙⲉⲕ	ⲙⲟⲕⲙⲉⲕ
ⲙⲟⲛⲁⲭⲟⲥ	ⲙⲟⲛⲁⲭⲟⲥ
ⲙⲟⲛⲕ	ⲙⲟⲛⲕ
ⲙⲟⲛⲟⲅⲉⲛⲏⲥ	ⲙⲟⲛⲟⲅⲉⲛⲏⲥ
ⲙⲟⲛⲟⲛ	ⲙⲟⲛⲟⲛ
ⲙⲟⲟϣⲉ	ⲙⲟⲟϣⲉ
ⲙⲟⲟⲛⲉ	ⲙⲟⲟⲛⲉ
ⲙⲟⲟⲧ	ⲙⲟⲟⲧ
ⲙⲟⲟⲩ	ⲙⲟⲟⲩ
ⲙⲟⲟⲩϣⲉ	ⲙⲟⲟⲩϣⲉ
ⲙⲟⲟⲩⲧ	ⲙⲟⲟⲩⲧ
ⲙⲟⲣ	ⲙⲟⲣ
ⲙⲟⲣⲥ	ⲙⲟⲣⲥ
ⲙⲟⲣⲫⲏ	ⲙⲟⲣⲫⲏ
ⲙⲟⲥⲧⲉ	ⲙⲟⲥⲧⲉ
ⲙⲟⲧⲉ	ⲙⲟⲧⲉ
ⲙⲟⲧⲛ	ⲙⲟⲧⲛ
ⲙⲟⲩ	ⲙⲟⲩ
ⲙⲟⲩϣⲧ	ⲙⲟⲩϣⲧ
ⲙⲟⲩϩ	ⲙⲟⲩϩ
ⲙⲟⲩϫϭ	ⲙⲟⲩϫϭ
ⲙⲟⲩϫⲧ	ⲙⲟⲩϫⲧ
ⲙⲟⲩⲓ	ⲙⲟⲩⲓ
ⲙⲟⲩⲛ	ⲙⲟⲩⲛ
ⲙⲟⲩⲛⲅ	ⲙⲟⲩⲛⲅ
ⲙⲟⲩⲟⲩⲧ	ⲙⲟⲩⲟⲩⲧ
ⲙⲟⲩⲣ	ⲙⲟⲩⲣ
ⲙⲟⲩⲥ	ⲙⲟⲩⲥ
ⲙⲟⲩⲧⲉ	ⲙⲟⲩⲧⲉ
ⲙⲡ	ⲙⲡ
ⲙⲡϣⲁ	ⲙⲡϣⲁ
ⲙⲡⲁ	ⲙⲡⲁ
ⲙⲡⲁⲧ	ⲙⲡⲁⲧ
ⲙⲡⲁⲧⲉ	ⲙⲡⲁⲧⲉ
ⲙⲡⲉ	ⲙⲡⲉ
ⲙⲡⲉϥ	ⲙⲡⲉϥ
ⲙⲡⲏⲩⲉ	ⲙⲡⲏⲩⲉ
ⲙⲡⲕ	ⲙⲡⲕ
ⲙⲡⲟ	ⲙⲡⲟ
ⲙⲡⲟⲩ	ⲙⲡⲟⲩ
ⲙⲡⲣ	ⲙⲡⲣ
ⲙⲡⲣⲧⲣⲉ	ⲙⲡⲣⲧⲣⲉ
ⲙⲡⲱⲣ	ⲙⲡⲱⲣ
ⲙⲣⲣⲉ	ⲙⲣⲣⲉ
ⲙⲧⲟ	ⲙⲧⲟ
ⲙⲧⲟⲛ	ⲙⲧⲟⲛ
ⲙⲩⲥⲧⲏⲣⲓⲟⲛ	ⲙⲩⲥⲧⲏⲣⲓⲟⲛ
ⲙⲱⲅⲓⲥ	ⲙⲱⲅⲓⲥ
ⲙⲱⲛⲟⲛ	ⲙⲱⲛⲟⲛ
ⲙⲱⲩⲥⲏⲥ	ⲙⲱⲩⲥⲏⲥ
ⲛ	ⲛ
ⲛϣⲁ	ⲛϣⲁ
ⲛϣⲟ	ⲛϣⲟ
ⲛϣⲟⲧ	ⲛϣⲟⲧ
ⲛϥⲓ	ⲛϥⲓ
ⲛϩⲏ	ⲛϩⲏ
ⲛϩⲏⲧ	ⲛϩⲏⲧ
ⲛϩⲟⲧ	ⲛϩⲟⲧ
ⲛϩⲟⲩⲛ	ⲛϩⲟⲩⲛ
ⲛϩⲟⲩⲟ	ⲛϩⲟⲩⲟ
ⲛϩⲣⲁⲓ	ⲛϩⲣⲁⲓ
ⲛϩⲧⲏ	ⲛϩⲧⲏ
ⲛϫⲓ	ⲛϫⲓ
ⲛϫⲧⲁ	ⲛϫⲧⲁ
ⲛϭⲓ	ⲛϭⲓ
ⲛⲁ	ⲛⲁ
ⲛⲁϣⲉ	ⲛⲁϣⲉ
ⲛⲁϣⲧ	ⲛⲁϣⲧ
ⲛⲁϣⲧⲉ	ⲛⲁϣⲧⲉ
ⲛⲁϣⲱ	ⲛⲁϣⲱ
ⲛⲁϩⲙ	ⲛⲁϩⲙ
ⲛⲁϩⲙⲉ	ⲛⲁϩⲙⲉ
ⲛⲁϩⲙⲉⲃⲱⲕ	ⲛⲁϩⲙⲉ|ⲃⲱⲕ
ⲛⲁϩⲣⲁ	ⲛⲁϩⲣⲁ
ⲛⲁϩⲣⲛ	ⲛⲁϩⲣⲛ
ⲛⲁϩⲧⲉ	ⲛⲁϩⲧⲉ
ⲛⲁϫ	ⲛⲁϫ
ⲛⲁⲁ	ⲛⲁⲁ
ⲛⲁⲁⲕⲉ	ⲛⲁⲁⲕⲉ
ⲛⲁⲃⲟⲩⲭⲟⲇⲟⲛⲟⲥⲟⲣ	ⲛⲁⲃⲟⲩⲭⲟⲇⲟⲛⲟⲥⲟⲣ
ⲛⲁⲉ	ⲛⲁⲉ
ⲛⲁⲉⲓⲁⲧ	ⲛⲁ|ⲉⲓⲁⲧ
ⲛⲁⲍⲁⲣⲁⲓⲟⲥ	ⲛⲁⲍⲁⲣⲁⲓⲟⲥ
ⲛⲁⲍⲁⲣⲉⲑ	ⲛⲁⲍⲁⲣⲉⲑ
ⲛⲁⲍⲁⲣⲏⲛⲟⲥ	ⲛⲁⲍⲁⲣⲏⲛⲟⲥ
ⲛⲁⲍⲱⲣⲁⲓⲟⲥ	ⲛⲁⲍⲱⲣⲁⲓⲟⲥ
ⲛⲁⲓ	ⲛⲁⲓ
ⲛⲁⲓⲁⲧ	ⲛⲁ|ⲓⲁⲧ
ⲛⲁⲓⲁⲧ	ⲛⲁⲓⲁⲧ
ⲛⲁⲙⲉ	ⲛⲁⲙⲉ
ⲛⲁⲛⲉ	ⲛⲁⲛⲉ
ⲛⲁⲛⲟⲩ	ⲛⲁⲛⲟⲩ
ⲛⲁⲣⲇⲟⲥ	ⲛⲁⲣⲇⲟⲥ
ⲛⲁⲩ	ⲛⲁⲩ
ⲛⲁⲩⲏ	ⲛⲁⲩⲏ
ⲛⲃⲗⲁ	ⲛⲃⲗⲁ
ⲛⲃⲗⲗⲁ	ⲛⲃⲗⲗⲁ
ⲛⲉ	ⲛⲉ
ⲛⲉϣ	ⲛⲉϣ
ⲛⲉϥ	ⲛⲉϥ
ⲛⲉϩ	ⲛⲉϩ
ⲛⲉϩϣⲗϥ	ⲛⲉϩϣⲗϥ
ⲛⲉϩⲡⲉ	ⲛⲉϩ|ⲡⲉ
ⲛⲉϩⲥⲉ	ⲛⲉϩⲥⲉ
ⲛⲉϫ	ⲛⲉϫ
ⲛⲉϫⲕⲁϩ	ⲛⲉϫ|ⲕⲁϩ
ⲛⲉϫⲧⲁϥ	ⲛⲉϫ|ⲧⲁϥ
ⲛⲉϭⲛⲟⲩϭ	ⲛⲉϭⲛⲟⲩϭ
ⲛⲉⲉϥ	ⲛⲉⲉϥ
ⲛⲉⲓ	ⲛⲉⲓ
ⲛⲉⲕ	ⲛⲉⲕ
ⲛⲉⲛ	ⲛⲉⲛ
ⲛⲉⲣ	ⲛⲉⲣ
ⲛⲉⲣⲉ	ⲛⲉⲣⲉ
ⲛⲉⲥ	ⲛⲉⲥ
ⲛⲉⲥⲱ	ⲛⲉⲥⲱ
ⲛⲉⲧ	ⲛⲉⲧ
ⲛⲉⲧⲛ	ⲛⲉⲧⲛ
ⲛⲉⲩ	ⲛⲉⲩ
ⲛⲏ	ⲛⲏ
ⲛⲏϫ	ⲛⲏϫ
ⲛⲏⲏⲃⲉ	ⲛⲏⲏⲃⲉ
ⲛⲏⲥⲧⲉⲓⲁ	ⲛⲏⲥⲧⲉⲓⲁ
ⲛⲏⲥⲧⲉⲩⲉ	ⲛⲏⲥⲧⲉⲩⲉ
ⲛⲏⲥⲧⲓⲁ	ⲛⲏⲥⲧⲓⲁ
ⲛⲏⲩ	ⲛⲏⲩ
ⲛⲏⲫⲉ	ⲛⲏⲫⲉ
ⲛⲓ	ⲛⲓ
ⲛⲓϥⲉ	ⲛⲓϥⲉ
ⲛⲓⲙ	ⲛⲓⲙ
ⲛⲓⲛⲉⲩⲏ	ⲛⲓⲛⲉⲩⲏ
ⲛⲕⲁ	ⲛⲕⲁ
ⲛⲕⲟⲧⲕ	ⲛⲕⲟⲧⲕ
ⲛⲗⲓⲃⲁⲛⲟⲥ	ⲛ|ⲗⲓⲃⲁⲛⲟⲥ
ⲛⲙ	ⲛⲙ
ⲛⲙⲙ	ⲛⲙⲙ
ⲛⲙⲙⲁ	ⲛⲙⲙⲁ
ⲛⲙⲙⲏ	ⲛⲙⲙⲏ
ⲛⲙⲛⲁ	ⲛⲙⲛⲁ
ⲛⲛ	ⲛⲛ
ⲛⲛⲁϩⲣⲁ	ⲛⲛⲁϩⲣⲁ
ⲛⲛⲁϩⲣⲙ	ⲛⲛⲁϩⲣⲙ
ⲛⲛⲁϩⲣⲛ	ⲛⲛⲁϩⲣⲛ
ⲛⲛⲉ	ⲛⲛⲉ
ⲛⲟϣⲡ	ⲛⲟϣⲡ
ⲛⲟϥⲣⲉ	ⲛⲟϥⲣⲉ
ⲛⲟϫ	ⲛⲟϫ
ⲛⲟϫⲟⲩ	ⲛⲟϫⲟⲩ
ⲛⲟϭ	ⲛⲟϭ
ⲛⲟϭⲛⲉϭ	ⲛⲟϭⲛⲉϭ
ⲛⲟⲃⲉ	ⲛⲟⲃⲉ
ⲛⲟⲉⲓ	ⲛⲟⲉⲓ
ⲛⲟⲉⲓⲕ	ⲛⲟⲉⲓⲕ
ⲛⲟⲉⲓⲛ	ⲛⲟⲉⲓⲛ
ⲛⲟⲏ	ⲛⲟⲏ
ⲛⲟⲓ	ⲛⲟⲓ
ⲛⲟⲙⲓⲥⲙⲁ	ⲛⲟⲙⲓⲥⲙⲁ
ⲛⲟⲙⲟⲥ	ⲛⲟⲙⲟⲥ
ⲛⲟⲛ	ⲛⲟⲛ
ⲛⲟⲩ	ⲛⲟⲩ
ⲛⲟⲩϥ	ⲛⲟⲩϥ
ⲛⲟⲩϫ	ⲛⲟⲩϫ
ⲛⲟⲩϫϭ	ⲛⲟⲩϫϭ
ⲛⲟⲩϫⲉ	ⲛⲟⲩϫⲉ
ⲛⲟⲩϫⲕ	ⲛⲟⲩϫⲕ
ⲛⲟⲩϭⲥ	ⲛⲟⲩϭⲥ
ⲛⲟⲩⲃ	ⲛⲟⲩⲃ
ⲛⲟⲩⲓ	ⲛⲟⲩⲓ
ⲛⲟⲩⲕ	ⲛⲟⲩⲕ
ⲛⲟⲩⲛⲉ	ⲛⲟⲩⲛⲉ
ⲛⲟⲩⲥ	ⲛⲟⲩⲥ
ⲛⲟⲩⲧⲉ	ⲛⲟⲩⲧⲉ
ⲛⲣϣⲁⲩ	ⲛⲣϣⲁⲩ
ⲛⲣⲙ	ⲛⲣⲙ
ⲛⲣⲱⲙⲉ	ⲛⲣⲱⲙⲉ
ⲛⲥⲁ	ⲛⲥⲁ
ⲛⲥⲁⲃⲏⲗ	ⲛⲥⲁⲃⲏⲗ
ⲛⲥⲱ	ⲛⲥⲱ
ⲛⲧ	ⲛⲧ
ⲛⲧ	ⲛⲧ
ⲛⲧⲁ	ⲛⲧⲁ
ⲛⲧⲉ	ⲛⲧⲉ
ⲛⲧⲉⲣ	ⲛⲧⲉⲣ
ⲛⲧⲉⲣⲉ	ⲛⲧⲉⲣⲉ
ⲛⲧⲉⲧⲛ	ⲛⲧⲉⲧⲛ
ⲛⲧⲉⲩⲛⲟⲩ	ⲛⲧⲉⲩⲛⲟⲩ
ⲛⲧⲕ	ⲛⲧⲕ
ⲛⲧⲙ	ⲛⲧⲙ
ⲛⲧⲛ	ⲛⲧⲛ
ⲛⲧⲟ	ⲛⲧⲟ
ⲛⲧⲟϣ	ⲛⲧⲟϣ
ⲛⲧⲟϥ	ⲛⲧⲟϥ
ⲛⲧⲟⲕ	ⲛⲧⲟⲕ
ⲛⲧⲟⲗⲏ	ⲛⲧⲟⲗⲏ
ⲛⲧⲟⲟⲧ	ⲛⲧⲟⲟⲧ
ⲛⲧⲟⲟⲩ	ⲛⲧⲟⲟⲩ
ⲛⲧⲟⲟⲩⲛ	ⲛⲧⲟⲟⲩⲛ
ⲛⲧⲟⲥ	ⲛⲧⲟⲥ
ⲛⲧⲱⲕ	ⲛⲧⲱⲕ
ⲛⲧⲱⲧⲛ	ⲛⲧⲱⲧⲛ
ⲛⲩⲕⲧⲉⲣⲓⲥ	ⲛⲩⲕⲧⲉⲣⲓⲥ
ⲛⲱϩⲉ	ⲛⲱϩⲉ
ⲝⲉⲥⲧⲏⲥ	ⲝⲉⲥⲧⲏⲥ
ⲝⲟⲩⲣ	ⲝⲟⲩⲣ
ⲟ	ⲟ
ⲟϣ	ⲟϣ
ⲟϣⲉ	ⲟϣⲉ
ⲟϩⲉ	ⲟϩⲉ
ⲟϭⲉ	ⲟϭⲉ
ⲟϭⲧ	ⲟϭⲧ
ⲟⲃϣ	ⲟⲃϣ
ⲟⲃϩⲉ	ⲟⲃϩⲉ
ⲟⲃⲉ	ⲟⲃⲉ
ⲟⲃⲣⲣⲉ	ⲟⲃⲣⲣⲉ
ⲟⲃⲧ	ⲟⲃⲧ
ⲟⲇⲟⲗⲗⲁ	ⲟⲇⲟⲗⲗⲁ
ⲟⲉⲓϣ	ⲟⲉⲓϣ
ⲟⲉⲓⲉ	ⲟⲉⲓⲉ
ⲟⲉⲓⲕ	ⲟⲉⲓⲕ
ⲟⲓ	ⲟⲓ
ⲟⲓⲕⲟⲛⲟⲙⲓⲁ	ⲟⲓⲕⲟⲛⲟⲙⲓⲁ
ⲟⲓⲕⲟⲛⲟⲙⲟⲥ	ⲟⲓⲕⲟⲛⲟⲙⲟⲥ
ⲟⲓⲕⲟⲩⲙⲉⲛⲏ	ⲟⲓⲕⲟⲩⲙⲉⲛⲏ
ⲟⲕⲙ	ⲟⲕⲙ
ⲟⲗ	ⲟⲗ
ⲟⲗⲟⲕⲁⲩⲧⲱⲙⲁ	ⲟⲗⲟⲕⲁⲩⲧⲱⲙⲁ
ⲟⲙ	ⲟⲙ
ⲟⲙⲉ	ⲟⲙⲉ
ⲟⲙⲕ	ⲟⲙⲕ
ⲟⲙⲥ	ⲟⲙⲥ
ⲟⲛ	ⲟⲛ
ⲟⲛϩ	ⲟⲛϩ
ⲟⲛⲕ	ⲟⲛⲕ
ⲟⲛⲧⲱⲥ	ⲟⲛⲧⲱⲥ
ⲟⲟϩ	ⲟⲟϩ
ⲟⲟⲧⲉ	ⲟⲟⲧⲉ
ⲟⲟⲩ	ⲟⲟⲩ
ⲟⲡ	ⲟⲡ
ⲟⲡⲥ	ⲟⲡⲥ
ⲟⲡⲧⲉⲩⲉ	ⲟⲡⲧⲉⲩⲉ
ⲟⲣϫ	ⲟⲣϫ
ⲟⲣⲃ	ⲟⲣⲃ
ⲟⲣⲅⲏ	ⲟⲣⲅⲏ
ⲟⲣⲇⲓⲛⲟⲛ	ⲟⲣⲇⲓⲛⲟⲛ
ⲟⲣⲛⲏ	ⲟⲣⲛⲏ
ⲟⲣⲫⲁⲛⲟⲥ	ⲟⲣⲫⲁⲛⲟⲥ
ⲟⲣⲭⲉ	ⲟⲣⲭⲉ
ⲟⲥⲉ	ⲟⲥⲉ
ⲟⲧϩ	ⲟⲧϩ
ⲟⲧⲡ	ⲟⲧⲡ
ⲟⲩ	ⲟⲩ
ⲟⲩϣⲏ	ⲟⲩϣⲏ
ⲟⲩϩⲟⲟⲣ	ⲟⲩϩⲟⲟⲣ
ⲟⲩϫⲁⲉⲓ	ⲟⲩϫⲁⲉⲓ
ⲟⲩϫⲁⲓ	ⲟⲩϫⲁⲓ
ⲟⲩϭⲥ	ⲟⲩϭⲥ
ⲟⲩϯ	ⲟⲩϯ
ⲟⲩⲁ	ⲟⲩⲁ
ⲟⲩⲁϣ	ⲟⲩⲁϣ
ⲟⲩⲁϩ	ⲟⲩⲁϩ
ⲟⲩⲁϩⲙ	ⲟⲩⲁϩⲙ
ⲟⲩⲁϩⲙⲉ	ⲟⲩⲁϩⲙⲉ
ⲟⲩⲁⲁ	ⲟⲩⲁⲁ
ⲟⲩⲁⲁⲃ	ⲟⲩⲁⲁⲃ
ⲟⲩⲁⲧ	ⲟⲩⲁⲧ
ⲟⲩⲁⲧϥⲉ	ⲟⲩⲁⲧϥⲉ
ⲟⲩⲃⲁϣ	ⲟⲩⲃⲁϣ
ⲟⲩⲃⲉ	ⲟⲩⲃⲉ
ⲟⲩⲃⲏ	ⲟⲩⲃⲏ
ⲟⲩⲇ[.......]	ⲟⲩⲇ[.......]
ⲟⲩⲇⲉ	ⲟⲩⲇⲉ
ⲟⲩⲉ	ⲟⲩⲉ
ⲟⲩⲉϣ	ⲟⲩⲉϣ
ⲟⲩⲉϣϫⲱⲕⲙ	ⲟⲩⲉϣ|ϫⲱⲕⲙ
ⲟⲩⲉϣⲛ	ⲟⲩⲉϣⲛ
ⲟⲩⲉϩ	ⲟⲩⲉϩ
ⲟⲩⲉϩⲥⲁϩⲛⲉ	ⲟⲩⲉϩ|ⲥⲁϩⲛⲉ
ⲟⲩⲉϩⲥⲟⲓ	ⲟⲩⲉϩⲥⲟⲓ
ⲟⲩⲉϭⲡ	ⲟⲩⲉϭⲡ
ⲟⲩⲉϭⲣⲟ	ⲟⲩⲉϭⲣⲟ
ⲟⲩⲉⲉⲓⲉⲛⲓⲛ	ⲟⲩⲉⲉⲓⲉⲛⲓⲛ
ⲟⲩⲉⲓ	ⲟⲩⲉⲓ
ⲟⲩⲉⲓⲉ	ⲟⲩⲉⲓⲉ
ⲟⲩⲉⲓⲉⲕ	ⲟⲩⲉⲓⲉⲕ
ⲟⲩⲉⲓⲏ	ⲟⲩⲉⲓⲏ
ⲟⲩⲉⲓⲛⲉ	ⲟⲩⲉⲓⲛⲉ
ⲟⲩⲉⲙ	ⲟⲩⲉⲙ
ⲟⲩⲉⲙⲁϥ	ⲟⲩⲉⲙ|ⲁϥ
ⲟⲩⲉⲛ	ⲟⲩⲉⲛ
ⲟⲩⲉⲣⲏⲧⲉ	ⲟⲩⲉⲣⲏⲧⲉ
ⲟⲩⲉⲧ	ⲟⲩⲉⲧ
ⲟⲩⲉⲧⲟⲩⲱⲧ	ⲟⲩⲉⲧⲟⲩⲱⲧ
ⲟⲩⲏϩ	ⲟⲩⲏϩ
ⲟⲩⲏⲏⲃ	ⲟⲩⲏⲏⲃ
ⲟⲩⲏⲏⲩ	ⲟⲩⲏⲏⲩ
ⲟⲩⲏⲣ	ⲟⲩⲏⲣ
ⲟⲩⲏⲩ	ⲟⲩⲏⲩ
ⲟⲩⲕ	ⲟⲩⲕ
ⲟⲩⲙ	ⲟⲩⲙ
ⲟⲩⲛ	ⲟⲩⲛ
ⲟⲩⲛⲁⲙ	ⲟⲩⲛⲁⲙ
ⲟⲩⲛⲟϥ	ⲟⲩⲛⲟϥ
ⲟⲩⲛⲟⲩ	ⲟⲩⲛⲟⲩ
ⲟⲩⲛⲣⲟ	ⲟⲩⲛⲣⲟ
ⲟⲩⲛⲧ	ⲟⲩⲛⲧ
ⲟⲩⲛⲧⲁ	ⲟⲩⲛⲧⲁ
ⲟⲩⲛⲧⲉ	ⲟⲩⲛⲧⲉ
ⲟⲩⲛⲧⲏ	ⲟⲩⲛⲧⲏ
ⲟⲩⲟϣⲙ	ⲟⲩⲟϣⲙ
ⲟⲩⲟϫ	ⲟⲩⲟϫ
ⲟⲩⲟϭⲉ	ⲟⲩⲟϭⲉ
ⲟⲩⲟϭⲡ	ⲟⲩⲟϭⲡ
ⲟⲩⲟⲃϣ	ⲟⲩⲟⲃϣ
ⲟⲩⲟⲉⲓ	ⲟⲩⲟⲉⲓ
ⲟⲩⲟⲉⲓϣ	ⲟⲩⲟⲉⲓϣ
ⲟⲩⲟⲉⲓⲉ	ⲟⲩⲟⲉⲓⲉ
ⲟⲩⲟⲉⲓⲕ	ⲟⲩⲟⲉⲓⲕ
ⲟⲩⲟⲉⲓⲛ	ⲟⲩⲟⲉⲓⲛ
ⲟⲩⲟⲉⲓⲧ	ⲟⲩⲟⲉⲓⲧ
ⲟⲩⲟⲓ	ⲟⲩⲟⲓ
ⲟⲩⲟⲓⲉϣ	ⲟⲩⲟⲓⲉϣ
ⲟⲩⲟⲗⲥ	ⲟⲩⲟⲗⲥ
ⲟⲩⲟⲙ	ⲟⲩⲟⲙ
ⲟⲩⲟⲛ	ⲟⲩⲟⲛ
ⲟⲩⲟⲛϩ	ⲟⲩⲟⲛϩ
ⲟⲩⲟⲛⲧ	ⲟⲩⲟⲛⲧ
ⲟⲩⲟⲟϭⲉ	ⲟⲩⲟⲟϭⲉ
ⲟⲩⲟⲟⲗⲉ	ⲟⲩⲟⲟⲗⲉ
ⲟⲩⲟⲟⲙ	ⲟⲩⲟⲟⲙ
ⲟⲩⲟⲟⲧⲉ	ⲟⲩⲟⲟⲧⲉ
ⲟⲩⲟⲡ	ⲟⲩⲟⲡ
ⲟⲩⲟⲥϥ	ⲟⲩⲟⲥϥ
ⲟⲩⲟⲧⲟⲩⲉⲧ	ⲟⲩⲟⲧⲟⲩⲉⲧ
ⲟⲩⲣⲟⲧ	ⲟⲩⲣⲟⲧ
ⲟⲩⲥⲓⲁ	ⲟⲩⲥⲓⲁ
ⲟⲩⲧⲁϩ	ⲟⲩⲧⲁϩ
ⲟⲩⲧⲃⲁ	ⲟⲩⲧⲃⲁ
ⲟⲩⲧⲉ	ⲟⲩⲧⲉ
ⲟⲩⲱ	ⲟⲩⲱ
ⲟⲩⲱ̇ⲛϩ	ⲟⲩⲱ̇ⲛϩ
ⲟⲩⲱϣ	ⲟⲩⲱϣ
ⲟⲩⲱϣⲃ	ⲟⲩⲱϣⲃ
ⲟⲩⲱϣⲙ	ⲟⲩⲱϣⲙ
ⲟⲩⲱϣⲥ	ⲟⲩⲱϣⲥ
ⲟⲩⲱϣⲧ	ⲟⲩⲱϣⲧ
ⲟⲩⲱϩ	ⲟⲩⲱϩ
ⲟⲩⲱϩⲉ	ⲟⲩⲱϩⲉ
ⲟⲩⲱϩⲙ	ⲟⲩⲱϩⲙ
ⲟⲩⲱϭⲡ	ⲟⲩⲱϭⲡ
ⲟⲩⲱϭⲥ	ⲟⲩⲱϭⲥ
ⲟⲩⲱⲙ	ⲟⲩⲱⲙ
ⲟⲩⲱⲛ	ⲟⲩⲱⲛ
ⲟⲩⲱⲛϣ	ⲟⲩⲱⲛϣ
ⲟⲩⲱⲛϩ	ⲟⲩⲱⲛϩ
ⲟⲩⲱⲛⲁϩ	ⲟⲩⲱⲛⲁϩ
ⲟⲩⲱⲥϥ	ⲟⲩⲱⲥϥ
ⲟⲩⲱⲧ	ⲟⲩⲱⲧ
ⲟⲩⲱⲧⲃ	ⲟⲩⲱⲧⲃ
ⲟⲩⲱⲧⲛ	ⲟⲩⲱⲧⲛ
ⲟⲯⲱⲛⲓⲟⲛ	ⲟⲯⲱⲛⲓⲟⲛ
ⲡ	ⲡ
ⲡ+E1064	ⲡ+E1064
ⲡ̣[…]ⲡⲟⲥ	ⲡ̣[…]ⲡⲟⲥ
ⲡⲁ	ⲡⲁ
ⲡⲁ[…]ϥⲟϭⲉ	ⲡⲁ[…]ϥⲟϭⲉ
ⲡⲁϣ	ⲡⲁϣ
ⲡⲁϣⲉ	ⲡⲁϣⲉ
ⲡⲁϩ	ⲡⲁϩ
ⲡⲁϩⲟ	ⲡⲁϩⲟ
ⲡⲁϩⲟⲩ	ⲡⲁϩⲟⲩ
ⲡⲁϩⲣⲉ	ⲡⲁϩⲣⲉ
ⲡⲁϩⲧ	ⲡⲁϩⲧ
ⲡⲁϩⲱⲙⲱ	ⲡⲁϩⲱⲙⲱ
ⲡⲁϭⲥⲉ	ⲡⲁϭⲥⲉ
ⲡⲁⲅⲁⲛⲱⲥ	ⲡⲁⲅⲁⲛⲱⲥ
ⲡⲁⲏⲥⲉ	ⲡⲁⲏⲥⲉ
ⲡⲁⲑⲟⲥ	ⲡⲁⲑⲟⲥ
ⲡⲁⲓ	ⲡⲁⲓ
ⲡⲁⲓⲇⲁⲅⲱⲅⲟⲥ	ⲡⲁⲓⲇⲁⲅⲱⲅⲟⲥ
ⲡⲁⲓⲇⲉⲥ	ⲡⲁⲓⲇⲉⲥ
ⲡⲁⲓⲇⲉⲩⲉ	ⲡⲁⲓⲇⲉⲩⲉ
ⲡⲁⲗⲓⲛ	ⲡⲁⲗⲓⲛ
ⲡⲁⲗⲗⲁϯⲟⲛ	ⲡⲁⲗⲗⲁϯⲟⲛ
ⲡⲁⲙⲃⲱ	ⲡⲁⲙⲃⲱ
ⲡⲁⲛⲟⲩⲣⲅⲓⲁ	ⲡⲁⲛⲟⲩⲣⲅⲓⲁ
ⲡⲁⲛⲧⲟⲕⲣⲁⲧⲱⲣ	ⲡⲁⲛⲧⲟⲕⲣⲁⲧⲱⲣ
ⲡⲁⲛⲧⲱⲕⲣⲁⲧⲱⲣ	ⲡⲁⲛⲧⲱⲕⲣⲁⲧⲱⲣ
ⲡⲁⲛⲧⲱⲥ	ⲡⲁⲛⲧⲱⲥ
ⲡⲁⲡⲁⲥ	ⲡⲁⲡⲁⲥ
ⲡⲁⲡⲛⲟⲩⲧⲉ	ⲡⲁⲡⲛⲟⲩⲧⲉ
ⲡⲁⲣϩⲏⲥⲓⲁ	ⲡⲁⲣϩⲏⲥⲓⲁ
ⲡⲁⲣϩⲓⲥⲧⲁ	ⲡⲁⲣϩⲓⲥⲧⲁ
ⲡⲁⲣϩⲟⲩⲥⲓⲁ	ⲡⲁⲣϩⲟⲩⲥⲓⲁ
ⲡⲁⲣⲁ	ⲡⲁⲣⲁ
ⲡⲁⲣⲁⲃⲁ	ⲡⲁⲣⲁⲃⲁ
ⲡⲁⲣⲁⲃⲟⲗⲏ	ⲡⲁⲣⲁⲃⲟⲗⲏ
ⲡⲁⲣⲁⲅⲅⲉⲓⲗⲉ	ⲡⲁⲣⲁⲅⲅⲉⲓⲗⲉ
ⲡⲁⲣⲁⲅⲉ	ⲡⲁⲣⲁⲅⲉ
ⲡⲁⲣⲁⲇⲉⲓⲥⲟⲥ	ⲡⲁⲣⲁⲇⲉⲓⲥⲟⲥ
ⲡⲁⲣⲁⲇⲓⲅⲙⲁⲧⲓⲍⲉ	ⲡⲁⲣⲁⲇⲓⲅⲙⲁⲧⲓⲍⲉ
ⲡⲁⲣⲁⲇⲓⲇⲟⲩ	ⲡⲁⲣⲁⲇⲓⲇⲟⲩ
ⲡⲁⲣⲁⲇⲓⲥⲟⲥ	ⲡⲁⲣⲁⲇⲓⲥⲟⲥ
ⲡⲁⲣⲁⲇⲟⲥⲓⲥ	ⲡⲁⲣⲁⲇⲟⲥⲓⲥ
ⲡⲁⲣⲁⲓⲧⲉⲓ	ⲡⲁⲣⲁⲓⲧⲉⲓ
ⲡⲁⲣⲁⲕⲁⲗⲉⲓ	ⲡⲁⲣⲁⲕⲁⲗⲉⲓ
ⲡⲁⲣⲁⲣⲟ	ⲡⲁⲣⲁⲣⲟ
ⲡⲁⲣⲁⲥⲕⲉⲩⲏ	ⲡⲁⲣⲁⲥⲕⲉⲩⲏ
ⲡⲁⲣⲁⲧⲏⲣⲉⲓ	ⲡⲁⲣⲁⲧⲏⲣⲉⲓ
ⲡⲁⲣⲃⲁⲥⲓⲥ	ⲡⲁⲣⲃⲁⲥⲓⲥ
ⲡⲁⲣⲑⲉⲛⲟⲥ	ⲡⲁⲣⲑⲉⲛⲟⲥ
ⲡⲁⲣⲓⲅⲟⲣⲓ	ⲡⲁⲣⲓⲅⲟⲣⲓ
ⲡⲁⲣⲙⲟⲩⲧⲉ	ⲡⲁⲣⲙⲟⲩⲧⲉ
ⲡⲁⲣⲟⲩⲥⲓⲁ	ⲡⲁⲣⲟⲩⲥⲓⲁ
ⲡⲁⲣⲣⲏⲥⲓⲁ	ⲡⲁⲣⲣⲏⲥⲓⲁ
ⲡⲁⲥⲧ	ⲡⲁⲥⲧ
ⲡⲁⲥⲧⲁⲙⲱⲛ	ⲡⲁⲥⲧⲁⲙⲱⲛ
ⲡⲁⲥⲭⲁ	ⲡⲁⲥⲭⲁ
ⲡⲁⲧ	ⲡⲁⲧ
ⲡⲁⲧⲁⲥⲥⲉⲓ	ⲡⲁⲧⲁⲥⲥⲉⲓ
ⲡⲁⲧⲣⲓⲁⲣⲭⲏⲥ	ⲡⲁⲧⲣⲓⲁⲣⲭⲏⲥ
ⲡⲁⲩⲗⲟⲥ	ⲡⲁⲩⲗⲟⲥ
ⲡⲉ	ⲡⲉ
ⲡⲉϣ	ⲡⲉϣ
ⲡⲉϣⲛ	ⲡⲉϣⲛ
ⲡⲉϥ	ⲡⲉϥ
ⲡⲉϩ	ⲡⲉϩ
ⲡⲉϫⲁ	ⲡⲉϫⲁ
ⲡⲉϫⲉ	ⲡⲉϫⲉ
ⲡⲉϫⲉ 	ⲡⲉϫⲉ 
ⲡⲉⲑⲟⲟⲩ	ⲡ|ⲉⲧ|ϩⲟⲟⲩ
ⲡⲉⲓ	ⲡⲉⲓ
ⲡⲉⲓⲑⲉ	ⲡⲉⲓⲑⲉ
ⲡⲉⲓⲣⲁⲍⲉ	ⲡⲉⲓⲣⲁⲍⲉ
ⲡⲉⲓⲣⲁⲥⲙⲟⲥ	ⲡⲉⲓⲣⲁⲥⲙⲟⲥ
ⲡⲉⲕ	ⲡⲉⲕ
ⲡⲉⲗϭⲉ	ⲡⲉⲗϭⲉ
ⲡⲉⲗⲁⲅⲟⲥ	ⲡⲉⲗⲁⲅⲟⲥ
ⲡⲉⲗⲁⲕ	ⲡⲉⲗⲁⲕ
ⲡⲉⲗⲓⲥ	ⲡⲉⲗⲓⲥ
ⲡⲉⲛ	ⲡⲉⲛ
ⲡⲉⲛⲉ	ⲡⲉⲛⲉ
ⲡⲉⲛⲧⲏⲕⲟⲥⲧⲏ	ⲡⲉⲛⲧⲏⲕⲟⲥⲧⲏ
ⲡⲉⲣⲓⲍⲱⲙⲁ	ⲡⲉⲣⲓⲍⲱⲙⲁ
ⲡⲉⲣⲓⲕⲁⲑⲁⲣⲙⲁ	ⲡⲉⲣⲓⲕⲁⲑⲁⲣⲙⲁ
ⲡⲉⲥ	ⲡⲉⲥ
ⲡⲉⲥⲏⲧ	ⲡⲉⲥⲏⲧ
ⲡⲉⲧ	ⲡⲉⲧ
ⲡⲉⲧϩⲏⲡ	ⲡ|ⲉⲧ|ϩⲏⲡ
ⲡⲉⲧϩⲟⲟⲩ	ⲡ|ⲉⲧ|ϩⲟⲟⲩ
ⲡⲉⲧⲛ	ⲡⲉⲧⲛ
ⲡⲉⲧⲛⲁⲛⲟⲩϥ	ⲡ|ⲉⲧ|ⲛⲁⲛⲟⲩ|ϥ
ⲡⲉⲧⲟⲩⲁⲁⲃ	ⲡ|ⲉⲧ|ⲟⲩⲁⲁⲃ
ⲡⲉⲧⲣⲁ	ⲡⲉⲧⲣⲁ
ⲡⲉⲧⲣⲟⲥ	ⲡⲉⲧⲣⲟⲥ
ⲡⲉⲩ	ⲡⲉⲩ
ⲡⲏ	ⲡⲏ
ⲡⲏϣ	ⲡⲏϣ
ⲡⲏϩ	ⲡⲏϩ
ⲡⲏⲅⲏ	ⲡⲏⲅⲏ
ⲡⲏⲣⲁ	ⲡⲏⲣⲁ
ⲡⲏⲧ	ⲡⲏⲧ
ⲡⲏⲩ̣ⲉ	ⲡⲏⲩ̣ⲉ
ⲡⲏⲩⲉ	ⲡⲏⲩⲉ
ⲡⲓ	ⲡⲓ
ⲡⲓⲑⲉ	ⲡⲓⲑⲉ
ⲡⲓⲗⲁⲧⲟⲥ	ⲡⲓⲗⲁⲧⲟⲥ
ⲡⲓⲛⲁⲝ	ⲡⲓⲛⲁⲝ
ⲡⲓⲛⲟⲩ	ⲡⲓⲛⲟⲩ
ⲡⲓⲣⲁⲥⲙⲟⲥ	ⲡⲓⲣⲁⲥⲙⲟⲥ
ⲡⲓⲣⲉ	ⲡⲓⲣⲉ
ⲡⲓⲥⲧⲉⲩⲉ	ⲡⲓⲥⲧⲉⲩⲉ
ⲡⲓⲥⲧⲓⲥ	ⲡⲓⲥⲧⲓⲥ
ⲡⲓⲥⲧⲟⲥ	ⲡⲓⲥⲧⲟⲥ
ⲡⲗϭⲉ	ⲡⲗϭⲉ
ⲡⲗⲁⲛⲁ	ⲡⲗⲁⲛⲁ
ⲡⲗⲁⲛⲏ	ⲡⲗⲁⲛⲏ
ⲡⲗⲁⲛⲟⲥ	ⲡⲗⲁⲛⲟⲥ
ⲡⲗⲁⲥⲥⲉ	ⲡⲗⲁⲥⲥⲉ
ⲡⲗⲉⲁ	ⲡⲗⲉⲁ
ⲡⲗⲉⲟⲛⲉⲕⲧⲉ	ⲡⲗⲉⲟⲛⲉⲕⲧⲉ
ⲡⲗⲏⲅⲉ	ⲡⲗⲏⲅⲉ
ⲡⲗⲏⲅⲏ	ⲡⲗⲏⲅⲏ
ⲡⲗⲏⲛ	ⲡⲗⲏⲛ
ⲡⲗⲏⲥⲧⲏⲥ	ⲡⲗⲏⲥⲧⲏⲥ
ⲡⲗⲩⲅⲏ	ⲡⲗⲩⲅⲏ
ⲡⲛⲉⲩⲙⲁ	ⲡⲛⲉⲩⲙⲁ
ⲡⲛⲉⲩⲙⲁⲧⲓⲕⲏ	ⲡⲛⲉⲩⲙⲁⲧⲓⲕⲏ
ⲡⲛⲉⲩⲙⲁⲧⲓⲕⲟⲛ	ⲡⲛⲉⲩⲙⲁⲧⲓⲕⲟⲛ
ⲡⲛⲉⲩⲙⲁⲧⲓⲕⲟⲥ	ⲡⲛⲉⲩⲙⲁⲧⲓⲕⲟⲥ
ⲡⲛⲉⲩⲙⲁⲧⲓⲕⲱⲥ	ⲡⲛⲉⲩⲙⲁⲧⲓⲕⲱⲥ
ⲡⲛⲏ	ⲡⲛⲏ
ⲡⲛⲟⲩⲧⲉ	ⲡⲛⲟⲩⲧⲉ
ⲡⲟϣ	ⲡⲟϣ
ⲡⲟϩⲥ	ⲡⲟϩⲥ
ⲡⲟⲓⲙⲏⲛ	ⲡⲟⲓⲙⲏⲛ
ⲡⲟⲗⲉⲙⲓⲕⲟⲛ	ⲡⲟⲗⲉⲙⲓⲕⲟⲛ
ⲡⲟⲗⲉⲙⲟⲥ	ⲡⲟⲗⲉⲙⲟⲥ
ⲡⲟⲗⲓⲥ	ⲡⲟⲗⲓⲥ
ⲡⲟⲗⲓⲧⲏⲥ	ⲡⲟⲗⲓⲧⲏⲥ
ⲡⲟⲗⲩⲙⲉⲓ	ⲡⲟⲗⲩⲙⲉⲓ
ⲡⲟⲛ	ⲡⲟⲛ
ⲡⲟⲛⲏⲣⲉⲩⲉ	ⲡⲟⲛⲏⲣⲉⲩⲉ
ⲡⲟⲛⲏⲣⲓⲁ	ⲡⲟⲛⲏⲣⲓⲁ
ⲡⲟⲛⲏⲣⲟⲛ	ⲡⲟⲛⲏⲣⲟⲛ
ⲡⲟⲛⲏⲣⲟⲥ	ⲡⲟⲛⲏⲣⲟⲥ
ⲡⲟⲟⲩ	ⲡⲟⲟⲩ
ⲡⲟⲣϣ	ⲡⲟⲣϣ
ⲡⲟⲣϫ	ⲡⲟⲣϫ
ⲡⲟⲣⲕ	ⲡⲟⲣⲕ
ⲡⲟⲣⲛⲉⲓⲁ	ⲡⲟⲣⲛⲉⲓⲁ
ⲡⲟⲣⲛⲉⲩⲉ	ⲡⲟⲣⲛⲉⲩⲉ
ⲡⲟⲣⲛⲏ	ⲡⲟⲣⲛⲏ
ⲡⲟⲣⲛⲓⲁ	ⲡⲟⲣⲛⲓⲁ
ⲡⲟⲣⲛⲟⲥ	ⲡⲟⲣⲛⲟⲥ
ⲡⲟⲥⲉ	ⲡⲟⲥⲉ
ⲡⲟⲩ	ⲡⲟⲩ
ⲡⲣϣ	ⲡⲣϣ
ⲡⲣⲁⲓⲧⲱⲣⲓⲟⲛ	ⲡⲣⲁⲓⲧⲱⲣⲓⲟⲛ
ⲡⲣⲁⲝⲉⲓⲥ	ⲡⲣⲁⲝⲉⲓⲥ
ⲡⲣⲁⲝⲓⲥ	ⲡⲣⲁⲝⲓⲥ
ⲡⲣⲁⲝⲓⲥⲟⲛ	ⲡⲣⲁⲝⲓⲥⲟⲛ
ⲡⲣⲉⲥⲃⲉⲩⲉ	ⲡⲣⲉⲥⲃⲉⲩⲉ
ⲡⲣⲉⲥⲃⲩⲧⲉⲣⲟⲥ	ⲡⲣⲉⲥⲃⲩⲧⲉⲣⲟⲥ
ⲡⲣⲏϣ	ⲡⲣⲏϣ
ⲡⲣⲓⲥⲕⲁ	ⲡⲣⲓⲥⲕⲁ
ⲡⲣⲟϩⲓⲥⲧⲁ	ⲡⲣⲟϩⲓⲥⲧⲁ
ⲡⲣⲟⲇⲟⲧⲏⲥ	ⲡⲣⲟⲇⲟⲧⲏⲥ
ⲡⲣⲟⲑⲉⲥⲓⲥ	ⲡⲣⲟⲑⲉⲥⲓⲥ
ⲡⲣⲟⲕⲓⲙⲉⲛⲟⲛ	ⲡⲣⲟⲕⲓⲙⲉⲛⲟⲛ
ⲡⲣⲟⲕⲟⲡⲧⲉ	ⲡⲣⲟⲕⲟⲡⲧⲉ
ⲡⲣⲟⲥ	ⲡⲣⲟⲥ
ⲡⲣⲟⲥⲉⲭⲉ	ⲡⲣⲟⲥⲉⲭⲉ
ⲡⲣⲟⲥⲕⲁⲣⲧⲉⲣⲉⲓ	ⲡⲣⲟⲥⲕⲁⲣⲧⲉⲣⲉⲓ
ⲡⲣⲟⲥⲟⲩⲟⲉⲓϣ	ⲡⲣⲟⲥⲟⲩⲟⲉⲓϣ
ⲡⲣⲟⲥⲫⲟⲣⲁ	ⲡⲣⲟⲥⲫⲟⲣⲁ
ⲡⲣⲟⲧⲉⲕⲧⲱⲣ	ⲡⲣⲟⲧⲉⲕⲧⲱⲣ
ⲡⲣⲟⲫⲏⲧⲉⲩⲉ	ⲡⲣⲟⲫⲏⲧⲉⲩⲉ
ⲡⲣⲟⲫⲏⲧⲏⲥ	ⲡⲣⲟⲫⲏⲧⲏⲥ
ⲡⲣⲟⲫⲏⲧⲓⲁ	ⲡⲣⲟⲫⲏⲧⲓⲁ
ⲡⲣⲱ	ⲡⲣⲱ
ⲡⲩⲅⲏ	ⲡⲩⲅⲏ
ⲡⲩⲕⲧⲉⲩⲉ	ⲡⲩⲕⲧⲉⲩⲉ
ⲡⲩⲗⲏ	ⲡⲩⲗⲏ
ⲡⲩⲣⲅⲟⲥ	ⲡⲩⲣⲅⲟⲥ
ⲡⲱ	ⲡⲱ
ⲡⲱϣ	ⲡⲱϣ
ⲡⲱϣⲥ	ⲡⲱϣⲥ
ⲡⲱϥ	ⲡⲱϥ
ⲡⲱϩ	ⲡⲱϩ
ⲡⲱϩⲥ	ⲡⲱϩⲥ
ⲡⲱϩⲧ	ⲡⲱϩⲧ
ⲡⲱⲓ	ⲡⲱⲓ
ⲡⲱⲗⲁϩ	ⲡⲱⲗⲁϩ
ⲡⲱⲛ	ⲡⲱⲛ
ⲡⲱⲛⲅ	ⲡⲱⲛⲅ
ⲡⲱⲛⲕ	ⲡⲱⲛⲕ
ⲡⲱⲣϣ	ⲡⲱⲣϣ
ⲡⲱⲣϫ	ⲡⲱⲣϫ
ⲡⲱⲥ	ⲡⲱⲥ
ⲡⲱⲧ	ⲡⲱⲧ
ⲡⲱⲧⲛ	ⲡⲱⲧⲛ
ⲡⲱⲱⲛⲉ	ⲡⲱⲱⲛⲉ
ⲡⲱⲱⲣⲉ	ⲡⲱⲱⲣⲉ
ⲣ	ⲣ
ⲣϣϥⲉ	ⲣ|ϣϥⲉ
ⲣϣⲁ	ⲣ|ϣⲁ
ⲣϣⲁⲩ	ⲣ|ϣⲁⲩ
ⲣϣⲟⲣⲡ	ⲣ|ϣⲟⲣⲡ
ⲣϣⲡⲏⲣⲉ	ⲣ|ϣⲡⲏⲣⲉ
ⲣϣⲡⲣⲉ	ⲣ|ϣⲡⲣⲉ
ⲣϣⲣⲡ	ⲣ|ϣⲣⲡ
ⲣϣⲣⲡⲛⲁⲩ	ⲣ|ϣⲣⲡ|ⲛⲁⲩ
ⲣϣⲱⲛ	ⲣϣⲱⲛ
ⲣϩⲁϩ	ⲣ|ϩⲁϩ
ⲣϩⲁⲉ	ⲣ|ϩⲁⲉ
ⲣϩⲁⲗ	ⲣ|ϩⲁⲗ
ⲣϩⲃⲁ	ⲣ|ϩⲃⲁ
ⲣϩⲃⲃⲉ	ⲣ|ϩⲃⲃⲉ
ⲣϩⲏⲃⲉ	ⲣ|ϩⲏⲃⲉ
ⲣϩⲏⲕⲉ	ⲣ|ϩⲏⲕⲉ
ⲣϩⲏⲧ	ⲣ|ϩⲏⲧ
ⲣϩⲙϩⲁⲗ	ⲣ|ϩⲙϩⲁⲗ
ⲣϩⲙⲉ	ⲣ|ϩⲙⲉ
ⲣϩⲙⲙⲉ	ⲣ|ϩⲙⲙⲉ
ⲣϩⲙⲟⲧ	ⲣ|ϩⲙⲟⲧ
ⲣϩⲛⲁ	ⲣ|ϩⲛⲁ
ⲣϩⲛⲁⲩ	ⲣ|ϩⲛⲁⲩ
ⲣϩⲛⲏ	ⲣ|ϩⲛⲏ
ⲣϩⲟⲧⲉ	ⲣ|ϩⲟⲧⲉ
ⲣϩⲟⲩⲉ	ⲣ|ϩⲟⲩⲉ
ⲣϩⲟⲩⲉⲥⲁⲃⲉ	ⲣ|ϩⲟⲩⲉ|ⲥⲁⲃⲉ
ⲣϩⲟⲩⲟ	ⲣ|ϩⲟⲩⲟ
ⲣϩⲱⲃ	ⲣ|ϩⲱⲃ
ⲣϩⲱⲧ	ⲣ|ϩⲱⲧ
ⲣϫⲟⲉⲓⲥ	ⲣ|ϫⲟⲉⲓⲥ
ⲣϫⲟⲩⲱⲧ	ⲣ|ϫⲟⲩⲱⲧ
ⲣϭⲟⲙ	ⲣ|ϭⲟⲙ
ⲣϭⲣⲱϩ	ⲣ|ϭⲣⲱϩ
ⲣϭⲱⲃ	ⲣ|ϭⲱⲃ
ⲣϯⲟⲩ	ⲣ|ϯⲟⲩ
ⲣⲁϣⲉ	ⲣⲁϣⲉ
ⲣⲁϩⲧ	ⲣⲁϩⲧ
ⲣⲁⲅⲁⲑⲟⲥ	ⲣ|ⲁⲅⲁⲑⲟⲥ
ⲣⲁⲕⲟⲧⲉ	ⲣⲁⲕⲟⲧⲉ
ⲣⲁⲗ	ⲣ|ⲁⲗ
ⲣⲁⲛ	ⲣⲁⲛ
ⲣⲁⲛⲁ	ⲣ|ⲁⲛⲁ
ⲣⲁⲛⲁϣ	ⲣ|ⲁⲛⲁϣ
ⲣⲁⲡⲟⲡⲛⲓⲅⲉ	ⲣ|ⲁⲡⲟⲡⲛⲓⲅⲉ
ⲣⲁⲡⲟⲥⲧⲟⲗⲟⲥ	ⲣ|ⲁⲡⲟⲥⲧⲟⲗⲟⲥ
ⲣⲁⲥⲟⲩ	ⲣⲁⲥⲟⲩ
ⲣⲁⲥⲧⲉ	ⲣⲁⲥⲧⲉ
ⲣⲁⲧ	ⲣⲁⲧ
ⲣⲁⲧϣⲁⲩ	ⲣⲁⲧϣⲁⲩ
ⲣⲁⲧϭⲟⲙ	ⲣ|ⲁⲧ|ϭⲟⲙ
ⲣⲁⲧⲛⲁϩⲧⲉ	ⲣ|ⲁⲧ|ⲛⲁϩⲧⲉ
ⲣⲁⲧⲟⲟⲧ	ⲣ|ⲁⲧⲟⲟⲧ
ⲣⲁⲧⲟⲩⲱⲛ	ⲣ|ⲁⲧ|ⲟⲩⲱⲛ
ⲣⲁⲧⲟⲩⲱⲛϩ	ⲣ|ⲁⲧ|ⲟⲩⲱⲛϩ
ⲣⲁⲧⲥⲟⲟⲩⲛ	ⲣ|ⲁⲧ|ⲥⲟⲟⲩⲛ
ⲣⲃⲟⲗ	ⲣ|ⲃⲟⲗ
ⲣⲃⲟⲟⲛⲉ	ⲣ|ⲃⲟⲟⲛⲉ
ⲣⲇⲓⲁⲃⲟⲗⲟⲥ	ⲣ|ⲇⲓⲁⲃⲟⲗⲟⲥ
ⲣⲇⲓⲕⲁⲓⲟⲥ	ⲣ|ⲇⲓⲕⲁⲓⲟⲥ
ⲣⲉ	ⲣⲉ
ⲣⲉϥϣⲙϣⲉ	ⲣⲉϥ|ϣⲙϣⲉ
ⲣⲉϥϣⲙϣⲉⲉⲓⲇⲱⲗⲟⲛ	ⲣⲉϥ|ϣⲙϣⲉ|ⲉⲓⲇⲱⲗⲟⲛ
ⲣⲉϥϣⲟⲟⲣ	ⲣⲉϥ|ϣⲟⲟⲣ
ⲣⲉϥϣⲡϩⲓⲥⲉ	ⲣⲉϥ|ϣⲡ|ϩⲓⲥⲉ
ⲣⲉϥϩⲱϥⲧ	ⲣⲉϥ|ϩⲱϥⲧ
ⲣⲉϥϩⲱⲧⲃ	ⲣⲉϥ|ϩⲱⲧⲃ
ⲣⲉϥϫⲓ	ⲣⲉϥ|ϫⲓ
ⲣⲉϥϫⲓϣⲟϫⲛⲉ	ⲣⲉϥ|ϫⲓ|ϣⲟϫⲛⲉ
ⲣⲉϥϫⲓⲕⲟⲗⲩⲙⲃⲟⲛ	ⲣⲉϥ|ϫⲓ|ⲕⲟⲗⲩⲙⲃⲟⲛ
ⲣⲉϥϫⲓⲛϭⲟⲛⲥ	ⲣⲉϥ|ϫⲓ|ⲛ|ϭⲟⲛⲥ
ⲣⲉϥϫⲓⲟⲩⲉ	ⲣⲉϥ|ϫⲓⲟⲩⲉ
ⲣⲉϥϫⲱⲱⲗⲉ	ⲣⲉϥ|ϫⲱⲱⲗⲉ
ⲣⲉϥϭⲉⲡⲣⲱⲙⲉ	ⲣⲉϥ|ϭⲉⲡ|ⲣⲱⲙⲉ
ⲣⲉϥϯ	ⲣⲉϥ|ϯ
ⲣⲉϥϯ	ⲣⲉϥ|ϯ
ⲣⲉϥϯϩⲁⲡ	ⲣⲉϥ|ϯ|ϩⲁⲡ
ⲣⲉϥϯϩⲉ	ⲣⲉϥ|ϯ|ϩⲉ
ⲣⲉϥϯⲱⲛϩ	ⲣⲉϥ|ϯ|ⲱⲛϩ
ⲣⲉϥⲃⲱϭⲉ	ⲣⲉϥ|ⲃⲱϭⲉ
ⲣⲉϥⲃⲱⲗ	ⲣⲉϥ|ⲃⲱⲗ
ⲣⲉϥⲉⲡⲉⲓⲑⲩⲙⲉⲓ	ⲣⲉϥ|ⲉⲡⲉⲓⲑⲩⲙⲉⲓ
ⲣⲉϥⲉⲡⲓⲑⲩⲙⲉⲓ	ⲣⲉϥ|ⲉⲡⲓⲑⲩⲙⲉⲓ
ⲣⲉϥⲕⲱϩ	ⲣⲉϥ|ⲕⲱϩ
ⲣⲉϥⲙⲓϣⲉ	ⲣⲉϥ|ⲙⲓϣⲉ
ⲣⲉϥⲙⲟⲟⲩⲧ	ⲣⲉϥ|ⲙⲟⲟⲩⲧ
ⲣⲉϥⲛⲕⲟⲧⲕ	ⲣⲉϥ|ⲛⲕⲟⲧⲕ
ⲣⲉϥⲣ	ⲣⲉϥⲣ
ⲣⲉϥⲣϩⲙⲙⲉ	ⲣⲉϥ|ⲣ|ϩⲙⲙⲉ
ⲣⲉϥⲣⲁⲛⲁϣ	ⲣⲉϥ|ⲣ|ⲁⲛⲁϣ
ⲣⲉϥⲣⲛⲟⲃⲉ	ⲣⲉϥ|ⲣ|ⲛⲟⲃⲉ
ⲣⲉϥⲣⲡⲉⲧϩⲟⲟⲩ	ⲣⲉϥ|ⲣ|ⲡ|ⲉⲧ|ϩⲟⲟⲩ
ⲣⲉϥⲥⲁϩⲟⲩ	ⲣⲉϥ|ⲥⲁϩⲟⲩ
ⲣⲉϥⲧⲁⲕⲟ	ⲣⲉϥ|ⲧⲁⲕⲟ
ⲣⲉϥⲧⲁⲛϩⲟ	ⲣⲉϥ|ⲧⲁⲛϩⲟ
ⲣⲉϥⲧⲱⲣⲡ	ⲣⲉϥ|ⲧⲱⲣⲡ
ⲣⲉϥⲱϫⲛ	ⲣⲉϥ|ⲱϫⲛ
ⲣⲉϩⲧ	ⲣⲉϩⲧ
ⲣⲉⲃⲏ	ⲣ|ⲉⲃⲏ
ⲣⲉⲓⲣⲏⲛⲏ	ⲣ|ⲉⲓⲣⲏⲛⲏ
ⲣⲉⲙⲏⲧ	ⲣⲉⲙⲏⲧ
ⲣⲏ	ⲣⲏ
ⲣⲏⲥ	ⲣⲏⲥ
ⲣⲏⲧ	ⲣⲏⲧ
ⲣⲑⲉ	ⲣ|ⲧ|ϩⲉ
ⲣⲓ	ⲣⲓ
ⲣⲓⲕⲉ	ⲣⲓⲕⲉ
ⲣⲓⲙⲉ	ⲣⲓⲙⲉ
ⲣⲓⲣ	ⲣⲓⲣ
ⲣⲕⲁⲕⲉ	ⲣ|ⲕⲁⲕⲉ
ⲣⲕⲃⲁ	ⲣ|ⲕⲃⲁ
ⲣⲕⲟⲓⲛⲱⲛⲟⲥ	ⲣ|ⲕⲟⲓⲛⲱⲛⲟⲥ
ⲣⲕⲟⲩⲉⲓ	ⲣ|ⲕⲟⲩⲉⲓ
ⲣⲕⲟⲩⲓ	ⲣ|ⲕⲟⲩⲓ
ⲣⲕⲣⲟϥ	ⲣ|ⲕⲣⲟϥ
ⲣⲗⲁⲁⲩ	ⲣ|ⲗⲁⲁⲩ
ⲣⲙ	ⲣⲙ
ⲣⲙϩⲉ	ⲣⲙ|ϩⲉ
ⲣⲙϩⲏ	ⲣⲙϩⲏ
ⲣⲙⲁⲅⲓⲁⲉⲣⲟ	ⲣ|ⲙⲁⲅⲓⲁⲉⲣⲟ
ⲣⲙⲁⲓⲧⲟ	ⲣ|ⲙⲁⲓ|ⲧⲟ
ⲣⲙⲁⲗⲁⲕⲟⲥ	ⲣ|ⲙⲁⲗⲁⲕⲟⲥ
ⲣⲙⲁⲣⲧⲏⲣⲟⲥ	ⲣ|ⲙⲁⲣⲧⲏⲣⲟⲥ
ⲣⲙⲁⲧⲟⲓ	ⲣ|ⲙⲁⲧⲟⲓ
ⲣⲙⲉ	ⲣ|ⲙⲉ
ⲣⲙⲉⲉⲩⲉ	ⲣ|ⲙⲉⲉⲩⲉ
ⲣⲙⲉⲓⲟⲟⲩⲉ	ⲣⲙⲉⲓⲟⲟⲩⲉ
ⲣⲙⲏ	ⲣ|ⲙⲏ
ⲣⲙⲙⲁⲟ	ⲣⲙ|ⲙⲁⲟ
ⲣⲙⲙⲙⲉ	ⲣⲙⲙⲙⲉ
ⲣⲙⲛ	ⲣⲙⲛ
ⲣⲙⲛϩⲏⲧ	ⲣⲙ|ⲛ|ϩⲏⲧ
ⲣⲙⲛⲁⲥ	ⲣⲙ|ⲛ|ⲁⲥ
ⲣⲙⲛⲕⲁϩ	ⲣⲙ|ⲛ|ⲕⲁϩ
ⲣⲙⲛⲧⲣⲉ	ⲣ|ⲙⲛⲧⲣⲉ
ⲣⲙⲟⲛⲁⲭⲟⲥ	ⲣ|ⲙⲟⲛⲁⲭⲟⲥ
ⲣⲙⲣⲁϣ	ⲣⲙ|ⲣⲁϣ
ⲣⲛ	ⲣⲛ
ⲣⲛⲟϥⲣⲉ	ⲣ|ⲛⲟϥⲣⲉ
ⲣⲛⲟϭ	ⲣ|ⲛⲟϭ
ⲣⲛⲟⲃⲉ	ⲣ|ⲛⲟⲃⲉ
ⲣⲛⲟⲃⲣⲉ	ⲣ|ⲛⲟⲃⲣⲉ
ⲣⲛⲟⲉⲓⲕ	ⲣ|ⲛⲟⲉⲓⲕ
ⲣⲛⲧ	ⲣⲛⲧ
ⲣⲟ	ⲣⲟ
ⲣⲟⲉⲓⲥ	ⲣⲟⲉⲓⲥ
ⲣⲟⲙⲡⲉ	ⲣⲟⲙⲡⲉ
ⲣⲟⲟⲩϣ	ⲣⲟⲟⲩϣ
ⲣⲟⲟⲩⲉ	ⲣⲟⲟⲩⲉ
ⲣⲟⲟⲩⲧ	ⲣⲟⲟⲩⲧ
ⲣⲟⲩ	ⲣ|ⲟⲩ
ⲣⲟⲩϩⲉ	ⲣⲟⲩϩⲉ
ⲣⲟⲩⲏⲏⲃ	ⲣ|ⲟⲩⲏⲏⲃ
ⲣⲟⲩⲟⲉⲓⲛ	ⲣ|ⲟⲩⲟⲉⲓⲛ
ⲣⲟⲩⲱ	ⲣⲟⲩⲱ
ⲣⲡⲁⲓ	ⲣ|ⲡⲁⲓ
ⲣⲡⲁⲣⲑⲉⲛⲟⲥ	ⲣ|ⲡⲁⲣⲑⲉⲛⲟⲥ
ⲣⲡⲉ	ⲣⲡⲉ
ⲣⲡⲉⲑⲟⲟⲩ	ⲣ|ⲡ|ⲉⲧ|ϩⲟⲟⲩ
ⲣⲡⲉⲓⲑⲉⲓ	ⲣ|ⲡⲉⲓⲑⲉⲓ
ⲣⲡⲉⲣⲡⲉⲣⲟⲥ	ⲣ|ⲡⲉⲣⲡⲉⲣⲟⲥ
ⲣⲡⲏⲩⲉ	ⲣⲡⲏⲩⲉ
ⲣⲡⲓⲥⲧⲟⲥ	ⲣ|ⲡⲓⲥⲧⲟⲥ
ⲣⲡⲙⲉⲉⲩⲉ	ⲣ|ⲡ|ⲙⲉⲉⲩⲉ
ⲣⲡⲟⲗⲉⲙⲟⲥ	ⲣ|ⲡⲟⲗⲉⲙⲟⲥ
ⲣⲡⲟⲗⲩⲙⲟⲥ	ⲣ|ⲡⲟⲗⲩⲙⲟⲥ
ⲣⲡⲟⲥⲉ	ⲣ|ⲡⲟⲥⲉ
ⲣⲡⲣⲟⲫⲏⲧⲏⲥ	ⲣ|ⲡⲣⲟⲫⲏⲧⲏⲥ
ⲣⲣⲙ	ⲣⲣⲙ
ⲣⲣⲙϩⲉ	ⲣ|ⲣⲙϩⲉ
ⲣⲣⲙⲙⲁⲟ	ⲣ|ⲣⲙⲙⲁⲟ
ⲣⲣⲟ	ⲣⲣⲟ
ⲣⲣⲟⲟⲩϣ	ⲣ|ⲣⲟⲟⲩϣ
ⲣⲣⲣⲟ	ⲣ|ⲣⲣⲟ
ⲣⲣⲱ	ⲣⲣⲱ
ⲣⲣⲱⲟⲩ	ⲣⲣⲱⲟⲩ
ⲣⲥϩⲓⲙⲉ	ⲣ|ⲥϩⲓⲙⲉ
ⲣⲥⲁϣϥ	ⲣ|ⲥⲁϣϥ
ⲣⲥⲁϩ	ⲣ|ⲥⲁϩ
ⲣⲥⲁⲃⲉ	ⲣ|ⲥⲁⲃⲉ
ⲣⲥⲙⲟⲧ	ⲣ|ⲥⲙⲟⲧ
ⲣⲥⲛⲁⲩ	ⲣ|ⲥⲛⲁⲩ
ⲣⲥⲟϭ	ⲣ|ⲥⲟϭ
ⲣⲥⲧ	ⲣ|ⲥⲧ
ⲣⲧⲁⲃ	ⲣⲧⲁⲃ
ⲣⲧⲁⲓⲟⲩ	ⲣ|ⲧⲁⲓⲟⲩ
ⲣⲧⲉⲗⲓⲟⲥ	ⲣ|ⲧⲉⲗⲓⲟⲥ
ⲣⲧⲱⲛ	ⲣ|ⲧⲱⲛ
ⲣⲫⲟⲛⲟⲥ	ⲣ|ⲫⲟⲛⲟⲥ
ⲣⲭⲣⲉⲓⲁ	ⲣ|ⲭⲣⲉⲓⲁ
ⲣⲭⲣⲏⲥⲧⲟⲥ	ⲣ|ⲭⲣⲏⲥⲧⲟⲥ
ⲣⲱ	ⲣⲱ
ⲣⲱϣⲉ	ⲣⲱϣⲉ
ⲣⲱϩⲧ	ⲣⲱϩⲧ
ⲣⲱⲃ	ⲣⲱⲃ
ⲣⲱⲕϩ	ⲣⲱⲕϩ
ⲣⲱⲙⲉ	ⲣⲱⲙⲉ
ⲣⲱⲟⲩ	ⲣⲱⲟⲩ
ⲣⲱⲧ	ⲣⲱⲧ
ⲥ	ⲥ
ⲥ 	ⲥ 
ⲥϣϥⲉ	ⲥϣϥⲉ
ⲥϥ	ⲥϥ
ⲥϩⲁⲓ	ⲥϩⲁⲓ
ⲥϩⲁⲓⲥ	ⲥϩⲁⲓⲥ
ⲥϩⲃⲏⲏⲧⲉ	ⲥϩⲃⲏⲏⲧⲉ
ⲥϩⲓⲙⲉ	ⲥϩⲓⲙⲉ
ⲥϩⲟⲩⲟⲣⲧ	ⲥϩⲟⲩⲟⲣⲧ
ⲥϩⲟⲩⲣ	ⲥϩⲟⲩⲣ
ⲥϩⲟⲩⲱⲣ	ⲥϩⲟⲩⲱⲣ
ⲥϭⲏⲣ	ⲥϭⲏⲣ
ⲥϭⲣⲁϩⲧ	ⲥϭⲣⲁϩⲧ
ⲥϯⲛⲟⲩϥⲉ	ⲥϯⲛⲟⲩϥⲉ
ⲥⲁ	ⲥⲁ
ⲥⲁϣϥ	ⲥⲁϣϥ
ⲥⲁϣϥⲉ	ⲥⲁϣϥⲉ
ⲥⲁϣⲉ	ⲥⲁϣⲉ
ⲥⲁϩ	ⲥⲁϩ
ⲥⲁϩⲃⲟⲩⲣ	ⲥⲁ|ϩⲃⲟⲩⲣ
ⲥⲁϩⲉ	ⲥⲁϩⲉ
ⲥⲁϩⲛⲉ	ⲥⲁϩⲛⲉ
ⲥⲁϩⲟⲩ	ⲥⲁϩⲟⲩ
ⲥⲁϩⲱ	ⲥⲁϩⲱ
ⲥⲁⲁⲧ	ⲥⲁⲁⲧ
ⲥⲁⲁⲧⲉ	ⲥⲁⲁⲧⲉ
ⲥⲁⲃϩ	ⲥⲁⲃϩ
ⲥⲁⲃⲃⲁⲧⲟⲛ	ⲥⲁⲃⲃⲁⲧⲟⲛ
ⲥⲁⲃⲉ	ⲥⲁⲃⲉ
ⲥⲁⲃⲉⲉⲩ	ⲥⲁⲃⲉⲉⲩ
ⲥⲁⲇⲇⲟⲩⲕⲁⲓⲟⲥ	ⲥⲁⲇⲇⲟⲩⲕⲁⲓⲟⲥ
ⲥⲁⲉⲓⲛ	ⲥⲁⲉⲓⲛ
ⲥⲁⲓⲛ	ⲥⲁⲓⲛ
ⲥⲁⲗⲡⲓⲅⲝ	ⲥⲁⲗⲡⲓⲅⲝ
ⲥⲁⲗⲡⲓⲍⲉ	ⲥⲁⲗⲡⲓⲍⲉ
ⲥⲁⲗⲱⲙⲏ	ⲥⲁⲗⲱⲙⲏ
ⲥⲁⲙⲓⲧ	ⲥⲁⲙⲓⲧ
ⲥⲁⲙⲟⲩⲏⲗ	ⲥⲁⲙⲟⲩⲏⲗ
ⲥⲁⲙⲯⲱⲛ	ⲥⲁⲙⲯⲱⲛ
ⲥⲁⲛϣ	ⲥⲁⲛϣ
ⲥⲁⲛⲇⲁⲗⲓⲟⲛ	ⲥⲁⲛⲇⲁⲗⲓⲟⲛ
ⲥⲁⲛⲟⲩϣ	ⲥⲁⲛⲟⲩϣ
ⲥⲁⲟⲩⲗ	ⲥⲁⲟⲩⲗ
ⲥⲁⲣⲁ	ⲥⲁⲣⲁ
ⲥⲁⲣⲁⲡⲓⲟⲛ	ⲥⲁⲣⲁⲡⲓⲟⲛ
ⲥⲁⲣⲕⲓⲕⲟⲛ	ⲥⲁⲣⲕⲓⲕⲟⲛ
ⲥⲁⲣⲕⲓⲕⲟⲥ	ⲥⲁⲣⲕⲓⲕⲟⲥ
ⲥⲁⲣⲝ	ⲥⲁⲣⲝ
ⲥⲁⲣⲣⲁ	ⲥⲁⲣⲣⲁ
ⲥⲁⲧⲁⲛⲁⲥ	ⲥⲁⲧⲁⲛⲁⲥ
ⲥⲁⲧⲉ	ⲥⲁⲧⲉ
ⲥⲁⲧⲉⲉⲣⲉ	ⲥⲁⲧⲉⲉⲣⲉ
ⲥⲁⲭⲑⲁⲛⲉⲓ	ⲥⲁⲭⲑⲁⲛⲉⲓ
ⲥⲃⲃⲉ	ⲥⲃⲃⲉ
ⲥⲃⲃⲏⲧ	ⲥⲃⲃⲏⲧ
ⲥⲃⲃⲏⲩ	ⲥⲃⲃⲏⲩ
ⲥⲃⲏⲓⲧⲉ	ⲥⲃⲏⲓⲧⲉ
ⲥⲃⲟ	ⲥⲃⲟ
ⲥⲃⲟⲟⲩⲉ	ⲥⲃⲟⲟⲩⲉ
ⲥⲃⲧⲉ	ⲥⲃⲧⲉ
ⲥⲃⲧⲱⲧ	ⲥⲃⲧⲱⲧ
ⲥⲃⲱ	ⲥⲃⲱ
ⲥⲉ	ⲥⲉ
ⲥⲉϩ	ⲥⲉϩ
ⲥⲉⲉⲡⲉ	ⲥⲉⲉⲡⲉ
ⲥⲉⲏⲣⲡ	ⲥⲉ|ⲏⲣⲡ
ⲥⲉⲓ	ⲥⲉⲓ
ⲥⲉⲕ	ⲥⲉⲕ
ⲥⲉⲕⲙⲟⲟⲩ	ⲥⲉⲕ|ⲙⲟⲟⲩ
ⲥⲉⲗⲓⲥ	ⲥⲉⲗⲓⲥ
ⲥⲉⲙⲛ	ⲥⲉⲙⲛ
ⲥⲉⲛϩ	ⲥⲉⲛϩ
ⲥⲉⲛⲟⲩⲑⲓⲟⲩ	ⲥⲉⲛⲟⲩⲑⲓⲟⲩ
ⲥⲉⲡ	ⲥⲉⲡ
ⲥⲉⲡⲥⲱⲡ	ⲥⲉⲡⲥⲱⲡ
ⲥⲉⲧⲡ	ⲥⲉⲧⲡ
ⲥⲉⲩϩ	ⲥⲉⲩϩ
ⲥⲏϣ	ⲥⲏϣ
ⲥⲏϥⲉ	ⲥⲏϥⲉ
ⲥⲏϩ	ⲥⲏϩ
ⲥⲏϭ	ⲥⲏϭ
ⲥⲏⲃⲉ	ⲥⲏⲃⲉ
ⲥⲏⲧ	ⲥⲏⲧ
ⲥⲏⲩ	ⲥⲏⲩ
ⲥⲓ	ⲥⲓ
ⲥⲓ[....]ⲟⲩ	ⲥⲓ[....]ⲟⲩ
ⲥⲓϣⲉ	ⲥⲓϣⲉ
ⲥⲓⲇⲱⲛ	ⲥⲓⲇⲱⲛ
ⲥⲓⲕⲉ	ⲥⲓⲕⲉ
ⲥⲓⲙⲱⲛ	ⲥⲓⲙⲱⲛ
ⲥⲓⲛⲇⲱⲛ	ⲥⲓⲛⲇⲱⲛ
ⲥⲓⲟⲟⲩⲛⲉ	ⲥⲓⲟⲟⲩⲛⲉ
ⲥⲓⲟⲩ	ⲥⲓⲟⲩ
ⲥⲓⲟⲩⲣ	ⲥⲓⲟⲩⲣ
ⲥⲓⲧⲉ	ⲥⲓⲧⲉ
ⲥⲕⲁⲓ	ⲥⲕⲁⲓ
ⲥⲕⲁⲛⲇⲁⲗⲓⲍⲉ	ⲥⲕⲁⲛⲇⲁⲗⲓⲍⲉ
ⲥⲕⲁⲛⲇⲁⲗⲟⲛ	ⲥⲕⲁⲛⲇⲁⲗⲟⲛ
ⲥⲕⲉⲡⲁⲥⲧⲏⲥ	ⲥⲕⲉⲡⲁⲥⲧⲏⲥ
ⲥⲕⲉⲩⲏ	ⲥⲕⲉⲩⲏ
ⲥⲕⲏⲛⲏ	ⲥⲕⲏⲛⲏ
ⲥⲕⲗⲁⲇⲟⲥ	ⲥⲕⲗⲁⲇⲟⲥ
ⲥⲕⲣⲕⲣ	ⲥⲕⲣⲕⲣ
ⲥⲕⲩⲛⲏ	ⲥⲕⲩⲛⲏ
ⲥⲗⲁⲁⲧⲉ	ⲥⲗⲁⲁⲧⲉ
ⲥⲗⲡ	ⲥⲗⲡ
ⲥⲗⲥⲱⲗ	ⲥⲗⲥⲱⲗ
ⲥⲙ	ⲥⲙ
ⲥⲙⲁⲙⲁⲁⲧ	ⲥⲙⲁⲙⲁⲁⲧ
ⲥⲙⲁⲧⲁⲁⲁ	ⲥⲙⲁⲧⲁⲁⲁ
ⲥⲙⲏ	ⲥⲙⲏ
ⲥⲙⲓⲛⲉ	ⲥⲙⲓⲛⲉ
ⲥⲙⲙⲉ	ⲥⲙⲙⲉ
ⲥⲙⲛ	ⲥⲙⲛ
ⲥⲙⲛⲛⲟⲙⲟⲥ	ⲥⲙⲛ|ⲛⲟⲙⲟⲥ
ⲥⲙⲛⲟⲛ	ⲥⲙⲛⲟⲛ
ⲥⲙⲛⲧ	ⲥⲙⲛⲧ
ⲥⲙⲟⲛⲧ	ⲥⲙⲟⲛⲧ
ⲥⲙⲟⲧ	ⲥⲙⲟⲧ
ⲥⲙⲟⲩ	ⲥⲙⲟⲩ
ⲥⲛⲁⲩ	ⲥⲛⲁⲩ
ⲥⲛⲁⲩϩ	ⲥⲛⲁⲩϩ
ⲥⲛⲏⲩ	ⲥⲛⲏⲩ
ⲥⲛⲟϥ	ⲥⲛⲟϥ
ⲥⲛⲟⲟϥ	ⲥⲛⲟⲟϥ
ⲥⲛⲧ	ⲥⲛⲧ
ⲥⲛⲧⲉ	ⲥⲛⲧⲉ
ⲥⲟ	ⲥⲟ
ⲥⲟoⲩⲛ	ⲥⲟoⲩⲛ
ⲥⲟοⲩⲛ	ⲥⲟοⲩⲛ
ⲥⲟϣ	ⲥⲟϣ
ⲥⲟϣϥ	ⲥⲟϣϥ
ⲥⲟϭ	ⲥⲟϭ
ⲥⲟϭⲛ	ⲥⲟϭⲛ
ⲥⲟⲃϩ	ⲥⲟⲃϩ
ⲥⲟⲃⲕ	ⲥⲟⲃⲕ
ⲥⲟⲃⲧ	ⲥⲟⲃⲧ
ⲥⲟⲃⲧⲉ	ⲥⲟⲃⲧⲉ
ⲥⲟⲉⲓ	ⲥⲟⲉⲓ
ⲥⲟⲉⲓⲧ	ⲥⲟⲉⲓⲧ
ⲥⲟⲓ	ⲥⲟⲓ
ⲥⲟⲗⲟⲙⲱⲛ	ⲥⲟⲗⲟⲙⲱⲛ
ⲥⲟⲗⲥⲗ	ⲥⲟⲗⲥⲗ
ⲥⲟⲛ	ⲥⲟⲛ
ⲥⲟⲛϩ	ⲥⲟⲛϩ
ⲥⲟⲛⲧ	ⲥⲟⲛⲧ
ⲥⲟⲟ	ⲥⲟⲟ
ⲥⲟⲟϥ	ⲥⲟⲟϥ
ⲥⲟⲟϩⲉ	ⲥⲟⲟϩⲉ
ⲥⲟⲟⲛⲉ	ⲥⲟⲟⲛⲉ
ⲥⲟⲟⲧ	ⲥⲟⲟⲧ
ⲥⲟⲟⲩ	ⲥⲟⲟⲩ
ⲥⲟⲟⲩϩ	ⲥⲟⲟⲩϩ
ⲥⲟⲟⲩϩⲥ	ⲥⲟⲟⲩϩⲥ
ⲥⲟⲟⲩⲛ	ⲥⲟⲟⲩⲛ
ⲥⲟⲟⲩⲧⲛ	ⲥⲟⲟⲩⲧⲛ
ⲥⲟⲡ	ⲥⲟⲡ
ⲥⲟⲡ[.]	ⲥⲟⲡ[.]
ⲥⲟⲡⲥ	ⲥⲟⲡⲥ
ⲥⲟⲣ	ⲥⲟⲣ
ⲥⲟⲣⲙ	ⲥⲟⲣⲙ
ⲥⲟⲣⲙⲉ	ⲥⲟⲣⲙⲉ
ⲥⲟⲧ	ⲥⲟⲧ
ⲥⲟⲧϥ	ⲥⲟⲧϥ
ⲥⲟⲧⲙ	ⲥⲟⲧⲙ
ⲥⲟⲧⲡ	ⲥⲟⲧⲡ
ⲥⲟⲩ	ⲥⲟⲩ
ⲥⲟⲩϣⲙⲟⲩⲛ	ⲥⲟⲩ|ϣⲙⲟⲩⲛ
ⲥⲟⲩϣⲟⲙⲛⲧ	ⲥⲟⲩ|ϣⲟⲙⲛⲧ
ⲥⲟⲩϥⲧⲟⲟⲩ	ⲥⲟⲩ|ϥⲧⲟⲟⲩ
ⲥⲟⲩϫⲟⲩⲧϣⲙⲏⲛ	ⲥⲟⲩ|ϫⲟⲩⲧ|ϣⲙⲏⲛ
ⲥⲟⲩϫⲟⲩⲧϣⲟⲙⲧⲉ	ⲥⲟⲩ|ϫⲟⲩⲧ|ϣⲟⲙⲧⲉ
ⲥⲟⲩϫⲟⲩⲧⲁϥⲧⲉ	ⲥⲟⲩ|ϫⲟⲩⲧ|ⲁϥⲧⲉ
ⲥⲟⲩϫⲟⲩⲧⲏ	ⲥⲟⲩ|ϫⲟⲩⲧ|ⲏ
ⲥⲟⲩϫⲟⲩⲧⲟⲩⲉ	ⲥⲟⲩ|ϫⲟⲩⲧ|ⲟⲩⲉ
ⲥⲟⲩϫⲟⲩⲧⲥⲁϣϥⲉ	ⲥⲟⲩ|ϫⲟⲩⲧ|ⲥⲁϣϥⲉ
ⲥⲟⲩϫⲟⲩⲧⲥⲛⲟⲟⲩⲛⲥ	ⲥⲟⲩ|ϫⲟⲩⲧ|ⲥⲛⲟⲟⲩⲛⲥ
ⲥⲟⲩϫⲟⲩⲧⲯⲓⲥ	ⲥⲟⲩ|ϫⲟⲩⲧ|ⲯⲓⲥ
ⲥⲟⲩϯⲟⲩ	ⲥⲟⲩ|ϯⲟⲩ
ⲥⲟⲩⲁ	ⲥⲟⲩ|ⲁ
ⲥⲟⲩⲃ	ⲥⲟⲩ|ⲃ
ⲥⲟⲩⲅ	ⲥⲟⲩ|ⲅ
ⲥⲟⲩⲇ	ⲥⲟⲩ|ⲇ
ⲥⲟⲩⲉⲛ	ⲥⲟⲩⲉⲛ
ⲥⲟⲩⲉⲛⲧ	ⲥⲟⲩⲉⲛⲧ
ⲥⲟⲩⲙⲏⲧ	ⲥⲟⲩ|ⲙⲏⲧ
ⲥⲟⲩⲙⲛϯⲟⲩ	ⲥⲟⲩ|ⲙⲛϯ|ⲟⲩ
ⲥⲟⲩⲙⲛⲧϣⲙⲟⲩⲛ	ⲥⲟⲩ|ⲙⲛⲧ|ϣⲙⲟⲩⲛ
ⲥⲟⲩⲙⲛⲧϣⲟⲙⲧ	ⲥⲟⲩ|ⲙⲛⲧ|ϣⲟⲙⲧ
ⲥⲟⲩⲙⲛⲧϯⲟⲩ	ⲥⲟⲩ|ⲙⲛⲧ|ϯⲟⲩ
ⲥⲟⲩⲙⲛⲧⲁϥⲧⲉ	ⲥⲟⲩ|ⲙⲛⲧ|ⲁϥⲧⲉ
ⲥⲟⲩⲙⲛⲧⲁⲥⲉ	ⲥⲟⲩ|ⲙⲛⲧ|ⲁⲥⲉ
ⲥⲟⲩⲙⲛⲧⲁⲥⲥⲉ	ⲥⲟⲩ|ⲙⲛⲧ|ⲁⲥⲥⲉ
ⲥⲟⲩⲙⲛⲧⲟⲩⲉ	ⲥⲟⲩ|ⲙⲛⲧ|ⲟⲩⲉ
ⲥⲟⲩⲙⲛⲧⲥⲁϣϥ	ⲥⲟⲩ|ⲙⲛⲧ|ⲥⲁϣϥ
ⲥⲟⲩⲙⲛⲧⲥⲛⲟⲟⲩⲥ	ⲥⲟⲩ|ⲙⲛⲧ|ⲥⲛⲟⲟⲩⲥ
ⲥⲟⲩⲙⲛⲧⲥⲟⲟⲩ	ⲥⲟⲩ|ⲙⲛⲧ|ⲥⲟⲟⲩ
ⲥⲟⲩⲙⲛⲧⲧⲁⲥⲉ	ⲥⲟⲩ|ⲙⲛⲧ|ⲧⲁⲥⲉ
ⲥⲟⲩⲙⲛⲧⲯⲓⲥ	ⲥⲟⲩ|ⲙⲛⲧ|ⲯⲓⲥ
ⲥⲟⲩⲛ	ⲥⲟⲩⲛ
ⲥⲟⲩⲛⲧ	ⲥⲟⲩⲛⲧ
ⲥⲟⲩⲟ	ⲥⲟⲩⲟ
ⲥⲟⲩⲟⲩⲁ	ⲥⲟⲩ|ⲟⲩⲁ
ⲥⲟⲩⲟⲩⲁ	ⲥⲟⲩ|ⲟⲩⲁ
ⲥⲟⲩⲥⲁϣϥ	ⲥⲟⲩ|ⲥⲁϣϥ
ⲥⲟⲩⲥⲛⲁⲩ	ⲥⲟⲩ|ⲥⲛⲁⲩ
ⲥⲟⲩⲥⲟⲟⲩ	ⲥⲟⲩ|ⲥⲟⲟⲩ
ⲥⲟⲩⲧⲛ	ⲥⲟⲩⲧⲛ
ⲥⲟⲩⲧⲱⲛ	ⲥⲟⲩⲧⲱⲛ
ⲥⲟⲩⲱⲛ	ⲥⲟⲩⲱⲛ
ⲥⲟⲫⲓⲁ	ⲥⲟⲫⲓⲁ
ⲥⲟⲫⲟⲥ	ⲥⲟⲫⲟⲥ
ⲥⲡ	ⲥⲡ
ⲥⲡⲉⲕⲟⲩⲗⲁⲧⲱⲣ	ⲥⲡⲉⲕⲟⲩⲗⲁⲧⲱⲣ
ⲥⲡⲉⲣⲙⲁ	ⲥⲡⲉⲣⲙⲁ
ⲥⲡⲏⲗⲁⲓⲟⲛ	ⲥⲡⲏⲗⲁⲓⲟⲛ
ⲥⲡⲓⲣⲁ	ⲥⲡⲓⲣⲁ
ⲥⲡⲟⲅⲅⲟⲥ	ⲥⲡⲟⲅⲅⲟⲥ
ⲥⲡⲟⲧⲟⲩ	ⲥⲡⲟⲧⲟⲩ
ⲥⲡⲟⲩⲇⲁⲍⲉ	ⲥⲡⲟⲩⲇⲁⲍⲉ
ⲥⲡⲟⲩⲇⲏ	ⲥⲡⲟⲩⲇⲏ
ⲥⲣ	ⲥⲣ
ⲥⲣϥⲉ	ⲥⲣϥⲉ
ⲥⲣⲁϩⲧ	ⲥⲣⲁϩⲧ
ⲥⲣⲉϥⲣⲓϥⲉ	ⲥⲣⲉϥⲣⲓϥⲉ
ⲥⲣⲙⲣⲱⲙ	ⲥⲣⲙⲣⲱⲙ
ⲥⲣⲟϥⲧ	ⲥⲣⲟϥⲧ
ⲥⲧⲁⲇⲓⲟⲛ	ⲥⲧⲁⲇⲓⲟⲛ
ⲥⲧⲁⲥⲓⲁⲍⲉ	ⲥⲧⲁⲥⲓⲁⲍⲉ
ⲥⲧⲁⲥⲓⲥ	ⲥⲧⲁⲥⲓⲥ
ⲥⲧⲁⲩⲣⲟⲥ	ⲥⲧⲁⲩⲣⲟⲥ
ⲥⲧⲁⲩⲣⲟⲩ	ⲥⲧⲁⲩⲣⲟⲩ
ⲥⲧⲉⲓⲱϩⲉ	ⲥⲧ|ⲉⲓⲱϩⲉ
ⲥⲧⲉⲣⲉⲱⲙⲁ	ⲥⲧⲉⲣⲉⲱⲙⲁ
ⲥⲧⲉⲫⲁⲛⲁ	ⲥⲧⲉⲫⲁⲛⲁ
ⲥⲧⲏⲗⲏ	ⲥⲧⲏⲗⲏ
ⲥⲧⲏⲙ	ⲥⲧⲏⲙ
ⲥⲧⲟ	ⲥⲧⲟ
ⲥⲧⲟⲓ	ⲥⲧⲟⲓ
ⲥⲧⲟⲓⲭⲉⲓ	ⲥⲧⲟⲓⲭⲉⲓ
ⲥⲧⲟⲗⲁⲣⲭⲏⲥ	ⲥⲧⲟⲗⲁⲣⲭⲏⲥ
ⲥⲧⲟⲗⲏ	ⲥⲧⲟⲗⲏ
ⲥⲧⲣⲁⲧⲉⲩⲙⲁ	ⲥⲧⲣⲁⲧⲉⲩⲙⲁ
ⲥⲧⲣⲁⲧⲏⲗⲁⲧⲏⲥ	ⲥⲧⲣⲁⲧⲏⲗⲁⲧⲏⲥ
ⲥⲧⲩⲗⲏ	ⲥⲧⲩⲗⲏ
ⲥⲧⲩⲗⲗⲟⲥ	ⲥⲧⲩⲗⲗⲟⲥ
ⲥⲧⲱⲧ	ⲥⲧⲱⲧ
ⲥⲩⲅⲅⲉⲛⲏⲥ	ⲥⲩⲅⲅⲉⲛⲏⲥ
ⲥⲩⲅⲕⲉⲣⲁ	ⲥⲩⲅⲕⲉⲣⲁ
ⲥⲩⲅⲕⲗⲏⲧⲓⲕⲏ	ⲥⲩⲅⲕⲗⲏⲧⲓⲕⲏ
ⲥⲩⲙⲃⲟⲩⲗⲉⲩⲉ	ⲥⲩⲙⲃⲟⲩⲗⲉⲩⲉ
ⲥⲩⲛ	ⲥⲩⲛ
ⲥⲩⲛϩⲉⲇⲣⲓⲟⲛ	ⲥⲩⲛϩⲉⲇⲣⲓⲟⲛ
ⲥⲩⲛⲁⲅⲱⲅⲏ	ⲥⲩⲛⲁⲅⲱⲅⲏ
ⲥⲩⲛⲁⲝⲓⲥ	ⲥⲩⲛⲁⲝⲓⲥ
ⲥⲩⲛⲃⲓⲁ	ⲥⲩⲛⲃⲓⲁ
ⲥⲩⲛⲅⲛⲱⲙⲏ	ⲥⲩⲛⲅⲛⲱⲙⲏ
ⲥⲩⲛⲉⲓⲇⲏⲥⲓⲥ	ⲥⲩⲛⲉⲓⲇⲏⲥⲓⲥ
ⲥⲩⲛⲍⲏⲧⲏⲧⲏⲥ	ⲥⲩⲛⲍⲏⲧⲏⲧⲏⲥ
ⲥⲩⲛⲏⲑⲉⲓⲁ	ⲥⲩⲛⲏⲑⲉⲓⲁ
ⲥⲩⲛⲏⲑⲓⲁ	ⲥⲩⲛⲏⲑⲓⲁ
ⲥⲩⲛⲕⲗⲏⲧⲓⲕⲏ	ⲥⲩⲛⲕⲗⲏⲧⲓⲕⲏ
ⲥⲩⲛⲕⲗⲏⲧⲓⲕⲟⲥ	ⲥⲩⲛⲕⲗⲏⲧⲓⲕⲟⲥ
ⲥⲩⲛⲕⲗⲓϯⲕⲟⲥ	ⲥⲩⲛⲕⲗⲓϯⲕⲟⲥ
ⲥⲩⲛⲧⲉⲗⲉⲓⲁ	ⲥⲩⲛⲧⲉⲗⲉⲓⲁ
ⲥⲩⲛⲧⲉⲗⲓⲁ	ⲥⲩⲛⲧⲉⲗⲓⲁ
ⲥⲩⲣⲁ	ⲥⲩⲣⲁ
ⲥⲩⲣⲉ	ⲥⲩⲣⲉ
ⲥⲩⲣⲓⲁ	ⲥⲩⲣⲓⲁ
ⲥⲫⲁⲅⲓⲁ	ⲥⲫⲁⲅⲓⲁ
ⲥⲫⲁⲗⲙⲁ	ⲥⲫⲁⲗⲙⲁ
ⲥⲫⲣⲁⲅⲓⲥ	ⲥⲫⲣⲁⲅⲓⲥ
ⲥⲭⲏⲙⲁ	ⲥⲭⲏⲙⲁ
ⲥⲱ	ⲥⲱ
ⲥⲱϣ	ⲥⲱϣ
ⲥⲱϣϥ	ⲥⲱϣϥ
ⲥⲱϣⲉ	ⲥⲱϣⲉ
ⲥⲱϣⲙ	ⲥⲱϣⲙ
ⲥⲱⲃⲁϩ	ⲥⲱⲃⲁϩ
ⲥⲱⲃⲉ	ⲥⲱⲃⲉ
ⲥⲱⲕ	ⲥⲱⲕ
ⲥⲱⲙⲁ	ⲥⲱⲙⲁ
ⲥⲱⲛ	ⲥⲱⲛ
ⲥⲱⲛⲉ	ⲥⲱⲛⲉ
ⲥⲱⲛⲧ	ⲥⲱⲛⲧ
ⲥⲱⲟⲩ	ⲥⲱⲟⲩ
ⲥⲱⲟⲩϩ	ⲥⲱⲟⲩϩ
ⲥⲱⲣⲙ	ⲥⲱⲣⲙ
ⲥⲱⲥⲑⲉⲛⲏⲥ	ⲥⲱⲥⲑⲉⲛⲏⲥ
ⲥⲱⲧ	ⲥⲱⲧ
ⲥⲱⲧϥ	ⲥⲱⲧϥ
ⲥⲱⲧⲉ	ⲥⲱⲧⲉ
ⲥⲱⲧⲏⲣ	ⲥⲱⲧⲏⲣ
ⲥⲱⲧⲏⲣⲓⲁ	ⲥⲱⲧⲏⲣⲓⲁ
ⲥⲱⲧⲙ	ⲥⲱⲧⲙ
ⲥⲱⲧⲡ	ⲥⲱⲧⲡ
ⲥⲱⲱ	ⲥⲱⲱ
ⲥⲱⲱϥ	ⲥⲱⲱϥ
ⲥⲱⲱⲡ	ⲥⲱⲱⲡ
ⲧ	ⲧ
ⲧϣⲟⲟⲡ	ⲧϣⲟⲟⲡ
ⲧϩⲛⲉⲣⲱⲙⲉ	ⲧϩⲛⲉ|ⲣⲱⲙⲉ
ⲧϩⲡⲟ	ⲧϩⲡⲟ
ⲧϭⲁⲉⲓⲟ	ⲧϭⲁⲉⲓⲟ
ⲧϭⲁⲓⲉ	ⲧϭⲁⲓⲉ
ⲧϭⲁⲓⲏⲩ	ⲧϭⲁⲓⲏⲩ
ⲧϭⲁⲓⲟ	ⲧϭⲁⲓⲟ
ⲧⲁ	ⲧⲁ
ⲧⲁϣⲉ	ⲧⲁϣⲉ
ⲧⲁϣⲉⲟⲉⲓϣ	ⲧⲁϣⲉ|ⲟⲉⲓϣ
ⲧⲁϣⲟ	ⲧⲁϣⲟ
ⲧⲁϥ	ⲧⲁϥ
ⲧⲁϩ	ⲧⲁϩ
ⲧⲁϩⲉ	ⲧⲁϩⲉ
ⲧⲁϩⲙ	ⲧⲁϩⲙ
ⲧⲁϩⲟ	ⲧⲁϩⲟ
ⲧⲁϩⲥ	ⲧⲁϩⲥ
ⲧⲁϩⲱ	ⲧⲁϩⲱ
ⲧⲁϫⲣⲉ	ⲧⲁϫⲣⲉ
ⲧⲁϫⲣⲏⲩ	ⲧⲁϫⲣⲏⲩ
ⲧⲁϫⲣⲟ	ⲧⲁϫⲣⲟ
ⲧⲁϭⲥⲉ	ⲧⲁϭⲥⲉ
ⲧⲁⲁ	ⲧⲁⲁ
ⲧⲁⲁⲁ	ⲧⲁⲁⲁ
ⲧⲁⲁⲧ	ⲧⲁⲁⲧ
ⲧⲁⲅⲙⲁ	ⲧⲁⲅⲙⲁ
ⲧⲁⲉⲓⲉ	ⲧⲁⲉⲓⲉ
ⲧⲁⲉⲓⲏⲩ	ⲧⲁⲉⲓⲏⲩ
ⲧⲁⲉⲓⲟ	ⲧⲁⲉⲓⲟ
ⲧⲁⲉⲓⲟⲩ	ⲧⲁⲉⲓⲟⲩ
ⲧⲁⲓ	ⲧⲁⲓ
ⲧⲁⲓⲉ	ⲧⲁⲓⲉ
ⲧⲁⲓⲏⲩ	ⲧⲁⲓⲏⲩ
ⲧⲁⲓⲟ	ⲧⲁⲓⲟ
ⲧⲁⲕⲉ	ⲧⲁⲕⲉ
ⲧⲁⲕⲉϩⲟⲓⲛⲉ	ⲧⲁⲕⲉ|ϩⲟⲓⲛⲉ
ⲧⲁⲕⲟ	ⲧⲁⲕⲟ
ⲧⲁⲗϭⲟ	ⲧⲁⲗϭⲟ
ⲧⲁⲗⲁⲓⲡⲱⲣⲟⲥ	ⲧⲁⲗⲁⲓⲡⲱⲣⲟⲥ
ⲧⲁⲗⲉ	ⲧⲁⲗⲉ
ⲧⲁⲗⲉⲓⲑⲁ	ⲧⲁⲗⲉⲓⲑⲁ
ⲧⲁⲗⲟ	ⲧⲁⲗⲟ
ⲧⲁⲙⲉ	ⲧⲁⲙⲉ
ⲧⲁⲙⲉⲓⲟⲛ	ⲧⲁⲙⲉⲓⲟⲛ
ⲧⲁⲙⲓⲉ	ⲧⲁⲙⲓⲉ
ⲧⲁⲙⲓⲉⲓⲟⲛ	ⲧⲁⲙⲓⲉⲓⲟⲛ
ⲧⲁⲙⲓⲟ	ⲧⲁⲙⲓⲟ
ⲧⲁⲙⲓⲟⲛ	ⲧⲁⲙⲓⲟⲛ
ⲧⲁⲙⲓⲱ	ⲧⲁⲙⲓⲱ
ⲧⲁⲙⲙⲉ	ⲧⲁⲙⲙⲉ
ⲧⲁⲙⲟ	ⲧⲁⲙⲟ
ⲧⲁⲙⲟⲓ	ⲧⲁⲙⲟⲓ
ⲧⲁⲙⲱ	ⲧⲁⲙⲱ
ⲧⲁⲛϩⲉ	ⲧⲁⲛϩⲉ
ⲧⲁⲛϩⲟ	ⲧⲁⲛϩⲟ
ⲧⲁⲛϩⲟⲩⲧ	ⲧⲁⲛϩⲟⲩⲧ
ⲧⲁⲝⲓⲥ	ⲧⲁⲝⲓⲥ
ⲧⲁⲟⲩⲉ	ⲧⲁⲟⲩⲉ
ⲧⲁⲟⲩⲟ	ⲧⲁⲟⲩⲟ
ⲧⲁⲡⲣⲟ	ⲧⲁⲡⲣⲟ
ⲧⲁⲣ	ⲧⲁⲣ
ⲧⲁⲣe	ⲧⲁⲣe
ⲧⲁⲣⲉ	ⲧⲁⲣⲉ
ⲧⲁⲣⲧⲁⲣⲟⲥ	ⲧⲁⲣⲧⲁⲣⲟⲥ
ⲧⲁⲩⲉ	ⲧⲁⲩⲉ
ⲧⲁⲩⲉⲥϩⲃⲏⲓⲧⲉ	ⲧⲁⲩⲉ|ⲥϩⲃⲏⲓⲧⲉ
ⲧⲁⲩⲟ	ⲧⲁⲩⲟ
ⲧⲁⲩⲟⲩⲟ	ⲧⲁⲩⲟⲩⲟ
ⲧⲁⲭⲁ	ⲧⲁⲭⲁ
ⲧⲁⲭⲏ	ⲧⲁⲭⲏ
ⲧⲁⲭⲩ	ⲧⲁⲭⲩ
ⲧⲃⲁ	ⲧⲃⲁ
ⲧⲃⲃⲉ	ⲧⲃⲃⲉ
ⲧⲃⲃⲏⲩ	ⲧⲃⲃⲏⲩ
ⲧⲃⲃⲟ	ⲧⲃⲃⲟ
ⲧⲃⲛⲏ	ⲧⲃⲛⲏ
ⲧⲃⲛⲟⲟⲩⲉ	ⲧⲃⲛⲟⲟⲩⲉ
ⲧⲃⲧ	ⲧⲃⲧ
ⲧⲉ	ⲧⲉ
ⲧⲉϣ	ⲧⲉϣ
ⲧⲉϥ	ⲧⲉϥ
ⲧⲉϩⲙ	ⲧⲉϩⲙ
ⲧⲉϩⲛⲉ	ⲧⲉϩⲛⲉ
ⲧⲉϩⲥ	ⲧⲉϩⲥ
ⲧⲉⲓ	ⲧⲉⲓ
ⲧⲉⲕ	ⲧⲉⲕ
ⲧⲉⲕⲙ	ⲧⲉⲕⲙ
ⲧⲉⲗⲉⲓⲟⲥ	ⲧⲉⲗⲉⲓⲟⲥ
ⲧⲉⲗⲱⲛⲏⲥ	ⲧⲉⲗⲱⲛⲏⲥ
ⲧⲉⲗⲱⲛⲓⲟⲛ	ⲧⲉⲗⲱⲛⲓⲟⲛ
ⲧⲉⲛ	ⲧⲉⲛ
ⲧⲉⲛⲟⲩ	ⲧⲉⲛⲟⲩ
ⲧⲉⲥ	ⲧⲉⲥ
ⲧⲉⲧ	ⲧⲉⲧ
ⲧⲉⲧⲛ	ⲧⲉⲧⲛ
ⲧⲉⲩ	ⲧⲉⲩ
ⲧⲉⲭⲛⲉ	ⲧⲉⲭⲛⲉ
ⲧⲉⲭⲛⲏ	ⲧⲉⲭⲛⲏ
ⲧⲏ	ⲧⲏ
ⲧⲏϣ	ⲧⲏϣ
ⲧⲏϩ	ⲧⲏϩ
ⲧⲏϭ	ⲧⲏϭ
ⲧⲏⲏⲃⲉ	ⲧⲏⲏⲃⲉ
ⲧⲏⲕ	ⲧⲏⲕ
ⲧⲏⲙ	ⲧⲏⲙ
ⲧⲏⲛⲟⲩ	ⲧⲏⲛⲟⲩ
ⲧⲏⲣ	ⲧⲏⲣ
ⲧⲏⲣϥ	ⲧⲏⲣ|ϥ
ⲧⲏⲧⲛ	ⲧⲏⲧⲛ
ⲧⲏⲩ	ⲧⲏⲩ
ⲧⲏⲩⲗⲟ	ⲧⲏⲩⲗⲟ
ⲧⲏⲩⲧⲛ	ⲧⲏⲩⲧⲛ
ⲧⲓ	ⲧⲓ
ⲧⲓⲙⲁⲓⲟⲥ	ⲧⲓⲙⲁⲓⲟⲥ
ⲧⲓⲙⲏ	ⲧⲓⲙⲏ
ⲧⲓⲙⲟⲑⲉⲟⲥ	ⲧⲓⲙⲟⲑⲉⲟⲥ
ⲧⲓⲙⲱⲣⲓⲁ	ⲧⲓⲙⲱⲣⲓⲁ
ⲧⲓⲟⲩ	ⲧⲓⲟⲩ
ⲧⲗⲧⲗ	ⲧⲗⲧⲗ
ⲧⲙ	ⲧⲙ
ⲧⲙⲁⲉⲓⲟ	ⲧⲙⲁⲉⲓⲟ
ⲧⲙⲁⲓⲏⲩ	ⲧⲙⲁⲓⲏⲩ
ⲧⲙⲁⲓⲟ	ⲧⲙⲁⲓⲟ
ⲧⲙⲉ	ⲧⲙⲉ
ⲧⲙⲏ	ⲧⲙⲏ
ⲧⲙⲙⲟ	ⲧⲙⲙⲟ
ⲧⲙⲙⲟⲩⲣ	ⲧⲙⲙⲟⲩⲣ
ⲧⲛ	ⲧⲛ
ⲧⲛⲉⲧ	ⲧⲛⲉⲧ
ⲧⲛⲛⲉⲩ	ⲧⲛⲛⲉⲩ
ⲧⲛⲛⲟ	ⲧⲛⲛⲟ
ⲧⲛⲛⲟⲟⲩ	ⲧⲛⲛⲟⲟⲩ
ⲧⲛⲧⲛ	ⲧⲛⲧⲛ
ⲧⲛⲧⲱⲛ	ⲧⲛⲧⲱⲛ
ⲧⲟ	ⲧⲟ
ⲧⲟϣ	ⲧⲟϣ
ⲧⲟϭ	ⲧⲟϭ
ⲧⲟⲃⲧⲃ	ⲧⲟⲃⲧⲃ
ⲧⲟⲉⲓⲥ	ⲧⲟⲉⲓⲥ
ⲧⲟⲕ	ⲧⲟⲕ
ⲧⲟⲕⲙ	ⲧⲟⲕⲙ
ⲧⲟⲗⲙ	ⲧⲟⲗⲙ
ⲧⲟⲗⲙⲁ	ⲧⲟⲗⲙⲁ
ⲧⲟⲗⲙⲏⲣⲓⲁ	ⲧⲟⲗⲙⲏⲣⲓⲁ
ⲧⲟⲗⲟⲙⲁ	ⲧⲟⲗⲟⲙⲁ
ⲧⲟⲙⲥ	ⲧⲟⲙⲥ
ⲧⲟⲛⲟⲩ	ⲧⲟⲛⲟⲩ
ⲧⲟⲟⲧ	ⲧⲟⲟⲧ
ⲧⲟⲟⲩ	ⲧⲟⲟⲩ
ⲧⲟⲟⲩⲉ	ⲧⲟⲟⲩⲉ
ⲧⲟⲡ	ⲧⲟⲡ
ⲧⲟⲡⲟⲥ	ⲧⲟⲡⲟⲥ
ⲧⲟⲣⲡ	ⲧⲟⲣⲡ
ⲧⲟⲧⲉ	ⲧⲟⲧⲉ
ⲧⲟⲩ	ⲧⲟⲩ
ⲧⲟⲩϫⲉ	ⲧⲟⲩϫⲉ
ⲧⲟⲩϫⲟ	ⲧⲟⲩϫⲟ
ⲧⲟⲩⲓⲏ	ⲧⲟⲩⲓⲏ
ⲧⲟⲩⲓⲟ	ⲧⲟⲩⲓⲟ
ⲧⲟⲩⲛ	ⲧⲟⲩⲛ
ⲧⲟⲩⲛⲉⲓⲁⲧ	ⲧⲟⲩⲛ|ⲉⲓⲁⲧ
ⲧⲟⲩⲛⲉⲥ	ⲧⲟⲩⲛⲉⲥ
ⲧⲟⲩⲛⲟⲥ	ⲧⲟⲩⲛⲟⲥ
ⲧⲟⲩⲛⲟⲩⲥ	ⲧⲟⲩⲛⲟⲩⲥ
ⲧⲟⲩⲧⲟ	ⲧⲟⲩⲧⲟ
ⲧⲟⲩⲱ	ⲧⲟⲩⲱ
ⲧⲡⲉ	ⲧⲡⲉ
ⲧⲣ	ⲧⲣ
ⲧⲣⲁ	ⲧⲣⲁ
ⲧⲣⲁⲡⲉⲍⲁ	ⲧⲣⲁⲡⲉⲍⲁ
ⲧⲣⲉ	ⲧⲣⲉ
ⲧⲣⲓⲧⲟⲛ	ⲧⲣⲓⲧⲟⲛ
ⲧⲣⲣⲉ	ⲧⲣⲣⲉ
ⲧⲣⲩⲫⲁ	ⲧⲣⲩⲫⲁ
ⲧⲥⲁⲃⲉ	ⲧⲥⲁⲃⲉ
ⲧⲥⲁⲃⲟ	ⲧⲥⲁⲃⲟ
ⲧⲥⲁⲃⲱ	ⲧⲥⲁⲃⲱ
ⲧⲥⲁⲛⲟ	ⲧⲥⲁⲛⲟ
ⲧⲥⲃ	ⲧⲥⲃ
ⲧⲥⲉ	ⲧⲥⲉ
ⲧⲥⲉⲃⲉ	ⲧⲥⲉⲃⲉ
ⲧⲥⲓⲉ	ⲧⲥⲓⲉ
ⲧⲥⲓⲟ	ⲧⲥⲓⲟ
ⲧⲥⲛⲕⲟ	ⲧⲥⲛⲕⲟ
ⲧⲥⲟ	ⲧⲥⲟ
ⲧⲥⲧⲟ	ⲧⲥⲧⲟ
ⲧⲧ	ⲧⲧ
ⲧⲩⲡⲟⲥ	ⲧⲩⲡⲟⲥ
ⲧⲩⲣⲟⲥ	ⲧⲩⲣⲟⲥ
ⲧⲱ	ⲧⲱ
ⲧⲱϣ	ⲧⲱϣ
ⲧⲱϥ	ⲧⲱϥ
ⲧⲱϩ	ⲧⲱϩ
ⲧⲱϩⲙ	ⲧⲱϩⲙ
ⲧⲱϩⲥ	ⲧⲱϩⲥ
ⲧⲱϭⲉ	ⲧⲱϭⲉ
ⲧⲱϭⲥ	ⲧⲱϭⲥ
ⲧⲱⲃϩ	ⲧⲱⲃϩ
ⲧⲱⲃⲁϩ	ⲧⲱⲃⲁϩ
ⲧⲱⲃⲥ	ⲧⲱⲃⲥ
ⲧⲱⲕ	ⲧⲱⲕ
ⲧⲱⲕⲙ	ⲧⲱⲕⲙ
ⲧⲱⲗⲙ	ⲧⲱⲗⲙ
ⲧⲱⲙ	ⲧⲱⲙ
ⲧⲱⲙⲧ	ⲧⲱⲙⲧ
ⲧⲱⲛ	ⲧⲱⲛ
ⲧⲱⲛⲉ	ⲧⲱⲛⲉ
ⲧⲱⲛⲟⲩ	ⲧⲱⲛⲟⲩ
ⲧⲱⲟⲩⲛ	ⲧⲱⲟⲩⲛ
ⲧⲱⲡ	ⲧⲱⲡ
ⲧⲱⲣⲡ	ⲧⲱⲣⲡ
ⲧⲱⲥ	ⲧⲱⲥ
ⲧⲱⲧ	ⲧⲱⲧ
ⲧⲱⲱⲃⲉ	ⲧⲱⲱⲃⲉ
ⲩ	ⲩ
ⲩϣⲏ	ⲩϣⲏ
ⲩϣⲟⲟⲩⲉ	ⲩϣⲟⲟⲩⲉ
ⲩϩⲟⲟⲣ	ⲩϩⲟⲟⲣ
ⲩⲉⲛⲧ	ⲩⲉⲛⲧ
ⲩⲛ	ⲩⲛ
ⲩⲛⲟⲩ	ⲩⲛⲟⲩ
ⲩⲛⲧ	ⲩⲛⲧ
ⲩⲛⲧⲁ	ⲩⲛⲧⲁ
ⲩⲟⲉⲓϣ	ⲩⲟⲉⲓϣ
ⲩⲟⲩⲟⲉⲓ	ⲩⲟⲩⲟⲉⲓ
ⲫⲁⲛⲟⲩⲏⲗ	ⲫⲁⲛⲟⲩⲏⲗ
ⲫⲁⲛⲧⲁⲥⲙⲁ	ⲫⲁⲛⲧⲁⲥⲙⲁ
ⲫⲁⲣⲁⲱ	ⲫⲁⲣⲁⲱ
ⲫⲁⲣⲓⲥⲥⲁⲓⲟⲥ	ⲫⲁⲣⲓⲥⲥⲁⲓⲟⲥ
ⲫⲁⲣⲙⲟⲩⲧⲉ	ⲫⲁⲣⲙⲟⲩⲧⲉ
ⲫⲁⲣⲣⲓⲥⲁⲓⲟⲥ	ⲫⲁⲣⲣⲓⲥⲁⲓⲟⲥ
ⲫⲁⲥⲅⲓⲁ	ⲫⲁⲥⲅⲓⲁ
ⲫⲑⲟⲛⲉⲓ	ⲫⲑⲟⲛⲉⲓ
ⲫⲑⲟⲛⲟⲥ	ⲫⲑⲟⲛⲟⲥ
ⲫⲓⲗⲁⲅⲣⲓⲟⲥ	ⲫⲓⲗⲁⲅⲣⲓⲟⲥ
ⲫⲓⲗⲓⲡⲡⲟⲥ	ⲫⲓⲗⲓⲡⲡⲟⲥ
ⲫⲓⲗⲟⲑⲉⲟⲥ	ⲫⲓⲗⲟⲑⲉⲟⲥ
ⲫⲓⲗⲟⲑⲉⲥ	ⲫⲓⲗⲟⲑⲉⲥ
ⲫⲟⲓⲃⲁⲙⲙⲱⲛ	ⲫⲟⲓⲃⲁⲙⲙⲱⲛ
ⲫⲟⲓⲛⲓⲕⲏ	ⲫⲟⲓⲛⲓⲕⲏ
ⲫⲟⲛⲟⲥ	ⲫⲟⲛⲟⲥ
ⲫⲟⲣⲉⲓ	ⲫⲟⲣⲉⲓ
ⲫⲟⲣⲧⲟⲩⲛⲁⲧⲟⲥ	ⲫⲟⲣⲧⲟⲩⲛⲁⲧⲟⲥ
ⲫⲣⲁⲅⲉⲗⲗⲓⲟⲛ	ⲫⲣⲁⲅⲉⲗⲗⲓⲟⲛ
ⲫⲣⲁⲅⲉⲗⲗⲟⲩ	ⲫⲣⲁⲅⲉⲗⲗⲟⲩ
ⲫⲣⲟⲛⲧⲓⲍⲉ	ⲫⲣⲟⲛⲧⲓⲍⲉ
ⲫⲩⲗⲓⲥⲧⲉⲓⲙ	ⲫⲩⲗⲓⲥⲧⲉⲓⲙ
ⲫⲩⲗⲓⲥⲧⲓⲉⲓⲙ	ⲫⲩⲗⲓⲥⲧⲓⲉⲓⲙ
ⲫⲩⲥⲓ	ⲫⲩⲥⲓ
ⲫⲩⲥⲓⲥ	ⲫⲩⲥⲓⲥ
ⲫⲱϭⲉ	ⲫⲱϭⲉ
ⲫⲱⲛⲉⲩⲥ	ⲫⲱⲛⲉⲩⲥ
ⲫⲱⲛⲏ	ⲫⲱⲛⲏ
ⲫⲱⲣⲉⲓ	ⲫⲱⲣⲉⲓ
ⲫⲱⲥⲥⲁ	ⲫⲱⲥⲥⲁ
ⲭⲁⲏⲗ	ⲭⲁⲏⲗ
ⲭⲁⲓⲣⲉ	ⲭⲁⲓⲣⲉ
ⲭⲁⲗⲁ	ⲭⲁⲗⲁ
ⲭⲁⲗⲓⲛⲟⲥ	ⲭⲁⲗⲓⲛⲟⲥ
ⲭⲁⲗⲕⲓⲛ	ⲭⲁⲗⲕⲓⲛ
ⲭⲁⲟⲥ	ⲭⲁⲟⲥ
ⲭⲁⲣⲓⲍⲉ	ⲭⲁⲣⲓⲍⲉ
ⲭⲁⲣⲓⲥ	ⲭⲁⲣⲓⲥ
ⲭⲁⲣⲓⲥⲙⲁ	ⲭⲁⲣⲓⲥⲙⲁ
ⲭⲁⲣⲧⲏⲥ	ⲭⲁⲣⲧⲏⲥ
ⲭⲉⲓⲙⲏⲧⲓ	ⲭⲉⲓⲙⲏⲧⲓ
ⲭⲏⲣⲁ	ⲭⲏⲣⲁ
ⲭⲓⲗⲓⲁⲣⲭⲟⲥ	ⲭⲓⲗⲓⲁⲣⲭⲟⲥ
ⲭⲗⲁⲙⲏⲥ	ⲭⲗⲁⲙⲏⲥ
ⲭⲗⲁⲙⲩⲥ	ⲭⲗⲁⲙⲩⲥ
ⲭⲗⲟⲏ	ⲭⲗⲟⲏ
ⲭⲟⲣⲧⲟⲥ	ⲭⲟⲣⲧⲟⲥ
ⲭⲣⲉⲓⲁ	ⲭⲣⲉⲓⲁ
ⲭⲣⲉⲓⲥⲧⲓⲁⲛⲟⲥ	ⲭⲣⲉⲓⲥⲧⲓⲁⲛⲟⲥ
ⲭⲣⲏⲙⲁ	ⲭⲣⲏⲙⲁ
ⲭⲣⲓⲁ	ⲭⲣⲓⲁ
ⲭⲣⲓⲥϯⲁⲛⲟⲥ	ⲭⲣⲓⲥϯⲁⲛⲟⲥ
ⲭⲣⲓⲥⲧⲓⲁⲛⲟⲥ	ⲭⲣⲓⲥⲧⲓⲁⲛⲟⲥ
ⲭⲣⲓⲥⲧⲟⲥ	ⲭⲣⲓⲥⲧⲟⲥ
ⲭⲣⲓⲥⲧⲟⲫⲟⲣⲟⲥ	ⲭⲣⲓⲥⲧⲟⲫⲟⲣⲟⲥ
ⲭⲣⲱ	ⲭⲣⲱ
ⲭⲱⲣⲁ	ⲭⲱⲣⲁ
ⲭⲱⲣⲓⲥ	ⲭⲱⲣⲓⲥ
ⲯⲁⲗⲗⲉⲓ	ⲯⲁⲗⲗⲉⲓ
ⲯⲁⲗⲙⲟⲥ	ⲯⲁⲗⲙⲟⲥ
ⲯⲉⲗⲓⲟⲛ	ⲯⲉⲗⲓⲟⲛ
ⲯⲓⲧⲉ	ⲯⲓⲧⲉ
ⲯⲩⲭⲏ	ⲯⲩⲭⲏ
ⲯⲩⲭⲓⲕⲟⲛ	ⲯⲩⲭⲓⲕⲟⲛ
ⲯⲩⲭⲓⲕⲟⲥ	ⲯⲩⲭⲓⲕⲟⲥ
ⲯⲩⲭⲟⲟⲩⲉ	ⲯⲩⲭⲟⲟⲩⲉ
ⲱ	ⲱ
ⲱϣ	ⲱϣ
ⲱϥⲉ	ⲱϥⲉ
ⲱϩⲉ	ⲱϩⲉ
ⲱϩⲥ	ⲱϩⲥ
ⲱϩⲧ	ⲱϩⲧ
ⲱϫⲛ	ⲱϫⲛ
ⲱϭⲉ	ⲱϭⲉ
ⲱϭⲧ	ⲱϭⲧ
ⲱⲃϣ	ⲱⲃϣ
ⲱⲇⲏ	ⲱⲇⲏ
ⲱⲕ	ⲱⲕ
ⲱⲕⲙ	ⲱⲕⲙ
ⲱⲗ	ⲱⲗ
ⲱⲛϩ	ⲱⲛϩ
ⲱⲛⲁϩ	ⲱⲛⲁϩ
ⲱⲛⲉ	ⲱⲛⲉ
ⲱⲟⲟⲡ	ⲱⲟⲟⲡ
ⲱⲟⲩⲉⲓⲧ	ⲱⲟⲩⲉⲓⲧ
ⲱⲡ	ⲱⲡ
ⲱⲣϥ	ⲱⲣϥ
ⲱⲣϫ	ⲱⲣϫ
ⲱⲣⲅⲁⲛⲟⲛ	ⲱⲣⲅⲁⲛⲟⲛ
ⲱⲣⲕ	ⲱⲣⲕ
ⲱⲥⲁⲛⲛⲁ	ⲱⲥⲁⲛⲛⲁ
ⲱⲥⲕ	ⲱⲥⲕ
ⲱⲧⲡ	ⲱⲧⲡ
ⲱⲱ	ⲱⲱ
ⲻ	ⲻ
ⲻ·	ⲻ·
⳾	⳾
⳾⳾⳾	⳾⳾⳾
⸓	⸓
⸖	⸖
〚...〛	〚...〛