··	.
·̣	·
·ⲻ	.
·	·
·]	·
̂ⲣ	ⲣ
̄ϩⲙⲟⲩ	ϩⲙⲟⲩ
̄ⲡ	ⲡ
̇ϣⲁ	ϣⲁ
̇ⲉ̇	ⲉ
̇ⲙ̄ⲡ︤	ⲙⲡ
̇ⲙⲁⲕⲁⲣⲓ̇ⲁ	ⲙⲁⲕⲁⲣⲓⲁ
̇ⲛ̇	ⲛ
̇ⲧⲱ̇ⲱ̇ⲃⲉ	ⲧⲱⲱⲃⲉ
̣·	·
̣̣ⲛ̣[ⲟ]ⲩ̣ⲧⲉ	ⲛⲟⲩⲧⲉ
̣ϣⲱⲡ̣ⲉ	ϣⲱⲡⲉ
̣ϥ	ϥ
̣ⲛ̣	ⲛ
̣ⲛⲧ	ⲛⲧ
̣[ⲡⲉⲓ	ⲡⲉⲓ
̣[.....]ⲟ̣[...]	.....ⲟ...
Φαμθ	Φαμενωθ
β	β
γ̣	γ
γ	γ
θἰνδ	θἰνδικτίονος
νο	ⲛⲟⲙⲓⲥⲙⲁ
ο̣	ο
ο	ο
υἱό	υἱός
ϣ̄ⲁϩⲣⲁⲓ̈	ϣⲁϩⲣⲁⲓ
ϣ̄ⲱϣ	ϣⲱϣ
ϣ̇ϣⲉ	ϣϣⲉ
ϣ̇ϥⲉ	ϣϥⲉ
ϣ̇ϭⲙ̇ϭⲟⲙ	ϣϭⲙϭⲟⲙ
ϣ̇ⲁ	ϣⲁ
ϣ̇ⲃⲛ̇ⲛⲉ	ϣⲃⲛⲛⲉ
ϣ̇ⲗⲏⲗ	ϣⲗⲏⲗ
ϣ̇ⲙⲟⲩⲛⲉ	ϣⲙⲟⲩⲛⲉ
ϣ̇ⲙⲟⲩⲛ	ϣⲙⲟⲩⲛ
ϣ̇ⲡ̇ϩ̇ⲙⲟⲧ	ϣⲡϩⲙⲟⲧ
ϣ̇ⲡⲛ̇ϣⲱⲡ	ϣⲡⲛϣⲱⲡ
ϣ̇ⲥ̇ⲛⲉ	ϣⲥⲛⲉ
ϣ̇ⲥ	ϣⲥ
ϣ̇ⲧⲏⲛ	ϣⲧⲏⲛ
ϣ̇ⲧⲟⲣⲧ̇ⲣ	ϣⲧⲟⲣⲧⲣ
ϣ̇ⲧⲟⲣⲧⲣ̇	ϣⲧⲟⲣⲧⲣ
ϣ̇ⲧⲣ̇ⲧⲱⲣ	ϣⲧⲣⲧⲱⲣ
ϣ̇ⲧⲱⲟⲩⲛ	ϣⲧⲱⲟⲩⲛ
ϣ̇ⲱⲡⲉ	ϣⲱⲡⲉ
ϣ̈ⲏⲣⲉ⳿	ϣⲏⲣⲉ
ϣ̣ⲁ̣ϫⲉ	ϣⲁϫⲉ
ϣ̣ⲁ̣	ϣⲁ
ϣ̣ⲏ̣ⲣⲉ	ϣⲏⲣⲉ
ϣ̣ⲏⲣⲉ	ϣⲏⲣⲉ
ϣ̣ⲗ̣ⲟ̣ϥ	ϣⲗⲟϥ
ϣ̣ⲱⲡⲉ	ϣⲱⲡⲉ
ϣ̣︤ϫ︥ⲥⲟϭ	ϣϫⲥⲟϭ
ϣ̣[ⲃ]ⲃⲓⲱ	ϣⲃⲃⲓⲱ
ϣϣⲉⲉⲣⲉ	ϣⲉⲉⲣⲉ
ϣϣⲉ	ϣϣⲉ
ϣϣⲉ 	ϣϣⲉ
ϣϥⲉ	ϣϥⲉ
ϣϥⲉ`	ϣϥⲉ
ϣϫⲁϩⲙ	ϣϫⲁϩⲙ
ϣϫⲉ	ϣϫⲉ
ϣϫⲥⲟϭ	ϣϫⲥⲟϭ
ϣϭⲙ̄ϭⲟⲙ	ϣϭⲙϭⲟⲙ
ϣϭⲙ̇ϭⲟⲙ	ϣϭⲙϭⲟⲙ
ϣϭⲙϭⲟⲙ	ϣϭⲙϭⲟⲙ
ϣϭⲟⲙ	ϣϭⲟⲙ
ϣϭⲟⲙ`	ϣϭⲟⲙ
ϣⲁ̂	ϣⲁ
ϣⲁϩⲉ	ϣⲁϩⲉ
ϣⲁϩⲟⲩⲛ	ϣⲁϩⲟⲩⲛ
ϣⲁϩⲣⲁⲓ̈	ϣⲁϩⲣⲁⲓ
ϣⲁϩⲣⲁⲓ	ϣⲁϩⲣⲁⲓ
ϣⲁϩ	ϣⲁϩ
ϣⲁϩ`	ϣⲁϩ
ϣⲁϫⲉ⳿	ϣⲁϫⲉ
ϣⲁϫⲉ	ϣⲁϫⲉ
ϣⲁϫⲉ`	ϣⲁϫⲉ
ϣⲁⲁ̇ⲧ	ϣⲁⲁⲧ
ϣⲁⲁⲣ	ϣⲁⲁⲣ
ϣⲁⲁⲧ︤	ϣⲁⲁⲧ
ϣⲁⲁⲧ	ϣⲁⲁⲧ
ϣⲁⲁ	ϣⲁⲁ
ϣⲁⲃⲟⲗ	ϣⲁⲃⲟⲗ
ϣⲁⲉⲓ	ϣⲁⲉⲓ
ϣⲁⲓ	ϣⲁⲓ
ϣⲁⲕⲧ	ϣⲁⲕⲧ
ϣⲁⲗ	ϣⲁⲗ
ϣⲁⲛⲧⲉ	ϣⲁⲛⲧⲉ
ϣⲁⲛⲧ	ϣⲁⲛⲧ
ϣⲁⲛ	ϣⲁⲛ
ϣⲁⲣⲉ	ϣⲁⲣⲉ
ϣⲁⲣⲟ	ϣⲁⲣⲟ
ϣⲁⲣⲡ̄	ϣⲁⲣⲡ
ϣⲁⲣⲡ	ϣⲁⲣⲡ
ϣⲁⲣⲱ	ϣⲁⲣⲱ
ϣⲁⲣ	ϣⲁⲣ
ϣⲁⲣ[ⲟ̣]	ϣⲁⲣⲟ
ϣⲁⲧⲟⲩ	ϣⲁⲧⲟⲩ
ϣⲁⲧ	ϣⲁⲧ
ϣⲁ⳯ⲧ	ϣⲁⲛⲧ
ϣⲁ⳯	ϣⲁⲛ
ϣⲁ	ϣⲁ
ϣⲁ]ⲛ̣	ϣⲛ
ϣⲁ`	ϣⲁ
ϣⲃⲃⲓⲱ	ϣⲃⲃⲓⲱ
ϣⲃⲉⲉⲣ	ϣⲃⲉⲉⲣ
ϣⲃⲉⲉⲣ`	ϣⲃⲉⲉⲣ
ϣⲃⲉⲓⲱ	ϣⲃⲉⲓⲱ
ϣⲃⲏⲣⲡⲣⲉⲥⲃⲩⲧⲉⲣⲟⲥ	ϣⲃⲏⲣⲡⲣⲉⲥⲃⲩⲧⲉⲣⲟⲥ
ϣⲃⲏⲣ⳿	ϣⲃⲏⲣ
ϣⲃⲏⲣ	ϣⲃⲏⲣ
ϣⲃⲛⲛⲉ	ϣⲃⲛⲛⲉ
ϣⲃⲣⲣϩⲱⲃ	ϣⲃⲣⲣϩⲱⲃ
ϣⲃⲣ	ϣⲃⲣ
ϣⲃⲧ	ϣⲃⲧ
ϣⲃ︤ⲣ︥	ϣⲃⲣ
ϣⲃ	ϣⲃ
ϣⲉϩⲙⲉ	ϣⲉϩⲙⲉ
ϣⲉⲉⲣⲉ	ϣⲉⲉⲣⲉ
ϣⲉⲉⲣⲉ`	ϣⲉⲉⲣⲉ
ϣⲉⲗⲉⲉⲧ	ϣⲉⲗⲉⲉⲧ
ϣⲉⲙⲛ̄ⲧϣⲉⲥⲉⲧⲏ	ϣⲙⲛⲧϣⲉⲥⲉⲧⲏ
ϣⲉⲙⲛⲧϣⲉⲥⲉⲧⲏ	ϣⲙⲛⲧϣⲉⲥⲉⲧⲏ
ϣⲉⲛⲟⲩⲧⲉ	ϣⲉⲛⲟⲩⲧⲉ
ϣⲉⲟⲉⲓϣ	ϣⲉⲟⲉⲓϣ
ϣⲉⲡϣⲡ	ϣⲉⲡϣⲡ
ϣⲉⲡϣⲱⲡ	ϣⲉⲡϣⲱⲡ
ϣⲉⲡϣ︤ⲡ︥	ϣⲉⲡϣⲡ
ϣⲉⲡ	ϣⲉⲡ
ϣⲉⲧϣⲱⲧ	ϣⲉⲧϣⲱⲧ
ϣⲉ	ϣⲉ
ϣⲏϣ	ϣⲏϣ
ϣⲏⲓ̈	ϣⲏⲓ
ϣⲏⲓ	ϣⲏⲓ
ϣⲏⲙ⳿	ϣⲏⲙ
ϣⲏⲙ	ϣⲏⲙ
ϣⲏⲛ̇	ϣⲏⲛ
ϣⲏⲛ	ϣⲏⲛ
ϣⲏⲡ	ϣⲏⲡ
ϣⲏⲣⲉ	ϣⲏⲣⲉ
ϣⲏⲣⲉ`	ϣⲏⲣⲉ
ϣⲏⲣⲡⲥϩⲁⲓ	ϣⲏⲣⲡⲥϩⲁⲓ
ϣⲏⲣ︤ⲡ︥ⲥϩⲁⲓ	ϣⲏⲣⲡⲥϩⲁⲓ
ϣⲏⲧ	ϣⲏⲧ
ϣⲏⲩⲉ	ϣⲏⲩⲉ
ϣⲏ⳯	ϣⲏⲛ
ϣⲏ	ϣⲏ
ϣⲏ[ⲣ̣]ⲉ	ϣⲏⲣⲉ
ϣⲓ̇ⲏⲧ	ϣⲓⲏⲧ
ϣⲓ̇ⲡⲉ	ϣⲓⲡⲉ
ϣⲓ̇	ϣⲓ
ϣⲓ̈ⲛⲉ	ϣⲓⲛⲉ
ϣⲓ̈ⲡⲉ	ϣⲓⲡⲉ
ϣⲓⲃⲉ	ϣⲓⲃⲉ
ϣⲓⲏⲧ	ϣⲓⲏⲧ
ϣⲓⲛⲉ	ϣⲓⲛⲉ
ϣⲓⲛⲉ`	ϣⲓⲛⲉ
ϣⲓⲛ	ϣⲓⲛⲉ
ϣⲓⲡⲉ	ϣⲓⲡⲉ
ϣⲓⲧⲉ⳿	ϣⲓⲧⲉ
ϣⲓⲧⲉ	ϣⲓⲧⲉ
ϣⲓ	ϣⲓ
ϣⲕⲁⲕ	ϣⲕⲁⲕ
ϣⲗϩⲗ	ϣⲗϩⲗ
ϣⲗⲏⲗ⳿	ϣⲗⲏⲗ
ϣⲗⲏⲗ	ϣⲗⲏⲗ
ϣⲗⲏⲗ`	ϣⲗⲏⲗ
ϣⲗⲟϥ	ϣⲗⲟϥ
ϣⲗⲧⲙ	ϣⲗⲧⲙ
ϣⲙ̄ϣⲉ	ϣⲙϣⲉ
ϣⲙ̇ⲙⲟ	ϣⲙⲙⲟ
ϣⲙϣⲉ	ϣⲙϣⲉ
ϣⲙⲙⲟ	ϣⲙⲙⲟ
ϣⲙⲙⲟ`	ϣⲙⲙⲟ
ϣⲙⲛⲧ	ϣⲟⲙⲛⲧ
ϣⲙⲟⲩⲛⲉ	ϣⲙⲟⲩⲛⲉ
ϣⲙⲟⲩⲛ	ϣⲙⲟⲩⲛ
ϣⲙⲧ	ϣⲙⲧ
ϣⲛⲉ	ϣⲛⲉ
ϣⲛⲏⲩ	ϣⲛⲏⲩ
ϣⲛⲧ	ϣⲛⲧ
ϣⲛ	ϣⲛ
ϣⲟ̇ⲟⲡ	ϣⲟⲟⲡ
ϣⲟϣⲟⲩ	ϣⲟϣⲟⲩ
ϣⲟϫⲛⲉ	ϣⲟϫⲛⲉ
ϣⲟϫⲛⲉ`	ϣⲟϫⲛⲉ
ϣⲟϫⲧ	ϣⲟϫⲧ
ϣⲟⲃⲉ	ϣⲟⲃⲉ
ϣⲟⲃⲧ	ϣⲟⲃⲧ
ϣⲟⲉⲓϣ	ϣⲟⲉⲓϣ
ϣⲟⲕϩ	ϣⲟⲕϩ
ϣⲟⲕ︤ϩ︥	ϣⲟⲕϩ
ϣⲟⲗϣⲗ	ϣⲟⲗϣⲗ
ϣⲟⲗϩ	ϣⲟⲗϩ
ϣⲟⲗ︤ϩ︥	ϣⲟⲗϩ
ϣⲟⲙⲛ̄ⲧ̄	ϣⲟⲙⲛⲧ
ϣⲟⲙⲛⲧ̄	ϣⲟⲙⲛⲧ
ϣⲟⲙⲛⲧ̇	ϣⲟⲙⲛⲧ
ϣⲟⲙⲛⲧ	ϣⲟⲙⲛⲧ
ϣⲟⲙⲧⲉ	ϣⲟⲙⲧⲉ
ϣⲟⲙⲧ	ϣⲟⲙⲧ
ϣⲟⲙ︤ⲛ︦ⲧ︥	ϣⲟⲙⲛⲧ
ϣⲟⲙ︤ⲧ︥	ϣⲟⲙⲧ
ϣⲟⲛⲧⲉ⳿	ϣⲟⲛⲧⲉ
ϣⲟⲛⲧⲉ	ϣⲟⲛⲧⲉ
ϣⲟⲟ̇ⲡ	ϣⲟⲟⲡ
ϣⲟⲟⲡ̂	ϣⲟⲟⲡ
ϣⲟⲟⲡ⳿	ϣⲟⲟⲡ
ϣⲟⲟⲡ	ϣⲟⲟⲡ
ϣⲟⲟⲡ`	ϣⲟⲟⲡ
ϣⲟⲟⲧⲓ	ϣⲟⲟⲡ
ϣⲟⲟⲩⲉ	ϣⲟⲟⲩⲉ
ϣⲟⲟⲩ	ϣⲟⲟⲩ
ϣⲟⲡ̣	ϣⲟⲡ
ϣⲟⲡ︤	ϣⲟⲡ
ϣⲟⲡ	ϣⲟⲡ
ϣⲟⲣϣⲣ	ϣⲟⲣϣⲣ
ϣⲟⲣϣ︤ⲣ︥	ϣⲟⲣϣⲣ
ϣⲟⲣⲡ̣	ϣⲟⲣⲡ
ϣⲟⲣⲡ	ϣⲟⲣⲡ
ϣⲟⲣ︤ⲡ︥	ϣⲟⲣⲡ
ϣⲟⲣ︤ⲡ︥`	ϣⲟⲣⲡ
ϣⲟⲧⲙ	ϣⲟⲧⲙ
ϣⲟⲧ	ϣⲟⲧ
ϣⲟⲩϣⲟⲩ	ϣⲟⲩϣⲟⲩ
ϣⲟⲩϣⲧ̇	ϣⲟⲩϣⲧ
ϣⲟⲩϣⲧⲙⲣⲱϥ	ϣⲟⲩϣⲧⲙⲣⲱϥ
ϣⲟⲩϣⲧ︤ⲙ︥ⲣⲱϥ	ϣⲟⲩϣⲧⲙⲣⲱϥ
ϣⲟⲩϣⲧ	ϣⲟⲩϣⲧ
ϣⲟⲩϣⲱⲱⲧ⳿	ϣⲟⲩϣⲱⲱⲧ
ϣⲟⲩϣⲱⲱⲧ	ϣⲟⲩϣⲱⲱⲧ
ϣⲟⲩϩⲏⲛⲉ	ϣⲟⲩϩⲏⲛⲉ
ϣⲟⲩⲉⲓⲧ	ϣⲟⲩⲉⲓⲧ
ϣⲟⲩⲉⲓⲧ`	ϣⲟⲩⲉⲓⲧ
ϣⲟⲩⲟ̇	ϣⲟⲩⲟ
ϣⲟⲩⲟ	ϣⲟⲩⲟ
ϣⲟⲩⲣⲏ	ϣⲟⲩⲣⲏ
ϣⲟⲩⲧⲙ	ϣⲟⲩⲧⲙ
ϣⲟⲩⲱϩ	ϣⲟⲩⲱϩ
ϣⲟⲩⲱⲟⲩ	ϣⲟⲩⲱⲟⲩ
ϣⲟⲩⲱ⳿	ϣⲟⲩⲱ
ϣⲟⲩⲱ	ϣⲟⲩⲱ
ϣⲟⲩ	ϣⲟⲩ
ϣⲟ	ϣⲟ
ϣⲟ[ⲣⲡ̄	ϣⲟⲣⲡ
ϣⲟ]ⲟ̣ⲡ`	ϣⲟⲟⲡ
ϣⲡϩⲓⲥⲉ	ϣⲡϩⲓⲥⲉ
ϣⲡϩⲙⲟⲧ	ϣⲡϩⲙⲟⲧ
ϣⲡⲏⲣⲉ	ϣⲡⲏⲣⲉ
ϣⲡⲛϣⲱⲡ	ϣⲡⲛϣⲱⲡ
ϣⲡ	ϣⲡ
ϣⲣⲡ	ϣⲣⲡ
ϣⲥⲛⲉ	ϣⲥⲛⲉ
ϣⲥ	ϣⲥ
ϣⲧⲁⲙ	ϣⲧⲁⲙ
ϣⲧⲁⲙ`	ϣⲧⲁⲙ
ϣⲧⲉⲕⲟ	ϣⲧⲉⲕⲟ
ϣⲧⲏⲛ	ϣⲧⲏⲛ
ϣⲧⲙ	ϣⲧⲙ
ϣⲧⲟⲣⲧⲣ̇	ϣⲧⲟⲣⲧⲣ
ϣⲧⲟⲣⲧⲣ	ϣⲧⲟⲣⲧⲣ
ϣⲧⲟⲣⲧ︤ⲣ︥	ϣⲧⲟⲣⲧⲣ
ϣⲧⲣ̄ⲧⲱⲣ	ϣⲧⲣⲧⲱⲣ
ϣⲧⲣⲧⲱⲣ	ϣⲧⲣⲧⲱⲣ
ϣⲧⲱⲟⲩⲛ	ϣⲧⲱⲟⲩⲛ
ϣⲱ̇ⲱ̇ϭⲉ	ⲱϭⲉ
ϣⲱ̇ⲱⲧ	ϣⲱⲱⲧ
ϣⲱϣⲧ̇	ϣⲱϣⲧ
ϣⲱϣⲧ	ϣⲱϣⲧ
ϣⲱϣ	ϣⲱϣ
ϣⲱϥⲧ	ϣⲱϥⲧ
ϣⲱϥ︤ⲧ︥	ϣⲱϥⲧ
ϣⲱϥ	ϣⲱϥ
ϣⲱϫⲡ	ϣⲱϫⲡ
ϣⲱϫ︤ⲡ̣︥	ϣⲱϫⲡ
ϣⲱϭⲉ	ϣⲱϭⲉ
ϣⲱⲗ	ϣⲱⲗ
ϣⲱⲙⲉ	ϣⲱⲙⲉ
ϣⲱⲙ	ϣⲱⲙ
ϣⲱⲛ̣ⲉ	ϣⲱⲛⲉ
ϣⲱⲛϥ̇	ϣⲱⲛϥ
ϣⲱⲛϥ	ϣⲱⲛϥ
ϣⲱⲛⲃ	ϣⲱⲛⲃ
ϣⲱⲛⲉ	ϣⲱⲛⲉ
ϣⲱⲛⲉ`	ϣⲱⲛⲉ
ϣⲱⲛ	ϣⲱⲛ
ϣⲱⲡ̣ⲉ	ϣⲱⲡⲉ
ϣⲱⲡⲉ̣	ϣⲱⲡⲉ
ϣⲱⲡⲉ	ϣⲱⲡⲉ
ϣⲱⲡⲉ`	ϣⲱⲡⲉ
ϣⲱⲡ⳿	ϣⲱⲡ
ϣⲱⲡ	ϣⲱⲡ
ϣⲱⲣⲡ	ϣⲱⲣⲡ
ϣⲱⲣ︤ⲡ︥	ϣⲱⲣⲡ
ϣⲱⲣ︤ⲡ︥`	ϣⲱⲣⲡ
ϣⲱⲥ̇ⲙ	ϣⲱⲥⲙ
ϣⲱⲥⲙ	ϣⲱⲥⲙ
ϣⲱⲥ	ϣⲱⲥ
ϣⲱⲧⲉ	ϣⲱⲧⲉ
ϣⲱⲱϭⲉ	ⲱϭⲉ
ϣⲱⲱⲡⲉ	ϣⲱⲱⲡⲉ
ϣⲱⲱⲧ⳿	ϣⲱⲱⲧ
ϣⲱⲱⲧ	ϣⲱⲱⲧ
ϣⲱⲱⲧ`	ϣⲱⲱⲧ
ϣⲱ	ϣⲱ
ϣⲱ]ⲡⲉ	ϣⲱⲡⲉ
ϣ̣︤ⲡ̣︥	ϣⲡ
ϣ︤ⲃ︥ⲃⲓⲱ	ϣⲃⲃⲓⲱ
ϣ︤ⲃ︥ⲉⲓⲱ̂	ϣⲃⲉⲓⲱ
ϣ︤ⲃ︦ⲣ︥	ϣⲃⲣ
ϣ︤ⲙ︥ϣⲉ	ϣⲙϣⲉ
ϣ︤ⲙ︥ⲙⲟ̂	ϣⲙⲙⲟ
ϣ︤ⲙ︥ⲙⲟ	ϣⲙⲙⲟ
ϣ︤ⲙ︥ⲙⲟ`	ϣⲙⲙⲟ
ϣ︤ⲛ︥	ϣⲛ
ϣ︤ⲡ︥ϩⲓⲥⲉ	ϣⲡϩⲓⲥⲉ
ϣ︤ⲡ︥	ϣⲡ
ϣ︤ⲣ︥ⲡ	ϣⲣⲡ
ϣ︤ⲣ︦ⲡ︥	ϣⲣⲡ
ϣ︦ⲙ︥ϣⲉ	ϣⲙϣⲉ
ϣ	ϣ
ϣ[ⲟ]ⲟⲡ	ϣⲟⲟⲡ
ϤⲀⲒⲔⲖⲞⲘ	ϥⲁⲓⲕⲗⲟⲙ
Ϥⲓ	ϥⲓ
Ϥ	ϥ
ϥ̄	ϥ
ϥ̇	ϥ
ϥ̣	ϥ
ϥⲉϭ	ϥⲉϭ
ϥⲉⲓ̇ⲣⲟⲟⲩϣ̇	ϥⲉⲓⲣⲟⲟⲩϣ
ϥⲉⲓ̇	ϥⲓ
ϥⲉⲓⲣⲟⲟⲩϣ	ϥⲉⲓⲣⲟⲟⲩϣ
ϥⲉⲓ	ϥⲉⲓ
ϥⲓ̂	ϥⲓ
ϥⲓ̇ⲣⲟⲟⲩϣ	ϥⲓⲣⲟⲟⲩϣ
ϥⲓ̇ⲧ̇	ϥⲓⲧ
ϥⲓ̇	ϥⲓ
ϥⲓ̈	ϥⲓ
ϥⲓ̣	ϥⲓ
ϥⲓⲁⲧ	ϥⲓⲧ
ϥⲓⲓⲁⲧ	ϥⲓⲉⲓⲁⲧ
ϥⲓⲣⲟⲟⲩϣ	ϥⲓⲣⲟⲟⲩϣ
ϥⲓⲧ︤︥	ϥⲓⲧ
ϥⲓⲧ︤	ϥⲓⲧ
ϥⲓⲧ	ϥⲓⲧ
ϥⲓ⳿	ϥⲓ
ϥⲓ	ϥⲓ
ϥⲓ`	ϥⲓ
ϥⲛⲁⲉⲓ⳿	ⲉⲓ
ϥⲛⲁⲉⲓ	ⲉⲓ
ϥⲛⲧ	ϥⲛⲧ
ϥⲟⲧ	ϥⲟⲧ
ϥⲟ	ϥⲟ
ϥⲧⲟⲟⲩ	ϥⲧⲟⲟⲩ
ϥⲧⲟⲩϣⲉ	ϥⲧⲟⲟⲩϣⲉ
ϥⲧⲟⲩ	ϥⲧⲟⲩ
ϥⲱϭⲉ	ϥⲱϭⲉ
ϥⲱⲧⲉ	ϥⲱⲧⲉ
ϥⲱⲧⲉ`	ϥⲱⲧⲉ
ϥⲱ	ϥⲱ
ϥ⳿	ϥ
ϥ︤ⲛ︦ⲧ︥	ϥⲛⲧ
ϥ︤	ϥ
ϥ︥	ϥ
ϥ︥`	ϥ
ϥ	ϥ
ϥ]	ϥ
ϥ`	ϥ
ϨⲀⲄⲒⲞⲤ	ϩⲁⲅⲓⲟⲥ
ϨⲀⲘⲎⲚ	ϩⲁⲙⲏⲛ
Ϩⲁⲙⲟⲓ̈	ϩⲁⲙⲟⲓ
Ϩⲁⲙⲟⲓ	ϩⲁⲙⲟⲓ
Ϩⲉⲛ	ϩⲉⲛ
Ϩⲉ	ϩⲉ
ϨⲒ	ϩⲓ
Ϩⲙ	ϩⲙ
ϨⲚ̄	ϩⲛ
ϨⲚ	ϩⲛ
Ϩⲣⲁⲭⲏⲗ	ϩⲣⲁⲭⲏⲗ
Ϩⲣⲁⲭⲏⲗ`	ϩⲣⲁⲭⲏⲗ
Ϩⲱⲃ⳿	ϩⲱⲃ
Ϩⲱⲃ	ϩⲱⲃ
Ϩⲱⲱ	ϩⲱⲱ
Ϩ︤ⲙ︥	ϩⲙ
ϩ·ⲉⲡ	ϩⲉⲡ
ϩ̄ⲃⲏⲩⲉ	ϩⲃⲏⲩⲉ
ϩ̄ⲗ̄ⲗⲟ⳿	ϩⲗⲗⲟ
ϩ̄ⲗⲗⲟ	ϩⲗⲗⲟ
ϩ̇ⲏⲧ	ϩⲏⲧ
ϩ̇ⲗ̇ⲗⲟ	ϩⲗⲗⲟ
ϩ̇ⲗⲗⲟ	ϩⲗⲗⲟ
ϩ̇ⲗⲡ̇ⲗⲱⲡ	ϩⲗⲡⲗⲱⲡ
ϩ̇ⲙϩⲁⲗ	ϩⲙϩⲁⲗ
ϩ̇ⲙⲉ	ϩⲙⲉ
ϩ̇ⲙⲟⲟⲥ	ϩⲙⲟⲟⲥ
ϩ̇ⲙⲟⲧ	ϩⲙⲟⲧ
ϩ̇ⲙ	ϩⲙ
ϩ̇ⲛ̇	ϩⲛ
ϩ̇ⲛ	ϩⲛ
ϩ̇ⲣⲁⲓ̇	ϩⲣⲁⲓ
ϩ̇ⲣⲁⲙⲛⲟⲥ	ϩⲣⲁⲙⲛⲟⲥ
ϩ̇ⲣⲟϣ	ϩⲣⲟϣ
ϩ̇ⲧⲟⲣ	ϩⲧⲟⲣ
ϩ̇ⲱⲱ	ϩⲱⲱ
ϩ̣ⲁ̣ⲣⲉϩ	ϩⲁⲣⲉϩ
ϩ̣ⲁ̣ⲧ	ϩⲁⲧ
ϩ̣ⲁⲣⲉϩ	ϩⲁⲣⲉϩ
ϩ̣ⲃⲏⲩⲉ	ϩⲃⲏⲩⲉ
ϩ̣ⲉⲛ	ϩⲉⲛ
ϩ̣ⲓ̣ⲧⲟⲩⲱ	ϩⲓⲧⲟⲩⲱ
ϩ̣ⲙ	ϩⲙ
ϩ̣ⲙ]	ϩⲙ
ϩ̣ⲛ̣	ϩⲛ
ϩ̣ⲛ	ϩⲛ
ϩ̣ⲱⲃ	ϩⲱⲃ
ϩⲁ̇ⲡⲥ̇	ϩⲁⲡⲥ
ϩⲁ̣ⲧⲏ	ϩⲁⲧⲏ
ϩⲁϩ̣	ϩⲁϩ
ϩⲁϩ̣`	ϩⲁϩ
ϩⲁϩⲟⲧⲉ	ϩⲁϩⲟⲧⲉ
ϩⲁϩⲧⲉⲛ	ϩⲁϩⲧⲉⲛ
ϩⲁϩⲧⲉ	ϩⲁϩⲧⲉ
ϩⲁϩⲧⲏ̣	ϩⲁϩⲧⲏ
ϩⲁϩⲧⲏ	ϩⲁϩⲧⲏ
ϩⲁϩⲧⲛ̇	ϩⲁϩⲧⲛ
ϩⲁϩⲧⲛ	ϩⲁϩⲧⲛ
ϩⲁϩ	ϩⲁϩ
ϩⲁϩ`	ϩⲁϩ
ϩⲁϫϩⲉϫ	ϩⲁϫϩⲉϫ
ϩⲁⲁⲩ	ϩⲁⲁⲩ
ϩⲁⲃⲟⲗ	ϩⲁⲃⲟⲗ
ϩⲁⲅⲓ̈ⲟⲥ	ϩⲁⲅⲓⲟⲥ
ϩⲁⲅⲓⲟⲥ	ϩⲁⲅⲓⲟⲥ
ϩⲁⲉⲓⲃⲉⲥ	ϩⲁⲉⲓⲃⲉⲥ
ϩⲁⲉⲓ	ϩⲁⲉⲓ
ϩⲁⲉⲟⲩ	ϩⲁⲉⲟⲩ
ϩⲁⲉ	ϩⲁⲉ
ϩⲁⲏ̄	ϩⲁⲏ
ϩⲁⲏ	ϩⲁⲏ
ϩⲁⲑⲏ	ϩⲁⲑⲏ
ϩⲁⲓ̈	ϩⲁⲓ
ϩⲁⲓⲣⲉⲥⲓⲥ	ϩⲁⲓⲣⲉⲥⲓⲥ
ϩⲁⲓⲣⲉⲧⲓ̈ⲕⲟⲥ	ϩⲁⲓⲣⲉⲧⲓⲕⲟⲥ
ϩⲁⲓⲣⲉⲧⲓⲕⲟⲥ	ϩⲁⲓⲣⲉⲧⲓⲕⲟⲥ
ϩⲁⲓ	ϩⲁⲓ
ϩⲁⲗⲁⲁ̇ⲧⲉ	ϩⲁⲗⲁⲁⲧⲉ
ϩⲁⲗⲁⲁⲧⲉ	ϩⲁⲗⲁⲁⲧⲉ
ϩⲁⲗⲁⲧⲉ	ϩⲁⲗⲁⲧⲉ
ϩⲁⲗⲁⲧⲉ`	ϩⲁⲗⲁⲧⲉ
ϩⲁⲗⲏⲧ	ϩⲁⲗⲏⲧ
ϩⲁⲗⲩⲥⲓⲥ	ϩⲁⲗⲩⲥⲓⲥ
ϩⲁⲗ	ϩⲁⲗ
ϩⲁⲗ`	ϩⲁⲗ
ϩⲁⲙ̣[ⲟⲓ	ϩⲁⲙⲟⲓ
ϩⲁⲙϣⲉ	ϩⲁⲙϣⲉ
ϩⲁⲙⲏⲛ	ϩⲁⲙⲏⲛ
ϩⲁⲙⲕⲗⲗⲉ	ϩⲁⲙⲕⲗⲗⲉ
ϩⲁⲙⲕ︤ⲗ︥ⲗⲉ	ϩⲁⲙⲕⲗⲗⲉ
ϩⲁⲙⲟⲓ̈	ϩⲁⲙⲟⲓ
ϩⲁⲙⲟⲓ	ϩⲁⲙⲟⲓ
ϩⲁⲙ	ϩⲁⲙ
ϩⲁⲛⲉ	ϩⲁⲛⲉ
ϩⲁⲛ[ⲉ]	ϩⲁⲛⲉ
ϩⲁⲡⲥ̇	ϩⲁⲡⲥ
ϩⲁⲡⲥ	ϩⲁⲡⲥ
ϩⲁⲡ⳿	ϩⲁⲡ
ϩⲁⲡ	ϩⲁⲡ
ϩⲁⲣ̣ⲉϩ	ϩⲁⲣⲉϩ
ϩⲁⲣϣϩⲏⲧ	ϩⲁⲣϣϩⲏⲧ
ϩⲁⲣⲁⲧ︤	ϩⲁⲣⲁⲧ
ϩⲁⲣⲁⲧ	ϩⲁⲣⲁⲧ
ϩⲁⲣⲉ̣[ϩ]	ϩⲁⲣⲉϩ
ϩⲁⲣⲉϩ̂	ϩⲁⲣⲉϩ
ϩⲁⲣⲉϩ⳿	ϩⲁⲣⲉϩ
ϩⲁⲣⲉϩ	ϩⲁⲣⲉϩ
ϩⲁⲣⲉϩ`	ϩⲁⲣⲉϩ
ϩⲁⲣⲓϩⲁⲣⲟ	ϩⲁⲣⲓϩⲁⲣⲟ
ϩⲁⲣⲙⲁ	ϩⲁⲣⲙⲁ
ϩⲁⲣⲟ	ϩⲁⲣⲟ
ϩⲁⲣⲱ	ϩⲁⲣⲱ
ϩⲁⲣ︤ϣ̣︥ϩⲏⲧ	ϩⲁⲣϣϩⲏⲧ
ϩⲁⲣ︤ϣ︥ϩⲏⲧ⳿	ϩⲁⲣϣϩⲏⲧ
ϩⲁⲣ[ⲟ	ϩⲁⲣⲟ
ϩⲁⲧ̣︤ⲛ	ϩⲁⲧⲛ
ϩⲁⲧⲉ	ϩⲁⲧⲉ
ϩⲁⲧⲏ̂	ϩⲁⲧⲏ
ϩⲁⲧⲏ̇	ϩⲁⲧⲏ
ϩⲁⲧⲏⲩ	ϩⲁⲧⲏⲩ
ϩⲁⲧⲏ	ϩⲁⲧⲏ
ϩⲁⲧⲙ̇	ϩⲁⲧⲙ
ϩⲁⲧⲙ	ϩⲁⲧⲙ
ϩⲁⲧⲛ̣	ϩⲁⲧⲛ
ϩⲁⲧⲛ	ϩⲁⲧⲛ
ϩⲁⲧ︤ⲛ︥	ϩⲁⲧⲛ
ϩⲁⲧ	ϩⲁⲧ
ϩⲁⲧ]	ϩⲁⲧ
ϩⲁ	ϩⲁ
ϩⲁ[ϩ	ϩⲁϩ
ϩⲁ]ⲧ︤ⲛ︥	ϩⲁⲧⲛ
ϩⲃ̄ⲥⲱ	ϩⲃⲥⲱ
ϩⲃⲃⲉ	ϩⲃⲃⲉ
ϩⲃⲏⲟⲩⲉ	ϩⲃⲏⲟⲩⲉ
ϩⲃⲏⲟⲩⲉ`	ϩⲃⲏⲩⲉ
ϩⲃⲏⲩⲉ	ϩⲃⲏⲩⲉ
ϩⲃⲏⲩⲉ`	ϩⲃⲏⲩⲉ
ϩⲃⲟⲣⲃⲣ	ϩⲃⲟⲣⲃⲣ
ϩⲃⲟⲣⲃ︤ⲣ︥	ϩⲃⲟⲣⲃⲣ
ϩⲃⲟⲩⲣ	ϩⲃⲟⲩⲣ
ϩⲃⲥⲱ	ϩⲃⲥⲱ
ϩⲃⲥ	ϩⲃⲥ
ϩⲉ̣ⲛ	ϩⲉⲛ
ϩⲉϫϩⲱϫ	ϩⲉϫϩⲱϫ
ϩⲉⲃⲱⲱⲛ	ϩⲉⲃⲱⲱⲛ
ϩⲉⲑⲛⲓⲕⲟⲥ	ϩⲉⲑⲛⲓⲕⲟⲥ
ϩⲉⲑⲛⲓⲕⲟⲥ`	ϩⲉⲑⲛⲓⲕⲟⲥ
ϩⲉⲑⲛⲟⲥ⳿	ϩⲉⲑⲛⲟⲥ
ϩⲉⲑⲛⲟⲥ	ϩⲉⲑⲛⲟⲥ
ϩⲉⲑⲛⲟⲥ`	ϩⲉⲑⲛⲟⲥ
ϩⲉⲓϫⲙ	ϩⲓϫⲙ
ϩⲉⲓⲣ	ϩⲉⲓⲣ
ϩⲉⲓ	ϩⲓ
ϩⲉⲕⲉ	ϩⲉⲕⲉ
ϩⲉⲗⲗⲏⲛ⳿	ϩⲉⲗⲗⲏⲛ
ϩⲉⲗⲗⲏⲛ	ϩⲉⲗⲗⲏⲛ
ϩⲉⲗⲗⲏ	ϩⲉⲗⲗⲏⲛ
ϩⲉⲗⲡⲓⲍⲉ⳿	ϩⲉⲗⲡⲓⲍⲉ
ϩⲉⲗⲡⲓⲍⲉ	ϩⲉⲗⲡⲓⲍⲉ
ϩⲉⲗⲡⲓⲥ⳿	ϩⲉⲗⲡⲓⲥ
ϩⲉⲗⲡⲓⲥ	ϩⲉⲗⲡⲓⲥ
ϩⲉⲛ̣	ϩⲉⲛ
ϩⲉⲛⲁⲧⲟⲛ	ϩⲉⲛⲁⲧⲟⲛ
ϩⲉⲛⲉⲉⲧⲉ	ϩⲉⲛⲉⲉⲧⲉ
ϩⲉⲛⲉⲉⲧⲏ	ϩⲉⲛⲉⲉⲧⲏ
ϩⲉⲛ	ϩⲉⲛ
ϩⲉⲡ⳿	ϩⲉⲡ
ϩⲉⲡ	ϩⲉⲡ
ϩⲉⲣⲙⲁⲛ	ϩⲉⲣⲙⲁⲛ
ϩⲉⲣⲙⲉⲛⲉⲩⲉ	ϩⲉⲣⲙⲉⲛⲉⲩⲉ
ϩⲉⲣⲙⲏⲛⲉⲩⲉ	ϩⲉⲣⲙⲏⲛⲉⲩⲉ
ϩⲉⲣⲙⲏⲛⲓⲁ	ϩⲉⲣⲙⲏⲛⲉⲓⲁ
ϩⲉⲣⲙⲏⲥ	ϩⲉⲣⲙⲏⲥ
ϩⲉⲻ	ϩⲉⲛ
ϩⲉ⳯	ϩⲉⲛ
ϩⲉ⳿	ϩⲉ
ϩⲉ	ϩⲉ
ϩⲉ`	ϩⲉ
ϩⲏ̣ⲧ	ϩⲏⲧ
ϩⲏ̣[ⲧ]	ϩⲏⲧ
ϩⲏϭⲉ	ϩⲏϭⲉ
ϩⲏⲃⲥ	ϩⲏⲃⲥ
ϩⲏⲃ︤ⲥ︥	ϩⲏⲃⲥ
ϩⲏⲃ︤ⲥ︥`	ϩⲏⲃⲥ
ϩⲏⲅⲉⲙⲱⲛ	ϩⲏⲅⲉⲙⲱⲛ
ϩⲏⲅⲉⲙⲱⲛ`	ϩⲏⲅⲉⲙⲱⲛ
ϩⲏⲏ̇ⲧⲉ	ϩⲏⲏⲧⲉ
ϩⲏⲏⲛⲉ	ϩⲏⲏⲛⲉ
ϩⲏⲏⲛⲉ`	ϩⲏⲏⲛⲉ
ϩⲏⲏⲧⲉ	ϩⲏⲏⲧⲉ
ϩⲏⲕⲉ⳿	ϩⲏⲕⲉ
ϩⲏⲕⲉ	ϩⲏⲕⲉ
ϩⲏⲗⲉⲓⲁⲥ	ϩⲏⲗⲉⲓⲁⲥ
ϩⲏⲗⲉⲓ⳿	ϩⲏⲗⲉⲓ
ϩⲏⲗⲉⲓ	ϩⲏⲗⲉⲓ
ϩⲏⲙ	ϩⲏⲙ
ϩⲏⲛⲉ	ϩⲏⲛⲉ
ϩⲏⲛ	ϩⲏⲛ
ϩⲏⲡⲟⲕⲣⲏⲥⲓⲥ	ϩⲩⲡⲟⲕⲣⲓⲥⲓⲥ
ϩⲏⲡ⳿	ϩⲏⲡ
ϩⲏⲡ	ϩⲏⲡ
ϩⲏⲣⲱⲇⲏⲥ	ϩⲏⲣⲱⲇⲏⲥ
ϩⲏⲣⲱⲇⲓⲁⲛⲟⲥ	ϩⲏⲣⲱⲇⲓⲁⲛⲟⲥ
ϩⲏⲣⲱⲇⲓⲁⲥ	ϩⲏⲣⲱⲇⲓⲁⲥ
ϩⲏⲧⲛ	ϩⲏⲧⲛ
ϩⲏⲧ⳿	ϩⲏⲧ
ϩⲏⲧ︤ⲛ︥	ϩⲏⲧⲛ
ϩⲏⲧ︤ⲛ︥`	ϩⲏⲧⲛ
ϩⲏⲧ︤	ϩⲏⲧ
ϩⲏⲧ	ϩⲏⲧ
ϩⲏⲧ`	ϩⲏⲧ
ϩⲏⲩ	ϩⲏⲩ
ϩⲏ⳿	ϩⲏ
ϩⲏ	ϩⲏ
ϩⲏ..ⲉ	ϩⲏ[..]ⲉ
ϩⲏ[..]ⲉ̣	ϩⲏ[..]ⲉ
ϩⲓ̄ⲧⲟⲩⲱ̂ⲱ	ϩⲓⲧⲟⲩⲱⲱ
ϩⲓ̄	ϩⲓ
ϩⲓ̇̇ⲥⲉ	ϩⲓⲥⲉ
ϩⲓ̇ϩⲟⲩⲛ	ϩⲓϩⲟⲩⲛ
ϩⲓ̇ϫⲙ̇	ϩⲓϫⲙ
ϩⲓ̇ⲃⲟⲗ	ϩⲓⲃⲟⲗ
ϩⲓ̇ⲏ̇	ϩⲓⲏ
ϩⲓ̇ⲥⲉ	ϩⲓⲥⲉ
ϩⲓ̇ⲧⲙ̇	ϩⲓⲧⲙ
ϩⲓ̇ⲧⲛ̇	ϩⲓⲧⲛ
ϩⲓ̇ⲧⲟⲟ̇ⲧ	ϩⲓⲧⲟⲟⲧ
ϩⲓ̇ⲧⲟⲟⲧ	ϩⲓⲧⲟⲟⲧ
ϩⲓ̇ⲧⲟⲩⲱ	ϩⲓⲧⲟⲩⲱ
ϩⲓ̇ⲱ̇ⲱ	ϩⲓⲱⲱ
ϩⲓ̇ⲱⲱ	ϩⲓⲱⲱ
ϩⲓ̇	ϩⲓ
ϩⲓ̈ϫⲙ̄	ϩⲓϫⲙ
ϩⲓ̈ϫⲙ̇	ϩⲓϫⲙ
ϩⲓ̈ϫⲙ	ϩⲓϫⲙ
ϩⲓ̈ϫⲛ̄	ϩⲓϫⲛ
ϩⲓ̈ϫⲱ	ϩⲓϫⲱ
ϩⲓ̈ϫ︤ⲙ︥	ϩⲓϫⲙ
ϩⲓ̈ⲥⲉ	ϩⲓⲥⲉ
ϩⲓ̈ⲧ︤ⲛ︥	ϩⲓⲧⲛ
ϩⲓϩⲏ	ϩⲓϩⲏ
ϩⲓϩⲟⲩⲛ	ϩⲓϩⲟⲩⲛ
ϩⲓϩⲣⲁ	ϩⲓϩⲣⲁ
ϩⲓϫⲙ̄	ϩⲓϫⲙ
ϩⲓϫⲙ	ϩⲓϫⲙ
ϩⲓϫⲛ̄	ϩⲓϫⲛ
ϩⲓϫⲛ̇	ϩⲓϫⲛ
ϩⲓϫⲛ	ϩⲓϫⲛ
ϩⲓϫⲱ	ϩⲓϫⲱ
ϩⲓϫ︤ⲙ︥	ϩⲓϫⲙ
ϩⲓϫ︤ⲛ︥	ϩⲓϫⲛ
ϩⲓⲁⲃⲉ	ϩⲓⲁⲃⲉ
ϩⲓⲁⲉⲓⲃⲉ	ϩⲓⲁⲉⲓⲃⲉ
ϩⲓⲁⲓⲃⲉ	ϩⲓⲉⲓⲃ
ϩⲓⲃⲟⲗ	ϩⲓⲃⲟⲗ
ϩⲓⲃⲱ	ϩⲓⲃⲱ
ϩⲓⲇⲓⲱⲧⲏⲥ	ϩⲓⲇⲓⲱⲧⲏⲥ
ϩⲓⲉⲓⲧ	ϩⲓⲉⲓⲧ
ϩⲓⲉⲣⲉⲩⲥ̇	ϩⲓⲉⲣⲉⲩⲥ
ϩⲓⲉⲣⲉⲩⲥ	ϩⲓⲉⲣⲉⲩⲥ
ϩⲓⲉⲣⲓⲭⲱ	ϩⲓⲉⲣⲓⲭⲱ
ϩⲓⲉⲣⲟⲥⲟⲗⲩⲙⲁ	ϩⲓⲉⲣⲟⲩⲥⲁⲗⲏⲙ
ϩⲓⲏ	ϩⲓⲏ
ϩⲓⲕⲁⲛⲟⲥ	ϩⲓⲕⲁⲛⲟⲥ
ϩⲓⲕⲱⲛ	ϩⲓⲕⲱⲛ
ϩⲓⲕⲱⲛ`	ϩⲓⲕⲱⲛ
ϩⲓⲙⲉ	ϩⲓⲙⲉ
ϩⲓⲛⲁⲓ	ϩⲓⲛⲁⲓ
ϩⲓⲛⲏⲃ	ϩⲓⲛⲏⲃ
ϩⲓⲟⲙⲉ	ϩⲓⲟⲙⲉ
ϩⲓⲟⲙⲉ`	ϩⲓⲟⲙⲉ
ϩⲓⲟⲙⲟⲓⲱⲥ	ϩⲟⲙⲟⲓⲱⲥ
ϩⲓⲟⲛⲉ	ϩⲓⲟⲛⲉ
ϩⲓⲟⲛⲉ`	ϩⲓⲟⲛⲉ
ϩⲓⲟⲟⲩⲉ	ϩⲓⲟⲟⲩⲉ
ϩⲓⲟⲩⲉ	ϩⲓⲟⲩⲉ
ϩⲓⲡⲉⲥⲏⲧ	ϩⲓⲡⲉⲥⲏⲧ
ϩⲓⲣⲙ̄	ϩⲓⲣⲙ
ϩⲓⲣⲙ	ϩⲓⲣⲙ
ϩⲓⲣⲛ	ϩⲓⲣⲛ
ϩⲓⲣ	ϩⲓⲣ
ϩⲓⲥⲉ⳿	ϩⲓⲥⲉ
ϩⲓⲥⲉ	ϩⲓⲥⲉ
ϩⲓⲥⲉ`	ϩⲓⲥⲉ
ϩⲓⲧⲉ	ϩⲓⲧⲉ
ϩⲓⲧⲙ̄	ϩⲓⲧⲙ
ϩⲓⲧⲙ̇	ϩⲓⲧⲙ
ϩⲓⲧⲙ	ϩⲓⲧⲙ
ϩⲓⲧⲛ̄	ϩⲓⲧⲛ
ϩⲓⲧⲛ	ϩⲓⲧⲛ
ϩⲓⲧⲟⲟ̇ⲧ	ϩⲓⲧⲟⲟⲧ
ϩⲓⲧⲟⲟⲧ︤	ϩⲓⲧⲟⲟⲧ
ϩⲓⲧⲟⲟⲧ	ϩⲓⲧⲟⲟⲧ
ϩⲓⲧⲟⲟ[ⲧ]	ϩⲓⲧⲟⲟⲧ
ϩⲓⲧⲟⲩⲛ̄	ϩⲓⲧⲟⲩⲛ
ϩⲓⲧⲟⲩⲛ	ϩⲓⲧⲟⲩⲛ
ϩⲓⲧⲟⲩⲱ̂ⲱ	ϩⲓⲧⲟⲩⲱⲱ
ϩⲓⲧⲟⲩⲱ̇	ϩⲓⲧⲟⲩⲱ
ϩⲓⲧⲟⲩⲱⲱ	ϩⲓⲧⲟⲩⲱⲱ
ϩⲓⲧⲟⲩⲱ	ϩⲓⲧⲟⲩⲱ
ϩⲓⲧ︤ⲙ︥	ϩⲓⲧⲙ
ϩⲓⲧ︤ⲛ̣︥	ϩⲓⲧⲛ
ϩⲓⲧ︤ⲛ︥	ϩⲓⲧⲛ
ϩⲓⲧ︤ⲛ︥]	ϩⲓⲧⲛ
ϩⲓⲧ[ⲟⲟⲧ	ϩⲓⲧⲟⲟⲧ
ϩⲓⲱ̄ⲱ	ϩⲓⲱⲱ
ϩⲓⲱⲧ	ϩⲓⲱⲧ
ϩⲓⲱⲱⲧ	ϩⲓⲱⲱⲧ
ϩⲓⲱⲱ	ϩⲓⲱⲱ
ϩⲓⲱ	ϩⲓⲱ
ϩⲓ	ϩⲓ
ϩⲓ]ϫⲛ	ϩⲓϫⲛ
ϩⲕⲁⲉⲓⲧ⳿	ϩⲕⲁⲉⲓⲧ
ϩⲕⲁⲉⲓⲧ	ϩⲕⲁⲉⲓⲧ
ϩⲕⲟ	ϩⲕⲟ
ϩⲗ̄ⲗⲟⲉⲓ	ϩⲗⲗⲟⲓ
ϩⲗ̇ⲗⲟ	ϩⲗⲗⲟ
ϩⲗⲗ̣ⲟ	ϩⲗⲗⲟ
ϩⲗⲗⲟ̇	ϩⲗⲗⲟ
ϩⲗⲗⲟⲉⲓ	ϩⲗⲗⲟⲓ
ϩⲗⲗⲟ⳿	ϩⲗⲗⲟ
ϩⲗⲗⲟ	ϩⲗⲗⲟ
ϩⲗⲗⲱ	ϩⲗⲗⲱ
ϩⲗⲟϭ	ϩⲗⲟϭ
ϩⲗⲟⲟⲗⲉ	ϩⲗⲟⲟⲗⲉ
ϩⲗⲟⲡⲗⲡ	ϩⲗⲟⲡⲗⲡ
ϩⲗⲡⲗⲱⲡ	ϩⲗⲡⲗⲱⲡ
ϩⲙ̄ϩⲁⲗ	ϩⲙϩⲁⲗ
ϩⲙ̄ϫ	ϩⲙϫ
ϩⲙ̄ⲡϩⲟϫϩⲉϫ	ϩⲟϫϩϫ
ϩⲙ̄	ϩⲙ
ϩⲙ̇ⲟⲟ̇ⲥ	ϩⲙⲟⲟⲥ
ϩⲙ̇ⲟⲟⲥ	ϩⲙⲟⲟⲥ
ϩⲙ̇	ϩⲙ
ϩⲙϩⲁⲗ	ϩⲙϩⲁⲗ
ϩⲙϩⲙ	ϩⲙϩⲙ
ϩⲙϫ	ϩⲙϫ
ϩⲙⲉ⳿	ϩⲙⲉ
ϩⲙⲉ	ϩⲙⲉ
ϩⲙⲟⲙ	ϩⲙⲟⲙ
ϩⲙⲟⲟ̇ⲥ	ϩⲙⲟⲟⲥ
ϩⲙⲟⲟⲥ̄	ϩⲙⲟⲟⲥ
ϩⲙⲟⲟⲥ	ϩⲙⲟⲟⲥ
ϩⲙⲟⲟ	ϩⲙⲟⲟ
ϩⲙⲟⲧ⳿	ϩⲙⲟⲧ
ϩⲙⲟⲧ	ϩⲙⲟⲧ
ϩⲙⲟⲩ	ϩⲙⲟⲩ
ϩⲙⲡϩⲟϫϩⲉϫ	ϩⲟϫϩϫ
ϩⲙⲥ	ϩⲙⲥ
ϩⲙ︥ϩⲁⲗ`	ϩⲙϩⲁⲗ
ϩⲙ︥	ϩⲙ
ϩⲙ	ϩⲙ
ϩⲛ̄	ϩⲛ
ϩⲛ̇ⲕⲟⲟⲩⲉ̇	ⲕⲟⲟⲩⲉ
ϩⲛ̇	ϩⲛ
ϩⲛ̣	ϩⲛ
ϩⲛⲁⲁⲩ⳿	ϩⲛⲁⲁⲩ
ϩⲛⲁⲁⲩ	ϩⲛⲁⲁⲩ
ϩⲛⲁⲁⲩ`	ϩⲛⲁⲁⲩ
ϩⲛⲁⲩ	ϩⲛⲁⲩ
ϩⲛⲁⲩ`	ϩⲛⲁⲩ
ϩⲛⲁ	ϩⲛⲁ
ϩⲛⲏ	ϩⲛⲏ
ϩⲛⲕⲟⲟⲩⲉ	ⲕⲟⲟⲩⲉ
ϩⲛⲛ	ϩⲛ
ϩⲛⲟ̂	ϩⲛⲟ
ϩⲛⲟ⳿	ϩⲛⲟ
ϩⲛⲟ	ϩⲛⲟ
ϩⲛ︥	ϩⲛ
ϩⲛ	ϩⲛ
ϩⲛ]	ϩⲛ
ϩⲟ̂	ϩⲟ
ϩⲟϥ	ϩⲟϥ
ϩⲟϫϩϫ	ϩⲟϫϩϫ
ϩⲟϫ︤ϩ︥ϫ	ϩⲟϫϩϫ
ϩⲟⲃⲥ︤	ϩⲟⲃⲥ
ϩⲟⲃⲥ	ϩⲟⲃⲥ
ϩⲟⲃ︤ⲥ︥	ϩⲟⲃⲥ
ϩⲟⲉⲓ̈ⲙ	ϩⲟⲉⲓⲙ
ϩⲟⲉⲓⲙ	ϩⲟⲉⲓⲙ
ϩⲟⲉⲓⲛⲉ	ϩⲟⲉⲓⲛⲉ
ϩⲟⲉⲓⲧⲉ	ϩⲟⲉⲓⲧⲉ
ϩⲟⲓ̇ⲛⲉ	ϩⲟⲓⲛⲉ
ϩⲟⲓ̇ⲧⲉ	ϩⲟⲓⲧⲉ
ϩⲟⲓ̈ⲛⲉ	ϩⲟⲓⲛⲉ
ϩⲟⲓ̈ⲛⲉ`	ϩⲟⲓⲛⲉ
ϩⲟⲓ̈	ϩⲟⲓ
ϩⲟⲓⲛⲉ	ϩⲟⲓⲛⲉ
ϩⲟⲓⲧⲉ	ϩⲟⲉⲓⲧⲉ
ϩⲟⲓ	ϩⲟⲓ
ϩⲟⲗϭ̇	ϩⲟⲗϭ
ϩⲟⲗϭ	ϩⲟⲗϭ
ϩⲟⲗⲟⲕⲟⲧⲧⲓ̇ⲛⲟⲥ	ϩⲟⲗⲟⲕⲟⲧⲧⲓⲛⲟⲥ
ϩⲟⲗⲟⲕⲟⲧⲧⲓⲛⲟⲥ	ϩⲟⲗⲟⲕⲟⲧⲧⲓⲛⲟⲥ
ϩⲟⲗⲱⲥ⳿	ϩⲟⲗⲱⲥ
ϩⲟⲗⲱⲥ	ϩⲟⲗⲱⲥ
ϩⲟⲗ︤ϭ︥	ϩⲟⲗϭ
ϩⲟⲙⲛⲧ	ϩⲟⲙⲛⲧ
ϩⲟⲙⲟⲓⲱⲥ	ϩⲟⲙⲟⲓⲱⲥ
ϩⲟⲙⲟⲗⲟⲅⲉⲓⲁ	ϩⲟⲙⲟⲗⲟⲅⲉⲓⲁ
ϩⲟⲙⲟⲗⲟⲅⲉⲓ	ϩⲟⲙⲟⲗⲟⲅⲉⲓ
ϩⲟⲙⲟⲗⲟⲗⲉⲓ	ϩⲟⲙⲟⲗⲟⲅⲉⲓ
ϩⲟⲙⲧ	ϩⲟⲙⲧ
ϩⲟⲙ︤ⲧ︥	ϩⲟⲙⲧ
ϩⲟⲛ	ϩⲟⲛ
ϩⲟⲟⲕⲉ	ϩⲟⲟⲕⲉ
ϩⲟⲟⲗⲉ	ϩⲟⲟⲗⲉ
ϩⲟⲟⲣ	ϩⲟⲟⲣ
ϩⲟⲟⲩ̣`	ϩⲟⲟⲩ
ϩⲟⲟⲩϣ	ϩⲟⲟⲩϣ
ϩⲟⲟⲩⲧ	ϩⲟⲟⲩⲧ
ϩⲟⲟⲩⲧ`	ϩⲟⲟⲩⲧ
ϩⲟⲟⲩ⳿	ϩⲟⲟⲩ
ϩⲟⲟⲩ	ϩⲟⲟⲩ
ϩⲟⲟⲩ`	ϩⲟⲟⲩ
ϩⲟⲡⲗⲟⲛ	ϩⲟⲡⲗⲟⲛ
ϩⲟⲡⲟⲩ	ϩⲟⲡⲟⲩ
ϩⲟⲡⲥ̇	ϩⲁⲡⲥ
ϩⲟⲡⲥ	ϩⲁⲡⲥ
ϩⲟⲡ︤︥	ϩⲟⲡ
ϩⲟⲡ︤	ϩⲟⲡ
ϩⲟⲡ	ϩⲟⲡ
ϩⲟⲣϣ	ϩⲟⲣϣ
ϩⲟⲣⲡ	ϩⲟⲣⲡ
ϩⲟⲣ︤ϣ︥	ϩⲟⲣϣ
ϩⲟⲣ	ϩⲟⲣ
ϩⲟⲥⲉ	ϩⲟⲥⲉ
ϩⲟⲥⲟⲛ	ϩⲟⲥⲟⲛ
ϩⲟⲥⲟⲛ`	ϩⲟⲥⲟⲛ
ϩⲟⲥⲟ⳯	ϩⲟⲥⲟⲛ
ϩⲟⲧϩⲧ̇	ϩⲟⲧϩⲧ
ϩⲟⲧϩⲧ	ϩⲟⲧϩⲧ
ϩⲟⲧⲁⲛ	ϩⲟⲧⲁⲛ
ϩⲟⲧⲁⲛ`	ϩⲟⲧⲁⲛ
ϩⲟⲧⲃⲉ	ϩⲟⲧⲃⲉ
ϩⲟⲧⲉ	ϩⲟⲧⲉ
ϩⲟⲧⲉ`	ϩⲟⲧⲉ
ϩⲟⲧⲡ	ϩⲟⲧⲡ
ϩⲟⲩϩⲉ	ϩⲟⲩϩⲉ
ϩⲟⲩⲉⲓⲧⲉ	ϩⲟⲩⲉⲓⲧⲉ
ϩⲟⲩⲉ	ϩⲟⲩⲉ
ϩⲟⲩⲓⲧⲉ	ϩⲟⲩⲉⲓⲧⲉ
ϩⲟⲩⲙⲓⲥⲉ	ϩⲟⲩⲙⲓⲥⲉ
ϩⲟⲩⲛ̣	ϩⲟⲩⲛ
ϩⲟⲩⲛ	ϩⲟⲩⲛ
ϩⲟⲩⲟ̂	ϩⲟⲩⲟ
ϩⲟⲩⲟ̇	ϩⲟⲩⲟ
ϩⲟⲩⲟ⳿	ϩⲟⲩⲟ
ϩⲟⲩⲟ	ϩⲟⲩⲟ
ϩⲟⲩⲟ`	ϩⲟⲩⲟ
ϩⲟⲩ	ϩⲟⲩo
ϩⲟ	ϩⲟ
ϩⲣ̣ⲁ̣ⲓ̣	ϩⲣⲁⲓ
ϩⲣϣⲓⲣⲉ	ϩⲣϣⲓⲣⲉ
ϩⲣⲁϫⲣⲉϫ	ϩⲣⲁϫⲣⲉϫ
ϩⲣⲁⲃⲃⲉⲓ	ϩⲣⲁⲃⲃⲉⲓ
ϩⲣⲁⲃⲃⲟⲩⲛⲉⲓ	ϩⲣⲁⲃⲃⲟⲩⲛⲉⲓ
ϩⲣⲁⲓ̈	ϩⲣⲁⲓ
ϩⲣⲁⲓ	ϩⲣⲁⲓ
ϩⲣⲁⲙⲛⲟⲥ	ϩⲣⲁⲙⲛⲟⲥ
ϩⲣⲁⲭ̇ⲏⲗ	ϩⲣⲁⲭⲏⲗ
ϩⲣⲁⲭⲏⲗ	ϩⲣⲁⲭⲏⲗ
ϩⲣⲁⲭⲏⲗ`	ϩⲣⲁⲭⲏⲗ
ϩⲣⲁ	ϩⲣⲁ
ϩⲣⲃ	ϩⲣⲃ
ϩⲣⲉⲃⲉⲕⲕⲁ	ϩⲣⲉⲃⲉⲕⲕⲁ
ϩⲣⲉⲃⲉⲕⲕⲁ`	ϩⲣⲉⲃⲉⲕⲕⲁ
ϩⲣⲉ	ϩⲣⲉ
ϩⲣⲉ`	ϩⲣⲉ
ϩⲣⲏϭ	ϩⲣⲏϭ
ϩⲣⲟϣ	ϩⲣⲟϣ
ϩⲣⲟϣ`	ϩⲣⲟϣ
ϩⲣⲟⲕⲉⲩⲉ	ϩⲣⲟⲕⲉⲩⲉ
ϩⲣⲟⲙⲁⲓⲟⲥ	ϩⲣⲱⲙⲁⲓⲟⲥ
ϩⲣⲟⲙⲁⲛⲟⲥ	ϩⲣⲱⲙⲁⲛⲟⲥ
ϩⲣⲟⲟⲩ	ϩⲣⲟⲟⲩ
ϩⲣⲟⲩⲃⲃⲁⲉⲓ	ϩⲣⲟⲩⲃⲃⲁⲉⲓ
ϩⲣⲟⲩⲫⲟⲥ	ϩⲣⲟⲩⲫⲟⲥ
ϩⲣⲟⲩ	ϩⲣⲟⲩ
ϩⲣⲱ̂	ϩⲣⲱ
ϩⲣⲱⲙⲁⲓⲟⲥ	ϩⲣⲱⲙⲁⲓⲟⲥ
ϩⲣⲱⲙⲁⲛⲓⲁ	ϩⲣⲱⲙⲁⲛⲓⲁ
ϩⲣⲱⲙⲁⲛⲟⲥ	ϩⲣⲱⲙⲁⲛⲟⲥ
ϩⲣⲱ	ϩⲣⲱ
ϩⲧⲏ︤	ϩⲧⲏ
ϩⲧⲏ	ϩⲧⲏ
ϩⲧⲟ̂	ϩⲧⲟ
ϩⲧⲟⲟⲩⲉ	ϩⲧⲟⲟⲩⲉ
ϩⲧⲟⲟⲩ	ϩⲧⲟⲟⲩ
ϩⲧⲟⲣ	ϩⲧⲟⲣ
ϩⲧⲟ	ϩⲧⲟ
ϩⲨⲗⲏ	ϩⲩⲗⲏ
ϩⲩⲇⲟⲛⲏ	ϩⲏⲇⲟⲛⲏ
ϩⲩⲙⲛⲟⲥ	ϩⲩⲙⲛⲟⲥ
ϩⲩⲡⲁⲣⲭⲟⲛⲧⲁ	ϩⲩⲡⲁⲣⲭⲟⲛⲧⲁ
ϩⲩⲡⲁⲣⲭⲟⲛⲧⲁ`	ϩⲩⲡⲁⲣⲭⲟⲛⲧⲁ
ϩⲩⲡⲁⲣⲭⲟ⳯ⲧⲁ	ϩⲩⲡⲁⲣⲭⲟⲛⲧⲁ
ϩⲩⲡⲉⲣⲉⲥⲓⲁ	ϩⲩⲡⲉⲣⲉⲥⲓⲁ
ϩⲩⲡⲉⲣⲉⲭⲓ̇ⲟⲥ	ϩⲩⲡⲉⲣⲉⲭⲓⲟⲥ
ϩⲩⲡⲉⲣⲉⲭⲓⲟⲥ	ϩⲩⲡⲉⲣⲉⲭⲓⲟⲥ
ϩⲩⲡⲏⲣⲉⲧⲏⲥ	ϩⲩⲡⲏⲣⲉⲧⲏⲥ
ϩⲩⲡⲏⲣⲉⲭⲓⲟⲥ	ϩⲩⲡⲏⲣⲉⲭⲓⲟⲥ
ϩⲩⲡⲟⲕⲣⲓ̇ⲛⲉ	ϩⲩⲡⲟⲕⲣⲓⲛⲉ
ϩⲩⲡⲟⲕⲣⲓ̈ⲥⲓⲥ	ϩⲩⲡⲟⲕⲣⲓⲥⲓⲥ
ϩⲩⲡⲟⲕⲣⲓⲛⲉ	ϩⲩⲡⲟⲕⲣⲓⲛⲉ
ϩⲩⲡⲟⲕⲣⲓⲥⲓⲥ̣	ϩⲩⲡⲟⲕⲣⲓⲥⲓⲥ
ϩⲩⲡⲟⲕⲣⲓⲥⲓⲥ	ϩⲩⲡⲟⲕⲣⲓⲥⲓⲥ
ϩⲩⲡⲟⲕⲣⲓⲥⲓⲥ`	ϩⲩⲡⲟⲕⲣⲓⲥⲓⲥ
ϩⲩⲡⲟⲕⲣⲓⲧⲏⲥ	ϩⲩⲡⲟⲕⲣⲓⲧⲏⲥ
ϩⲩⲡⲟⲕⲣⲓⲧⲏⲥ`	ϩⲩⲡⲟⲕⲣⲓⲧⲏⲥ
ϩⲩⲡⲟⲙⲓ̇ⲛⲉ	ϩⲩⲡⲟⲙⲓⲛⲉ
ϩⲩⲡⲟⲙⲓⲛⲉ	ϩⲩⲡⲟⲙⲓⲛⲉ
ϩⲩⲡⲟⲙⲓⲛⲉ`	ϩⲩⲡⲟⲙⲓⲛⲉ
ϩⲩⲡⲟⲙⲟⲛⲏ	ϩⲩⲡⲟⲙⲟⲛⲏ
ϩⲩⲡⲟⲥⲧⲁⲥⲓ̣ⲥ̣	ϩⲩⲡⲟⲥⲧⲁⲥⲓⲥ
ϩⲩⲡⲟⲥⲧⲁⲥⲓⲥ	ϩⲩⲡⲟⲥⲧⲁⲥⲓⲥ
ϩⲩⲡⲟⲧⲁⲅⲏ	ϩⲩⲡⲟⲧⲁⲅⲏ
ϩⲩⲡⲟⲧⲁⲥⲥⲉ	ϩⲩⲡⲟⲧⲁⲥⲥⲉ
ϩⲱ̂	ϩⲱ
ϩⲱ̇ⲱ̇	ϩⲱⲱ
ϩⲱ̇ⲱ	ϩⲱⲱ
ϩⲱ̣ⲛ	ϩⲱⲛ
ϩⲱϫⲉ	ϩⲱϫⲉ
ϩⲱϫⲡ	ϩⲱϫⲡ
ϩⲱϭⲃ	ϩⲱϭⲃ
ϩⲱϭⲥ	ϩⲱⲥ
ϩⲱⲂ	ϩⲱⲃ
ϩⲱⲃⲥ̄	ϩⲱⲃⲥ
ϩⲱⲃⲥ	ϩⲱⲃⲥ
ϩⲱⲃ⳿	ϩⲱⲃ
ϩⲱⲃ︤ⲥ︥	ϩⲱⲃⲥ
ϩⲱⲃ	ϩⲱⲃ
ϩⲱⲃ`	ϩⲱⲃ
ϩⲱⲗϭ	ϩⲱⲗϭ
ϩⲱⲗ︤ϭ︥	ϩⲱⲗϭ
ϩⲱⲙ	ϩⲱⲙ
ϩⲱⲛ	ϩⲱⲛ
ϩⲱⲟⲩ	ϩⲱⲟⲩ
ϩⲱⲟⲩ`	ϩⲱⲟⲩ
ϩⲱⲡ⳿	ϩⲱⲡ
ϩⲱⲡ	ϩⲱⲡ
ϩⲱⲡ`	ϩⲱⲡ
ϩⲱⲣⲡ	ϩⲱⲣⲡ
ϩⲱⲣⲥⲓ̇ⲏⲥⲓ̈	ϩⲱⲣⲥⲓⲏⲥⲓ
ϩⲱⲣⲥⲓⲏⲥⲓ	ϩⲱⲣⲥⲓⲏⲥⲓ
ϩⲱⲣ︤ⲡ︥	ϩⲱⲣⲡ
ϩⲱⲥⲟⲛ	ϩⲱⲥⲟⲛ
ϩⲱⲥⲧⲉ⳿	ϩⲱⲥⲧⲉ
ϩⲱⲥⲧⲉ	ϩⲱⲥⲧⲉ
ϩⲱⲥⲧⲉ`	ϩⲱⲥⲧⲉ
ϩⲱⲥ⳿	ϩⲱⲥ
ϩⲱⲥ	ϩⲱⲥ
ϩⲱⲧⲃ	ϩⲱⲧⲃ
ϩⲱⲧⲡ	ϩⲱⲧⲡ
ϩⲱⲧ︤ⲃ︥	ϩⲱⲧⲃ
ϩⲱⲧ︤ⲡ︥	ϩⲱⲧⲡ
ϩⲱⲧ	ϩⲱⲧ
ϩⲱⲰ	ϩⲱⲱ
ϩⲱⲱⲥ	ϩⲱⲱⲥ
ϩⲱⲱ	ϩⲱⲱ
ϩⲱ	ϩⲱ
ϩ︤ⲗ̣︥[ⲗⲟ]	ϩⲗⲗⲟ
ϩ︤ⲗ︥ⲗⲟ	ϩⲗⲗⲟ
ϩ︤ⲗ︥ⲗⲟ`	ϩⲗⲗⲟ
ϩ︤ⲗ︥ⲗⲱ̂	ϩⲗⲗⲱ
ϩ︤ⲗ︥ⲗⲱ	ϩⲗⲗⲱ
ϩ︤ⲙ︥ϩⲁⲗ	ϩⲙϩⲁⲗ
ϩ︤ⲙ︥ϩⲁⲗ]	ϩⲙϩⲁⲗ
ϩ︤ⲙ︥ϩⲁⲗ`	ϩⲙϩⲁⲗ
ϩ︤ⲙ︥ϩ︤ⲙ︥	ϩⲙϩⲙ
ϩ︤ⲙ︥ⲟⲧ	ϩⲙⲟⲧ
ϩ︤ⲙ︥ⲟⲧ`	ϩⲙⲟⲧ
ϩ︤ⲙ︥	ϩⲙ
ϩ︤ⲛ̣︥	ϩⲛ
ϩ︤ⲛ︥ⲁ	ϩⲛⲁ
ϩ︤ⲛ︥ⲛ︤	ϩⲛ
ϩ︤ⲛ︥	ϩⲛ
ϩ︤ⲛ	ϩⲛ
ϩ︤︥ⲙ	ϩⲙ
ϩ︤︥ⲛ	ϩⲛ
ϩ︥ⲗⲟⲡⲗ[ⲡ	ϩⲗⲟⲡⲗⲡ
ϩ︦ⲗ︥ⲗⲟ`	ϩⲗⲗⲟ
ϩ︦ⲙ︥ϩⲁⲗ	ϩⲙϩⲁⲗ
ϩ︦ⲛ︥	ϩⲛ
ϩ...	ϩ...
ϩ[...]	ϩ...
ϪⲈ	ϫⲉ
Ϫⲉⲕⲁⲥ	ϫⲉⲕⲁⲁⲥ
ϪⲞⲨⲦⲤⲀϢϤⲈ	ϫⲟⲩⲧⲥⲁϣϥⲉ
ϪⲰⲔ	ϫⲱⲕ
ϫ̇ⲉ	ϫⲉ
ϫ̇ⲛⲉ	ϫⲛⲉ
ϫ̇ⲛⲟⲩ	ϫⲛⲟⲩ
ϫ̇ⲟⲟ̇	ϫⲟⲟ
ϫ̇ⲡⲉ	ϫⲡⲉ
ϫ̇ⲡⲟ	ϫⲡⲟ
ϫ̇ⲣⲟⲡ	ϫⲣⲟⲡ
ϫ̣ⲉⲣⲟ	ϫⲉⲣⲟ
ϫ̣ⲓ̣	ϫⲓ
ϫ̣ⲓϩⲣⲁ̣ϥ	ϫⲓϩⲣⲁϥ
ϫ̣ⲓⲛ	ϫⲓⲛ
ϫ̣ⲡ̣ⲟ	ϫⲡⲟ
ϫ̣ⲡⲉ	ϫⲡⲉ
ϫ̣ⲱⲱⲙⲉ	ϫⲱⲱⲙⲉ
ϫ̣ⲱ	ϫⲱ
ϫ̣[ⲟⲉⲓⲥ]	ϫⲟⲉⲓⲥ
ϫ⟨ⲉ⟩	ϫⲉ
ϫⲁϩⲙ	ϫⲁϩⲙ
ϫⲁϩ︤ⲙ︥	ϫⲁϩⲙ
ϫⲁϫⲉⲉⲩ	ϫⲁϫⲉⲉⲩ
ϫⲁϫⲉ	ϫⲁϫⲉ
ϫⲁϫⲉ`	ϫⲁϫⲉ
ϫⲁⲉⲓⲉ	ϫⲁⲉⲓⲉ
ϫⲁⲓ̇ⲉ̇	ϫⲁⲓⲉ
ϫⲁⲓ̈ⲉ	ϫⲁⲓⲉ
ϫⲁⲓⲃⲉⲕⲉ	ϫⲁⲓⲃⲉⲕⲉ
ϫⲁⲓⲉ	ϫⲁⲓⲉ
ϫⲁⲙⲏ	ϫⲁⲙⲏ
ϫⲁⲥⲓϩⲏⲧ	ϫⲁⲥⲓϩⲏⲧ
ϫⲁⲥ	ϫⲁⲥ
ϫⲁⲩⲙⲟⲉⲓⲧ	ϫⲁⲩⲙⲟⲉⲓⲧ
ϫⲃⲃⲉⲥ	ϫⲃⲃⲉⲥ
ϫⲉ̇	ϫⲉ
ϫⲉ̣	ϫⲉ
ϫⲉⲕⲁⲁⲥ	ϫⲉⲕⲁⲁⲥ
ϫⲉⲕⲁⲥ	ϫⲉⲕⲁⲥ
ϫⲉⲕⲁⲥ`	ϫⲉⲕⲁⲥ
ϫⲉⲕⲙ	ϫⲉⲕⲙ
ϫⲉⲕ︤ⲙ︥	ϫⲉⲕⲙ
ϫⲉⲕ	ϫⲉⲕ
ϫⲉⲛⲁ	ϫⲉⲛⲁ
ϫⲉⲛⲉⲡⲱⲣ	ϫⲉⲛⲉⲡⲱⲣ
ϫⲉⲛⲟⲩ	ϫⲉⲛⲟⲩ
ϫⲉⲣⲉ	ϫⲉⲣⲉ
ϫⲉⲣⲟ̂	ϫⲉⲣⲟ
ϫⲉⲣⲟ	ϫⲉⲣⲟ
ϫⲉⲣⲱ	ϫⲉⲣⲱ
ϫⲉⲩ	ϫⲉⲩ
ϫⲉ⳿	ϫⲉ
ϫⲉ	ϫⲉ
ϫⲉ`	ϫⲉ
ϫⲏ̣	ϫⲏ
ϫⲏϭⲉ	ϫⲏϭⲉ
ϫⲏⲏⲥ	ϫⲏⲏⲥ
ϫⲏⲕ	ϫⲏⲕ
ϫⲏⲣ	ϫⲏⲣ
ϫⲏ⳿	ϫⲏ
ϫⲏ	ϫⲏ
ϫⲓ̂ϫⲣⲟⲡ	ϫⲓϫⲣⲟⲡ
ϫⲓ̂	ϫⲓ
ϫⲓ̇ϣ̇ⲕⲁⲕ	ϫⲓϣⲕⲁⲕ
ϫⲓ̇ϫⲱⲓ̇	ϫⲓϫⲱⲓ
ϫⲓ̇ϫⲱⲓ	ϫⲓϫⲱⲓ
ϫⲓ̇ⲉⲟⲟⲩ	ϫⲓⲉⲟⲟⲩ
ϫⲓ̇ⲕⲱⲧ	ϫⲓⲕⲱⲧ
ϫⲓ̇ⲛ	ϫⲓⲛ
ϫⲓ̇ⲟⲩⲉ̇	ϫⲓⲟⲩⲉ
ϫⲓ̇ⲧ	ϫⲓⲧ
ϫⲓ̇	ϫⲓ
ϫⲓ̈	ϫⲓ
ϫⲓϣⲁϫⲉ	ϫⲓϣⲁϫⲉ
ϫⲓϣⲓⲡⲉ	ϫⲓϣⲓⲡⲉ
ϫⲓϣⲕⲁⲕ	ϫⲓϣⲕⲁⲕ
ϫⲓϣⲟϫⲛⲉ	ϫⲓϣⲟϫⲛⲉ
ϫⲓϥⲟϭⲥ	ϫⲓϥⲟϭⲥ
ϫⲓϥⲟϭ︤ⲥ︥	ϫⲓϥⲟϭⲥ
ϫⲓϩⲁⲓ	ϫⲓϩⲁⲓ
ϫⲓϩⲁⲡ̂	ϫⲓϩⲁⲡ
ϫⲓϩⲁⲡ	ϫⲓϩⲁⲡ
ϫⲓϩⲓⲙⲉ	ϫⲓϩⲓⲙⲉ
ϫⲓϩⲟ̂	ϫⲓϩⲟ
ϫⲓϩⲟ	ϫⲓϩⲟ
ϫⲓϩⲣⲁϥ	ϫⲓϩⲣⲁϥ
ϫⲓϩⲣⲁ	ϫⲓϩⲣⲁ
ϫⲓϫⲉⲉⲩⲉ	ϫⲓϫⲉⲉⲩⲉ
ϫⲓϫⲉⲉⲩⲉ`	ϫⲓϫⲉⲉⲩⲉ
ϫⲓϫⲉⲉⲩ	ϫⲓϫⲉⲉⲩⲉ
ϫⲓϫⲉⲉⲩ`	ϫⲓϫⲉⲉⲩⲉ
ϫⲓϫⲣⲟⲡ	ϫⲓϫⲣⲟⲡ
ϫⲓϫⲱⲓ	ϫⲓϫⲱⲓ
ϫⲓϭⲟⲗ	ϫⲓϭⲟⲗ
ϫⲓϯⲡⲉ	ϫⲓϯⲡⲉ
ϫⲓⲉⲟⲟⲩ	ϫⲓⲉⲟⲟⲩ
ϫⲓⲕⲃⲁ	ϫⲓⲕⲃⲁ
ϫⲓⲕⲱⲧ	ϫⲓⲕⲱⲧ
ϫⲓⲙ̣	ϫⲓⲙ
ϫⲓⲙ	ϫⲓⲙ
ϫⲓⲛ̄	ϫⲓⲛ
ϫⲓⲛϫⲏ̂	ϫⲓⲛϫⲏ
ϫⲓⲛϫⲏ⳿	ϫⲓⲛϫⲏ
ϫⲓⲛϫⲏ	ϫⲓⲛϫⲏ
ϫⲓⲛϭⲟⲛⲥ	ϫⲓⲛϭⲟⲛⲥ
ϫⲓⲛϭⲟⲛ︤ⲥ︥	ϫⲓⲛϭⲟⲛⲥ
ϫⲓⲛⲧⲁ	ϫⲓⲛⲧⲁ
ϫⲓⲛⲧ	ϫⲓⲛ
ϫⲓⲛ	ϫⲓⲛ
ϫⲓⲟⲟⲣ	ϫⲓⲟⲟⲣ
ϫⲓⲟⲩⲁ̂	ϫⲓⲟⲩⲁ
ϫⲓⲟⲩⲁ	ϫⲓⲟⲩⲁ
ϫⲓⲟⲩⲉ	ϫⲓⲟⲩⲉ
ϫⲓⲟⲩⲉ`	ϫⲓⲟⲩⲉ
ϫⲓⲥⲃⲱ	ϫⲓⲥⲃⲱ
ϫⲓⲥⲉ	ϫⲓⲥⲉ
ϫⲓⲥⲕⲉⲩⲏ	ϫⲓⲥⲕⲉⲩⲏ
ϫⲓⲥⲙⲟⲩ⳿	ϫⲓⲥⲙⲟⲩ
ϫⲓⲥⲙⲟⲩ	ϫⲓⲥⲙⲟⲩ
ϫⲓⲥⲟⲟⲩⲉ	ϫⲓⲥⲟⲟⲩⲉ
ϫⲓⲧⲉ	ϫⲓⲧⲉ
ϫⲓⲧ︤	ϫⲓⲧ
ϫⲓⲧ	ϫⲓⲧ
ϫⲓ⳯	ϫⲓⲛ
ϫⲓ	ϫⲓ
ϫⲓ`	ϫⲓ
ϫⲕ	ϫⲕ
ϫⲛ̄	ϫⲛ
ϫⲛⲁϩ	ϫⲛⲁϩ
ϫⲛⲁⲁⲩ	ϫⲛⲁⲁⲩ
ϫⲛⲉ	ϫⲛⲉ
ϫⲛⲟⲩ	ϫⲛⲟⲩ
ϫⲛ	ϫⲛ
ϫⲟ̂	ϫⲟ
ϫⲟ̇ⲟⲩ	ϫⲟⲟⲩ
ϫⲟ̇ⲟ	ϫⲟⲟ
ϫⲟϥϫϥ	ϫⲟϥϫϥ
ϫⲟⲉⲓ̇ⲥ	ϫⲟⲉⲓⲥ
ϫⲟⲉⲓ̈ⲥ	ϫⲟⲉⲓⲥ
ϫⲟⲉⲓⲥ	ϫⲟⲉⲓⲥ
ϫⲟⲉⲓⲥ`	ϫⲟⲉⲓⲥ
ϫⲟⲉⲓⲧ	ϫⲟⲉⲓⲧ
ϫⲟⲉⲓ⳿	ϫⲟⲉⲓ
ϫⲟⲉⲓ	ϫⲟⲉⲓ
ϫⲟⲓ̈ⲥ	ϫⲟⲉⲓⲥ
ϫⲟⲓ̈	ϫⲟⲓ
ϫⲟⲓⲥ	ϫⲟⲉⲓⲥ
ϫⲟⲓ	ϫⲟⲓ
ϫⲟⲕⲙ	ϫⲟⲕⲙ
ϫⲟⲕⲣ̇	ϫⲟⲕⲣ
ϫⲟⲕⲣ	ϫⲟⲕⲣ
ϫⲟⲛⲧ	ϫⲟⲛⲧ
ϫⲟⲞ	ϫⲟⲟ
ϫⲟⲟ̇ⲣ	ϫⲟⲟⲣ
ϫⲟⲟ̇	ϫⲟⲟ
ϫⲟⲟⲣ	ϫⲟⲟⲣ
ϫⲟⲟⲩⲥⲉ	ϫⲟⲟⲩⲥⲉ
ϫⲟⲟⲩⲧ	ϫⲟⲟⲩⲧ
ϫⲟⲟⲩ	ϫⲟⲟⲩ
ϫⲟⲟ	ϫⲟⲟ
ϫⲟⲡϫⲡ	ϫⲟⲡϫⲡ
ϫⲟⲡϫ︤ⲡ︥	ϫⲟⲡϫⲡ
ϫⲟⲥⲉ	ϫⲟⲥⲉ
ϫⲟⲥⲉ`	ϫⲟⲥⲉ
ϫⲟⲥ	ϫⲟⲥ
ϫⲟⲩⲣⲏ	ϫⲟⲩⲣⲏ
ϫⲟⲩⲧⲏ⳿	ϫⲟⲩⲧⲏ
ϫⲟⲩⲧⲏ	ϫⲟⲩⲧⲏ
ϫⲟⲩⲧ	ϫⲟⲩⲧ
ϫⲟⲩⲱⲧ	ϫⲟⲩⲱⲧ
ϫⲟ	ϫⲟ
ϫⲟ`	ϫⲟ
ϫⲡⲉ	ϫⲡⲉ
ϫⲡⲓ̇ⲉ̇	ϫⲡⲓⲉ
ϫⲡⲓ̇ⲟ	ϫⲡⲓⲟ
ϫⲡⲓⲉ	ϫⲡⲓⲉ
ϫⲡⲓⲟ̂	ϫⲡⲓⲟ
ϫⲡⲓⲟ	ϫⲡⲓⲟ
ϫⲡⲓⲟ`	ϫⲡⲓⲟ
ϫⲡⲓ	ϫⲡⲓ
ϫⲡⲟ̂	ϫⲡⲟ
ϫⲡⲟ	ϫⲡⲟ
ϫⲡ	ϫⲡ
ϫⲣ̣ⲟⲡ	ϫⲣⲟⲡ
ϫⲣⲟ̂	ϫⲣⲟ
ϫⲣⲟⲡ̂	ϫⲣⲟⲡ
ϫⲣⲟⲡ⳿	ϫⲣⲟⲡ
ϫⲣⲟⲡ	ϫⲣⲟⲡ
ϫⲣⲟ	ϫⲣⲟ
ϫⲥ̄	ϫⲟⲉⲓⲥ
ϫⲥ	ϫⲟⲉⲓⲥ
ϫⲧⲉ	ϫⲧⲉ
ϫⲱ̂	ϫⲱ
ϫⲱ̂`	ϫⲱ
ϫⲱ̣	ϫⲱ
ϫⲱϥ	ϫⲱϥ
ϫⲱϩⲙ̄	ϫⲱϩⲙ
ϫⲱϩⲙ︥	ϫⲱϩⲙ
ϫⲱϩⲙ	ϫⲱϩⲙ
ϫⲱϩ︤ⲙ︥	ϫⲱϩⲙ
ϫⲱϩ︤ⲙ︥`	ϫⲱϩⲙ
ϫⲱϩ︤︥ⲙ	ϫⲱϩⲙ
ϫⲱϩ	ϫⲱϩ
ϫⲱⲕⲙ	ϫⲱⲕⲙ
ϫⲱⲕ︤ⲙ︥	ϫⲱⲕⲙ
ϫⲱⲕ	ϫⲱⲕ
ϫⲱⲕ`	ϫⲱⲕ
ϫⲱⲗϩ	ϫⲱⲗϩ
ϫⲱⲗϫ	ϫⲱⲗϫ
ϫⲱⲗⲕ	ϫⲱⲗⲕ
ϫⲱⲗ︤ϩ︥	ϫⲱⲗϩ
ϫⲱⲗ︤ϫ︥	ϫⲱⲗϫ
ϫⲱⲗ︤ⲕ︥	ϫⲱⲗⲕ
ϫⲱⲛⲧ	ϫⲱⲛⲧ
ϫⲱⲧⲙ	ϫⲱⲧⲙ
ϫⲱⲧ︤ⲙ̣︥	ϫⲱⲧⲙ
ϫⲱⲱ̂ⲙⲉ⳿	ϫⲱⲱⲙⲉ
ϫⲱⲱ̇ⲙⲉ	ϫⲱⲱⲙⲉ
ϫⲱⲱⲙⲉ	ϫⲱⲱⲙⲉ
ϫⲱⲱⲣⲉ	ϫⲱⲱⲣⲉ
ϫⲱⲱⲣ	ϫⲱⲱⲣ
ϫⲱ⳿	ϫⲱ
ϫⲱ	ϫⲱ
ϫ︤ⲃ︥ⲃⲉⲥ⳿	ϫⲃⲃⲉⲥ
ϫ︤ⲛ︥	ϫⲛ
ϫ[ⲉ]	ϫⲉ
ϫ[ⲓⲛ]ϫ̣ⲏ	ϫⲓⲛϫⲏ
Ϭⲓ̇ϫ	ϭⲓϫ
Ϭⲓϫ	ϭⲓϫ
ϭ̣ⲉ	ϭⲉ
ϭ̣ⲟⲙ`	ϭⲟⲙ
ϭⲁⲃ	ϭⲁⲃ
ϭⲁⲗⲉ	ϭⲁⲗⲉ
ϭⲁⲗⲱⲟⲩ	ϭⲁⲗⲱⲟⲩ
ϭⲁⲗⲱ	ϭⲁⲗⲱ
ϭⲁⲗ	ϭⲁⲗ
ϭⲁⲙⲟⲩⲗ	ϭⲁⲙⲟⲩⲗ
ϭⲁⲛⲁϩ	ϭⲁⲛⲁϩ
ϭⲃ̇ⲃⲉ	ϭⲃⲃⲉ
ϭⲃⲃⲉ	ϭⲃⲃⲉ
ϭⲉϣϭⲱϣ	ϭⲉϣϭⲱϣ
ϭⲉⲉⲧ	ϭⲉⲉⲧ
ϭⲉⲗⲡ	ϭⲉⲗⲡ
ϭⲉⲗ︤ⲡ︥	ϭⲉⲗⲡ
ϭⲉⲡⲏ̂	ϭⲉⲡⲏ
ϭⲉⲡⲏ	ϭⲉⲡⲏ
ϭⲉⲡ	ϭⲉⲡ
ϭⲉⲣⲟⲟⲃ	ϭⲉⲣⲟⲟⲃ
ϭⲉⲣⲱⲃ	ϭⲉⲣⲱⲃ
ϭⲉ⳿	ϭⲉ
ϭⲉ	ϭⲉ
ϭⲉ`	ϭⲉ
ϭⲏⲡ	ϭⲏⲡ
ϭⲓ̇ϫ	ϭⲓϫ
ϭⲓ̇ⲛⲉ	ϭⲓⲛⲉ
ϭⲓ̇ⲛⲛⲥⲱⲧ[ⲙ]	ϭⲓⲛⲛⲥⲱⲧⲙ
ϭⲓ̇ⲛⲱ̇ⲛⲁϩ	ϭⲓⲛⲱⲛⲁϩ
ϭⲓϫ	ϭⲓϫ
ϭⲓⲛϣⲁϫⲉ	ϭⲓⲛϣⲁϫⲉ
ϭⲓⲛϣⲱⲗⲙ̄	ϭⲓⲛϣⲱⲗⲙ
ϭⲓⲛϣⲱⲗⲙ	ϭⲓⲛϣⲱⲗⲙ
ϭⲓⲛϭⲗⲱ	ϭⲓⲛϭⲗⲱ
ϭⲓⲛⲁϩⲉⲣⲁⲧ︤	ϭⲓⲛⲁϩⲉⲣⲁⲧ
ϭⲓⲛⲁϩⲉⲣⲁⲧ	ϭⲓⲛⲁϩⲉⲣⲁⲧ
ϭⲓⲛⲉ	ϭⲓⲛⲉ
ϭⲓⲛⲙⲟⲟϣⲉ	ϭⲓⲛⲙⲟⲟϣⲉ
ϭⲓⲛⲛⲁⲩ	ϭⲓⲛⲛⲁⲩ
ϭⲓⲛⲛⲥⲱⲧⲙ	ϭⲓⲛⲛⲥⲱⲧⲙ
ϭⲓⲛⲟⲩⲃⲁⲗ	ϭⲓⲛⲟⲩⲃⲁⲗ
ϭⲓⲛⲟⲩⲟⲟⲙ	ϭⲓⲛⲟⲩⲟⲟⲙ
ϭⲓⲛⲟⲩⲱⲙ⳿	ϭⲓⲛⲟⲩⲱⲙ
ϭⲓⲛⲟⲩⲱⲙ	ϭⲓⲛⲟⲩⲱⲙ
ϭⲓⲛⲡⲟⲗⲩⲙⲉⲓ	ϭⲓⲛⲡⲟⲗⲩⲙⲉⲓ
ϭⲓⲛⲥⲱⲧⲙ̇	ϭⲓⲛⲥⲱⲧⲙ
ϭⲓⲛⲥⲱⲧⲙ	ϭⲓⲛⲥⲱⲧⲙ
ϭⲓⲛⲱⲛⲁϩ	ϭⲓⲛⲱⲛⲁϩ
ϭⲓⲛ	ϭⲓⲛ
ϭⲓⲥ	ϭⲓⲥ
ϭⲗⲙⲗⲱⲙ	ϭⲗⲙⲗⲱⲙ
ϭⲗⲟϭ	ϭⲗⲟϭ
ϭⲗⲟⲙⲗⲙ	ϭⲗⲟⲙⲗⲙ
ϭⲗⲟⲙⲗ︤ⲙ︥	ϭⲗⲟⲙⲗⲙ
ϭⲗⲟⲟϭⲉ	ϭⲗⲟⲟϭⲉ
ϭⲗⲱϭ	ϭⲗⲱϭ
ϭⲙ̄ϭⲟⲙ	ϭⲙϭⲟⲙ
ϭⲙ̇ϭⲟⲙ̇	ϭⲙϭⲟⲙ
ϭⲙ̇ϭⲟⲙ	ϭⲙϭⲟⲙ
ϭⲙϣⲓⲛⲉ	ϭⲙ[ϣⲓ]ⲛⲉ
ϭⲙϭⲟⲙ	ϭⲙϭⲟⲙ
ϭⲙⲏⲟⲩ	ϭⲙⲏⲟⲩ
ϭⲙⲏⲩ	ϭⲙⲏⲩ
ϭⲙ[ϣⲓ]ⲛⲉ	ϭⲙ[ϣⲓ]ⲛⲉ
ϭⲛ̄ⲧ̣	ϭⲛⲧ
ϭⲛ̄	ϭⲛ
ϭⲛ̇ⲁ̇ⲣⲓⲕⲉ	ϭⲛⲁⲣⲓⲕⲉ
ϭⲛ̇ⲧ	ϭⲛⲧ
ϭⲛ̇	ϭⲛ
ϭⲛⲁⲣⲓ̈ⲕⲉ	ϭⲛⲁⲣⲓⲕⲉ
ϭⲛⲁⲣⲓⲕⲉ	ϭⲛⲁⲣⲓⲕⲉ
ϭⲛⲁⲣⲓⲕ[ⲉ]	ϭⲛⲁⲣⲓⲕⲉ
ϭⲛⲁⲧ	ϭⲛⲁⲧ
ϭⲛⲉⲓⲇⲱⲗⲟⲛ	ϭⲛⲉⲓⲇⲱⲗⲟⲛ
ϭⲛⲧ︤	ϭⲛⲧ
ϭⲛⲧ	ϭⲛⲧ
ϭⲛ	ϭⲛ
ϭⲟϫⲃ	ϭⲟϫⲃ
ϭⲟⲓⲗⲉ	ϭⲟⲓⲗⲉ
ϭⲟⲗⲡ̇	ϭⲟⲗⲡ
ϭⲟⲗⲡ	ϭⲟⲗⲡ
ϭⲟⲗ⳿	ϭⲟⲗ
ϭⲟⲗ	ϭⲟⲗ
ϭⲟⲗ`	ϭⲟⲗ
ϭⲟⲙ̣	ϭⲟⲙ
ϭⲟⲙ	ϭⲟⲙ
ϭⲟⲙ`	ϭⲟⲙ
ϭⲟⲛⲥ̄	ϭⲟⲛⲥ
ϭⲟⲛⲥ	ϭⲟⲛⲥ
ϭⲟⲛⲧ	ϭⲟⲛⲧ
ϭⲟⲛ︤ⲥ︥	ϭⲟⲛⲥ
ϭⲟⲟⲃ	ϭⲟⲟⲃ
ϭⲟⲟⲗⲉ	ϭⲟⲟⲗⲉ
ϭⲟⲟⲗ︤	ϭⲟⲟⲗ
ϭⲟⲟⲗ	ϭⲟⲟⲗ
ϭⲟⲟⲙⲉ	ϭⲟⲟⲙⲉ
ϭⲟⲟⲙ⳿	ϭⲟⲟⲙ
ϭⲟⲟⲙ	ϭⲟⲟⲙ
ϭⲟⲟⲩϭ	ϭⲟⲟⲩϭ
ϭⲟⲡ̇	ϭⲟⲡ
ϭⲟⲡⲧ	ϭⲟⲡⲧ
ϭⲟⲡ	ϭⲟⲡ
ϭⲟⲣϭⲥ̄︥	ϭⲟⲣϭⲥ
ϭⲟⲣϭⲥ	ϭⲟⲣϭⲥ
ϭⲟⲥⲙ	ϭⲟⲥⲙ
ϭⲟⲥ︤ⲙ︥	ϭⲟⲥⲙ
ϭⲟⲧⲡ	ϭⲟⲧⲡ
ϭⲟⲧ	ϭⲟⲧ
ϭⲣⲉϩⲧ	ϭⲣⲉϩⲧ
ϭⲣⲏⲡⲉ	ϭⲣⲏⲡⲉ
ϭⲣⲟϭ	ϭⲣⲟϭ
ϭⲣⲟⲟⲙⲡⲉ	ϭⲣⲟⲟⲙⲡⲉ
ϭⲣⲱϭ	ϭⲣⲱϭ
ϭⲣⲱⲱϭ	ϭⲣⲱⲱϭ
ϭⲱ̂	ϭⲱ
ϭⲱϣⲧ	ϭⲱϣⲧ
ϭⲱϣ︤ⲧ︥	ϭⲱϣⲧ
ϭⲱⲃⲉ	ϭⲱⲃⲉ
ϭⲱⲃ	ϭⲱⲃ
ϭⲱⲗⲡ̄	ϭⲱⲗⲡ
ϭⲱⲗⲡ̇	ϭⲱⲗⲡ
ϭⲱⲗⲡ	ϭⲱⲗⲡ
ϭⲱⲗ︤ⲡ︥	ϭⲱⲗⲡ
ϭⲱⲗ︤︥ⲡ	ϭⲱⲗⲡ
ϭⲱⲙ	ϭⲱⲙ
ϭⲱⲛⲧ̇	ϭⲱⲛⲧ
ϭⲱⲛⲧ︥	ϭⲱⲛⲧ
ϭⲱⲛⲧ	ϭⲱⲛⲧ
ϭⲱⲛ︤ⲧ︥	ϭⲱⲛⲧ
ϭⲱⲛ︤︥ⲧ	ϭⲱⲛⲧ
ϭⲱⲡⲉ	ϭⲱⲡⲉ
ϭⲱⲣϭ	ϭⲱⲣϭ
ϭⲱⲣ︤ϭ︥	ϭⲱⲣϭ
ϭⲱⲧⲡ	ϭⲱⲧⲡ
ϭⲱ	ϭⲱ
ϭ︤ⲙ︥ϭⲟⲙ	ϭⲙϭⲟⲙ
ϭ︤ⲛⲁⲣⲓⲕⲉ	ϭⲛⲁⲣⲓⲕⲉ
ϭ︤ⲛ︥ⲁⲣⲓⲕⲉ	ϭⲛⲁⲣⲓⲕⲉ
ϭ︤ⲛ︥ⲉⲓⲇⲱⲗⲟⲛ⳿	ϭⲛⲉⲓⲇⲱⲗⲟⲛ
ϭ︤ⲛ︥ⲧ	ϭⲛⲧ
ϭ︤ⲛ︥	ϭⲛ
ϭ︤ⲛ	ϭⲛ
ϭ[ⲛⲧ	ϭⲛⲧ
ϯ̇̇ϩⲏⲩ	ϯϩⲏⲩ
ϯ̇̇	ϯ
ϯ̇ϩⲏⲩ	ϯϩⲏⲩ
ϯ̇ϩⲓ̇ⲥⲉ	ϯϩⲓⲥⲉ
ϯ̇ϩⲓ̈ⲥⲉ	ϯϩⲓⲥⲉ
ϯ̇ⲉ̇ⲟⲟⲩ	ϯⲉⲟⲟⲩ
ϯ̇ⲙⲏ	ϯⲙⲏ
ϯ̇ⲛ̇ⲧⲟⲗⲏ	ϯⲛⲧⲟⲗⲏ
ϯ̇	ϯ
ϯ̣	ϯ
ϯϣⲓⲡⲉ	ϯϣⲓⲡⲉ
ϯϩⲁϩ	ϯϩⲁϩ
ϯϩⲁⲡ⳿	ϯϩⲁⲡ
ϯϩⲁⲡ	ϯϩⲁⲡ
ϯϩⲉ	ϯϩⲉ
ϯϩⲏⲩ⳿	ϯϩⲏⲩ
ϯϩⲏⲩ	ϯϩⲏⲩ
ϯϩⲓ̇ⲥⲉ	ϯϩⲓⲥⲉ
ϯϩⲓⲥⲉ	ϯϩⲓⲥⲉ
ϯϩⲓⲱⲱ̄ϥ	ϯϩⲓⲱⲱϥ
ϯϩⲓⲱⲱϥ	ϯϩⲓⲱⲱϥ
ϯϩⲣⲟⲟⲩ	ϯϩⲣⲟⲟⲩ
ϯϩⲧⲏ	ϯϩⲧⲏ
ϯϭⲟⲙ	ϯϭⲟⲙ
ϯϭⲣⲟⲟⲙⲡⲉ	ϯϭⲣⲟⲟⲙⲡⲉ
ϯⲁⲁⲥ	ϯⲁⲁⲥ
ϯⲁⲏⲥ	ϯⲁⲏⲥ
ϯⲁⲕⲱⲛⲉⲓ	ⲇⲓⲁⲕⲱⲛⲉⲓ
ϯⲃⲥ	ϯⲃⲥ
ϯⲃⲱⲱⲛ	ϯⲃⲱⲱⲛ
ϯⲃ︤ⲥ︥	ϯⲃⲥ
ϯⲉⲓⲃⲧ	ϯⲉⲓⲃⲧ
ϯⲉⲟⲟⲩ⳿	ϯⲉⲟⲟⲩ
ϯⲉⲟⲟⲩ	ϯⲉⲟⲟⲩ
ϯⲑⲉ	ϯⲑⲉ
ϯⲕ̄ⲗ̄ⲯ	ϯⲕⲗⲯ
ϯⲕⲗⲯ	ϯⲕⲗⲯ
ϯⲗⲟⲅⲟ̣ⲥ̣	ϯⲗⲟⲅⲟⲥ
ϯⲗⲟⲅⲟⲥ	ϯⲗⲟⲅⲟⲥ
ϯⲙⲁⲉⲓⲛ⳿	ϯⲙⲁⲉⲓⲛ
ϯⲙⲁⲉⲓⲛ	ϯⲙⲁⲉⲓⲛ
ϯⲙⲉⲩⲉ̄	ϯⲙⲉⲉⲩⲉ
ϯⲙⲉⲩⲉ	ϯⲙⲉⲉⲩⲉ
ϯⲙⲉ⳿	ϯⲙⲉ
ϯⲙⲉ	ϯⲙⲉ
ϯⲙⲏ	ϯⲙⲏ
ϯⲙⲧⲟⲛ	ϯⲙⲧⲟⲛ
ϯⲛⲁⲁⲕⲉ	ϯⲛⲁⲁⲕⲉ
ϯⲛⲟⲩϭⲥ	ϯⲛⲟⲩϭⲥ
ϯⲛⲟⲩϭ︤ⲥ︥	ϯⲛⲟⲩϭⲥ
ϯⲛⲧⲟⲗⲏ	ϯⲛⲧⲟⲗⲏ
ϯⲟⲥⲉ	ϯⲟⲥⲉ
ϯⲟⲩⲃⲉ	ϯⲟⲩⲃⲉ
ϯⲟⲩⲱ̇	ϯⲟⲩⲱ
ϯⲟⲩⲱ	ϯⲟⲩⲱ
ϯⲡ̣ⲓ̣	ϯⲡⲓ
ϯⲡⲉⲩⲟⲓ	ϯⲡⲉⲩⲟⲓ
ϯⲡⲉ	ϯⲡⲉ
ϯⲡⲓ	ϯⲡⲓ
ϯⲣⲁⲛ	ϯⲣⲁⲛ
ϯⲣⲙⲉⲓⲏ	ϯⲣⲙⲉⲓⲏ
ϯⲥⲃⲱ̂	ϯⲥⲃⲱ
ϯⲥⲃⲱ	ϯⲥⲃⲱ
ϯⲥⲙⲏ⳿	ϯⲥⲙⲏ
ϯⲥⲙⲏ	ϯⲥⲙⲏ
ϯⲥⲟⲟⲩⲛ	ϯⲥⲟⲟⲩⲛ
ϯⲥⲟ	ϯⲥⲟ
ϯⲧⲟⲟⲧ︤	ϯⲧⲟⲟⲧ
ϯⲧⲟⲟⲧ	ϯⲧⲟⲟⲧ
ϯⲧⲣⲁⲡⲉⲍⲁ	ϯⲧⲣⲁⲡⲉⲍⲁ
ϯⲧⲱⲛ⳿	ϯⲧⲱⲛ
ϯⲧⲱⲛ	ϯⲧⲱⲛ
ϯ	ϯ
—	—
†	†
…ⲛ	…ⲛ
…	[…]
…..ⲉⲁ	[…..]ⲉⲁ
…..	[…..]
⁛	⁛
☧	☧
⟦…̣ⲓⲁⲛ	⟦…ⲓⲁⲛ
⟦…ⲓⲁⲛ	⟦…ⲓⲁⲛ
Ⲁ̇ⲛⲟⲛ	ⲁⲛⲟⲛ
Ⲁ̣ⲩⲱ	ⲁⲩⲱ
Ⲁϣ	ⲁϣ
Ⲁϩⲣⲟ	ⲁϩⲣⲟ
Ⲁⲃⲣⲁϩⲁⲙ	ⲁⲃⲣⲁϩⲁⲙ
Ⲁⲃⲣⲁϩⲁⲙ`	ⲁⲃⲣⲁϩⲁⲙ
ⲀⲄⲰⲚ	ⲁⲅⲱⲛ
Ⲁⲗⲗⲁ	ⲁⲗⲗⲁ
Ⲁⲛⲟⲕ	ⲁⲛⲟⲕ
Ⲁⲛⲟⲛ	ⲁⲛⲟⲛ
Ⲁⲛⲟⲛ`	ⲁⲛⲟⲛ
Ⲁⲛ	ⲁⲛ
Ⲁⲧϩⲏⲧ	ⲁⲧϩⲏⲧ
ⲀⲨⲰ	ⲁⲩⲱ
Ⲁⲩⲱ̇	ⲁⲩⲱ
Ⲁⲩⲱ	ⲁⲩⲱ
Ⲁ	ⲁ
ⲁ̄ϫⲓⲏ̄ⲡⲉ	ⲁϫⲓⲏⲡⲉ
ⲁ̄	ⲁ
ⲁ̇ϣ	ⲁϣ
ⲁ̇ϩⲉⲣⲁⲧ̇	ⲁϩⲉⲣⲁⲧ
ⲁ̇ϩⲉⲣⲁⲧ	ⲁϩⲉⲣⲁⲧ
ⲁ̇ϩⲉ	ⲁϩⲉ
ⲁ̇ϫⲉⲛ	ⲁϫⲛ
ⲁ̇ϫⲓ̇̇	ⲁϫⲓ
ⲁ̇ϫⲓ̇	ⲁϫⲓ
ⲁ̇ϫⲙ̇	ⲁϫⲙ
ⲁ̇ϫⲛ̇	ⲁϫⲛ
ⲁ̇ϫⲛ	ⲁϫⲛ
ⲁ̇ⲁ	ⲁⲁ
ⲁ̇ⲅⲁⲑⲟⲛ	ⲁⲅⲁⲑⲟⲛ
ⲁ̇ⲅⲅⲉⲗⲟⲥ	ⲁⲅⲅⲉⲗⲟⲥ
ⲁ̇ⲅⲅⲏⲛ	ⲁⲅⲅⲏⲛ
ⲁ̇ⲅⲱⲛⲓ̇ⲍⲉ	ⲁⲅⲱⲛⲓⲍⲉ
ⲁ̇ⲗⲗⲁ	ⲁⲗⲗⲁ
ⲁ̇ⲙⲁϩⲧⲉ	ⲁⲙⲁϩⲧⲉ
ⲁ̇ⲙⲏⲓ̇	ⲁⲙⲏⲓ
ⲁ̇ⲛϫⲱϫ	ⲁⲛϫⲱϫ
ⲁ̇ⲛⲁⲩ	ⲁⲛⲁⲩ
ⲁ̇ⲛⲅ	ⲁⲛⲅ
ⲁ̇ⲛⲟⲕ	ⲁⲛⲟⲕ
ⲁ̇ⲛⲟⲛ	ⲁⲛⲟⲛ
ⲁ̇ⲛⲧⲱⲛⲓ̇ⲟⲥ	ⲁⲛⲧⲱⲛⲓⲟⲥ
ⲁ̇ⲛ	ⲁⲛ
ⲁ̇ⲡⲁ̇	ⲁⲡⲁ
ⲁ̇ⲡⲁⲛⲧⲁ	ⲁⲡⲁⲛⲧⲁ
ⲁ̇ⲡⲁ	ⲁⲡⲁ
ⲁ̇ⲡⲟⲧⲁⲥⲥⲉ	ⲁⲡⲟⲧⲁⲥⲥⲉ
ⲁ̇ⲡⲟⲧ	ⲁⲡⲟⲧ
ⲁ̇ⲣⲁ	ⲁⲣⲁ
ⲁ̇ⲣⲓ̇	ⲁⲣⲓ
ⲁ̇ⲣⲓ̈	ⲁⲣⲓ
ⲁ̇ⲥⲕⲉⲓ̇	ⲁⲥⲕⲉⲓ
ⲁ̇ⲥⲕⲏⲥⲓⲥ	ⲁⲥⲕⲏⲥⲓⲥ
ⲁ̇ⲥⲡⲁⲍⲉ	ⲁⲥⲡⲁⲍⲉ
ⲁ̇ⲧϭⲟⲙ	ⲁⲧϭⲟⲙ
ⲁ̇ⲧⲕⲓ̇ⲙ	ⲁⲧⲕⲓⲙ
ⲁ̇ⲧⲟⲩⲱ̇	ⲁⲧⲟⲩⲱ
ⲁ̇ⲩⲝⲁⲛⲉ	ⲁⲩⲝⲁⲛⲉ
ⲁ̇ⲩⲱ̇	ⲁⲩⲱ
ⲁ̇	ⲁ
ⲁ̣ϣ̣	ⲁϣ
ⲁ̣ⲗ̣ⲟⲙ̣	ⲁⲗⲟⲙ
ⲁ̣ⲛⲁⲅ̣ⲕⲁⲓⲟⲛ	ⲁⲛⲁⲅⲕⲁⲓⲟⲛ
ⲁ̣ⲛ	ⲁⲛ
ⲁ̣ⲣⲁ̣	ⲁⲣⲁ
ⲁ̣ⲩⲱ	ⲁⲩⲱ
ⲁ̣	ⲁ
ⲁ̣[	ⲁ
ⲁ̣]ⲅⲁⲡⲏ	ⲁⲅⲁⲡⲏ
ⲁϣ̣	ⲁϣ
ⲁϣⲁϩⲟⲙ	ⲁϣⲁϩⲟⲙ
ⲁϣⲁⲓ̇	ⲁϣⲁⲓ
ⲁϣⲁⲓ̈	ⲁϣⲁⲓ
ⲁϣⲁⲓ	ⲁϣⲁⲓ
ⲁϣⲉ	ⲁϣⲉ
ⲁϣⲏ	ⲁϣⲏ
ⲁϣⲱ	ⲁϣⲱ
ⲁϣ	ⲁϣ
ⲁϥ̂	ⲁϥ
ⲁϥⲣⲁϩⲁⲙ	ⲁϥⲣⲁϩⲁⲙ
ⲁϥ	ⲁϥ
ⲁϩⲉⲣⲁⲧⲉ	ⲁϩⲉⲣⲁⲧⲉ
ⲁϩⲉⲣⲁⲧ︤	ⲁϩⲉⲣⲁⲧ
ⲁϩⲉⲣⲁⲧ	ⲁϩⲉⲣⲁⲧ
ⲁϩⲉ	ⲁϩⲉ
ⲁϩⲏⲩ	ⲁϩⲏⲩ
ⲁϩⲟ̂	ⲁϩⲟ
ⲁϩⲟⲩ	ⲁϩⲟⲩ
ⲁϩⲟ	ⲁϩⲟ
ⲁϩⲣⲟ	ⲁϩⲣⲟ
ⲁϩⲣⲱ	ⲁϩⲣⲱ
ⲁϫⲉⲛ	ⲁϫⲛ
ⲁϫⲓⲏⲡⲉ	ⲁϫⲓⲏⲡⲉ
ⲁϫⲓ	ⲁϫⲓ
ⲁϫⲙ	ⲁϫⲙ
ⲁϫⲛ̄	ⲁϫⲛ
ⲁϫⲛⲧ	ⲁϫⲛⲧ
ⲁϫⲛ	ⲁϫⲛ
ⲁϫ︤ⲙ︥	ⲁϫⲙ
ⲁϫ︤ⲛ︥	ⲁϫⲛ
ⲁϭⲟⲗⲧⲉ⳿	ⲁϭⲟⲗⲧⲉ
ⲁϭⲟⲗⲧⲉ	ⲁϭⲟⲗⲧⲉ
ⲁϭⲣⲏⲛ	ⲁϭⲣⲏⲛ
ⲁ⟨ⲁ⟩	ⲁⲁ
ⲁⲁ̇	ⲁⲁ
ⲁⲁⲁ	ⲁⲁ
ⲁⲁ	ⲁⲁ
ⲁⲃⲃⲁ	ⲁⲃⲃⲁ
ⲁⲃⲉⲗ	ⲁⲃⲉⲗ
ⲁⲃⲓⲁⲑⲁⲣ	ⲁⲃⲓⲁⲑⲁⲣ
ⲁⲃⲣⲁϩⲁⲙ	ⲁⲃⲣⲁϩⲁⲙ
ⲁⲃⲣⲁϩⲁⲙ`	ⲁⲃⲣⲁϩⲁⲙ
ⲁⲃ	ⲁⲃ
ⲁⲅⲁⲑ̣ⲁⲣⲥⲓ	ⲁⲅⲁⲑⲁⲣⲥⲓ
ⲁⲅⲁⲑⲁⲣⲥⲓ	ⲁⲅⲁⲑⲁⲣⲥⲓ
ⲁⲅⲁⲑⲟⲛ	ⲁⲅⲁⲑⲟⲛ
ⲁⲅⲁⲑⲟⲛ`	ⲁⲅⲁⲑⲟⲛ
ⲁⲅⲁⲑⲟⲥ	ⲁⲅⲁⲑⲟⲥ
ⲁⲅⲁⲡⲏ⳿	ⲁⲅⲁⲡⲏ
ⲁⲅⲁⲡⲏ	ⲁⲅⲁⲡⲏ
ⲁⲅⲅⲉⲗⲓⲕⲏ	ⲁⲅⲅⲉⲗⲓⲕⲏ
ⲁⲅⲅⲉⲗⲓⲟⲛ	ⲁⲅⲅⲉⲗⲓⲟⲛ
ⲁⲅⲅⲉⲗⲟⲥ	ⲁⲅⲅⲉⲗⲟⲥ
ⲁⲅⲅⲉⲗⲟⲥ`	ⲁⲅⲅⲉⲗⲟⲥ
ⲁⲅⲅⲏⲛ	ⲁⲅⲅⲏⲛ
ⲁⲅⲅⲓⲟⲛ	ⲁⲅⲅⲓⲟⲛ
ⲁⲅⲉⲗⲏ	ⲁⲅⲉⲗⲏ
ⲁⲅⲟⲣⲁ	ⲁⲅⲟⲣⲁ
ⲁⲅⲱⲛⲓⲍⲉ	ⲁⲅⲱⲛⲓⲍⲉ
ⲁⲅⲱⲣⲁ	ⲁⲅⲱⲣⲁ
ⲁⲇ̣ⲓⲕ̣ⲟⲥ	ⲁⲇⲓⲕⲟⲥ
ⲁⲇⲁⲁⲇⲁⲙ	ⲁⲇⲁⲙ
ⲁⲇⲁⲙ	ⲁⲇⲁⲙ
ⲁⲇⲓⲕⲟⲥ	ⲁⲇⲓⲕⲟⲥ
ⲁⲇⲱⲛⲁⲓ	ⲁⲇⲱⲛⲁⲓ
ⲁⲉⲓⲧ	ⲁⲉⲓⲧ
ⲁⲏⲣ	ⲁⲏⲣ
ⲁⲏⲥ	ⲁⲏⲥ
ⲁⲏ	ϩⲁⲏ
ⲁⲏ`	ϩⲁⲏ
ⲁⲑⲁⲃ	ⲁⲧⲑⲁⲃ
ⲁⲑⲁ	ⲁⲑⲁ
ⲁⲑⲉⲧⲉⲓ	ⲁⲑⲉⲧⲉⲓ
ⲁⲑⲉⲧⲓ̂	ⲁⲑⲉⲧⲓ
ⲁⲑⲉⲧⲓ	ⲁⲑⲉⲧⲓ
ⲁⲑⲉⲧⲓ`	ⲁⲑⲉⲧⲓ
ⲁⲑⲏⲧ	ⲁⲧϩⲏⲧ
ⲁⲑⲟⲧⲉ	ⲁⲧϩⲟⲧⲉ
ⲁⲓ̇ⲥ̇ⲑⲁⲛⲉ	ⲁⲓⲥⲑⲁⲛⲉ
ⲁⲓ̇	ⲁⲓ
ⲁⲓ̈ⲃⲥ	ϩⲁⲓⲃⲉⲥ
ⲁⲓ̈ⲱⲛ	ⲁⲓⲱⲛ
ⲁⲓⲁⲧ	ⲉⲓⲁⲧ
ⲁⲓⲃⲥ	ϩⲁⲓⲃⲉⲥ
ⲁⲓⲥⲑⲁⲛⲉ	ⲁⲓⲥⲑⲁⲛⲉ
ⲁⲓⲥⲑⲁⲛⲉ`	ⲁⲓⲥⲑⲁⲛⲉ
ⲁⲓⲥⲑⲏⲥⲓⲥ	ⲁⲓⲥⲑⲏⲥⲓⲥ
ⲁⲓⲧⲉⲓ̈	ⲁⲓⲧⲉⲓ
ⲁⲓⲧⲉⲓ	ⲁⲓⲧⲉⲓ
ⲁⲓⲧⲏⲙⲁ	ⲁⲓⲧⲏⲙⲁ
ⲁⲓⲧⲓⲁ	ⲁⲓⲧⲓⲁ
ⲁⲓⲧⲓ	ⲁⲓⲧⲉⲓ
ⲁⲓⲭⲁ	ⲁⲓⲭⲁ
ⲁⲓⲭⲙⲁⲗⲱⲥⲓⲁ	ⲁⲓⲭⲙⲁⲗⲱⲥⲓⲁ
ⲁⲓⲱⲛ	ⲁⲓⲱⲛ
ⲁⲓ	ⲁⲓ
ⲁⲕⲁⲑⲁⲣⲥⲓⲁ	ⲁⲕⲁⲑⲁⲣⲥⲓⲁ
ⲁⲕⲁⲑⲁⲣⲧⲟⲛ	ⲁⲕⲁⲑⲁⲣⲧⲟⲛ
ⲁⲕⲁⲑⲁⲣⲧⲟⲥ	ⲁⲕⲁⲑⲁⲣⲧⲟⲥ
ⲁⲕⲁⲑⲁⲣⲧⲟⲥ`	ⲁⲕⲁⲑⲁⲣⲧⲟⲥ
ⲁⲕⲧⲓⲛ	ⲁⲕⲧⲓⲛ
ⲁⲕⲩⲗⲁ	ⲁⲕⲩⲗⲁ
ⲁⲗⲁⲃⲁⲥⲧⲣⲟⲛ	ⲁⲗⲁⲃⲁⲥⲧⲣⲟⲛ
ⲁⲗⲁⲗⲉⲓⲁ	ⲁⲗⲁⲗⲉⲓⲁ
ⲁⲗⲁⲗⲓⲁ	ⲁⲗⲁⲗⲓⲁ
ⲁⲗⲁⲥⲥⲁ	ⲑⲁⲗⲁⲥⲥⲁ
ⲁⲗⲉⲕⲧⲱⲣ	ⲁⲗⲉⲕⲧⲱⲣ
ⲁⲗⲉⲝⲁⲛⲇⲣⲟⲥ	ⲁⲗⲉⲝⲁⲛⲇⲣⲟⲥ
ⲁⲗⲉ	ⲁⲗⲉ
ⲁⲗⲏⲑⲱⲥ	ⲁⲗⲏⲑⲱⲥ
ⲁⲗⲖⲁ	ⲁⲗⲗⲁ
ⲁⲗⲗⲁⲥⲁ	ⲑⲁⲗⲁⲥⲥⲁ
ⲁⲗⲗⲁ	ⲁⲗⲗⲁ
ⲁⲗⲗⲁ`	ⲁⲗⲗⲁ
ⲁⲗⲗⲟ̂	ⲁⲗⲗⲟ
ⲁⲗⲗⲟ	ⲁⲗⲗⲟ
ⲁⲗⲟⲙ	ⲁⲗⲟⲙ
ⲁⲗⲟⲟⲩⲉ	ⲁⲗⲟⲟⲩⲉ
ⲁⲗⲫⲁⲓⲟⲥ	ⲁⲗⲫⲁⲓⲟⲥ
ⲁⲗⲱⲧⲛ	ⲁⲗⲱⲧⲛ
ⲁⲗⲱⲧ︤ⲛ︥	ⲁⲗⲱⲧⲛ
ⲁⲗⲱ	ⲁⲗⲱ
ⲁⲗ	ⲁⲗ
ⲁⲙ̇ⲁϩⲧⲉ	ⲁⲙⲁϩⲧⲉ
ⲁⲙⲁϩⲧⲉ	ⲁⲙⲁϩⲧⲉ
ⲁⲙⲉⲗⲓ̇ⲁ̇	ⲁⲙⲉⲗⲓⲁ
ⲁⲙⲉⲗⲓⲁ	ⲁⲙⲉⲗⲓⲁ
ⲁⲙⲏⲉⲓⲛ	ⲁⲙⲏⲉⲓⲛ
ⲁⲙⲏⲓⲛ	ⲁⲙⲏⲓⲛ
ⲁⲙⲏⲓ	ⲁⲙⲏⲓ
ⲁⲙⲛ̄ⲧⲉ	ⲁⲙⲛⲧⲉ
ⲁⲙⲛⲧⲉ	ⲁⲙⲛⲧⲉ
ⲁⲙⲟⲩ	ⲁⲙⲟⲩ
ⲁⲙⲱⲛⲁ	ⲁⲙⲱⲛⲁ
ⲁⲙ︤ⲛ︥ⲧⲉ	ⲁⲙⲛⲧⲉ
ⲁⲙ︤ⲛ︦ⲧ︥ⲉ	ⲁⲙⲛⲧⲉ
ⲁⲙ	ⲁⲙ
ⲁⲛ̇ⲟⲕ	ⲁⲛⲟⲕ
ⲁⲛ̣ⲁⲅⲕⲏ	ⲁⲛⲁⲅⲕⲏ
ⲁⲛ̣ⲉⲭⲉ	ⲁⲛⲉⲭⲉ
ⲁⲛ̣ⲟ̣ⲕ	ⲁⲛⲟⲕ
ⲁⲛ̣	ⲁⲛ
ⲁⲛϫⲱϫ	ⲁⲛϫⲱϫ
ⲁⲛϯ	ⲁⲛⲧⲓ
ⲁⲛⲁϣ	ⲁⲛⲁϣ
ⲁⲛⲁϥ	ⲁⲛⲁϥ
ⲁⲛⲁϥ`	ⲁⲛⲁϥ
ⲁⲛⲁⲅⲕ̣ⲏ̣	ⲁⲛⲁⲅⲕⲏ
ⲁⲛⲁⲅⲕⲁⲍⲉ⳿	ⲁⲛⲁⲅⲕⲁⲍⲉ
ⲁⲛⲁⲅⲕⲁⲍⲉ	ⲁⲛⲁⲅⲕⲁⲍⲉ
ⲁⲛⲁⲅⲕⲁⲓ̈ⲟⲛ	ⲁⲛⲁⲅⲕⲁⲓⲟⲛ
ⲁⲛⲁⲅⲕⲁⲓⲟⲛ⳿	ⲁⲛⲁⲅⲕⲁⲓⲟⲛ
ⲁⲛⲁⲅⲕⲁⲓⲟⲛ	ⲁⲛⲁⲅⲕⲁⲓⲟⲛ
ⲁⲛⲁⲅⲕⲏ	ⲁⲛⲁⲅⲕⲏ
ⲁⲛⲁⲅⲛⲱⲥⲧⲏⲥ	ⲁⲛⲁⲅⲛⲱⲥⲧⲏⲥ
ⲁⲛⲁⲑⲉⲙⲁ	ⲁⲛⲁⲑⲉⲙⲁ
ⲁⲛⲁⲕⲣⲓⲛⲉ	ⲁⲛⲁⲕⲣⲓⲛⲉ
ⲁⲛⲁⲥⲧⲁⲥⲓ̇ⲥ	ⲁⲛⲁⲥⲧⲁⲥⲓⲥ
ⲁⲛⲁⲥⲧⲁⲥⲓⲥ	ⲁⲛⲁⲥⲧⲁⲥⲓⲥ
ⲁⲛⲁⲩϣ	ⲁⲛⲁⲩϣ
ⲁⲛⲁⲩ	ⲁⲛⲁⲩ
ⲁⲛⲁⲭⲱⲣⲉⲓ	ⲁⲛⲁⲭⲱⲣⲉⲓ
ⲁⲛⲁⲭⲱⲣⲓ̇ⲧⲏⲥ	ⲁⲛⲁⲭⲱⲣⲏⲧⲏⲥ
ⲁⲛⲁⲭⲱⲣⲓⲧⲏⲥ	ⲁⲛⲁⲭⲱⲣⲏⲧⲏⲥ
ⲁⲛⲁⲭⲱⲣⲓ	ⲁⲛⲁⲭⲱⲣⲉⲓ
ⲁⲛⲁ[ϥ]	ⲁⲛⲁϥ
ⲁⲛⲅ̄	ⲁⲛⲅ
ⲁⲛⲅ	ⲁⲛⲅ
ⲁⲛⲇⲓⲗⲟⲅⲓ̈ⲁ	ⲁⲛⲇⲓⲗⲟⲅⲓⲁ
ⲁⲛⲇⲓⲗⲟⲅⲓⲁ	ⲁⲛⲇⲓⲗⲟⲅⲓⲁ
ⲁⲛⲇⲣⲉⲁⲥ	ⲁⲛⲇⲣⲉⲁⲥ
ⲁⲛⲉⲭⲉ⳿	ⲁⲛⲉⲭⲉ
ⲁⲛⲉⲭⲉ	ⲁⲛⲉⲭⲉ
ⲁⲛⲍⲏⲃⲉ	ⲁⲛⲍⲏⲃⲉ
ⲁⲛⲓ	ⲁⲛⲓ
ⲁⲛⲛⲁ	ⲁⲛⲛⲁ
ⲁⲛⲛⲁ`	ⲁⲛⲛⲁ
ⲁⲛⲟⲕ	ⲁⲛⲟⲕ
ⲁⲛⲟⲕ`	ⲁⲛⲟⲕ
ⲁⲛⲟⲙⲓⲁ	ⲁⲛⲟⲙⲓⲁ
ⲁⲛⲟⲙⲓⲁ`	ⲁⲛⲟⲙⲓⲁ
ⲁⲛⲟⲙⲟⲥ⳿	ⲁⲛⲟⲙⲟⲥ
ⲁⲛⲟⲙⲟⲥ	ⲁⲛⲟⲙⲟⲥ
ⲁⲛⲟⲛ⳿	ⲁⲛⲟⲛ
ⲁⲛⲟⲛ	ⲁⲛⲟⲛ
ⲁⲛⲟⲛ`	ⲁⲛⲟⲛ
ⲁⲛⲟⲭⲏ	ⲁⲛⲟⲭⲏ
ⲁⲛⲟ⳯	ⲁⲛⲟⲛ
ⲁⲛⲧ̄	ⲁⲛⲧ
ⲁⲛⲧⲓ̈	ⲁⲛⲧⲓ
ⲁⲛⲧⲓⲕⲓⲙⲉⲛⲟⲥ	ⲁⲛⲧⲓⲕⲓⲙⲉⲛⲟⲥ
ⲁⲛⲧⲓⲗⲟⲅⲓⲁ	ⲁⲛⲧⲓⲗⲟⲅⲓⲁ
ⲁⲛⲧⲓⲭⲣⲓⲥⲧⲟⲥ	ⲁⲛⲧⲓⲭⲣⲓⲥⲧⲟⲥ
ⲁⲛⲧⲓ	ⲁⲛⲧⲓ
ⲁⲛⲧⲱⲛⲓ̇ⲟⲥ	ⲁⲛⲧⲱⲛⲓⲟⲥ
ⲁⲛⲧⲱⲛⲓⲟⲥ	ⲁⲛⲧⲱⲛⲓⲟⲥ
ⲁⲛⲧ	ⲁⲛⲧ
ⲁⲛⲩⲥⲧⲏⲥ	ⲁⲛⲩⲥⲧⲏⲥ
ⲁⲛ⳿	ⲁⲛ
ⲁⲛ︤ⲅ︥	ⲁⲛⲅ
ⲁⲛ	ⲁⲛ
ⲁⲛ`	ⲁⲛ
ⲁⲝⲓⲱⲙⲁ	ⲁⲝⲓⲱⲙⲁ
ⲁⲡ̣ⲉⲭⲉ	ⲁⲡⲉⲭⲉ
ⲁⲡⲁⲛⲧⲁ	ⲁⲡⲁⲛⲧⲁ
ⲁⲡⲁⲣⲛⲁ	ⲁⲡⲁⲣⲛⲁ
ⲁⲡⲁⲣⲭⲏ	ⲁⲡⲁⲣⲭⲏ
ⲁⲡⲁⲣ︤ⲭ︥ⲏ	ⲁⲡⲁⲣⲭⲏ
ⲁⲡⲁⲧⲁ⳿	ⲁⲡⲁⲧⲁ
ⲁⲡⲁⲧⲁ	ⲁⲡⲁⲧⲁ
ⲁⲡⲁⲧⲏ	ⲁⲡⲁⲧⲏ
ⲁⲡⲁ	ⲁⲡⲁ
ⲁⲡⲉⲓⲗⲉⲓ⳿	ⲁⲡⲉⲓⲗⲉⲓ
ⲁⲡⲉⲓⲗⲉⲓ	ⲁⲡⲉⲓⲗⲉⲓ
ⲁⲡⲉⲭⲉ	ⲁⲡⲉⲭⲉ
ⲁⲡⲉ	ⲁⲡⲉ
ⲁⲡⲉ`	ⲁⲡⲉ
ⲁⲡⲏⲩⲉ	ⲁⲡⲏⲩⲉ
ⲁⲡⲓ̇ⲗⲏ	ⲁⲡⲓⲗⲏ
ⲁⲡⲓⲗⲏ	ⲁⲡⲓⲗⲏ
ⲁⲡⲓⲥⲧⲟⲥ	ⲁⲡⲓⲥⲧⲟⲥ
ⲁⲡⲟⲇⲏⲙⲉⲓ	ⲁⲡⲟⲇⲏⲙⲉⲓ
ⲁⲡⲟⲗⲁⲩⲉ	ⲁⲡⲟⲗⲁⲩⲉ
ⲁⲡⲟⲗⲁⲩⲥⲓⲥ⳿	ⲁⲡⲟⲗⲁⲩⲥⲓⲥ
ⲁⲡⲟⲗⲁⲩⲥⲓⲥ	ⲁⲡⲟⲗⲁⲩⲥⲓⲥ
ⲁⲡⲟⲗⲗⲟⲛ	ⲁⲡⲟⲗⲗⲱⲛ
ⲁⲡⲟⲗⲗⲱⲛ	ⲁⲡⲟⲗⲗⲱⲛ
ⲁⲡⲟⲗⲗⲱ	ⲁⲡⲟⲗⲗⲱ
ⲁⲡⲟⲗⲟⲅⲓ̇ⲁ̇	ⲁⲡⲟⲗⲟⲅⲓⲁ
ⲁⲡⲟⲗⲟⲅⲓⲁ	ⲁⲡⲟⲗⲟⲅⲓⲁ
ⲁⲡⲟⲥⲧⲁⲥⲥⲉ	ⲁⲡⲟⲥⲧⲁⲥⲥⲉ
ⲁⲡⲟⲥⲧⲁⲧⲏⲥ	ⲁⲡⲟⲥⲧⲁⲧⲏⲥ
ⲁⲡⲟⲥⲧⲟⲗⲟⲥ	ⲁⲡⲟⲥⲧⲟⲗⲟⲥ
ⲁⲡⲟⲥⲧⲟⲗⲟⲥ`	ⲁⲡⲟⲥⲧⲟⲗⲟⲥ
ⲁⲡⲟⲧⲁⲥⲥⲉ	ⲁⲡⲟⲧⲁⲥⲥⲉ
ⲁⲡⲟⲧⲁⲥⲥⲉ`	ⲁⲡⲟⲧⲁⲥⲥⲉ
ⲁⲡⲟⲧ	ⲁⲡⲟⲧ
ⲁⲡⲟⲫⲁⲥⲓⲥ	ⲁⲡⲟⲫⲁⲥⲓⲥ
ⲁⲡⲥ	ⲁⲡⲥ
ⲁⲡ	ϩⲁⲡ
ⲁⲣⲁ	ⲁⲣⲁ
ⲁⲣⲉⲥⲕⲉ	ⲁⲣⲉⲥⲕⲉ
ⲁⲣⲉⲥ	ⲁⲣⲉⲥ
ⲁⲣⲉⲧⲏ	ⲁⲣⲉⲧⲏ
ⲁⲣⲏϫ︤	ⲁⲣⲏϫ
ⲁⲣⲏϫ	ⲁⲣⲏϫ
ⲁⲣⲏⲩ	ⲁⲣⲏⲩ
ⲁⲣⲓⲑⲩⲥⲓⲁⲍⲉ	ⲁⲣⲓⲑⲩⲥⲓⲁⲍⲉ
ⲁⲣⲓⲕⲉ	ⲁⲣⲓⲕⲉ
ⲁⲣⲓⲕⲉ`	ⲁⲣⲓⲕⲉ
ⲁⲣⲓⲙⲁⲑⲁⲓⲟⲥ	ⲁⲣⲓⲙⲁⲑⲁⲓⲟⲥ
ⲁⲣⲓⲥⲧⲟⲛ	ⲁⲣⲓⲥⲧⲟⲛ
ⲁⲣⲓ	ⲁⲣⲓ
ⲁⲣⲛⲁ	ⲁⲣⲛⲁ
ⲁⲣⲟⲟⲩⲉ⳿	ⲁⲣⲟⲟⲩⲉ
ⲁⲣⲟⲟⲩⲉ	ⲁⲣⲟⲟⲩⲉ
ⲁⲣⲧⲉⲙⲓ̈ⲥ	ⲁⲣⲧⲉⲙⲓⲥ
ⲁⲣⲧⲉⲙⲓⲥ	ⲁⲣⲧⲉⲙⲓⲥ
ⲁⲣⲭⲁⲓⲟⲥ	ⲁⲣⲭⲁⲓⲟⲥ
ⲁⲣⲭⲁⲓⲟⲥ`	ⲁⲣⲭⲁⲓⲟⲥ
ⲁⲣⲭⲉⲓ	ⲁⲣⲭⲉⲓ
ⲁⲣⲭⲉⲓ`	ⲁⲣⲭⲉⲓ
ⲁⲣⲭⲉⲟⲥ	ⲁⲣⲭⲉⲟⲥ
ⲁⲣⲭⲉⲥⲑⲁⲓ	ⲁⲣⲭⲉⲥⲑⲁⲓ
ⲁⲣⲭⲏ̂	ⲁⲣⲭⲏ
ⲁⲣⲭⲏⲉ̇ⲡⲓ̇ⲥⲕⲟⲡⲟⲥ	ⲁⲣⲭⲏⲉⲡⲓⲥⲕⲟⲡⲟⲥ
ⲁⲣⲭⲏⲉⲡⲓⲥⲕⲟⲡⲟⲥ	ⲁⲣⲭⲏⲉⲡⲓⲥⲕⲟⲡⲟⲥ
ⲁⲣⲭⲏⲗⲏⲥⲧⲏⲥ	ⲁⲣⲭⲏⲗⲏⲥⲧⲏⲥ
ⲁⲣⲭⲏ	ⲁⲣⲭⲏ
ⲁⲣⲭⲓ̇ⲙⲁⲇⲣⲓ̇ⲧⲏⲥ	ⲁⲣⲭⲓⲙⲁⲛⲇⲣⲓⲧⲏⲥ
ⲁⲣⲭⲓⲉⲣⲉⲩⲥ	ⲁⲣⲭⲓⲉⲣⲉⲩⲥ
ⲁⲣⲭⲓⲙⲁⲇⲣⲓⲧⲏⲥ	ⲁⲣⲭⲓⲙⲁⲛⲇⲣⲓⲧⲏⲥ
ⲁⲣⲭⲓⲥⲩⲛⲁⲅⲱⲅⲟⲥ	ⲁⲣⲭⲓⲥⲩⲛⲁⲅⲱⲅⲟⲥ
ⲁⲣⲭⲓⲧⲉⲕⲧⲱⲛ	ⲁⲣⲭⲓⲧⲉⲕⲧⲱⲛ
ⲁⲣⲭⲓⲧⲗⲕ	ⲁⲣⲭⲓⲧⲗⲕ
ⲁⲣⲭⲓ	ⲁⲣⲭⲉⲓ
ⲁⲣⲭⲱⲛ	ⲁⲣⲭⲱⲛ
ⲁⲣ	ⲁⲣ
ⲁⲥⲉⲃⲏⲥ	ⲁⲥⲉⲃⲏⲥ
ⲁⲥⲑⲉⲛⲏⲥ	ⲁⲥⲑⲉⲛⲏⲥ
ⲁⲥⲓⲁ	ⲁⲥⲓⲁ
ⲁⲥⲕⲉⲓ	ⲁⲥⲕⲉⲓ
ⲁⲥⲕⲏⲥⲓ̇ⲥ	ⲁⲥⲕⲏⲥⲓⲥ
ⲁⲥⲕⲏⲥⲓⲥ	ⲁⲥⲕⲏⲥⲓⲥ
ⲁⲥⲟⲩ	ⲁⲥⲟⲩ
ⲁⲥⲡⲁⲍⲉ	ⲁⲥⲡⲁⲍⲉ
ⲁⲥⲡⲁⲥⲙⲟⲥ	ⲁⲥⲡⲁⲥⲙⲟⲥ
ⲁⲥⲡⲉ	ⲁⲥⲡⲉ
ⲁⲥⲭⲩⲙⲟⲛⲓ	ⲁⲥⲭⲏⲙⲟⲛⲉⲓ
ⲁⲥ	ⲁⲥ
ⲁⲧϣⲁⲩ	ⲁⲧϣⲁⲩ
ⲁⲧϣⲉⲗⲉⲉⲧ	ⲁⲧϣⲉⲗⲉⲉⲧ
ⲁⲧϩⲏⲧ	ⲁⲧϩⲏⲧ
ⲁⲧϩⲟⲧⲉ	ⲁⲧϩⲟⲧⲉ
ⲁⲧϭⲟⲙ	ⲁⲧϭⲟⲙ
ⲁⲧⲏⲡⲉ	ⲁⲧⲏⲡⲉ
ⲁⲧⲑⲁⲃ	ⲁⲧⲑⲁⲃ
ⲁⲧⲕⲁⲣⲡⲟⲥ	ⲁⲧⲕⲁⲣⲡⲟⲥ
ⲁⲧⲕⲓⲙ	ⲁⲧⲕⲓⲙ
ⲁⲧⲙⲟⲩⲛⲅ	ⲁⲧⲙⲟⲩⲛⲅ
ⲁⲧⲙⲡϣⲁ	ⲁⲧⲙⲡϣⲁ
ⲁⲧⲛⲁϩⲧⲉ	ⲁⲧⲛⲁϩⲧⲉ
ⲁⲧⲛⲁ⳿	ⲁⲧⲛⲁ
ⲁⲧⲛⲁ	ⲁⲧⲛⲁ
ⲁⲧⲛⲟⲃ̣ⲉ	ⲁⲧⲛⲟⲃⲉ
ⲁⲧⲛⲟⲃⲉ	ⲁⲧⲛⲟⲃⲉ
ⲁⲧⲛⲟⲩⲧⲉ	ⲁⲧⲛⲟⲩⲧⲉ
ⲁⲧⲛⲟⲩⲧⲉ`	ⲁⲧⲛⲟⲩⲧⲉ
ⲁⲧⲟⲩⲱ	ⲁⲧⲟⲩⲱ
ⲁⲧⲣⲟⲟⲩϣ	ⲁⲧⲣⲟⲟⲩϣ
ⲁⲧⲥⲃⲃⲉ	ⲁⲧⲥⲃⲃⲉ
ⲁⲧⲥⲃⲱ̂	ⲁⲧⲥⲃⲱ
ⲁⲧⲥⲃⲱ	ⲁⲧⲥⲃⲱ
ⲁⲧⲥⲟⲟⲩⲛ	ⲁⲧⲥⲟⲟⲩⲛ
ⲁⲧⲥⲟⲟⲩⲛ`	ⲙⲛⲧⲁⲧⲥⲟⲟⲩⲛ
ⲁⲧⲥⲱⲧⲙ̄`	ⲁⲧⲥⲱⲧⲙ
ⲁⲧⲥⲱⲧⲙ	ⲁⲧⲥⲱⲧⲙ
ⲁⲧⲥⲱⲧ︤ⲙ︥	ⲁⲧⲥⲱⲧⲙ
ⲁⲧⲧⲁⲕⲟ	ⲁⲧⲧⲁⲕⲟ
ⲁⲧ︤ⲙ︥ⲡϣⲁ`	ⲁⲧⲙⲡϣⲁ
ⲁⲧ	ⲁⲧ
ⲁⲩ̣ⲱ̣	ⲁⲩⲱ
ⲁⲩⲃⲱⲕ	ⲃⲱⲕ
ⲁⲩⲉⲓ̇ⲛ	ⲁⲩⲉⲓⲛ
ⲁⲩⲉⲓⲛ	ⲁⲩⲉⲓⲛ
ⲁⲩⲉⲓⲥ	ⲁⲩⲉⲓⲥ
ⲁⲩⲉⲧ	ⲁⲩⲉⲧ
ⲁⲩⲏⲧ	ⲁⲩⲏⲧ
ⲁⲩⲗⲏ	ⲁⲩⲗⲏ
ⲁⲩⲝⲁⲛⲉ	ⲁⲩⲝⲁⲛⲉ
ⲁⲩⲝⲁⲛⲉ`	ⲁⲩⲝⲁⲛⲉ
ⲁⲩⲧⲟⲩ	ⲁⲩⲧⲟⲩ
ⲁⲩⲧⲟⲩ`	ⲁⲩⲧⲟⲩ
ⲁⲩⲩⲱ	ⲁⲩⲱ
ⲁⲩⲱ̂	ⲁⲩⲱ
ⲁⲩⲱ̄	ⲁⲩⲱ
ⲁⲩⲱ̇	ⲁⲩⲱ
ⲁⲩⲱ̣	ⲁⲩⲱ
ⲁⲩⲱ	ⲁⲩⲱ
ⲁⲩ	ⲁⲩ
ⲁⲩ[ⲩ]ⲱ	ⲁⲩⲱ
ⲁⲩ[ⲱ	ⲁⲩⲱ
ⲁⲫⲑⲟⲛⲓⲁ	ⲁⲫⲑⲟⲛⲓⲁ
ⲁⲫⲟⲣⲙⲏ⳿	ⲁⲫⲟⲣⲙⲏ
ⲁⲫⲟⲣⲙⲏ	ⲁⲫⲟⲣⲙⲏ
ⲁⲭⲁⲓⲁ	ⲁⲭⲁⲓⲁ
ⲁⲭⲁⲓⲕⲟⲥ	ⲁⲭⲁⲓⲕⲟⲥ
ⲁⲯⲩⲭⲟⲛ	ⲁⲯⲩⲭⲟⲛ
ⲁ︤ⲣ︥ⲁ⳿	ⲁⲣⲁ
ⲁ︤ⲣ︥ⲁ	ⲁⲣⲁ
ⲁ︤	ⲁ
ⲁ	ⲁ
ⲁ[ⲛ̣]	ⲁⲛ
ⲁ[ⲡⲟⲥ]ⲧⲟⲗⲟⲥ	ⲁⲡⲟⲥⲧⲟⲗⲟⲥ
ⲂⲒⲔⲦⲰⲢ	ⲃⲓⲕⲧⲱⲣ
ⲃ̄ⲗⲗⲏ̂	ⲃⲗⲗⲏ
ⲃ̣ⲱⲕ⳿	ⲃⲱⲕ
ⲃϣⲉ	ⲃϣⲉ
ⲃϣⲉ`	ⲃϣⲉ
ⲃⲁϣⲟⲣ⳿	ⲃⲁϣⲟⲣ
ⲃⲁϣⲟⲣ	ⲃⲁϣⲟⲣ
ⲃⲁⲁⲃⲉ	ⲃⲁⲁⲃⲉ
ⲃⲁⲃⲉ̂	ⲃⲁⲃⲉ
ⲃⲁⲃⲉⲣⲱⲙⲉ	ⲃⲁⲃⲉⲣⲱⲙⲉ
ⲃⲁⲃⲉ⳿ⲣⲱⲙⲉ	ⲃⲁⲃⲉⲣⲱⲙⲉ
ⲃⲁⲃⲉ	ⲃⲁⲃⲉ
ⲃⲁⲗⲗⲁⲧⲓ̇ⲟⲛ	ⲃⲁⲗⲗⲁⲧⲓⲟⲛ
ⲃⲁⲗⲗⲁⲧⲓⲟⲛ	ⲃⲁⲗⲗⲁⲧⲓⲟⲛ
ⲃⲁⲗⲗⲁ	ⲃⲁⲗⲗⲁ
ⲃⲁⲗ	ⲃⲁⲗ
ⲃⲁⲗ`	ⲃⲁⲗ
ⲃⲁⲡⲧⲓⲍⲉ	ⲃⲁⲡⲧⲓⲍⲉ
ⲃⲁⲡⲧⲓⲥⲙⲁ	ⲃⲁⲡⲧⲓⲥⲙⲁ
ⲃⲁⲡⲧⲓⲥⲧⲏⲥ	ⲃⲁⲡⲧⲓⲥⲧⲏⲥ
ⲃⲁⲣⲁⲃⲃⲁⲥ	ⲃⲁⲣⲁⲃⲃⲁⲥ
ⲃⲁⲣⲁⲃⲃⲁ	ⲃⲁⲣⲁⲃⲃⲁⲥ
ⲃⲁⲣⲁⲭⲓⲁⲥ	ⲃⲁⲣⲁⲭⲓⲁⲥ
ⲃⲁⲣⲃⲁⲣⲟⲥ⳿	ⲃⲁⲣⲃⲁⲣⲟⲥ
ⲃⲁⲣⲃⲁⲣⲟⲥ	ⲃⲁⲣⲃⲁⲣⲟⲥ
ⲃⲁⲣⲑⲟⲗⲟⲙⲁⲓⲟⲥ	ⲃⲁⲣⲑⲟⲗⲟⲙⲁⲓⲟⲥ
ⲃⲁⲣⲛⲁⲃⲁⲥ	ⲃⲁⲣⲛⲁⲃⲁⲥ
ⲃⲁⲣⲟⲥ⳿	ⲃⲁⲣⲟⲥ
ⲃⲁⲣⲟⲥ	ⲃⲁⲣⲟⲥ
ⲃⲁⲣⲧⲓⲙⲁⲓⲟⲥ	ⲃⲁⲣⲧⲓⲙⲁⲓⲟⲥ
ⲃⲁⲥⲁⲛⲓⲍⲉ	ⲃⲁⲥⲁⲛⲓⲍⲉ
ⲃⲁⲥⲓ̇ⲙⲟⲥ	ⲃⲁⲥⲓⲙⲟⲥ
ⲃⲁⲥⲓⲗⲉⲓⲧⲏⲥ	ⲃⲁⲥⲓⲗⲉⲓⲧⲏⲥ
ⲃⲁⲥⲓⲗⲏⲧⲏⲥ	ⲃⲁⲥⲓⲗⲉⲓⲧⲏⲥ
ⲃⲁⲥⲓⲙⲟⲥ	ⲃⲁⲥⲓⲙⲟⲥ
ⲃⲁⲥⲕⲁⲛⲟⲥ	ⲃⲁⲥⲕⲁⲛⲟⲥ
ⲃⲁⲧⲟⲥ	ⲃⲁⲧⲟⲥ
ⲃⲁⲩⲕⲁⲗⲓⲟⲛ	ⲃⲁⲩⲕⲁⲗⲓⲟⲛ
ⲃⲁⲩⲕⲁⲗⲓⲟⲛ`	ⲃⲁⲩⲕⲁⲗⲓⲟⲛ
ⲃⲃⲗⲗⲁϥ	ⲃⲃⲗⲗⲁϥ
ⲃⲃⲟⲗ	ⲃⲃⲟⲗ
ⲃⲃⲣⲣⲉ	ⲃⲃⲣⲣⲉ
ⲃⲉⲉⲗⲍⲉⲃⲟⲩⲗ	ⲃⲉⲉⲗⲍⲉⲃⲟⲩⲗ
ⲃⲉⲉⲗⲍⲉⲃⲟⲩⲗ`	ⲃⲉⲉⲗⲍⲉⲃⲟⲩⲗ
ⲃⲉⲕⲉ	ⲃⲉⲕⲉ
ⲃⲉⲛⲓ̇ⲁ̇ⲙⲓ̇ⲛ	ⲃⲉⲛⲓⲁⲙⲓⲛ
ⲃⲉⲛⲓⲁⲙⲓⲛ	ⲃⲉⲛⲓⲁⲙⲓⲛ
ⲃⲉⲛⲓⲁⲙⲓⲛ`	ⲃⲉⲛⲓⲁⲙⲓⲛ
ⲃⲏⲃ	ⲃⲏⲃ
ⲃⲏⲇⲥⲁⲓⲇⲁⲛ	ⲃⲏⲇⲥⲁⲓⲇⲁⲛ
ⲃⲏⲑⲁⲛⲓⲁ	ⲃⲏⲑⲁⲛⲓⲁ
ⲃⲏⲑⲥⲁⲓⲇⲁ	ⲃⲏⲑⲥⲁⲓⲇⲁ
ⲃⲏⲕ	ⲃⲏⲕ
ⲃⲏⲗ	ⲃⲏⲗ
ⲃⲏⲙⲁ	ⲃⲏⲙⲁ
ⲃⲏⲥⲁⲣⲓ̈ⲟⲛ	ⲃⲏⲥⲁⲣⲓⲟⲛ
ⲃⲏⲥⲁⲣⲓⲟⲛ	ⲃⲏⲥⲁⲣⲓⲟⲛ
ⲃⲏⲧⲫⲁⲅⲏ	ⲃⲏⲧⲫⲁⲅⲏ
ⲃⲏⲧ	ⲃⲏⲧ
ⲃⲓ̇ⲣ	ⲃⲓⲣ
ⲃⲓⲕⲧⲱⲣ	ⲃⲓⲕⲧⲱⲣ
ⲃⲓⲟⲥ	ⲃⲓⲟⲥ
ⲃⲓⲟⲥ`	ⲃⲓⲟⲥ
ⲃⲓⲣ	ⲃⲓⲣ
ⲃⲗⲃⲓⲗⲉ	ⲃⲗⲃⲓⲗⲉ
ⲃⲗⲗⲉ	ⲃⲗⲗⲉ
ⲃⲗⲗⲏ	ⲃⲗⲗⲏ
ⲃⲗ	ⲃⲗ
ⲃⲛⲧ	ⲃⲛⲧ
ⲃⲛ︤ⲧ︥	ⲃⲛⲧ
ⲃⲟⲁⲛⲏⲣⲅⲉⲥ	ⲃⲟⲁⲛⲏⲣⲅⲉⲥ
ⲃⲟⲏⲑⲉⲓ̂	ⲃⲟⲏⲑⲉⲓ
ⲃⲟⲏⲑⲉⲓⲁ	ⲃⲟⲏⲑⲉⲓⲁ
ⲃⲟⲏⲑⲉⲓ	ⲃⲟⲏⲑⲉⲓ
ⲃⲟⲏⲑⲓⲁ⳿	ⲃⲟⲏⲑⲓⲁ
ⲃⲟⲏⲑⲓⲁ	ⲃⲟⲏⲑⲓⲁ
ⲃⲟⲏⲑⲟⲥ	ⲃⲟⲏⲑⲟⲥ
ⲃⲟⲗⲃⲗ	ⲃⲟⲗⲃⲗ
ⲃⲟⲗⲃ︤ⲗ︥	ⲃⲟⲗⲃⲗ
ⲃⲟⲗ	ⲃⲟⲗ
ⲃⲟⲙⲱⲥ	ⲃⲟⲙⲱⲥ
ⲃⲟⲟⲛⲉ	ⲃⲟⲟⲛⲉ
ⲃⲟⲧⲉ	ⲃⲟⲧⲉ
ⲃⲟⲩⲗⲉⲩⲧⲏⲥ	ⲃⲟⲩⲗⲉⲩⲧⲏⲥ
ⲃⲣⲣⲉ	ⲃⲣⲣⲉ
ⲃⲥⲱ	ϩⲃⲥⲱ
ⲃⲱϣ	ⲃⲱϣ
ⲃⲱⲕ⳿	ⲃⲱⲕ
ⲃⲱⲕ	ⲃⲱⲕ
ⲃⲱⲕ`	ⲃⲱⲕ
ⲃⲱⲗ	ⲃⲱⲗ
ⲃⲱⲗ`	ⲃⲱⲗ
ⲃⲱ	ⲃⲱ
ⲃ︤ⲗ︥ⲗⲉ	ⲃⲗⲗⲉ
ⲃ︤ⲣ︥ⲣⲉ⳿	ⲃⲣⲣⲉ
ⲃ︥ⲥⲱ	ϩⲃⲥⲱ
ⲃ	ⲛ
Ⲅⲁⲣ	ⲅⲁⲣ
ⲅ̄	ⲅ
ⲅ̇ⲛⲱⲙⲏ	ⲅⲛⲱⲙⲏ
ⲅ̇	ⲅ
ⲅⲁⲃⲣⲓⲏⲗ	ⲅⲁⲃⲣⲓⲏⲗ
ⲅⲁⲍⲟⲫⲩⲗⲁⲕⲓⲟⲛ	ⲅⲁⲍⲟⲫⲩⲗⲁⲕⲓⲟⲛ
ⲅⲁⲓⲟⲥ	ⲅⲁⲓⲟⲥ
ⲅⲁⲗⲁⲧⲓⲁ	ⲅⲁⲗⲁⲧⲓⲁ
ⲅⲁⲗⲓⲗⲁⲓⲁ	ⲅⲁⲗⲓⲗⲁⲓⲁ
ⲅⲁⲗⲓⲗⲁⲓⲟⲥ	ⲅⲁⲗⲓⲗⲁⲓⲟⲥ
ⲅⲁⲙⲟⲥ	ⲅⲁⲙⲟⲥ
ⲅⲁⲣ⳿	ⲅⲁⲣ
ⲅⲁⲣ	ⲅⲁⲣ
ⲅⲁⲣ`	ⲅⲁⲣ
ⲅⲁⲧⲁⲗⲁⲗⲓⲁ	ⲕⲁⲧⲁⲗⲁⲗⲓⲁ
ⲅⲉϩⲉⲛⲛⲁ	ⲅⲉϩⲉⲛⲛⲁ
ⲅⲉⲑⲥⲏⲙⲁⲛⲉⲓ	ⲅⲉⲑⲥⲏⲙⲁⲛⲉⲓ
ⲅⲉⲛⲉⲁ	ⲅⲉⲛⲉⲁ
ⲅⲉⲛⲏⲙⲁ	ⲅⲉⲛⲏⲙⲁ
ⲅⲉⲛⲛⲁⲓⲟⲥ	ⲅⲉⲛⲛⲁⲓⲟⲥ
ⲅⲉⲛⲛⲏⲥⲁⲣⲉⲧ	ⲅⲉⲛⲛⲏⲥⲁⲣⲉⲧ
ⲅⲉⲛⲟⲥ	ⲅⲉⲛⲟⲥ
ⲅⲉⲣⲁⲥⲏⲛⲟⲥ	ⲅⲉⲣⲁⲥⲏⲛⲟⲥ
ⲅⲛⲏⲥⲓⲟⲥ	ⲅⲛⲏⲥⲓⲟⲥ
ⲅⲛⲱⲙⲏ	ⲅⲛⲱⲙⲏ
ⲅⲟⲗⲅⲟⲑⲁ	ⲅⲟⲗⲅⲟⲑⲁ
ⲅⲣⲁⲙⲙⲁⲧⲉⲩⲥ⳿	ⲅⲣⲁⲙⲙⲁⲧⲉⲩⲥ
ⲅⲣⲁⲙⲙⲁⲧⲉⲩⲥ	ⲅⲣⲁⲙⲙⲁⲧⲉⲩⲥ
ⲅⲣⲁⲪⲏ	ⲅⲣⲁⲫⲏ
ⲅⲣⲁⲪⲏ`	ⲅⲣⲁⲫⲏ
ⲅⲣⲁⲫⲏ̂	ⲅⲣⲁⲫⲏ
ⲅⲣⲁⲫⲏ̂`	ⲅⲣⲁⲫⲏ
ⲅⲣⲁⲫⲏ̇	ⲅⲣⲁⲫⲏ
ⲅⲣⲁⲫⲏ⳿	ⲅⲣⲁⲫⲏ
ⲅⲣⲁⲫⲏ	ⲅⲣⲁⲫⲏ
ⲅⲣⲁⲫⲏ`	ⲅⲣⲁⲫⲏ
ⲅ⳿	ⲅ⳿
ⲅ︥	ⲅ
ⲅ	ⲅ
Ⲇⲉ̇	ⲇⲉ
Ⲇⲉ	ⲇⲉ
ⲇ̣ⲉ	ⲇⲉ
ⲇ̣ⲓ̣ⲁ̣ⲕ̣ⲣⲓⲛⲉ	ⲇⲓⲁⲕⲣⲓⲛⲉ
ⲇ̣ⲓ̣ⲕ̣[ⲁⲓⲟⲥ	ⲇⲓⲕⲁⲓⲟⲥ
ⲇⲁⲓ̇ⲙⲱⲛⲓ̇ⲟ̇ⲛ	ⲇⲁⲓⲙⲱⲛⲓⲟⲛ
ⲇⲁⲓ̇ⲙⲱⲛ	ⲇⲁⲓⲙⲱⲛ
ⲇⲁⲓⲙⲟⲛⲓⲟⲛ⳿	ⲇⲁⲓⲙⲟⲛⲓⲟⲛ
ⲇⲁⲓⲙⲟⲛⲓⲟⲛ	ⲇⲁⲓⲙⲟⲛⲓⲟⲛ
ⲇⲁⲓⲙⲱⲛⲓⲟⲛ	ⲇⲁⲓⲙⲱⲛⲓⲟⲛ
ⲇⲁⲓⲙⲱⲛ⳿	ⲇⲁⲓⲙⲱⲛ
ⲇⲁⲓⲙⲱⲛ	ⲇⲁⲓⲙⲱⲛ
ⲇⲁⲗⲙⲁⲛⲟⲩⲑⲁ	ⲇⲁⲗⲙⲁⲛⲟⲩⲑⲁ
ⲇⲁⲛⲓ̇ⲏⲗ	ⲇⲁⲛⲓⲏⲗ
ⲇⲁⲛⲓⲏ̄ⲗ	ⲇⲁⲛⲓⲏⲗ
ⲇⲁⲛⲓⲏⲗ	ⲇⲁⲛⲓⲏⲗ
ⲇⲁⲝⲓⲥ	ⲧⲁⲝⲓⲥ
ⲇⲁⲩⲉⲓⲇ	ⲇⲁⲩⲉⲓⲇ
ⲇⲉ̇	ⲇⲉ
ⲇⲉⲃⲃⲱⲣⲁ	ⲇⲉⲃⲃⲱⲣⲁ
ⲇⲉⲃⲃⲱⲣⲁ`	ⲇⲉⲃⲃⲱⲣⲁ
ⲇⲉⲓ̈ⲕⲁⲓ̈ⲟⲥ	ⲇⲓⲕⲁⲓⲟⲥ
ⲇⲉⲓⲕⲁⲓⲟⲥ	ⲇⲉⲓⲕⲁⲓⲟⲥ
ⲇⲉⲓⲡⲛⲟⲛ	ⲇⲉⲓⲡⲛⲟⲛ
ⲇⲉⲕⲁⲡⲟⲗⲓⲥ	ⲇⲉⲕⲁⲡⲟⲗⲓⲥ
ⲇⲉⲙⲱⲛ	ⲇⲁⲓⲙⲱⲛ
ⲇⲉⲩⲧ̣ⲉⲣ	ⲇⲉⲩⲧⲉⲣⲁⲥ
ⲇⲉⲩⲧⲉⲣ	ⲇⲉⲩⲧⲉⲣⲁⲥ
ⲇⲉ	ⲇⲉ
ⲇⲉ`	ⲇⲉ
ⲇⲓ̇ⲁ̇ⲃⲟⲗⲟⲥ	ⲇⲓⲁⲃⲟⲗⲟⲥ
ⲇⲓ̈ⲕⲁⲓ̈ⲱⲥ	ⲇⲓⲕⲁⲓⲱⲥ
ⲇⲓⲁⲃⲟⲗⲟⲥ⳿	ⲇⲓⲁⲃⲟⲗⲟⲥ
ⲇⲓⲁⲃⲟⲗⲟⲥ	ⲇⲓⲁⲃⲟⲗⲟⲥ
ⲇⲓⲁⲑⲏⲕⲏ	ⲇⲓⲁⲑⲏⲕⲏ
ⲇⲓⲁⲑⲏⲕⲏ`	ⲇⲓⲁⲑⲏⲕⲏ
ⲇⲓⲁⲕⲟⲛⲉⲓ	ⲇⲓⲁⲕⲟⲛⲉⲓ
ⲇⲓⲁⲕⲟⲛⲓⲁ	ⲇⲓⲁⲕⲟⲛⲓⲁ
ⲇⲓⲁⲕⲟⲛⲓⲁ`	ⲇⲓⲁⲕⲟⲛⲓⲁ
ⲇⲓⲁⲕⲟⲛⲓ	ⲇⲓⲁⲕⲟⲛⲓ
ⲇⲓⲁⲕⲟⲛⲟⲥ	ⲇⲓⲁⲕⲟⲛⲟⲥ
ⲇⲓⲁⲕⲣ̣ⲓ̣[ⲛ]ⲉ	ⲇⲓⲁⲕⲣⲓⲛⲉ
ⲇⲓⲁⲕⲣⲓⲛⲉ	ⲇⲓⲁⲕⲣⲓⲛⲉ
ⲇⲓⲁⲕⲣⲓⲥⲓⲥ	ⲇⲓⲁⲕⲣⲓⲥⲓⲥ
ⲇⲓⲁⲕⲱⲛ	ⲇⲓⲁⲕⲱⲛ
ⲇⲓⲁⲧⲁⲅⲙⲁ	ⲇⲓⲁⲧⲁⲅⲙⲁ
ⲇⲓⲕⲁⲓⲟⲛ	ⲇⲓⲕⲁⲓⲟⲛ
ⲇⲓⲕⲁⲓⲟⲥⲩⲛⲏ̂`	ⲇⲓⲕⲁⲓⲟⲥⲩⲛⲏ
ⲇⲓⲕⲁⲓⲟⲥⲩⲛⲏ	ⲇⲓⲕⲁⲓⲟⲥⲩⲛⲏ
ⲇⲓⲕⲁⲓⲟⲥⲩⲛⲏ`	ⲇⲓⲕⲁⲓⲟⲥⲩⲛⲏ
ⲇⲓⲕⲁⲓⲟⲥ	ⲇⲓⲕⲁⲓⲟⲥ
ⲇⲓⲕⲁⲓⲟⲥ`	ⲇⲓⲕⲁⲓⲟⲥ
ⲇⲓⲕⲁⲓⲱⲙⲁ	ⲇⲓⲕⲁⲓⲱⲙⲁ
ⲇⲓⲕⲁⲓⲱⲥ	ⲇⲓⲕⲁⲓⲱⲥ
ⲇⲓⲕⲁⲥⲧⲏⲥ	ⲇⲓⲕⲁⲥⲧⲏⲥ
ⲇⲓⲟ̄ⲕⲗⲏϯⲁⲛⲟⲥ	ⲇⲓⲟⲕⲗⲏϯⲁⲛⲟⲥ
ⲇⲓⲟⲕⲗⲏϯⲁⲛⲟⲥ	ⲇⲓⲟⲕⲗⲏϯⲁⲛⲟⲥ
ⲇⲓⲡⲛⲟⲛ	ⲇⲉⲓⲡⲛⲟⲛ
ⲇⲓⲥⲧⲁⲍⲉ	ⲇⲓⲥⲧⲁⲍⲉ
ⲇⲓⲱⲅⲙⲟⲥ	ⲇⲓⲱⲅⲙⲟⲥ
ⲇⲓⲱⲕⲉ	ⲇⲓⲱⲕⲉ
ⲇⲟⲇⲏⲥ	ⲇⲟⲇⲏⲥ
ⲇⲟⲕⲓⲙⲁⲍⲉ	ⲇⲟⲕⲓⲙⲁⲍⲉ
ⲇⲟⲕⲓ	ⲇⲟⲕⲉⲓ
ⲇⲟⲩⲗⲟⲥ	ⲇⲟⲩⲗⲟⲥ
ⲇⲟⲩⲙⲁⲓⲁ	ⲓⲇⲟⲩⲙⲁⲓⲁ
ⲇⲩⲛⲁⲧⲟⲥ	ⲇⲩⲛⲁⲧⲟⲥ
ⲇⲱⲣⲟⲛ⳿	ⲇⲱⲣⲟⲛ
ⲇⲱⲣⲟⲛ	ⲇⲱⲣⲟⲛ
Ⲉϣϫⲉ	ⲉϣϫⲉ
Ⲉϣⲱⲡⲉ	ⲉϣⲱⲡⲉ
Ⲉϣⲱⲡⲉ`	ⲉϣⲱⲡⲉ
ⲈϨⲢⲀⲒ	ⲉϩⲣⲁⲓ
ⲈϪⲰ	ⲉϫⲱ
ⲈⲂⲞⲖ	ⲉⲃⲟⲗ
ⲈⲂⲞⲦ	ⲉⲃⲟⲧ
ⲈⲒⲢⲎⲚⲎ	ⲉⲓⲣⲏⲛⲏ
ⲈⲒ	ⲉⲓ
Ⲉⲓⲧⲉ	ⲉⲓⲧⲉ
Ⲉⲕϣⲁⲛ	ⲉⲕϣⲁⲛ
Ⲉⲛϣⲁⲛ	ⲉⲛϣⲁⲛ
Ⲉⲛⲉ	ⲉⲛⲉ
Ⲉⲡⲉⲓⲇⲏ	ⲉⲡⲉⲓⲇⲏ
Ⲉⲡⲉⲓⲇⲏ`	ⲉⲡⲉⲓⲇⲏ
ⲈⲢⲈ	ⲉⲣⲉ
Ⲉⲣϣⲁⲛ	ⲉⲣϣⲁⲛ
Ⲉⲣⲉ	ⲉⲣⲉ
ⲈⲦ	ⲉⲧ
Ⲉⲧⲃⲉ	ⲉⲧⲃⲉ
Ⲉⲩⲉ	ⲉⲩⲉ
Ⲉ︤	ⲉ
Ⲉ	ⲉ
ⲉ̂	ⲉ
ⲉ̂[ⲧ	ⲉⲧ
ⲉ̄̄ⲣⲟ	ⲉⲣⲟ
ⲉ̄ϩⲟⲩⲛ	ⲉϩⲟⲩⲛ
ⲉ̄ϩⲟⲩ⳯	ⲉϩⲟⲩⲛ
ⲉ̄ϫⲙ̄	ⲉϫⲙ
ⲉ̄ϫⲛ̄	ⲉϫⲛ
ⲉ̄ϫⲱ	ⲉϫⲱ
ⲉ̄ⲃⲟⲗ	ⲉⲃⲟⲗ
ⲉ̄ⲛⲉ	ⲉⲛⲉ
ⲉ̄ⲟⲟⲩ	ⲉⲟⲟⲩ
ⲉ̄ⲡⲉ	ⲉⲡⲉ
ⲉ̄ⲡⲓⲧⲓⲙⲁ	ⲉⲡⲓⲧⲓⲙⲁ
ⲉ̄ⲣⲉ	ⲉⲣⲉ
ⲉ̄ⲣⲏⲩ	ⲉⲣⲏⲩ
ⲉ̄ⲣⲟ	ⲉⲣⲟ
ⲉ̄ⲣⲱ	ⲉⲣⲱ
ⲉ̄ⲧⲉ	ⲉⲧⲉ
ⲉ̄ⲧ	ⲉⲧ
ⲉ̄	ⲉ
ⲉ̇ϣϫⲉ	ⲉϣϫⲉ
ⲉ̇ϣⲱⲡⲉ	ⲉϣⲱⲡⲉ
ⲉ̇ϥϣⲁⲛ	ⲉϥϣⲁⲛ
ⲉ̇ϥⲉ	ⲉϥⲉ
ⲉ̇ϩⲟⲩⲉ̇	ⲉϩⲟⲩⲉ
ⲉ̇ϩⲟⲩⲛ	ⲉϩⲟⲩⲛ
ⲉ̇ϩⲣⲁⲓ̇	ⲉϩⲣⲁⲓ
ⲉ̇ϩⲣⲁⲓ	ⲉϩⲣⲁⲓ
ⲉ̇ϫⲙ̇	ⲉϫⲙ
ⲉ̇ϫⲛ̇	ⲉϫⲛ
ⲉ̇ϫⲛ	ⲉϫⲛ
ⲉ̇ϫⲱ	ⲉϫⲱ
ⲉ̇ⲂⲟⲖ	ⲉⲃⲟⲗ
ⲉ̇ⲃⲟⲗ	ⲉⲃⲟⲗ
ⲉ̇ⲑ	ⲉⲧ
ⲉ̇ⲓ̇ⲏⲥⲟⲩ	ⲉⲓⲏⲥⲟⲩ
ⲉ̇ⲕⲥⲧⲁⲥⲓⲥ	ⲉⲕⲥⲧⲁⲥⲓⲥ
ⲉ̇ⲛϣⲁⲛ	ⲉⲛϣⲁⲛ
ⲉ̇ⲛⲉϥ	ⲛⲉϥ
ⲉ̇ⲛⲉϩ	ⲉⲛⲉϩ
ⲉ̇ⲛⲉⲣⲅⲓⲁ	ⲉⲛⲉⲣⲅⲓⲁ
ⲉ̇ⲛⲉ	ⲉⲛⲉ
ⲉ̇ⲛⲧ	ⲉⲛⲧ
ⲉ̇ⲣϣⲁⲛ	ⲉⲣϣⲁⲛ
ⲉ̇ⲣⲉ	ⲉⲣⲉ
ⲉ̇ⲣⲏⲩ	ⲉⲣⲏⲩ
ⲉ̇ⲣⲟ	ⲉⲣⲟ
ⲉ̇ⲧ̇ⲃⲉ	ⲉⲧⲃⲉ
ⲉ̇ⲧⲃⲉ	ⲉⲧⲃⲉ
ⲉ̇ⲧⲉ	ⲉⲧⲉ
ⲉ̇ⲧⲓ	ⲉⲧⲓ
ⲉ̇ⲧ	ⲉⲧ
ⲉ̇ⲧ 	ⲉⲧ
ⲉ̇ⲩϣⲁⲛ	ⲉⲩϣⲁⲛ
ⲉ̇ⲩⲉ	ⲉⲩⲉ
ⲉ̇Ⲫⲣⲉⲙ	ⲉⲫⲣⲉⲙ
ⲉ̇	ⲉ
ⲉ̣ⲣ̣ⲟ	ⲉⲣⲟ
ⲉ̣ⲣⲟ	ⲉⲣⲟ
ⲉ̣ⲧ̣	ⲉⲧ
ⲉ̣ⲧ̣[ⲉ]	ⲉⲧⲉ
ⲉ̣ⲧ	ⲉⲧ
ⲉ̣	ⲉ
ⲉ̣[.....]	ⲉ[.....]
ⲉϣϣⲉ	ⲉϣϣⲉ
ⲉϣϩⲱⲡ	ⲉϣϩⲱⲡ
ⲉϣϪⲉ	ⲉϣϫⲉ
ⲉϣϫⲉ	ⲉϣϫⲉ
ⲉϣϫⲉ`	ⲉϣϫⲉ
ⲉϣⲁⲣⲉ	ⲉϣⲁⲣⲉ
ⲉϣⲁⲩ	ⲉϣⲁⲩ
ⲉϣⲗⲟⲩⲗⲁⲓ̈	ⲉϣⲗⲟⲩⲗⲁⲓ
ⲉϣⲗⲟⲩⲗⲁⲓ	ⲉϣⲗⲟⲩⲗⲁⲓ
ⲉϣⲱⲡⲉ̂	ⲉϣⲱⲡⲉ
ⲉϣⲱⲡⲉ	ⲉϣⲱⲡⲉ
ⲉϣ	ⲉϣ
ⲉϥϣⲁⲛ	ⲉϥϣⲁⲛ
ⲉϥⲉ	ⲉϥⲉ
ⲉϥⲓ	ⲉϥⲓ
ⲉϥ	ⲉϥ
ⲉϩ̣ⲣⲁⲓ	ⲉϩⲣⲁⲓ
ⲉϩⲁⲣⲉ	ⲉϩⲁⲣⲉ
ⲉϩⲉ⳿	ⲉϩⲉ
ⲉϩⲉ	ⲉϩⲉ
ⲉϩⲛⲁ	ⲉϩⲛⲁ
ⲉϩⲟⲟⲩ	ⲉϩⲟⲟⲩ
ⲉϩⲟⲩⲉ̇	ⲉϩⲟⲩⲉ
ⲉϩⲟⲩⲉ	ⲉϩⲟⲩⲉ
ⲉϩⲟⲩⲛ⳿	ⲉϩⲟⲩⲛ
ⲉϩⲟⲩⲛ	ⲉϩⲟⲩⲛ
ⲉϩⲟⲩⲛ`	ⲉϩⲟⲩⲛ
ⲉϩⲟⲩⲻ	ⲉϩⲟⲩⲛ
ⲉϩⲟⲩ⳯⳿	ⲉϩⲟⲩⲛ
ⲉϩⲟⲩ⳯	ⲉϩⲟⲩⲛ
ⲉϩⲟⲩ	ⲉϩⲟⲩ
ⲉϩⲟⲩ]ⲛ	ⲉϩⲟⲩⲛ
ⲉϩⲣ̣[ⲁⲓ]	ⲉϩⲣⲁⲓ
ⲉϩⲣⲁ̣ⲓ̣̈	ⲉϩⲣⲁⲓ
ⲉϩⲣⲁⲉⲓ	ⲉϩⲣⲁⲓ
ⲉϩⲣⲁⲓ̄	ⲉϩⲣⲁⲓ
ⲉϩⲣⲁⲓ̇	ⲉϩⲣⲁⲓ
ⲉϩⲣⲁⲓ̈	ⲉϩⲣⲁⲓ
ⲉϩⲣⲁⲓ	ⲉϩⲣⲁⲓ
ⲉϩⲣⲁ	ⲉϩⲣⲁ
ⲉϩⲣⲛ̣̄	ⲉϩⲣⲛ
ⲉϩⲣⲛ	ⲉϩⲣⲛ
ⲉϩ[ⲣⲁⲓ]	ⲉϩⲣⲁⲓ
ⲉϫⲏⲩ	ⲉϫⲏⲩ
ⲉϫⲙ̄	ⲉϫⲙ
ⲉϫⲙ̇	ⲉϫⲙ
ⲉϫⲙ̣	ⲉϫⲙ
ⲉϫⲙ	ⲉϫⲙ
ⲉϫⲛ̄	ⲉϫⲛ
ⲉϫⲛ̇	ⲉϫⲛ
ⲉϫⲛ	ⲉϫⲛ
ⲉϫⲱ̂	ⲉϫⲱ
ⲉϫⲱ	ⲉϫⲱ
ⲉϫ︤ⲙ︥	ⲉϫⲙ
ⲉϫ︤ⲛ︥	ⲉϫⲛ
ⲉϫ	ⲉϫ
ⲉϫ.....	ⲉϫ[.....]
ⲉϫ[.....]	ⲉϫ[.....]
ⲉ᷍ⲓ	ⲉⲓ
ⲉ‴ⲧ	ⲉⲧ
ⲉⲂⲟⲖ	ⲉⲃⲟⲗ
ⲉⲃⲓⲁⲧⲉ	ⲉⲃⲓⲁⲧⲉ
ⲉⲃⲓⲏⲛ	ⲉⲃⲓⲏⲛ
ⲉⲃⲓⲟⲟⲩ̣ⲉ̣	ⲉⲃⲓⲟⲟⲩⲉ
ⲉⲃⲓⲟⲟⲩⲉ	ⲉⲃⲓⲟⲟⲩⲉ
ⲉⲃⲓⲱ	ⲉⲃⲓⲱ
ⲉⲃⲟ̣[ⲗ]	ⲉⲃⲟⲗ
ⲉⲃⲟⲗ̂	ⲉⲃⲟⲗ
ⲉⲃⲟⲗ⳿	ⲉⲃⲟⲗ
ⲉⲃⲟⲗ	ⲉⲃⲟⲗ
ⲉⲃⲟⲗ ⲟⲩ	ⲉⲃⲟⲗ ⲟⲩ
ⲉⲃⲟⲗ]	ⲉⲃⲟⲗ
ⲉⲃⲟⲗ`	ⲉⲃⲟⲗ
ⲉⲃⲟⲧ	ⲉⲃⲟⲧ
ⲉⲃ........	ⲉⲃ[........]
ⲉⲃ[ⲟⲗ]	ⲉⲃⲟⲗ
ⲉⲃ[........]	ⲉⲃ[........]
ⲉⲅⲅⲩⲏ	ⲉⲅⲅⲩⲏ
ⲉⲅⲕⲣⲁⲧⲉⲩⲉ̣	ⲉⲅⲕⲣⲁⲧⲉⲩⲉ
ⲉⲅⲕⲣⲁⲧⲉⲩⲉ	ⲉⲅⲕⲣⲁⲧⲉⲩⲉ
ⲉⲇⲉⲙ	ⲉⲇⲉⲙ
ⲉⲇⲉⲙ`	ⲉⲇⲉⲙ
ⲉⲉⲓϣⲁⲛ	ⲉⲓϣⲁⲛ
ⲉⲉⲧ	ⲉⲉⲧ
ⲉⲉ	ⲉ
ⲉⲑ	ⲉⲧ
ⲉⲓ̂	ⲉⲓ
ⲉⲓ̄ⲉ	ⲉⲓⲉ
ⲉⲓ̇ϥⲧ̇	ⲉⲓϥⲧ
ⲉⲓ̇ⲃⲉ	ⲉⲓⲃⲉ
ⲉⲓ̇ⲉ̇ⲣϩ̇	ⲉⲓⲉⲣϩ
ⲉⲓ̇ⲉ̇	ⲉⲓⲉ
ⲉⲓ̇ⲛⲉ	ⲉⲓⲛⲉ
ⲉⲓ̇ⲟ̇ⲧⲉ	ⲉⲓⲟⲧⲉ
ⲉⲓ̇ⲟⲧⲉ	ⲉⲓⲟⲧⲉ
ⲉⲓ̇ⲣⲉ	ⲉⲓⲣⲉ
ⲉⲓ̇ⲥ	ⲉⲓⲥ
ⲉⲓ̇ⲱⲣ̇ϩ	ⲉⲓⲱⲣϩ
ⲉⲓ̇ⲱⲧ	ⲉⲓⲱⲧ
ⲉⲓ̇	ⲉⲓ
ⲉⲓ̣̈ⲉ	ⲉⲓⲉ
ⲉⲓ̈ϣⲁⲛ	ⲉⲓϣⲁⲛ
ⲉⲓ̈ⲉ	ⲉⲓⲉ
ⲉⲓ̈ⲙⲏⲧⲓ`	ⲉⲓⲙⲏⲧⲓ
ⲉⲓ̈ⲣⲉ	ⲉⲓⲣⲉ
ⲉⲓ̈ⲥ	ⲉⲓⲥ
ⲉⲓ̈ⲧⲉ	ⲉⲓⲧⲉ
ⲉⲓ̈	ⲉⲓ
ⲉⲓ̣[ⲱⲣϩ]	ⲉⲓⲱⲣϩ
ⲉⲓϣⲁⲛ	ⲉⲓϣⲁⲛ
ⲉⲓϥⲧ	ⲉⲓϥⲧ
ⲉⲓ᷍ⲛⲉ	ⲉⲓⲛⲉ
ⲉⲓ᷍	ⲉⲓ
ⲉⲓⲁⲗ	ⲉⲓⲁⲗ
ⲉⲓⲁⲧ	ⲉⲓⲁⲧ
ⲉⲓⲁ	ⲉⲓⲁ
ⲉⲓⲃⲉ	ⲉⲓⲃⲉ
ⲉⲓⲇⲟⲥ	ⲉⲓⲇⲟⲥ
ⲉⲓⲇⲱⲗⲟⲛ⳿	ⲉⲓⲇⲱⲗⲟⲛ
ⲉⲓⲇⲱⲗⲟⲛ	ⲉⲓⲇⲱⲗⲟⲛ
ⲉⲓⲉⲣϩ	ⲉⲓⲉⲣϩ
ⲉⲓⲉⲣⲟ⳿	ⲓⲉⲣⲟ
ⲉⲓⲉⲣⲟ	ⲓⲉⲣⲟ
ⲉⲓⲉ	ⲉⲓⲉ
ⲉⲓⲏⲥⲟⲩ	ⲉⲓⲏⲥⲟⲩ
ⲉⲓⲕⲏ	ⲉⲓⲕⲏ
ⲉⲓⲙ̣ⲉ	ⲉⲓⲙⲉ
ⲉⲓⲙⲁ	ⲉⲓⲙⲁ
ⲉⲓⲙⲉ⳿	ⲉⲓⲙⲉ
ⲉⲓⲙⲉ	ⲉⲓⲙⲉ
ⲉⲓⲙⲉ`	ⲉⲓⲙⲉ
ⲉⲓⲙⲏⲧⲉⲓ	ⲉⲓⲙⲏⲧⲉⲓ
ⲉⲓⲙⲏⲧⲓ⳿	ⲉⲓⲙⲏⲧⲓ
ⲉⲓⲙⲏⲧⲓ	ⲉⲓⲙⲏⲧⲓ
ⲉⲓⲙⲏⲧⲓ`	ⲉⲓⲙⲏⲧⲓ
ⲉⲓⲛⲉ̇	ⲉⲓⲛⲉ
ⲉⲓⲛⲉ	ⲉⲓⲛⲉ
ⲉⲓⲛⲉ`	ⲉⲓⲛⲉ
ⲉⲓⲟ̂ⲧⲉ⳿	ⲉⲓⲟⲧⲉ
ⲉⲓⲟⲙ	ⲉⲓⲟⲙ
ⲉⲓⲟⲟⲩⲉ⳿	ⲉⲓⲟⲟⲩⲉ
ⲉⲓⲟⲟⲩⲉ	ⲉⲓⲟⲟⲩⲉ
ⲉⲓⲟⲟⲩⲉ`	ⲉⲓⲟⲟⲩⲉ
ⲉⲓⲟⲣϩ	ⲉⲓⲟⲣϩ
ⲉⲓⲟⲧⲉ	ⲉⲓⲟⲧⲉ
ⲉⲓⲟⲧⲉ`	ⲉⲓⲟⲧⲉ
ⲉⲓⲣⲁⲥⲙⲟⲥ	ⲉⲓⲣⲁⲥⲙⲟⲥ
ⲉⲓⲣⲉ⳿	ⲉⲓⲣⲉ
ⲉⲓⲣⲉ	ⲉⲓⲣⲉ
ⲉⲓⲣⲉ`	ⲉⲓⲣⲉ
ⲉⲓⲣⲏⲛⲏ	ⲉⲓⲣⲏⲛⲏ
ⲉⲓⲣⲏⲛⲏ`	ⲉⲓⲣⲏⲛⲏ
ⲉⲓⲣⲏⲛⲓⲕⲟⲛ	ⲉⲓⲣⲏⲛⲓⲕⲟⲛ
ⲉⲓⲥ⳿	ⲉⲓⲥ
ⲉⲓⲥ	ⲉⲓⲥ
ⲉⲓⲧⲁ	ⲉⲓⲧⲁ
ⲉⲓⲧⲉ	ⲉⲓⲧⲉ
ⲉⲓⲧⲉ`	ⲉⲓⲧⲉ
ⲉⲓⲱ̂	ⲉⲓⲱ
ⲉⲓⲱⲣϩ	ⲉⲓⲱⲣϩ
ⲉⲓⲱⲧ⳿	ⲉⲓⲱⲧ
ⲉⲓⲱⲧ	ⲉⲓⲱⲧ
ⲉⲓⲱⲧ`	ⲉⲓⲱⲧ
ⲉⲓⲱ	ⲉⲓⲱ
ⲉⲓ	ⲉⲓ
ⲉⲓ`	ⲉⲓ
ⲉⲕϣ̇ⲁⲛ	ⲉⲕϣⲁⲛ
ⲉⲕϣⲁⲛ	ⲉⲕϣⲁⲛ
ⲉⲕⲉ	ⲉⲕⲉ
ⲉⲕⲓⲃⲉ	ⲉⲕⲓⲃⲉ
ⲉⲕⲓⲃⲉ`	ⲉⲕⲓⲃⲉ
ⲉⲕⲕⲗⲏⲥⲓⲁ⳿	ⲉⲕⲕⲗⲏⲥⲓⲁ
ⲉⲕⲕⲗⲏⲥⲓⲁ	ⲉⲕⲕⲗⲏⲥⲓⲁ
ⲉⲕⲥⲧⲁⲥⲓⲥ	ⲉⲕⲥⲧⲁⲥⲓⲥ
ⲉⲕ	ⲉⲕ
ⲉⲗⲁⲭⲓⲥⲧⲟⲛ	ⲉⲗⲁⲭⲓⲥⲧⲟⲛ
ⲉⲗⲁⲭⲓⲥⲧⲟⲥ	ⲉⲗⲁⲭⲓⲥⲧⲟⲥ
ⲉⲗⲁⲭⲓⲥⲧⲟ⳯ ⳿	ⲉⲗⲁⲭⲓⲥⲧⲟⲛ
ⲉⲗⲁⲭⲓⲥⲧⲟ⳯ 	ⲉⲗⲁⲭⲓⲥⲧⲟⲛ
ⲉⲗⲉⲩⲑⲉⲣⲟⲥ	ⲉⲗⲉⲩⲑⲉⲣⲟⲥ
ⲉⲗⲓⲥⲁⲃⲉⲧ	ⲉⲗⲓⲥⲁⲃⲉⲧ
ⲉⲗⲓⲥⲁⲃⲉⲧ`	ⲉⲗⲓⲥⲁⲃⲉⲧ
ⲉⲗⲟⲟ̇ⲗⲉ	ⲉⲗⲟⲟⲗⲉ
ⲉⲗⲟⲟⲗⲉ	ⲉⲗⲟⲟⲗⲉ
ⲉⲗⲟ	ⲉⲗⲟ
ⲉⲗⲱⲉⲓ	ⲉⲗⲱⲉⲓ
ⲉⲗⲱ	ⲉⲗⲱ
ⲉⲙ̇ⲧⲟⲛ	ⲉⲙⲧⲟⲛ
ⲉⲙⲁⲁⲧⲉ	ⲉⲙⲁⲧⲉ
ⲉⲙⲁⲧⲉ⳿	ⲉⲙⲁⲧⲉ
ⲉⲙⲁⲧⲉ	ⲉⲙⲁⲧⲉ
ⲉⲙⲁⲩ	ⲉⲙⲁⲩ
ⲉⲙⲁ]ⲧⲉ	ⲉⲙⲁⲧⲉ
ⲉⲙⲕ	ⲉⲙⲕ
ⲉⲙⲙⲟⲛ	ⲉⲙⲙⲟⲛ
ⲉⲙⲛⲧ	ⲉⲙⲛⲧ
ⲉⲙⲡϣⲁ	ⲉⲙⲡϣⲁ
ⲉⲙⲧⲟⲛ	ⲉⲙⲧⲟⲛ
ⲉⲙ︤ⲛ︦ⲧ︥	ⲉⲙⲛⲧ
ⲉⲙ	ⲙ
ⲉⲛ̄ⲧ	ⲉⲛⲧ
ⲉⲛ̄	ⲛ
ⲉⲛ̇ⲉ	ⲉⲛⲉ
ⲉⲛ̇ⲧ	ⲉⲛⲧ
ⲉⲛϣ̣ⲁⲛ	ⲉⲛϣⲁⲛ
ⲉⲛϣⲁⲛ	ⲉⲛϣⲁⲛ
ⲉⲛϣⲁⲛ`	ⲉⲛϣⲁⲛ
ⲉⲛⲁϣⲉⲥⲟⲩⲛⲧⲥ	ⲉ
ⲉⲛⲇⲁⲓⲙⲱⲛⲓⲟⲛ	ⲉⲛⲇⲁⲓⲙⲱⲛⲓⲟⲛ
ⲉⲛⲉϥ	ⲛⲉϥ
ⲉⲛⲉϩ⳿	ⲉⲛⲉϩ
ⲉⲛⲉϩ	ⲉⲛⲉϩ
ⲉⲛⲉϩ`	ⲉⲛⲉϩ
ⲉⲛⲉⲣⲅⲉⲓ	ⲉⲛⲉⲣⲅⲉⲓ
ⲉⲛⲉⲣⲅⲏⲙⲁ	ⲉⲛⲉⲣⲅⲏⲙⲁ
ⲉⲛⲉⲣⲅⲓⲁ	ⲉⲛⲉⲣⲅⲓⲁ
ⲉⲛⲉⲣⲅⲓ	ⲉⲛⲉⲣⲅⲉⲓ
ⲉⲛⲉ	ⲉⲛⲉ
ⲉⲛⲉ.ⲉⲧⲏ	ϩⲉⲛⲉⲉⲧⲏ
ⲉⲛⲛⲁ	ⲉⲛⲛⲁ
ⲉⲛⲛⲉ	ⲛⲛⲉ
ⲉⲛⲛ	ⲉⲛⲛ
ⲉⲛⲟⲭⲟⲥ	ⲉⲛⲟⲭⲟⲥ
ⲉⲛⲧⲉ	ⲛⲧⲉ
ⲉⲛⲧⲏϭ	ⲉⲛⲧⲏϭ
ⲉⲛⲧⲟⲗⲏ̂	ⲉⲛⲧⲟⲗⲏ
ⲉⲛⲧⲟⲗⲏ̂`	ⲉⲛⲧⲟⲗⲏ
ⲉⲛⲧⲟⲗⲏ	ⲉⲛⲧⲟⲗⲏ
ⲉⲛⲧⲟⲗⲏ`	ⲉⲛⲧⲟⲗⲏ
ⲉⲛⲧ	ⲉⲛⲧ
ⲉⲛⲱⲭⲗⲉⲓ̇	ⲉⲛⲱⲭⲗⲉⲓ
ⲉⲛⲱⲭⲗⲉⲓ	ⲉⲛⲱⲭⲗⲉⲓ
ⲉⲛ⳿ⲧ	ⲉⲛⲧ
ⲉⲛ	ⲛ
ⲉⲝⲁⲡⲁⲧⲁ	ⲉⲝⲁⲡⲁⲧⲁ
ⲉⲝⲉⲇⲣⲁ	ⲉⲝⲉⲇⲣⲁ
ⲉⲝⲉⲥⲧⲉⲓ	ⲉⲝⲉⲥⲧⲉⲓ
ⲉⲝⲉⲥⲧⲓ	ⲉⲝⲉⲥⲧⲓ
ⲉⲝⲏⲅⲉⲥⲓⲥ	ⲉⲝⲏⲅⲉⲥⲓⲥ
ⲉⲝⲟⲙⲟⲗⲟⲅⲓ	ⲉⲝⲟⲙⲟⲗⲟⲅⲓ
ⲉⲝⲟⲩⲥⲓⲁ	ⲉⲝⲟⲩⲥⲓⲁ
ⲉⲟⲟⲩ⳿	ⲉⲟⲟⲩ
ⲉⲟⲟⲩ	ⲉⲟⲟⲩ
ⲉⲡⲁϩⲟⲩ	ⲉⲡⲁϩⲟⲩ
ⲉⲡⲁⲓⲛⲟⲩ	ⲉⲡⲁⲓⲛⲟⲩ
ⲉⲡⲁⲣⲭⲟⲥ	ⲉⲡⲁⲣⲭⲟⲥ
ⲉⲡⲉⲓⲇⲏ	ⲉⲡⲉⲓⲇⲏ
ⲉⲡⲉⲓⲇⲏ`	ⲉⲡⲉⲓⲇⲏ
ⲉⲡⲉⲓ	ⲉⲡⲉⲓ
ⲉⲡⲉⲥⲏⲧ	ⲉⲡⲉⲥⲏⲧ
ⲉⲡⲉ	ⲉⲡⲉ
ⲉⲡⲓⲇⲏ	ⲉⲡⲓⲇⲏ
ⲉⲡⲓⲑⲁⲛⲁⲧⲏⲥ	ⲉⲡⲓⲑⲁⲛⲁⲧⲏⲥ
ⲉⲡⲓⲑⲩⲙⲉⲓ⳿	ⲉⲡⲓⲑⲩⲙⲉⲓ
ⲉⲡⲓⲑⲩⲙⲉⲓ	ⲉⲡⲓⲑⲩⲙⲉⲓ
ⲉⲡⲓⲑⲩⲙⲓⲁ	ⲉⲡⲓⲑⲩⲙⲓⲁ
ⲉⲡⲓⲕⲁⲗⲉⲓ⳿	ⲉⲡⲓⲕⲁⲗⲉⲓ
ⲉⲡⲓⲕⲁⲗⲉⲓ	ⲉⲡⲓⲕⲁⲗⲉⲓ
ⲉⲡⲓⲥⲕⲟⲡⲟⲥ	ⲉⲡⲓⲥⲕⲟⲡⲟⲥ
ⲉⲡⲓⲥⲧⲏⲙⲉⲓ	ⲉⲡⲓⲥⲧⲏⲙⲉⲓ
ⲉⲡⲓⲥⲧⲏⲙⲏ	ⲉⲡⲓⲥⲧⲏⲙⲏ
ⲉⲡⲓⲥⲧⲏ	ⲉⲡⲓⲥⲧⲏ
ⲉⲡⲓⲥⲧⲟⲗⲏ̂	ⲉⲡⲓⲥⲧⲟⲗⲏ
ⲉⲡⲓⲥⲧⲟⲗⲏ	ⲉⲡⲓⲥⲧⲟⲗⲏ
ⲉⲡⲓⲧⲓⲙⲁ	ⲉⲡⲓⲧⲓⲙⲁ
ⲉⲡⲟⲓⲕⲓⲟ⳯ ⳿	ⲉⲡⲟⲓⲕⲓⲟⲛ 
ⲉⲡⲟⲓⲕⲓⲟ⳯ 	ⲉⲡⲟⲓⲕⲓⲟⲛ 
ⲉⲡⲣⲁ⳿	ⲉⲡⲣⲁ
ⲉⲡⲣⲁ	ⲉⲡⲣⲁ
ⲉⲡⲣⲁ`	ⲉⲡⲣⲁ
ⲉⲡⲫⲁⲑⲁ	ⲉⲡⲫⲁⲑⲁ
ⲉⲡ⳿	ⲉⲡ
ⲉⲡ	ⲉⲡ
ⲉⲣ̄	ⲉⲣ
ⲉⲣ̇ⲙⲟⲛⲁⲭⲟⲥ	ⲣⲙⲟⲛⲁⲭⲟⲥ
ⲉⲣ̇ⲟ	ⲉⲣⲟ
ⲉⲣϢⲁⲛ	ⲉⲣϣⲁⲛ
ⲉⲣϣⲁⲛ	ⲉⲣϣⲁⲛ
ⲉⲣϣⲁ⳯	ⲉⲣϣⲁⲛ
ⲉⲣϣⲟⲣⲡ	ⲣϣⲟⲣⲡ
ⲉⲣⲁⲧ︤	ⲉⲣⲁⲧ
ⲉⲣⲁⲧ	ⲉⲣⲁⲧ
ⲉⲣⲁ	ⲉⲣⲁ
ⲉⲣⲉ⳿	ⲉⲣⲉ
ⲉⲣⲉ	ⲉⲣⲉ
ⲉⲣⲏⲙⲟⲥ	ⲉⲣⲏⲙⲟⲥ
ⲉⲣⲏⲧ⳿	ⲉⲣⲏⲧ
ⲉⲣⲏⲧ	ⲉⲣⲏⲧ
ⲉⲣⲏⲩ⳿	ⲉⲣⲏⲩ
ⲉⲣⲏⲩ	ⲉⲣⲏⲩ
ⲉⲣⲏⲩ`	ⲉⲣⲏⲩ
ⲉⲣⲗⲁⲁⲩ	ⲉⲣⲗⲁⲁⲩ
ⲉⲣⲙⲟⲛⲁⲭⲟⲥ	ⲣⲙⲟⲛⲁⲭⲟⲥ
ⲉⲣⲛ	ⲉⲣⲛ
ⲉⲣⲟ̂	ⲉⲣⲟ
ⲉⲣⲟ	ⲉⲣⲟ
ⲉⲣⲣⲙⲙⲁⲟ	ⲣⲣⲙⲙⲁⲟ
ⲉⲣⲱⲧⲉ	ⲉⲣⲱⲧⲉ
ⲉⲣⲱ	ⲉⲣⲱ
ⲉⲣ⳿ⲣ︤ⲙ︥ⲙⲁⲟ̂	ⲣⲣⲙⲙⲁⲟ
ⲉⲣ︤ⲛ︥	ⲉⲣⲛ
ⲉⲣ	ⲉⲣ
ⲉⲣ..ⲧ…	ⲉⲣ..ⲧ…
ⲉⲥ̇ⲑⲏⲧⲏ[ⲣⲓ]ⲟⲛ	ⲉⲥⲑⲏⲧⲏⲣⲓⲟⲛ
ⲉⲥϣⲁⲛ	ⲉⲥϣⲁⲛ
ⲉⲥⲉⲡⲉ	ⲥⲉⲉⲡⲉ
ⲉⲥⲉ	ⲉⲥⲉ
ⲉⲥⲏⲧ	ⲉⲥⲏⲧ
ⲉⲥⲏⲧ`	ⲉⲥⲏⲧ
ⲉⲥⲑⲁⲛⲉ	ⲉⲥⲑⲁⲛⲉ
ⲉⲥⲑⲏⲧⲏⲣⲓⲟⲛ	ⲉⲥⲑⲏⲧⲏⲣⲓⲟⲛ
ⲉⲥⲟⲟⲩ	ⲉⲥⲟⲟⲩ
ⲉⲥⲟⲟⲩ`	ⲉⲥⲟⲟⲩ
ⲉⲥⲱⲁⲛ	ⲉⲥϣⲁⲛ
ⲉⲥ	ⲉⲥ
ⲉⲦ	ⲉⲧ
ⲉⲧ̇ⲃⲉ	ⲉⲧⲃⲉ
ⲉⲧ̇	ⲉⲧ
ⲉⲧ̣	ⲉⲧ
ⲉⲧ̣[ⲃⲉ	ⲉⲧⲃⲉ
ⲉⲧ‎	ⲉⲧ
ⲉⲧⲃ̣	ⲉⲧⲃ
ⲉⲧⲃⲃⲏ	ⲉⲧⲃⲃⲏ
ⲉⲧⲃⲉ	ⲉⲧⲃⲉ
ⲉⲧⲃⲏⲏ̂ⲧ	ⲉⲧⲃⲏⲏⲧ
ⲉⲧⲃⲏⲏⲧ︤︥	ⲉⲧⲃⲏⲏⲧ
ⲉⲧⲃⲏⲏⲧ︤	ⲉⲧⲃⲏⲏⲧ
ⲉⲧⲃⲏⲏⲧ	ⲉⲧⲃⲏⲏⲧ
ⲉⲧⲃⲏⲏ	ⲉⲧⲃⲏⲏ
ⲉⲧⲃⲏⲧ	ⲉⲧⲃⲏⲧ
ⲉⲧⲃ	ⲉⲧⲃ
ⲉⲧⲉⲓ	ⲉⲧⲉⲓ
ⲉⲧⲉⲛⲟⲩ	ⲉⲧⲉⲛⲟⲩ
ⲉⲧⲉⲣⲉ	ⲉⲧⲉⲣⲉ
ⲉⲧⲉⲧⲛ̄ϣⲁⲛ	ⲉⲧⲉⲧⲛϣⲁⲛ
ⲉⲧⲉⲧⲛϣⲁⲛ	ⲉⲧⲉⲧⲛϣⲁⲛ
ⲉⲧⲉⲧⲛⲉ	ⲉⲧⲉⲧⲛⲉ
ⲉⲧⲉⲧ︤ⲛ︥ϣⲁⲛ	ⲉⲧⲉⲧⲛϣⲁⲛ
ⲉⲧⲉ	ⲉⲧⲉ
ⲉⲧⲓ	ⲉⲧⲓ
ⲉⲧⲛ	ⲧⲉⲧⲛ
ⲉⲧⲟⲟⲧ︤	ⲉⲧⲟⲟⲧ
ⲉⲧⲟⲟⲧ	ⲉⲧⲟⲟⲧ
ⲉⲧⲟⲧ	ⲉⲧⲟⲧ
ⲉⲧⲣⲉ	ⲉⲧⲣⲉ
ⲉⲧⲱ	ⲉⲧⲱ
ⲉⲧ⳿	ⲉⲧ
ⲉⲧ︤ⲃ︥ⲃⲏ	ⲉⲧⲃⲃⲏ
ⲉⲧ︤	ⲉⲧ
ⲉⲧ	ⲉⲧ
ⲉⲧ 	ⲉⲧ
ⲉⲧ`	ⲉⲧ
ⲉⲩ̣ⲉ	ⲉⲩⲉ
ⲉⲩϣⲁⲛ	ⲉⲩϣⲁⲛ
ⲉⲩϩⲁⲓⲟⲥ	ⲉⲩϩⲁⲓⲟⲥ
ⲉⲩϩⲁ⳿	ⲉⲩϩⲁ
ⲉⲩϩⲁ	ⲉⲩϩⲁ
ⲉⲩⲁⲅⲅⲉⲗⲓⲍⲉ	ⲉⲩⲁⲅⲅⲉⲗⲓⲍⲉ
ⲉⲩⲁⲅⲅⲉⲗⲓⲟⲛ	ⲉⲩⲁⲅⲅⲉⲗⲓⲟⲛ
ⲉⲩⲅⲉⲛⲏⲥ	ⲉⲩⲅⲉⲛⲏⲥ
ⲉⲩⲉ̄	ⲉⲩⲉ
ⲉⲩⲉ	ⲉⲩⲉ
ⲉⲩⲕⲁⲓⲣⲓⲁ	ⲉⲩⲕⲁⲓⲣⲓⲁ
ⲉⲩⲛⲟⲩ	ⲉⲩⲛⲟⲩ
ⲉⲩⲣⲓⲡⲟⲥ⳿	ⲉⲩⲣⲓⲡⲟⲥ
ⲉⲩⲣⲓⲡⲟⲥ	ⲉⲩⲣⲓⲡⲟⲥ
ⲉⲩⲥⲭⲩⲙⲟⲥⲩⲛⲏ	ⲉⲩⲥⲭⲩⲙⲟⲥⲩⲛⲏ
ⲉⲩⲫⲣⲁⲛⲉ	ⲉⲩⲫⲣⲁⲛⲉ
ⲉⲩⲫⲣⲁⲛⲉ`	ⲉⲩⲫⲣⲁⲛⲉ
ⲉⲩⲫⲣⲟⲥⲩⲛⲏ	ⲉⲩⲫⲣⲟⲥⲩⲛⲏ
ⲉⲩⲭⲁⲣⲓⲥⲧⲟⲩ	ⲉⲩⲭⲁⲣⲓⲥⲧⲟⲩ
ⲉⲩ	ⲉⲩ
ⲉⲪⲣⲉⲙ	ⲉⲫⲣⲉⲙ
ⲉⲫⲉⲥⲟⲥ	ⲉⲫⲉⲥⲟⲥ
ⲉ⳯ⲧⲟⲗⲏ̂	ⲉⲛⲧⲟⲗⲏ
ⲉ⳯ⲧⲟⲗⲏ	ⲉⲛⲧⲟⲗⲏ
ⲉ⳯ⲧ	ⲉⲛⲧ
ⲉ⳿	ⲉ
ⲉ	ⲉ
ⲉ.....	ⲉ[.....]
ⲉ......ⲙ....	ⲉ......ⲙ....
ⲉ[ϩ]ⲣⲁⲓ	ⲉϩⲣⲁⲓ
ⲉ[ⲓⲧ]ⲉ̣	ⲉⲓⲧⲉ
ⲉ[ⲓⲱ]ⲧ	ⲉⲓⲱⲧ
ⲉ[ⲧⲃ]ⲉ	ⲉⲧⲃⲉ
ⲉ[ⲧ	ⲉⲧ
ⲉ[ⲧ]	ⲉⲧ
ⲉ[......]ⲙ[....]	ⲉ......ⲙ....
ⲉ]ⲡⲓⲥⲧⲟⲗⲏ	ⲉⲡⲓⲥⲧⲟⲗⲏ
ⲉ]	ⲉ
ⲉ`	ϩⲉ
ⲍⲁⲗⲉϩ	ⲍⲁⲗⲉϩ
ⲍⲁⲭⲁⲣⲓⲁⲥ	ⲍⲁⲭⲁⲣⲓⲁⲥ
ⲍⲉⲃⲉⲇⲁⲓⲟⲥ	ⲍⲉⲃⲉⲇⲁⲓⲟⲥ
ⲍⲉⲗⲫⲁ	ⲍⲉⲗⲫⲁ
ⲍⲱⲟⲛ	ⲍⲱⲟⲛ
ⲏ̀ⲣ︤ⲡ︥	ⲏⲣⲡ
ⲏ̣̂	ⲏ
ⲏ̂ⲣⲡ̄	ⲏⲣⲡ
ⲏ̂ⲣ︤ⲡ︥	ⲏⲣⲡ
ⲏ̂ⲥⲁⲓ̈ⲁⲥ	ⲏⲥⲁⲓⲁⲥ
ⲏ̂ⲥⲁⲩ	ⲏⲥⲁⲩ
ⲏ̂ⲥⲁⲩ`	ⲏⲥⲁⲩ
ⲏ̂	ⲏ
ⲏ̄ⲣⲡ̄	ⲏⲣⲡ
ⲏ̄	ⲏ
ⲏ̣̇	ⲏ
ⲏ̇ⲣⲡ̇	ⲏⲣⲡ
ⲏ̇	ⲏ
ⲏ̈ⲓ	ⲏⲓ
ⲏ̣̇	ⲏ
ⲏ̣ⲇ̣ⲟ̣ⲛ̣ⲏ̣	ϩⲏⲇⲟⲛⲏ
ⲏ̣	̣ⲏ
ⲏⲇⲏ	ⲏⲇⲏ
ⲏⲇⲟⲛⲏ	ϩⲏⲇⲟⲛⲏ
ⲏⲉⲓ	ⲏⲉⲓ
ⲏⲓ̈	ⲏⲓ
ⲏⲓ	ⲏⲓ
ⲏⲡ̂	ⲏⲡ
ⲏⲡⲉ	ⲏⲡⲉ
ⲏⲡ⳿	ⲏⲡ
ⲏⲡ	ⲏⲡ
ⲏⲡ`	ⲏⲡ
ⲏⲣ̇ⲡ̇	ⲏⲣⲡ
ⲏⲣⲡ̇	ⲏⲣⲡ
ⲏⲣⲡ	ⲏⲣⲡ
ⲏⲣ︤ⲡ︥	ⲏⲣⲡ
ⲏⲥⲁⲓⲁⲥ	ⲏⲥⲁⲓⲁⲥ
ⲏⲥⲁⲩ	ⲏⲥⲁⲩ
ⲏⲧ	ϩⲏⲧ
ⲏⲩⲉ	ⲏⲩⲉ
ⲏ⳱	ⲏ
ⲏ⳿	ⲏ
ⲏ	ⲏ
ⲏ[ⲡ]	ⲏⲡ
ⲏ]	ⲏ
ⲏ`	ⲏ
Ⲑ	ⲧ
ⲑ̇ⲃⲃⲓ̇ⲉ̇	ⲑⲃⲃⲓⲉ
ⲑ̇ⲃⲃⲓ̇ⲟ̇	ⲑⲃⲃⲓⲟ
ⲑ̇ⲗⲓ̇ⲃⲉ	ⲑⲗⲓⲃⲉ
ⲑ̇ⲗⲓ̇ⲯⲓ̇ⲥ	ⲑⲗⲓⲯⲓⲥ
ⲑ̇ⲗⲓ̈ⲯⲓ̇ⲥ	ⲑⲗⲓⲯⲓⲥ
ⲑ̣	ⲧ
ⲑⲁⲃ	ⲑⲁⲃ
ⲑⲁⲇⲇⲁⲓⲟⲥ	ⲑⲁⲇⲇⲁⲓⲟⲥ
ⲑⲁⲗⲁⲥⲥⲁ	ⲑⲁⲗⲁⲥⲥⲁ
ⲑⲃ̄ⲃⲓⲟ	ⲑⲃⲃⲓⲟ
ⲑⲃ̇ⲃ̇ⲓ̇ⲟ̇	ⲑⲃⲃⲓⲟ
ⲑⲃ̇ⲃⲓ̇ⲉ̇	ⲑⲃⲃⲓⲉ
ⲑⲃ̇ⲃⲓ̇ⲟ	ⲑⲃⲃⲓⲟ
ⲑⲃ̇ⲃⲓⲟ	ⲑⲃⲃⲓⲟ
ⲑⲃⲃⲓ̇ⲟ̇	ⲑⲃⲃⲓⲟ
ⲑⲃⲃⲓ̇ⲟ	ⲑⲃⲃⲓⲟ
ⲑⲃⲃⲓⲉ	ⲑⲃⲃⲓⲉ
ⲑⲃⲃⲓⲟ	ⲑⲃⲃⲓⲟ
ⲑⲉⲁⲧⲣⲟⲛ	ⲑⲉⲁⲧⲣⲟⲛ
ⲑⲉⲟⲇⲱⲕⲟⲥ	ⲑⲉⲟⲧⲟⲕⲟⲥ
ⲑⲉⲟⲇⲱⲣ	ⲑⲉⲟⲇⲱⲣ
ⲑⲉⲟⲫⲓⲗⲟⲥ	ⲑⲉⲟⲫⲓⲗⲟⲥ
ⲑⲉⲣⲁⲡⲟⲩ	ⲑⲉⲣⲁⲡⲟⲩ
ⲑⲉⲱ̇ⲇⲟⲣⲟⲥ	ⲑⲉⲟⲇⲟⲣⲟⲥ
ⲑⲉⲱ̇ⲇⲱⲣⲟⲥ	ⲑⲉⲱⲇⲱⲣⲟⲥ
ⲑⲉⲱⲇⲟⲣⲟⲥ	ⲑⲉⲟⲇⲟⲣⲟⲥ
ⲑⲉⲱⲇⲱⲣⲟⲥ	ⲑⲉⲱⲇⲱⲣⲟⲥ
ⲑⲉⲱⲫⲓⲗⲟⲥ	ⲑⲉⲱⲫⲓⲗⲟⲥ
ⲑⲏⲡ	ϩⲏⲡ
ⲑⲏⲣⲓⲟⲛ	ⲑⲏⲣⲓⲟⲛ
ⲑⲗ̣ⲓ̣ⲯⲓⲥ	ⲑⲗⲓⲯⲓⲥ
ⲑⲗⲓ̇ⲯⲓ̇ⲥ	ⲑⲗⲓⲯⲓⲥ
ⲑⲗⲓⲃⲉ⳿	ⲑⲗⲓⲃⲉ
ⲑⲗⲓⲃⲉ	ⲑⲗⲓⲃⲉ
ⲑⲗⲓⲑⲗⲓⲯⲓⲥ	ⲑⲗⲓⲑⲗⲓⲯⲓⲥ
ⲑⲗⲓⲯⲓⲥ⳿	ⲑⲗⲓⲯⲓⲥ
ⲑⲗⲓⲯⲓⲥ	ⲑⲗⲓⲯⲓⲥ
ⲑⲗⲟ	ⲑⲗⲟ
ⲑⲙ̄ⲕⲟ	ⲑⲙⲕⲟ
ⲑⲙⲕⲟ	ⲑⲙⲕⲟ
ⲑⲙⲟ	ⲑⲙⲟ
ⲑⲛⲟⲛ	ⲑⲛⲟⲛ
ⲑⲛⲟⲛ`	ⲑⲛⲟⲛ
ⲑⲟⲟⲩ	ϩⲟⲟⲩ
ⲑⲟⲟⲩ`	ϩⲟⲟⲩ
ⲑⲟⲟⲯ	ϩⲟⲟⲩ
ⲑⲡⲟ	ⲑⲡⲟ
ⲑⲣⲟⲛⲟⲥ	ⲑⲣⲟⲛⲟⲥ
ⲑⲩⲥⲓ̈ⲁⲍⲉ	ⲑⲩⲥⲓⲁⲍⲉ
ⲑⲩⲥⲓ̈ⲁⲥⲧⲏⲣⲓⲟⲛ	ⲑⲩⲥⲓⲁⲥⲧⲏⲣⲓⲟⲛ
ⲑⲩⲥⲓ̈ⲁ	ⲑⲩⲥⲓⲁ
ⲑⲩⲥⲓⲁⲍⲉ	ⲑⲩⲥⲓⲁⲍⲉ
ⲑⲩⲥⲓⲁⲥⲧⲏⲣⲓⲟⲛ	ⲑⲩⲥⲓⲁⲥⲧⲏⲣⲓⲟⲛ
ⲑⲩⲥⲓⲁ	ⲑⲩⲥⲓⲁ
ⲑⲩⲥⲥⲁⲥⲧⲏⲣⲓⲟⲛ	ⲑⲩⲥⲓⲁⲥⲧⲏⲣⲓⲟⲛ
ⲑⲱⲙⲁⲥ	ⲑⲱⲙⲁⲥ
ⲑ︤ⲃ︥ⲃⲓⲟ̂	ⲑⲃⲃⲓⲟ
ⲑ︤ⲃ︥ⲃⲓⲟ̄̄	ⲑⲃⲃⲓⲟ
ⲑ︤ⲙ︥ⲕⲟ	ⲑⲙⲕⲟ
ⲑ︤	ⲧ
ⲑ︦	ⲧ
ⲑ	ⲧ
ⲑ 	ⲧ
Ⲓ̈ⲁⲕⲱⲃ	ⲓⲁⲕⲱⲃ
Ⲓ̈ⲟⲩⲇⲁⲥ	ⲓⲟⲩⲇⲁⲥ
Ⲓ̈ⲥⲁⲁⲕ`	ⲓⲥⲁⲁⲕ
Ⲓⲁⲕⲱⲃ	ⲓⲁⲕⲱⲃ
Ⲓⲟⲩⲇⲁⲥ	ⲓⲟⲩⲇⲁⲥ
Ⲓⲥⲁⲁⲕ	ⲓⲥⲁⲁⲕ
ⲓ̄	ⲓ
ⲓ̇ⲁⲗ	ⲉⲓⲁⲗ
ⲓ̇ⲇⲟⲥ	ⲉⲓⲇⲟⲥ
ⲓ̇ⲉ̇ⲣⲟ	ⲓⲉⲣⲟ
ⲓ̇ⲉⲢⲟ	ⲓⲉⲣⲟ
ⲓ̇ⲥⲁⲕ	ⲓⲥⲁⲕ
ⲓ̇ⲱⲥⲏⲫ	ⲓⲱⲥⲏⲫ
ⲓ̇︦︦︦︦ⲗ︦ⲏ︦ⲙ︦	ϩⲓⲉⲣⲟⲩⲥⲁⲗⲏⲙ
ⲓ̇	ⲓ
ⲓ̣̈	ⲓ
ⲓ̈ⲁⲕⲱⲃ	ⲓⲁⲕⲱⲃ
ⲓ̈ⲁⲕⲱⲃ`	ⲓⲁⲕⲱⲃ
ⲓ̈ⲉⲍⲉⲕⲓⲏⲗ`	ⲓⲉⲍⲉⲕⲓⲏⲗ
ⲓ̈ⲉⲣⲉⲙⲓⲁⲥ`	ⲓⲉⲣⲉⲙⲓⲁⲥ
ⲓ̈ⲏ︤︥ⲗ	ⲓⲥⲣⲁⲏⲗ
ⲓ̈ⲟⲩⲇⲁⲥ	ⲓⲟⲩⲇⲁⲥ
ⲓ̈ⲟⲩⲇⲁⲥ`	ⲓⲟⲩⲇⲁⲥ
ⲓ̈ⲥⲁⲁⲕ	ⲓⲥⲁⲁⲕ
ⲓ̈ⲥⲁⲁⲕ`	ⲓⲥⲁⲁⲕ
ⲓ̈ⲥⲙⲁⲏⲗ	ⲓⲥⲙⲁⲏⲗ
ⲓ̈ⲱϩⲁⲛⲛⲏⲥ`	ⲓⲱϩⲁⲛⲛⲏⲥ
ⲓ̈ⲱⲥⲏⲫ`	ⲓⲱⲥⲏⲫ
ⲓ̈ⲱⲥⲓⲁⲥ	ⲓⲱⲥⲓⲁⲥ
ⲓ̈ⲱⲧ`	ⲉⲓⲱⲧ
ⲓ̈⳿	ⲓ
ⲓ̈	ⲓ
ⲓ‎	ⲓ
ⲓⲁⲉⲓⲣⲟⲥ	ⲓⲁⲉⲓⲣⲟⲥ
ⲓⲁⲕⲱⲃⲟⲥ	ⲓⲁⲕⲱⲃⲟⲥ
ⲓⲁⲕⲱⲃ	ⲓⲁⲕⲱⲃ
ⲓⲁⲗ	ⲉⲓⲁⲗ
ⲓⲁⲧ	ⲉⲓⲁⲧ
ⲓⲁ	ⲓⲁ
ⲓⲃⲉ	ⲉⲓⲃ
ⲓⲇⲟⲥ	ⲉⲓⲇⲟⲥ
ⲓⲉⲍⲉⲕⲓⲏⲗ	ⲓⲉⲍⲉⲕⲓⲏⲗ
ⲓⲉⲓⲃ	ⲉⲓⲉⲓⲃ
ⲓⲉⲢⲟ	ⲓⲉⲣⲟ
ⲓⲉⲣⲉⲙⲓⲁⲥ	ⲓⲉⲣⲉⲙⲓⲁⲥ
ⲓⲉⲣⲟⲥⲟⲗⲩⲙⲁ	ϩⲓⲉⲣⲟⲥⲟⲗⲩⲙⲁ
ⲓⲉⲣⲟ	ⲓⲉⲣⲟ
ⲓⲏⲗ	ⲓⲥⲣⲁⲏⲗ
ⲓⲏⲥⲟⲩⲥ	ⲓⲏⲥⲟⲩⲥ
ⲓⲏⲥ	ⲓⲏⲥⲟⲩⲥ
ⲓⲏ︤ⲗ︥	ⲓⲥⲣⲁⲏⲗ
ⲓⲗⲏⲙ	ϩⲓⲉⲣⲟⲩⲥⲁⲗⲏⲙ
ⲓⲙⲉ	ϩⲓⲙⲉ
ⲓⲛⲁⲓ	ⲓⲛⲁ
ⲓⲛⲇ	ⲓⲛⲇⲓⲕⲧⲓⲟⲛⲟⲥ
ⲓⲟⲣⲇⲁⲛⲏⲥ	ⲓⲟⲣⲇⲁⲛⲏⲥ
ⲓⲟⲩⲇⲁⲓ̈	ⲓⲟⲩⲇⲁⲓ
ⲓⲟⲩⲇⲁⲓⲁ	ⲓⲟⲩⲇⲁⲓⲁ
ⲓⲟⲩⲇⲁⲓ	ⲓⲟⲩⲇⲁⲓ
ⲓⲟⲩⲇⲁⲥ	ⲓⲟⲩⲇⲁⲥ
ⲓⲟⲩⲇⲁ	ⲓⲟⲩⲇⲁ
ⲓⲟⲩⲗⲉ	ⲓⲟⲩⲗⲉ
ⲓⲟⲩ[ⲇⲁⲥ	ⲓⲟⲩⲇⲁⲥ
ⲓⲣⲏⲛⲏ	ⲉⲓⲣⲏⲛⲏ
ⲓⲥ̄	ⲓⲏⲥⲟⲩⲥ
ⲓⲥⲁⲁⲕ	ⲓⲥⲁⲁⲕ
ⲓⲥⲁⲕ	ⲓⲥⲁⲕ
ⲓⲥⲕⲁⲣⲓⲱⲧⲏⲥ	ⲓⲥⲕⲁⲣⲓⲱⲧⲏⲥ
ⲓⲥⲙⲁⲏⲗ	ⲓⲥⲙⲁⲏⲗ
ⲓⲥⲣⲁⲏⲗ	ⲓⲥⲣⲁⲏⲗ
ⲓⲥ	ⲓⲏⲥⲟⲩⲥ
ⲓⲧⲟⲩⲱ	ϩⲓⲧⲟⲩⲱ
ⲓⲱϩⲁⲛⲏⲥ	ⲓⲱϩⲁⲛⲏⲥ
ⲓⲱϩⲁⲛⲛⲏⲥ	ⲓⲱϩⲁⲛⲛⲏⲥ
ⲓⲱⲁⲛⲛⲏⲥ	ⲓⲱⲁⲛⲛⲏⲥ
ⲓⲱⲥⲏⲫ	ⲓⲱⲥⲏⲫ
ⲓⲱⲥⲏ	ⲓⲱⲥⲏ
ⲓⲱⲥⲓⲁⲥ	ⲓⲱⲥⲓⲁⲥ
ⲓⲱⲧ	ⲉⲓⲱⲧ
ⲓ︤ⲏ︦ⲗ︥	ⲓⲥⲣⲁⲏⲗ
ⲓ︤ⲏ︦ⲥ︥	ⲓⲏⲥⲟⲩⲥ
ⲓ︤ⲗ︥︦︤ⲏ︦︥︤ⲙ︦︥	ϩⲓⲉⲣⲟⲩⲥⲁⲗⲏⲙ
ⲓ︤ⲥ︥︥	ⲓⲏⲥⲟⲩⲥ
ⲓ︤ⲥ︥	ⲓⲏⲥⲟⲩⲥ
ⲓ︤ⲥ︥`	ⲓⲏⲥⲟⲩⲥ
ⲓ︤︥ⲥ	ⲓⲏⲥⲟⲩⲥ
ⲓ︦ⲏ︦ⲗ︥	ⲓⲥⲣⲁⲏⲗ
ⲓ︦ⲗ︦ⲏ︦ⲙ︥	ϩⲓⲉⲣⲟⲩⲥⲁⲗⲏⲙ
ⲓ︦ⲥ︦	ⲓⲏⲥⲟⲩⲥ
ⲓ	ⲓ
ⲓ[ⲛⲇ]	ⲓⲛⲇⲓⲕⲧⲓⲟⲛⲟⲥ
Ⲕⲉ	ⲕⲉ
ⲕ̇ⲣⲓ̇ⲛⲉ	ⲕⲣⲓⲛⲉ
ⲕ̇ⲧⲟ	ⲕⲧⲟ
ⲕ̇	ⲕ
ⲕ̣ⲁ̣	ⲕⲁ
ⲕ̣ⲁⲁ	ⲕⲁⲁ
ⲕ̣ⲟⲗⲁⲍ̣ⲉ	ⲕⲟⲗⲁⲍⲉ
ⲕ̣ⲱⲧⲉ	ⲕⲱⲧⲉ
ⲕⲁ̂	ⲕⲁ
ⲕⲁ̇ⲁ	ⲕⲁⲁ
ⲕⲁ̣ϩ̣	ⲕⲁϩ
ⲕⲁϣⲁⲃⲉⲗ	ⲕⲁϣⲁⲃⲉⲗ
ⲕⲁϣ⳿ⲁⲃⲉⲗ	ⲕⲁϣⲁⲃⲉⲗ
ⲕⲁϣ	ⲕⲁϣ
ⲕⲁϩ̇	ⲕⲁϩ
ⲕⲁϩⲏⲩ	ⲕⲁϩⲏⲩ
ⲕⲁϩ⳿	ⲕⲁϩ
ⲕⲁϩ	ⲕⲁϩ
ⲕⲁϩ`	ⲕⲁϩ
ⲕⲁϫⲣⲟⲡ	ⲕⲁϫⲣⲟⲡ
ⲕⲁⲁ̇	ⲕⲁⲁ
ⲕⲁⲁⲧ	ⲕⲁⲁⲧ
ⲕⲁⲁ	ⲕⲁⲁ
ⲕⲁⲃⲟⲗ⳿	ⲕⲁⲃⲟⲗ
ⲕⲁⲃⲟⲗ	ⲕⲁⲃⲟⲗ
ⲕⲁⲉⲓⲛ	ⲕⲁⲉⲓⲛ
ⲕⲁⲉⲩⲱ	ⲕⲁⲉⲩⲱ
ⲕⲁⲑⲁⲣⲓⲍⲉ	ⲕⲁⲑⲁⲣⲓⲍⲉ
ⲕⲁⲑⲁⲣⲟⲥ	ⲕⲁⲑⲁⲣⲟⲥ
ⲕⲁⲑⲉⲇⲣⲁ	ⲕⲁⲑⲉⲇⲣⲁ
ⲕⲁⲑⲏⲅⲉⲓ	ⲕⲁⲑⲏⲅⲉⲓ
ⲕⲁⲓ̇	ⲕⲁⲓ
ⲕⲁⲓⲣⲟⲥ⳿	ⲕⲁⲓⲣⲟⲥ
ⲕⲁⲓⲣⲟⲥ	ⲕⲁⲓⲣⲟⲥ
ⲕⲁⲓ	ⲕⲁⲓ
ⲕⲁⲕⲉ	ⲕⲁⲕⲉ
ⲕⲁⲕⲉ`	ⲕⲁⲕⲉ
ⲕⲁⲕⲓⲁ⳿	ⲕⲁⲕⲓⲁ
ⲕⲁⲕⲓⲁ	ⲕⲁⲕⲓⲁ
ⲕⲁⲕⲟ̂	ⲕⲁⲕⲟ
ⲕⲁⲕⲟ	ⲕⲁⲕⲟ
ⲕⲁⲕⲱⲥ	ⲕⲁⲕⲱⲥ
ⲕⲁⲗⲱⲥ	ⲕⲁⲗⲱⲥ
ⲕⲁⲙⲁ	ⲕⲁⲙⲁ
ⲕⲁⲛⲁⲛⲁⲓⲟⲥ	ⲕⲁⲛⲁⲛⲁⲓⲟⲥ
ⲕⲁⲛⲱⲛ	ⲕⲁⲛⲱⲛ
ⲕⲁⲛ⳿	ⲕⲁⲛ
ⲕⲁⲛ	ⲕⲁⲛ
ⲕⲁⲛ`	ⲕⲁⲛ
ⲕⲁⲡⲁⲣⲛⲁⲟⲩⲙ	ⲕⲁⲡⲁⲣⲛⲁⲟⲩⲙ
ⲕⲁⲡⲛⲟⲥ	ⲕⲁⲡⲛⲟⲥ
ⲕⲁⲣⲡⲟⲥ	ⲕⲁⲣⲡⲟⲥ
ⲕⲁⲣⲱϥ	ⲕⲁⲣⲱϥ
ⲕⲁⲣⲱ	ⲕⲁⲣⲱ
ⲕⲁⲥⲓ̇ⲁ̇ⲛⲟⲥ	ⲕⲁⲥⲓⲁⲛⲟⲥ
ⲕⲁⲥⲓⲁⲛⲟⲥ	ⲕⲁⲥⲓⲁⲛⲟⲥ
ⲕⲁⲧⲁⲕⲗⲩⲥⲙⲟⲥ	ⲕⲁⲧⲁⲕⲗⲩⲥⲙⲟⲥ
ⲕⲁⲧⲁⲕⲣⲓⲙⲁ	ⲕⲁⲧⲁⲕⲣⲓⲙⲁ
ⲕⲁⲧⲁⲗⲁⲗⲓⲁ	ⲕⲁⲧⲁⲗⲁⲗⲓⲁ
ⲕⲁⲧⲁⲛⲧⲁ	ⲕⲁⲧⲁⲛⲧⲁ
ⲕⲁⲧⲁⲡⲉⲧⲁⲥⲙⲁ	ⲕⲁⲧⲁⲡⲉⲧⲁⲥⲙⲁ
ⲕⲁⲧⲁⲡⲟⲛϯⲍⲉ	ⲕⲁⲧⲁⲡⲟⲛϯⲍⲉ
ⲕⲁⲧⲁⲣⲅⲉⲓ	ⲕⲁⲧⲁⲣⲅⲉⲓ
ⲕⲁⲧⲁⲣⲟ	ⲕⲁⲧⲁⲣⲟ
ⲕⲁⲧⲁⲫⲣⲟⲛⲉⲓ̈	ⲕⲁⲧⲁⲫⲣⲟⲛⲉⲓ
ⲕⲁⲧⲁⲫⲣⲟⲛⲉⲓ	ⲕⲁⲧⲁⲫⲣⲟⲛⲉⲓ
ⲕⲁⲧⲁⲫⲣⲟⲛⲓ	ⲕⲁⲧⲁⲫⲣⲟⲛⲉⲓ
ⲕⲁⲧⲁ	ⲕⲁⲧⲁ
ⲕⲁⲧⲏⲅⲟⲣⲓ	ⲕⲁⲧⲏⲅⲟⲣⲉⲓ
ⲕⲁⲧⲟⲟⲧ	ⲕⲁⲧⲟⲟⲧ
ⲕⲁⲧⲟⲣⲑⲟⲩ	ⲕⲁⲧⲟⲣⲑⲟⲩ
ⲕⲁⲫⲁⲣⲛⲁⲟⲩⲙ	ⲕⲁⲫⲁⲣⲛⲁⲟⲩⲙ
ⲕⲁ	ⲕⲁ
ⲕⲁ`	ⲕⲁ
ⲕⲃⲁ⳿	ⲕⲃⲁ
ⲕⲃⲁ	ⲕⲃⲁ
ⲕⲉϥⲉ	ⲕⲱⲱⲃⲉ
ⲕⲉⲉⲥ	ⲕⲉⲉⲥ
ⲕⲉⲗⲉⲩⲉ	ⲕⲉⲗⲉⲩⲉ
ⲕⲉⲛ̇ⲇⲉⲛⲁⲣⲓⲟⲛ	ⲕⲉⲛⲧⲏⲛⲁⲣⲓⲟⲛ
ⲕⲉⲛⲇⲉⲛⲁⲣⲓⲟⲛ	ⲕⲉⲛⲧⲏⲛⲁⲣⲓⲟⲛ
ⲕⲉⲛⲇⲩⲛⲁⲣⲓⲟⲛ	ⲕⲉⲛⲧⲏⲛⲁⲣⲓⲟⲛ
ⲕⲉⲛⲧⲩⲣⲓⲱⲛ	ⲕⲉⲛⲧⲩⲣⲓⲱⲛ
ⲕⲉⲣⲱⲛ	ⲕⲉⲣⲱⲛ
ⲕⲉⲥⲁⲣⲓⲁ	ⲕⲉⲥⲁⲣⲓⲁ
ⲕⲉⲧⲉ	ⲕⲉⲧⲉ
ⲕⲉⲧ⳿	ⲕⲉⲧ
ⲕⲉⲧ	ⲕⲉⲧ
ⲕⲉⲩⲁ	ⲕⲉⲩⲁ
ⲕⲉ	ⲕⲉ
ⲕⲏϩ⳿	ⲕⲏϩ
ⲕⲏϩ	ⲕⲏϩ
ⲕⲏⲃ⳿	ⲕⲏⲃ
ⲕⲏⲃ	ⲕⲏⲃ
ⲕⲏⲕⲁϩⲏⲩ	ⲕⲏⲕⲁϩⲏⲩ
ⲕⲏⲕ	ⲕⲏⲕ
ⲕⲏⲛⲥⲟⲥ	ⲕⲏⲛⲥⲟⲥ
ⲕⲏⲣⲩⲥⲥⲉ	ⲕⲏⲣⲩⲥⲥⲉ
ⲕⲏⲫⲁⲥ	ⲕⲏⲫⲁⲥ
ⲕⲏⲫⲁ	ⲕⲏⲫⲁⲥ
ⲕⲏ	ⲕⲏ
ⲕⲓϣⲉ	ϣⲓⲕⲉ
ⲕⲓⲑⲁⲣⲁ	ⲕⲓⲑⲁⲣⲁ
ⲕⲓⲑⲁⲣⲓⲍⲉ	ⲕⲓⲑⲁⲣⲓⲍⲉ
ⲕⲓⲙⲕⲓⲙ	ⲕⲓⲙⲕⲓⲙ
ⲕⲓⲙ	ⲕⲓⲙ
ⲕⲓⲙ`	ⲕⲓⲙ
ⲕⲓⲛⲇⲩⲛⲉⲩⲉ	ⲕⲓⲛⲇⲩⲛⲉⲩⲉ
ⲕⲗ̇ⲗⲉ	ⲕⲗⲗⲉ
ⲕⲗ̣ϫⲉ̣	ⲕⲗϫⲉ
ⲕⲗϫⲉ	ⲕⲗϫⲉ
ⲕⲗϫ	ⲕⲗϫ
ⲕⲗⲁϥⲧ	ⲕⲗⲁϥⲧ
ⲕⲗⲁϥ︤ⲧ︥	ⲕⲗⲁϥⲧ
ⲕⲗⲁⲇⲟⲥ	ⲕⲗⲁⲇⲟⲥ
ⲕⲗⲏⲣⲓⲕⲟⲥ	ⲕⲗⲏⲣⲓⲕⲟⲥ
ⲕⲗⲏⲣⲟⲛⲟⲙⲉⲓ	ⲕⲗⲏⲣⲟⲛⲟⲙⲉⲓ
ⲕⲗⲏⲣⲟⲛⲟⲙⲉⲓ`	ⲕⲗⲏⲣⲟⲛⲟⲙⲉⲓ
ⲕⲗⲏⲣⲟⲛⲟⲙⲓⲁ	ⲕⲗⲏⲣⲟⲛⲟⲙⲓⲁ
ⲕⲗⲏⲣⲟⲛⲟⲙⲓⲁ`	ⲕⲗⲏⲣⲟⲛⲟⲙⲓⲁ
ⲕⲗⲏⲣⲟⲛⲟⲙⲓ	ⲕⲗⲏⲣⲟⲛⲟⲙⲉⲓ
ⲕⲗⲏⲣⲟⲛⲟⲙⲟⲥ	ⲕⲗⲏⲣⲟⲛⲟⲙⲟⲥ
ⲕⲗⲏⲣⲟⲥ	ⲕⲗⲏⲣⲟⲥ
ⲕⲗⲗⲉ	ⲕⲗⲗⲉ
ⲕⲗⲟⲙ	ⲕⲗⲟⲙ
ⲕⲗⲟⲟⲗⲉ	ⲕⲗⲟⲟⲗⲉ
ⲕⲛⲧⲉ	ⲕⲛⲧⲉ
ⲕⲟⲇⲣⲁⲛⲧⲏⲥ	ⲕⲟⲇⲣⲁⲛⲧⲏⲥ
ⲕⲟⲓⲛⲟⲛⲟⲥ	ⲕⲟⲓⲛⲟⲛⲟⲥ
ⲕⲟⲓⲛⲱⲛⲓⲁ	ⲕⲟⲓⲛⲱⲛⲓⲁ
ⲕⲟⲓⲛⲱⲛⲟⲥ	ⲕⲟⲓⲛⲱⲛⲟⲥ
ⲕⲟⲕⲕⲟⲥ	ⲕⲟⲕⲕⲟⲥ
ⲕⲟⲗⲁⲍⲉ	ⲕⲟⲗⲁⲍⲉ
ⲕⲟⲗⲁⲥⲓ̇ⲥ	ⲕⲟⲗⲁⲥⲓⲥ
ⲕⲟⲗⲁⲥⲓⲥ	ⲕⲟⲗⲁⲥⲓⲥ
ⲕⲟⲗⲗⲩϭⲉ	ⲕⲟⲗⲗⲏⲅⲓⲟⲛ
ⲕⲟⲗⲗⲩⲕⲓ̇ⲟⲛ	ⲕⲟⲗⲗⲏⲅⲓⲟⲛ
ⲕⲟⲗⲗⲩⲕⲓⲟⲛ	ⲕⲟⲗⲗⲏⲅⲓⲟⲛ
ⲕⲟⲙϣ	ⲕⲟⲙϣ
ⲕⲟⲙⲉⲥ	ⲕⲟⲙⲉⲥ
ⲕⲟⲛϯⲧⲟⲛ	ⲕⲟⲛϯⲧⲟⲛ
ⲕⲟⲛⲥ	ⲕⲟⲛⲥ
ⲕⲟⲞⲩⲉ	ⲕⲟⲟⲩⲉ
ⲕⲟⲞⲩⲉ`	ⲕⲟⲟⲩⲉ
ⲕⲟⲟϩ	ⲕⲟⲟϩ
ⲕⲟⲟⲣⲉ	ⲕⲟⲟⲣⲉ
ⲕⲟⲟⲥⲧ	ⲕⲟⲟⲥⲧ
ⲕⲟⲟⲩⲉ̂	ⲕⲟⲟⲩⲉ
ⲕⲟⲟⲩⲉ̇	ⲕⲟⲟⲩⲉ
ⲕⲟⲟⲩⲉ⳿	ⲕⲟⲟⲩⲉ
ⲕⲟⲟⲩⲉ	ⲕⲟⲟⲩⲉ
ⲕⲟⲟⲩⲉ`	ⲕⲟⲟⲩⲉ
ⲕⲟⲟⲩ	ⲕⲟⲟⲩ
ⲕⲟⲡⲣⲓ̈ⲁ	ⲕⲟⲡⲣⲓⲁ
ⲕⲟⲡⲣⲓⲁ	ⲕⲟⲡⲣⲓⲁ
ⲕⲟⲣⲃⲁⲛ	ⲕⲟⲣⲃⲁⲛ
ⲕⲟⲣⲓⲛⲑⲟⲥ	ⲕⲟⲣⲓⲛⲑⲟⲥ
ⲕⲟⲥⲙⲟⲕⲣⲁⲧⲱⲣ	ⲕⲟⲥⲙⲟⲕⲣⲁⲧⲱⲣ
ⲕⲟⲥⲙⲟⲥ	ⲕⲟⲥⲙⲟⲥ
ⲕⲟⲧⲥ	ⲕⲟⲧⲥ
ⲕⲟⲧ︤ⲥ︥	ⲕⲟⲧⲥ
ⲕⲟⲧ	ⲕⲟⲧ
ⲕⲟⲩⲉⲓ	ⲕⲟⲩⲉⲓ
ⲕⲟⲩⲓ̇	ⲕⲟⲩⲓ
ⲕⲟⲩⲓ̈	ⲕⲟⲩⲓ
ⲕⲟⲩⲓ	ⲕⲟⲩⲓ
ⲕⲟⲩⲙ	ⲕⲟⲩⲙ
ⲕⲣⲁⲛⲓⲟⲛ	ⲕⲣⲁⲛⲓⲟⲛ
ⲕⲣⲁⲧⲟⲥ	ⲕⲣⲁⲧⲟⲥ
ⲕⲣⲓ̇ⲛⲉ	ⲕⲣⲓⲛⲉ
ⲕⲣⲓ̇ⲥⲓ̇ⲥ	ⲕⲣⲓⲥⲓⲥ
ⲕⲣⲓ̈ⲕⲟⲥ	ⲕⲣⲓⲕⲟⲥ
ⲕⲣⲓⲕⲟⲥ	ⲕⲣⲓⲕⲟⲥ
ⲕⲣⲓⲙⲁ	ⲕⲣⲓⲙⲁ
ⲕⲣⲓⲛⲉ	ⲕⲣⲓⲛⲉ
ⲕⲣⲓⲥⲓⲥ	ⲕⲣⲓⲥⲓⲥ
ⲕⲣⲓⲥⲡⲟⲥ	ⲕⲣⲓⲥⲡⲟⲥ
ⲕⲣⲓⲧⲏⲥ	ⲕⲣⲓⲧⲏⲥ
ⲕⲣⲙⲣⲙ	ⲕⲣⲙⲣⲙ
ⲕⲣⲙⲣ︤ⲙ︥	ⲕⲣⲙⲣⲙ
ⲕⲣⲟϥ	ⲕⲣⲟϥ
ⲕⲣⲟϥ`	ⲕⲣⲟϥ
ⲕⲣⲟⲛⲟⲥ⳿	ⲕⲣⲟⲛⲟⲥ
ⲕⲣⲟⲛⲟⲥ	ⲕⲣⲟⲛⲟⲥ
ⲕⲣⲟ	ⲕⲣⲟ
ⲕⲧⲉⲓⲁⲧ	ⲕⲧⲉⲓⲁⲧ
ⲕⲧⲉ	ⲕⲧⲉ
ⲕⲧⲟ̂	ⲕⲧⲟ
ⲕⲧⲟ	ⲕⲧⲟ
ⲕⲧⲟ`	ⲕⲧⲟ
ⲕⲩⲙⲃⲁⲗⲟⲛ	ⲕⲩⲙⲃⲁⲗⲟⲛ
ⲕⲩⲣⲏⲛⲁⲓⲟⲥ	ⲕⲩⲣⲏⲛⲁⲓⲟⲥ
ⲕⲩⲣⲓⲁⲕⲏ	ⲕⲩⲣⲓⲁⲕⲏ
ⲕⲩⲣⲓⲁⲕⲟⲛ	ⲕⲩⲣⲓⲁⲕⲟⲛ
ⲕⲩⲣⲓⲝ	ⲕⲩⲣⲓⲝ
ⲕⲩⲣⲓ	ⲕⲩⲣⲓⲟⲥ
ⲕⲱ̂	ⲕⲱ
ⲕⲱ̇ⲗϩ	ⲕⲱⲗϩ
ⲕⲱϩⲧ̇	ⲕⲱϩⲧ
ⲕⲱϩⲧ	ⲕⲱϩⲧ
ⲕⲱϩ⳿	ⲕⲱϩ
ⲕⲱϩ︤ⲧ︥	ⲕⲱϩⲧ
ⲕⲱϩ	ⲕⲱϩ
ⲕⲱⲃ	ⲕⲱⲃ
ⲕⲱⲃ`	ⲕⲱⲃ
ⲕⲱⲗϩ	ⲕⲱⲗϩ
ⲕⲱⲗⲩⲉ	ⲕⲱⲗⲩⲉ
ⲕⲱⲗⲩⲉ`	ⲕⲱⲗⲩⲉ
ⲕⲱⲗⲩ	ⲕⲱⲗⲩ
ⲕⲱⲗⲩ`	ⲕⲱⲗⲩ
ⲕⲱⲙϣ	ⲕⲱⲙϣ
ⲕⲱⲙⲏ	ⲕⲱⲙⲏ
ⲕⲱⲙ︤ϣ︥	ⲕⲱⲙϣ
ⲕⲱⲛⲥ	ⲕⲱⲛⲥ
ⲕⲱⲛ︤ⲥ︥	ⲕⲱⲛⲥ
ⲕⲱⲥⲙⲓⲕⲟⲛ	ⲕⲱⲥⲙⲓⲕⲟⲛ
ⲕⲱⲧⲉ	ⲕⲱⲧⲉ
ⲕⲱⲧⲉ`	ⲕⲱⲧⲉ
ⲕⲱⲧ⳿	ⲕⲱⲧ
ⲕⲱⲧ	ⲕⲱⲧ
ⲕⲱⲧ`	ⲕⲱⲧ
ⲕⲱ⳿	ⲕⲱ
ⲕⲱ	ⲕⲱ
ⲕⲱ`	ⲕⲱ
ⲕ⳿	ⲕ
ⲕ︤ⲗ︥ϫⲉ	ⲕⲗϫⲉ
ⲕ︤ⲛ︥ⲧⲉ	ⲕⲛⲧⲉ
ⲕ︤ⲣ︦ⲙ︥ⲣ︤ⲙ︥	ⲕⲣⲙⲣⲙ
ⲕ︤	ⲕ
ⲕ︥	ⲕ
ⲕ︥`	ⲕ
ⲕ	ⲕ
ⲕ[ⲓⲛⲇ]ⲩ̣ⲛⲉⲩⲉ	ⲕⲓⲛⲇⲩⲛⲉⲩⲉ
ⲕ`	ⲕ
ⲖⲁⲁⲨ	ⲗⲁⲁⲩ
ⲗ̇ⲁⲥ	ⲗⲁⲥ
ⲗ̣ⲟ̣ⲑ̣	ⲗⲟⲑ
ⲗ̣ⲟ̣	ⲗⲟ
ⲗϩⲏⲙ	ⲗϩⲏⲙ
ⲗⲁ̇ⲁⲩ	ⲗⲁⲁⲩ
ⲗⲁⲁ̇ⲩ	ⲗⲁⲁⲩ
ⲗⲁⲁⲩ⳿	ⲗⲁⲁⲩ
ⲗⲁⲁⲩ	ⲗⲁⲁⲩ
ⲗⲁⲁⲩ`	ⲗⲁⲁⲩ
ⲗⲁⲕⲙ	ⲗⲁⲕⲙ
ⲗⲁⲙⲁ	ⲗⲁⲙⲁ
ⲗⲁⲟⲥ⳿	ⲗⲁⲟⲥ
ⲗⲁⲟⲥ	ⲗⲁⲟⲥ
ⲗⲁⲟⲥ`	ⲗⲁⲟⲥ
ⲗⲁⲥ	ⲗⲁⲥ
ⲗⲁⲧⲟⲥ	ⲗⲁⲟⲥ
ⲗⲁⲩⲟ	ⲗⲁⲩⲟ
ⲗⲉϫⲗⲱϫ	ⲗⲉϫⲗⲱϫ
ⲗⲉⲅⲉⲱⲛ	ⲗⲉⲅⲉⲱⲛ
ⲗⲉⲅⲓⲱⲛ	ⲗⲉⲅⲓⲱⲛ
ⲗⲉⲗⲟⲩ	ⲗⲉⲗⲟⲩ
ⲗⲉⲟⲩⲉⲓ	ⲗⲉⲟⲩⲉⲓ
ⲗⲏⲡⲉⲓ	ⲗⲏⲡⲉⲓ
ⲗⲏⲡⲏ	ⲗⲏⲡⲏ
ⲗⲏⲥⲧⲏⲥ	ⲗⲏⲥⲧⲏⲥ
ⲗⲓⲁ	ⲗⲓⲁ
ⲗⲓⲃⲁⲛⲟⲥ	ⲗⲓⲃⲁⲛⲟⲥ
ⲗⲓⲧⲟⲩⲣⲅⲓ̇ⲁ̇	ⲗⲓⲧⲟⲩⲣⲅⲓⲁ
ⲗⲓⲧⲟⲩⲣⲅⲓⲁ	ⲗⲓⲧⲟⲩⲣⲅⲓⲁ
ⲗⲗⲁⲁⲩ	ⲗⲁⲁⲩ
ⲗⲗⲉⲡⲧⲟⲛ	ⲗⲗⲉⲡⲧⲟⲛ
ⲗⲗⲏⲃ	ⲗⲗⲏⲃ
ⲗⲟϭ	ⲗⲟϭ
ⲗⲟⲃⲉ	ⲗⲟⲃⲉ
ⲗⲟⲅⲟⲥ	ⲗⲟⲅⲟⲥ
ⲗⲟⲑ	ⲗⲟⲑ
ⲗⲟⲓ̇ϭⲉ	ⲗⲟⲓϭⲉ
ⲗⲟⲓϩⲉ	ⲗⲟⲓϩⲉ
ⲗⲟⲓϭⲉ	ⲗⲟⲓϭⲉ
ⲗⲟⲙⲥ	ⲗⲟⲙⲥ
ⲗⲟⲙ︤ⲥ︥	ⲗⲟⲙⲥ
ⲗⲟⲩⲕⲓ̇ⲁ̇ⲛⲟⲥ	ⲗⲟⲩⲕⲓⲁⲛⲟⲥ
ⲗⲟⲩⲕⲓⲁⲛⲟⲥ	ⲗⲟⲩⲕⲓⲁⲛⲟⲥ
ⲗⲟ	ⲗⲟ
ⲗⲟ[ϭ	ⲗⲟϭ
ⲗⲟ`	ⲗⲟ
ⲗⲩⲡⲉⲓ̇	ⲗⲩⲡⲉⲓ
ⲗⲩⲡⲉⲓ	ⲗⲩⲡⲉⲓ
ⲗⲩⲡⲉⲓ`	ⲗⲩⲡⲉⲓ
ⲗⲩⲡⲏ	ⲗⲩⲡⲏ
ⲗⲩⲡⲓ	ⲗⲩⲡⲉⲓ
ⲗⲩⲥⲧⲏⲥ	ⲗⲏⲥⲧⲏⲥ
ⲗⲩⲭⲛⲓⲁ	ⲗⲩⲭⲛⲓⲁ
ⲗⲩⲭ[ⲛⲓⲁ	ⲗⲩⲭⲛⲓⲁ
ⲗⲱϫϩ	ⲗⲱϫϩ
ⲗⲱϫ︤ϩ︥	ⲗⲱϫϩ
ⲗⲱⲕ	ⲗⲱⲕ
ⲗⲱⲧ	ⲗⲱⲧ
ⲗ	ⲛ
Ⲙ̄ⲙ︤ⲛ︥	ⲙⲙⲛ
Ⲙ̄ⲡⲱⲣ`	ⲙⲡⲱⲣ
Ⲙ̄ⲡ︤ⲣ︥	ⲙⲡⲣ
Ⲙ̄	ⲙ
ⲘⲀⲢⲦⲨⲢⲒⲀ	ⲙⲁⲣⲧⲩⲣⲓⲁ
ⲘⲀⲢⲦⲨⲢⲞⲤ	ⲙⲁⲣⲧⲩⲣⲟⲥ
Ⲙⲉⲛ	ⲙⲉⲛ
Ⲙⲉⲛ`	ⲙⲉⲛ
Ⲙⲏ⳿	ⲙⲏ
Ⲙⲏ	ⲙⲏ
Ⲙⲙⲛ	ⲙⲙⲛ
Ⲙⲡⲣ	ⲙⲡⲣ
Ⲙⲡⲱⲣ	ⲙⲡⲱⲣ
Ⲙ	ⲙ
ⲙ̣̄̄ⲙ︤ⲛ︥	ⲙⲙⲛ
ⲙ̣̄	ⲙ
ⲙ̄ϩⲏⲧ︤	ⲛϩⲏⲧ
ⲙ̄ⲁⲁⲃ	ⲙⲁⲁⲃ
ⲙ̄ⲕⲁϩ	ⲙⲕⲁϩ
ⲙ̄ⲕⲁϩ`	ⲙⲕⲁϩ
ⲙ̄ⲙ̄ⲙⲟ	ⲙⲙⲟ
ⲙ̄ⲙⲁ̣	ⲙⲙⲁ
ⲙ̄ⲙⲁⲁⲩ	ⲙⲙⲁⲁⲩ
ⲙ̄ⲙⲁⲧⲉ	ⲙⲙⲁⲧⲉ
ⲙ̄ⲙⲁⲩ	ⲙⲙⲁⲩ
ⲙ̄ⲙⲁⲩ`	ⲙⲙⲁⲩ
ⲙ̄ⲙⲁ	ⲙⲙⲁ
ⲙ̄ⲙⲏⲛⲉ	ⲙⲙⲏⲛⲉ
ⲙ̄ⲙⲓ̈ⲛ	ⲙⲙⲓⲛ
ⲙ̄ⲙⲓⲛⲙ̄ⲙⲟ	ⲙⲙⲓⲛⲙⲙⲟ
ⲙ̄ⲙⲓⲛⲙ̄ⲙⲱ	ⲙⲙⲓⲛⲙⲙⲱ
ⲙ̄ⲙⲓⲛ⳿ⲙ̄ⲙⲱ	ⲙⲙⲓⲛⲙⲙⲱ
ⲙ̄ⲙⲓⲛ[ⲙ]ⲙⲟ	ⲙⲙⲓⲛⲙⲙⲟ
ⲙ̄ⲙⲓⲛ`ⲙ̄ⲙⲟ	ⲙⲙⲓⲛⲙⲙⲟ
ⲙ̄ⲙⲓⲛ`ⲙ̄ⲙⲱ	ⲙⲙⲓⲛⲙⲙⲱ
ⲙ̄ⲙⲟ̂	ⲙⲙⲟ
ⲙ̄ⲙⲟ̣	ⲙⲙⲟ
ⲙ̄ⲙⲟⲛ	ⲙⲙⲟⲛ
ⲙ̄ⲙⲟⲛ`	ⲙⲙⲟⲛ
ⲙ̄ⲙⲟⲟⲩ	ⲙⲙⲟⲟⲩ
ⲙ̄ⲙⲟⲩ	ⲙⲙⲟⲩ
ⲙ̄ⲙⲟ	ⲙⲙⲟ
ⲙ̄ⲙⲱ	ⲙⲙⲱ
ⲙ̄ⲙ︤ⲛ̣̄	ⲙⲙⲛ
ⲙ̄ⲙ︤ⲛ︥ⲧⲉ	ⲙⲙⲛⲧⲉ
ⲙ̄ⲙ︤ⲛ︥	ⲙⲙⲛ
ⲙ̄ⲟ	ⲙⲙⲟ
ⲙ̄ⲡ̣	ⲙⲡ
ⲙ̄ⲡϣⲁ̂	ⲙⲡϣⲁ
ⲙ̄ⲡϣⲁ	ⲙⲡϣⲁ
ⲙ̄ⲡϣⲁ`	ⲙⲡϣⲁ
ⲙ̄ⲡⲁⲧⲉ	ⲙⲡⲁⲧⲉ
ⲙ̄ⲡⲁⲧ︤	ⲙⲡⲁⲧ
ⲙ̄ⲡⲁ	ⲙⲡⲁ
ⲙ̄ⲡⲉ	ⲙⲡⲉ
ⲙ̄ⲡⲟⲩ	ⲙⲡⲟⲩ
ⲙ̄ⲡⲣ̄	ⲙⲡⲣ
ⲙ̄ⲡⲣⲧⲣⲉ	ⲙⲡⲣⲧⲣⲉ
ⲙ̄ⲡⲣ	ⲙⲡⲣ
ⲙ̄ⲡⲱⲣ	ⲙⲡⲱⲣ
ⲙ̄ⲡⲱⲣ`	ⲙⲡⲱⲣ
ⲙ̄ⲡ︤ⲣ︥ⲧⲣⲉ	ⲙⲡⲣⲧⲣⲉ
ⲙ̄ⲡ︤ⲣ︥	ⲙⲡⲣ
ⲙ̄ⲡ︤ⲣ	ⲙⲡⲣ
ⲙ̄ⲡ︤	ⲙⲡ
ⲙ̄ⲡ	ⲙⲡ
ⲙ̄ⲧⲟ̂	ⲙⲧⲟ
ⲙ̄ⲧⲟⲛ	ⲙⲧⲟⲛ
ⲙ̄ⲧⲟⲛ`	ⲙⲧⲟⲛ
ⲙ̄ⲧⲟ	ⲙⲧⲟ
ⲙ̄	ⲙ
ⲙ̄[ ]	ⲙ[ ]
ⲙ̄]	ⲙ
ⲙ̇ⲁ	ⲙⲁ
ⲙ̇ⲕⲁϩ	ⲙⲕⲁϩ
ⲙ̇ⲙ̇ⲟ	ⲙⲙⲟ
ⲙ̇ⲙⲁ̣[.]	ⲙⲙⲁⲩ
ⲙ̇ⲙⲁⲧⲉ	ⲙⲙⲁⲧⲉ
ⲙ̇ⲙⲁⲨ	ⲙⲙⲁⲩ
ⲙ̇ⲙⲁⲩ	ⲙⲙⲁⲩ
ⲙ̇ⲙⲓ̇ⲛⲙⲙⲟ	ⲙⲙⲓⲛⲙⲙⲟ
ⲙ̇ⲙⲟ	ⲙⲙⲟ
ⲙ̇ⲙⲱ	ⲙⲙⲱ
ⲙ̇ⲛ	ⲙⲛ
ⲙ̇ⲟⲩⲧⲉ	ⲙⲟⲩⲧⲉ
ⲙ̇ⲡϣⲁ	ⲙⲡϣⲁ
ⲙ̇ⲡⲁⲧⲉ	ⲙⲡⲁⲧⲉ
ⲙ̇ⲡⲉ	ⲙⲡⲉ
ⲙ̇ⲡⲣ̇	ⲙⲡⲣ
ⲙ̇ⲡⲱⲣ	ⲙⲡⲱⲣ
ⲙ̇ⲡ	ⲙⲡ
ⲙ̇ⲧⲟⲛ̇	ⲙⲧⲟⲛ
ⲙ̇ⲧⲟⲛ	ⲙⲧⲟⲛ
ⲙ̇	ⲙ
ⲙ̣̄ⲙⲟ	ⲙⲙⲟ
ⲙ̣̄ⲡ̣̣ϣⲁ	ⲙⲡϣⲁ
ⲙ̣ⲁ̣ⲩ̣ⲁⲁ	ⲙⲁⲩⲁⲁ
ⲙ̣ⲁϣⲉ	ⲙⲁϣⲉ
ⲙ̣ⲁⲣ︤	ⲙⲁⲣ
ⲙ̣ⲉϣ̣ⲁ	ⲙⲉϣⲁ
ⲙ̣ⲉⲧⲁⲛⲟⲉⲓ	ⲙⲉⲧⲁⲛⲟⲉⲓ
ⲙ̣ⲉ	ⲙⲉ
ⲙ̣ⲓϣⲉ	ⲙⲓϣⲉ
ⲙ̣ⲓⲛⲉ	ⲙⲓⲛⲉ
ⲙ̣ⲙⲛⲧⲣⲉⲙⲡ	̣ⲙⲛⲧⲣⲉⲙⲡ
ⲙ̣ⲙⲟ	ⲙⲙⲟ
ⲙ̣ⲟⲩϩ	ⲙⲟⲩϩ
ⲙ̣ⲟⲩ	ⲙⲟⲩ
ⲙ̣︤ⲛ︥	ⲙⲛ
ⲙ̣	ⲙ
ⲙ̣[ⲙⲁ]ⲩ	ⲙⲙⲁⲩ
ⲙ̣[ⲡⲉ	ⲙⲡⲉ
ⲙ̣[.....]ⲟⲓ	ⲙ[.....]ⲟⲓ
ⲙϩⲁⲁⲩ	ⲙϩⲁⲁⲩ
ⲙϩⲁⲟⲩ	ⲙϩⲁⲟⲩ
ⲙϩⲏⲧ	ⲛϩⲏⲧ
ⲙⲁ̂	ⲙⲁ
ⲙⲁϣⲉ	ⲙⲁϣⲉ
ⲙⲁϩ︤	ⲙⲁϩ
ⲙⲁϩ	ⲙⲁϩ
ⲙⲁⲁ̇ⲩ	ⲙⲁⲁⲩ
ⲙⲁⲁϫⲉ⳿	ⲙⲁⲁϫⲉ
ⲙⲁⲁϫⲉ	ⲙⲁⲁϫⲉ
ⲙⲁⲁⲃⲉ	ⲙⲁⲁⲃⲉ
ⲙⲁⲁⲃ	ⲙⲁⲁⲃ
ⲙⲁⲁⲩ	ⲙⲁⲁⲩ
ⲙⲁⲁⲩ`	ⲙⲁⲁⲩ
ⲙⲁⲁ	ⲙⲁⲁ
ⲙⲁⲃⲧⲏ	ⲙⲁⲁⲃⲧⲏ
ⲙⲁⲅⲇⲁⲗⲏⲛⲏ	ⲙⲁⲅⲇⲁⲗⲏⲛⲏ
ⲙⲁⲅⲉⲓⲣⲟⲥ⳿	ⲙⲁⲅⲉⲓⲣⲟⲥ
ⲙⲁⲅⲉⲓⲣⲟⲥ	ⲙⲁⲅⲉⲓⲣⲟⲥ
ⲙⲁⲉⲓⲉ	ⲙⲁⲉⲓⲉ
ⲙⲁⲉⲓⲛ	ⲙⲁⲉⲓⲛ
ⲙⲁⲑⲁⲓⲟⲥ	ⲙⲁⲑⲁⲓⲟⲥ
ⲙⲁⲑⲏⲧⲏⲥ	ⲙⲁⲑⲏⲧⲏⲥ
ⲙⲁⲑⲙⲥⲟ	ⲙⲁⲑⲙⲥⲟ
ⲙⲁⲓ̈ⲛⲟⲩⲧⲉ	ⲙⲁⲓⲛⲟⲩⲧⲉ
ⲙⲁⲓ̈	ⲙⲁⲓ
ⲙⲁⲓⲛⲟⲃⲉ	ⲙⲁⲓⲛⲟⲃⲉ
ⲙⲁⲓⲛⲟⲩⲧⲉ	ⲙⲁⲓⲛⲟⲩⲧⲉ
ⲙⲁⲓⲛ	ⲙⲁⲓⲛ
ⲙⲁⲓⲣⲱⲙⲉ	ⲙⲁⲓⲣⲱⲙⲉ
ⲙⲁⲓⲥⲃⲱ	ⲙⲁⲓⲥⲃⲱ
ⲙⲁⲓⲧⲟ	ⲙⲁⲓⲧⲟⲉ
ⲙⲁⲓ	ⲙⲁⲓ
ⲙⲁⲕϩ	ⲙⲁⲕϩ
ⲙⲁⲕⲁⲣⲓ̇ⲁ̇	ⲙⲁⲕⲁⲣⲓⲁ
ⲙⲁⲕⲁⲣⲓ̇ⲟⲥ	ⲙⲁⲕⲁⲣⲓⲟⲥ
ⲙⲁⲕⲁⲣⲓⲁ̇	ⲙⲁⲕⲁⲣⲓⲁ
ⲙⲁⲕⲁⲣⲓⲁ	ⲙⲁⲕⲁⲣⲓⲁ
ⲙⲁⲕⲁⲣⲓⲍⲉ	ⲙⲁⲕⲁⲣⲓⲍⲉ
ⲙⲁⲕⲁⲣⲓⲟⲥ	ⲙⲁⲕⲁⲣⲓⲟⲥ
ⲙⲁⲕⲉⲇⲟⲛⲓⲁ	ⲙⲁⲕⲉⲇⲟⲛⲓⲁ
ⲙⲁⲕⲉⲗⲗⲟⲥ	ⲙⲁⲕⲉⲗⲗⲟⲥ
ⲙⲁⲕ︤ϩ︥	ⲙⲁⲕϩ
ⲙⲁⲗⲁⲕⲟⲥ	ⲙⲁⲗⲁⲕⲟⲥ
ⲙⲁⲗⲓ̇ⲥⲧⲁ	ⲙⲁⲗⲓⲥⲧⲁ
ⲙⲁⲗⲓⲤⲧⲁ	ⲙⲁⲗⲓⲥⲧⲁ
ⲙⲁⲗⲓⲥⲧⲁ⳿	ⲙⲁⲗⲓⲥⲧⲁ
ⲙⲁⲗⲓⲥⲧⲁ	ⲙⲁⲗⲓⲥⲧⲁ
ⲙⲁⲗⲓⲥⲧⲁ`	ⲙⲁⲗⲓⲥⲧⲁ
ⲙⲁⲗⲗⲟⲛ	ⲙⲁⲗⲗⲟⲛ
ⲙⲁⲙⲙⲱⲛⲁⲥ⳿	ⲙⲁⲙⲙⲱⲛⲁⲥ
ⲙⲁⲙⲙⲱⲛⲁⲥ	ⲙⲁⲙⲙⲱⲛⲁⲥ
ⲙⲁⲛⲓⲁⲕⲏⲥ	ⲙⲁⲛⲓⲁⲕⲏⲥ
ⲙⲁⲟⲩⲁⲁ	ⲙⲁⲟⲩⲁⲁ
ⲙⲁⲣⲁⲛ	ⲙⲁⲣⲁⲛ
ⲙⲁⲣⲉ	ⲙⲁⲣⲉ
ⲙⲁⲣⲓⲁ	ⲙⲁⲣⲓⲁ
ⲙⲁⲣⲛ	ⲙⲁⲣⲛ
ⲙⲁⲣⲟ	ⲙⲁⲣⲟ
ⲙⲁⲣ︤ⲛ︥	ⲙⲁⲣⲛ
ⲙⲁⲣ︤	ⲙⲁⲣ
ⲙⲁⲣ︥	ⲙⲁⲣ
ⲙⲁⲣ	ⲙⲁⲣ
ⲙⲁⲥⲉ⳿	ⲙⲁⲥⲉ
ⲙⲁⲥⲉ	ⲙⲁⲥⲉ
ⲙⲁⲥⲡⲟⲣⲕ̄	ⲙⲁⲥⲡⲟⲣⲕ
ⲙⲁⲥⲡⲟⲣⲕ	ⲙⲁⲥⲡⲟⲣⲕ
ⲙⲁⲥⲧⲏⲝ	ⲙⲁⲥⲧⲏⲝ
ⲙⲁⲥⲧⲓ̇ⲅⲝ̇	ⲙⲁⲥⲧⲓⲅⲝ
ⲙⲁⲥⲧⲓⲅⲝ	ⲙⲁⲥⲧⲓⲅⲝ
ⲙⲁⲥⲧⲓⲅⲟⲩ	ⲙⲁⲥⲧⲓⲅⲟⲩ
ⲙⲁⲥⲧⲓⲅ︤ⲝ︥	ⲙⲁⲥⲧⲓⲅⲝ
ⲙⲁⲥⲧⲓⲕⲟⲩ	ⲙⲁⲥⲧⲓⲅⲟⲩ
ⲙⲁⲥⲧⲓⲕ[ⲟⲩ]	ⲙⲁⲥⲧⲓⲅⲟⲩ
ⲙⲁⲧⲉ	ⲙⲁⲧⲉ
ⲙⲁⲧⲟⲓ	ⲙⲁⲧⲟⲓ
ⲙⲁⲩⲁ̇ⲁ	ⲙⲁⲩⲁⲁ
ⲙⲁⲩⲁⲁ̇	ⲙⲁⲩⲁⲁ
ⲙⲁⲩⲁⲁⲧ	ⲙⲁⲩⲁⲁⲧ
ⲙⲁⲩⲁⲁ	ⲙⲁⲩⲁⲁ
ⲙⲁⲩⲁⲧ	ⲙⲁⲩⲁⲧ
ⲙⲁⲩⲁ	ⲙⲁⲩⲁ
ⲙⲁ⳱	ⲙⲁ
ⲙⲁ⳿	ⲙⲁ
ⲙⲁ	ⲙⲁ
ⲙⲁ]ⲩ̣ⲁ	ⲙⲁⲩⲁ
ⲙⲁ`	ⲙⲁ
ⲙⲉ̣ⲧⲁⲛⲟⲉⲓ	ⲙⲉⲧⲁⲛⲟⲉⲓ
ⲙⲉϣϣⲉ	ⲙⲉϣϣⲉ
ⲙⲉϣⲁⲕ	ⲙⲉϣⲁⲕ
ⲙⲉϣⲁ	ⲙⲉϣⲁ
ⲙⲉϣⲉ	ⲙⲉϣⲉ
ⲙⲉϣⲧ	ⲙⲉϣⲧ
ⲙⲉϣ︤ⲧ︥	ⲙⲉϣⲧ
ⲙⲉϣ	ⲛⲉϣ
ⲙⲉϩ̣	ⲙⲉϩ
ⲙⲉϩϣⲙⲧⲥⲱⲱⲡ	ⲙⲉϩϣⲟⲙⲧⲥⲱⲱⲡ
ⲙⲉϩϣⲟⲙⲛⲧ	ⲙⲉϩϣⲟⲙⲛⲧ
ⲙⲉϩϣⲟⲙⲧⲉ	ⲙⲉϩϣⲟⲙⲧⲉ
ⲙⲉϩϥⲧⲟⲟⲩ	ⲙⲉϩϥⲧⲟⲟⲩ
ⲙⲉϩⲥⲁϣϥ	ⲙⲉϩⲥⲁϣϥ
ⲙⲉϩⲥⲉⲡⲥⲛⲁⲩ	ⲙⲉϩⲥⲉⲡⲥⲛⲁⲩ
ⲙⲉϩⲥⲛⲁⲩ	ⲙⲉϩⲥⲛⲁⲩ
ⲙⲉϩⲥⲛⲧⲉ	ⲙⲉϩⲥⲛⲧⲉ
ⲙⲉϩ	ⲙⲉϩ
ⲙⲉⲅⲓⲥⲧⲁⲛⲟⲥ	ⲙⲉⲅⲓⲥⲧⲁⲛⲟⲥ
ⲙⲉⲉ̇ⲩⲉ̇	ⲙⲉⲉⲩⲉ
ⲙⲉⲉ̇ⲩⲉ	ⲙⲉⲉⲩⲉ
ⲙⲉⲉⲣⲉ	ⲙⲉⲉⲣⲉ
ⲙⲉⲉⲩⲉ̇	ⲙⲉⲉⲩⲉ
ⲙⲉⲉⲩⲉ	ⲙⲉⲉⲩⲉ
ⲙⲉⲉⲩⲉ`	ⲙⲉⲉⲩⲉ
ⲙⲉⲕⲙⲟⲩⲕ	ⲙⲉⲕⲙⲟⲩⲕ
ⲙⲉⲗ̣ⲉⲧⲁ	ⲙⲉⲗⲉⲧⲁ
ⲙⲉⲗϩ	ⲙⲉⲗϩ
ⲙⲉⲗⲉⲧⲁ	ⲙⲉⲗⲉⲧⲁ
ⲙⲉⲗⲟⲥ	ⲙⲉⲗⲟⲥ
ⲙⲉⲗⲭⲓⲥⲉⲇⲉⲕ	ⲙⲉⲗⲭⲓⲥⲉⲇⲉⲕ
ⲙⲉⲛ⳿	ⲙⲉⲛ
ⲙⲉⲛ	ⲙⲉⲛ
ⲙⲉⲣ̇ⲉ	ⲙⲉⲣⲉ
ⲙⲉⲣⲁⲧⲉ	ⲙⲉⲣⲁⲧⲉ
ⲙⲉⲣⲉϩ	ⲙⲉⲣⲉϩ
ⲙⲉⲣⲉⲟⲩⲱϩ	ⲙⲉⲣⲉⲟⲩⲱϩ
ⲙⲉⲣⲉⲟⲩⲱϩ`	ⲙⲉⲣⲉⲟⲩⲱϩ
ⲙⲉⲣⲉ	ⲙⲉⲣⲉ
ⲙⲉⲣⲉ`	ⲙⲉⲣⲉ
ⲙⲉⲣⲓⲥ	ⲙⲉⲣⲓⲥ
ⲙⲉⲣⲓⲧ︤	ⲙⲉⲣⲓⲧ
ⲙⲉⲣⲓⲧ	ⲙⲉⲣⲓⲧ
ⲙⲉⲣⲓⲧ`	ⲙⲉⲣⲓⲧ
ⲙⲉⲣⲟⲥ⳿	ⲙⲉⲣⲟⲥ
ⲙⲉⲣⲟⲥ	ⲙⲉⲣⲟⲥ
ⲙⲉⲣⲟⲩⲥ	ⲙⲉⲣⲟⲩⲥ
ⲙⲉⲥⲟⲩⲁ⸍ⲫⲓ	ⲙⲉⲥⲟⲩⲁⲫⲓ
ⲙⲉⲥⲧⲉ	ⲙⲉⲥⲧⲉ
ⲙⲉⲥⲧⲱ	ⲙⲉⲥⲧⲱ
ⲙⲉⲧⲁⲛⲟⲉⲓ	ⲙⲉⲧⲁⲛⲟⲉⲓ
ⲙⲉⲧⲁⲛⲟⲓ̇ⲁ	ⲙⲉⲧⲁⲛⲟⲓⲁ
ⲙⲉⲧⲁⲛⲟⲓ̇	ⲙⲉⲧⲁⲛⲟⲉⲓ
ⲙⲉⲧⲁⲛⲟⲓ̈	ⲙⲉⲧⲁⲛⲟⲉⲓ
ⲙⲉⲧⲁⲛⲟⲓⲁ	ⲙⲉⲧⲁⲛⲟⲓⲁ
ⲙⲉⲧⲁⲛⲟⲓ	ⲙⲉⲧⲁⲛⲟⲉⲓ
ⲙⲉⲧⲉⲭⲉ	ⲙⲉⲧⲉⲭⲉ
ⲙⲉⲩⲉ	ⲙⲉⲉⲩⲉ
ⲙⲉⲩⲧ	ⲙⲉⲩⲧ
ⲙⲉ⳯	ⲙⲉⲛ
ⲙⲉ⳿	ⲙⲉ
ⲙⲉ	ⲙⲉ
ⲙⲉ`	ⲙⲉ
ⲙⲏ̣	ⲙⲏ
ⲙⲏⲏ̄ϣⲉ	ⲙⲏⲏϣⲉ
ⲙⲏⲏ̄ⲛⲉ	ⲙⲏⲏⲛⲉ
ⲙⲏⲏ̄ⲧⲉ	ⲙⲏⲧⲉ
ⲙⲏⲏϣⲉ̇	ⲙⲏⲏϣⲉ
ⲙⲏⲏϣⲉ	ⲙⲏⲏϣⲉ
ⲙⲏⲏϣⲉ`	ⲙⲏⲏϣⲉ
ⲙⲏⲏⲛⲉ	ⲙⲏⲏⲛⲉ
ⲙⲏⲏⲧⲉ	ⲙⲏⲏⲧⲉ
ⲙⲏⲙⲟⲟⲩ	ⲙⲏⲙⲟⲟⲩ
ⲙⲏⲛⲉ	ⲙⲏⲛⲉ
ⲙⲏⲛ⳿	ⲙⲏⲛ
ⲙⲏⲛ	ⲙⲏⲛ
ⲙⲏⲡⲟⲧⲉ̇	ⲙⲏⲡⲟⲧⲉ
ⲙⲏⲡⲟⲧⲉ	ⲙⲏⲡⲟⲧⲉ
ⲙⲏⲡⲱⲥ	ⲙⲏⲡⲱⲥ
ⲙⲏⲣ⳿	ⲙⲏⲣ
ⲙⲏⲣ	ⲙⲏⲣ
ⲙⲏⲧⲉ⳿	ⲙⲏⲧⲉ
ⲙⲏⲧⲉ	ⲙⲏⲧⲉ
ⲙⲏⲧⲉ`	ⲙⲏⲧⲉ
ⲙⲏⲧⲓ	ⲙⲏⲧⲓ
ⲙⲏⲧ	ⲙⲏⲧ
ⲙⲏ⳿	ⲙⲏ
ⲙⲏ	ⲙⲏ
ⲙⲏ`	ⲙⲏ
ⲙⲓ̇ϣⲉ	ⲙⲓϣⲉ
ⲙⲓ̇ⲗⲓ̇ⲟⲛ	ⲙⲓⲗⲓⲟⲛ
ⲙⲓ̇ⲛⲉ	ⲙⲓⲛⲉ
ⲙⲓ̈ϣⲉ	ⲙⲓϣⲉ
ⲙⲓ̈ⲛⲉ	ⲙⲓⲛⲉ
ⲙⲓϣⲉ	ⲙⲓϣⲉ
ⲙⲓⲗⲓⲟⲛ	ⲙⲓⲗⲓⲟⲛ
ⲙⲓⲛⲉ⳿	ⲙⲓⲛⲉ
ⲙⲓⲛⲉ	ⲙⲓⲛⲉ
ⲙⲓⲥⲉ	ⲙⲓⲥⲉ
ⲙⲓⲥⲉ`	ⲙⲓⲥⲉ
ⲙⲕⲁϩ	ⲙⲕⲁϩ
ⲙⲕⲁϩ`	ⲙⲕⲁϩ
ⲙⲗⲁϩ	ⲙⲗⲁϩ
ⲙⲙ̇ⲟ	ⲙⲙⲟ
ⲙⲙ̣ⲟ	ⲙⲙⲟ
ⲙⲙ̣[ⲟ	ⲙⲙⲟ
ⲙⲙⲁ̣ⲩ̣	ⲙⲙⲁⲩ
ⲙⲙⲁⲁⲩ	ⲙⲙⲁⲁⲩ
ⲙⲙⲁⲧⲉ	ⲙⲙⲁⲧⲉ
ⲙⲙⲁⲨ	ⲙⲙⲁⲩ
ⲙⲙⲁⲩ	ⲙⲙⲁⲩ
ⲙⲙⲁ	ⲙⲁ
ⲙⲙⲁ.	ⲙⲙⲁⲩ
ⲙⲙⲉ	ⲙⲉ
ⲙⲙⲏⲛⲉ	ⲙⲙⲏⲛⲉ
ⲙⲙⲓ̇ⲛⲙ̇ⲙⲟ	ⲙⲙⲓⲛⲙⲙⲟ
ⲙⲙⲓ̇ⲛⲙⲙⲟ	ⲙⲙⲓⲛⲙⲙⲟ
ⲙⲙⲓⲛⲙ̄ⲙⲟ	ⲙⲙⲓⲛⲙⲙⲟ
ⲙⲙⲓⲛⲙⲙⲟ	ⲙⲙⲓⲛⲙⲙⲟ
ⲙⲙⲓⲛⲙⲙⲱ	ⲙⲙⲓⲛⲙⲙⲱ
ⲙⲙⲓⲛ	ⲙⲙⲓⲛ
ⲙⲙⲙⲟ	ⲙⲙⲟ
ⲙⲙⲛⲛⲥⲁ	ⲙⲙⲛⲛⲥⲁ
ⲙⲙⲛⲧⲁ	ⲙⲙⲛⲧⲁ
ⲙⲙⲛⲧⲉ	ⲙⲙⲛⲧⲉ
ⲙⲙⲛⲧⲏ	ⲙⲙⲛⲧⲏ
ⲙⲙⲛⲧⲣⲉⲙⲡ	̣ⲙⲛⲧⲣⲉⲙⲡ
ⲙⲙⲛⲧ	ⲙⲙⲛⲧ
ⲙⲙⲛ	ⲙⲙⲛ
ⲙⲙⲟⲛ	ⲙⲙⲟⲛ
ⲙⲙⲟⲟⲩ	ⲙⲙⲟⲟⲩ
ⲙⲙⲟⲩ	ⲙⲙⲟⲩ
ⲙⲙⲟ	ⲙⲙⲟ
ⲙⲙⲱ	ⲙⲙⲱ
ⲙⲙ︤ⲛ︥	ⲙⲙⲛ
ⲙⲛ̄ⲛ̄ⲥⲁ	ⲙⲛⲛⲥⲁ
ⲙⲛ̄ⲛ̄ⲥⲱ	ⲙⲛⲛⲥⲱ
ⲙⲛ̄ⲧ̄ϣⲁⲛ̄ϩⲧⲏϥ	ⲙⲛⲧϣⲁⲛϩⲧⲏϥ
ⲙⲛ̄ⲧ̄ϣⲁⲛϩⲧⲏϥ	ⲙⲛⲧϣⲁⲛϩⲧⲏϥ
ⲙⲛ̄ⲧ̄ϫⲱⲱⲣⲉ	ⲙⲛⲧϫⲱⲱⲣⲉ
ⲙⲛ̄ⲧ̄ⲁⲩⲑⲁⲧⲏⲥ	ⲙⲛⲧⲁⲩⲑⲁⲇⲏⲥ
ⲙⲛ̄ⲧ̄ⲉⲣⲟ	ⲙⲛⲧⲉⲣⲟ
ⲙⲛ̄ⲧ̄ⲛⲟⲩⲧⲉ	ⲙⲛⲧⲛⲟⲩⲧⲉ
ⲙⲛ̄ⲧ̄ⲣⲉϥϣⲙϣⲉ	ⲙⲛⲧⲣⲉϥϣⲙϣⲉ
ⲙⲛ̄ⲧ̄ⲥⲧⲣⲁⲧⲏⲗⲁⲧⲏⲗⲁⲧⲏⲥ	ⲙⲛⲧⲥⲧⲣⲁⲧⲏⲗⲁⲧⲏⲥ
ⲙⲛ̄ⲧϣⲁⲛϩⲧⲏϥ	ⲙⲛⲧϣⲁⲛϩⲧⲏϥ
ⲙⲛ̄ⲧϫⲁⲥⲓϩⲏⲧ	ⲙⲛⲧϫⲁⲥⲓϩⲏⲧ
ⲙⲛ̄ⲧⲁⲧϣⲁⲩ	ⲙⲛⲧⲁⲧϣⲁⲩ
ⲙⲛ̄ⲧⲁⲧⲥⲟⲟⲩⲛ	ⲙⲛⲧⲁⲧⲥⲟⲟⲩⲛ
ⲙⲛ̄ⲧⲉⲣⲟ	ⲙⲛⲧⲉⲣⲟ
ⲙⲛ̄ⲧⲉ	ⲙⲛⲧⲏ
ⲙⲛ̄ⲧⲛⲟⲩⲧⲉ	ⲙⲛⲧⲛⲟⲩⲧⲉ
ⲙⲛ̄ⲧⲣⲉϥϩⲱⲧⲃ	ⲙⲛⲧⲣⲉϥϩⲱⲧⲃ
ⲙⲛ̄ⲧⲣⲉϥϫⲓⲟⲩⲉ	ⲙⲛⲧⲣⲉϥϫⲓⲟⲩⲉ
ⲙⲛ̄ⲧⲣⲉϥⲣ̄ϩⲓⲕ	ⲙⲛⲧⲣⲉϥⲣϩⲓⲕ
ⲙⲛ̄ⲧⲣⲉ	ⲙⲛⲧⲣⲉ
ⲙⲛ̄ⲧⲥⲁⲛⲕⲟⲧⲥ̄	ⲙⲛⲧⲥⲁⲛⲕⲟⲧⲥ
ⲙⲛ̄ⲧⲭⲣⲏⲥⲧⲟⲥ	ⲙⲛⲧⲭⲣⲏⲥⲧⲟⲥ
ⲙⲛ̄ⲧⲯⲓⲧⲉ	ⲙⲛⲧⲯⲓⲧⲉ
ⲙⲛ̄	ⲙⲛ
ⲙⲛ̇ⲛ̇ⲥⲁ	ⲙⲛⲛⲥⲁ
ⲙⲛ̇ⲛ̇ⲥⲱ	ⲙⲛⲛⲥⲱ
ⲙⲛ̇ⲛⲥⲁ	ⲙⲛⲛⲥⲁ
ⲙⲛ̇ⲛⲥⲱ	ⲙⲛⲛⲥⲱ
ⲙⲛ̇ⲧⲁ	ⲙⲛⲧⲁ
ⲙⲛ̇ⲧⲕⲁⲑⲁⲣⲟ̣[ⲥ]	ⲙⲛⲧⲕⲁⲑⲁⲣⲟⲥ
ⲙⲛ̇ⲧⲛⲟϭ	ⲙⲛⲧⲛⲟϭ
ⲙⲛ̇ⲧ	ⲙⲛⲧ
ⲙⲛ̇	ⲙⲛ
ⲙⲛ̣	ⲙⲛ
ⲙⲛⲛ̄ⲥⲁ	ⲙⲛⲛⲥⲁ
ⲙⲛⲛⲉⲛⲥⲁ	ⲙⲛⲛⲥⲁ
ⲙⲛⲛⲤⲁ	ⲙⲛⲛⲥⲁ
ⲙⲛⲛⲥⲁ	ⲙⲛⲛⲥⲁ
ⲙⲛⲛⲥⲱ	ⲙⲛⲛⲥⲱ
ⲙⲛⲟⲩⲧ	ⲙⲛⲟⲩⲧ
ⲙⲛⲧ̇ϣⲙ̇ⲙⲟ	ⲙⲛⲧϣⲙⲙⲟ
ⲙⲛⲧ̇ϩⲁⲣϣϩⲏ̇ⲧ	ⲙⲛⲧϩⲁⲣϣϩⲏⲧ
ⲙⲛⲧ̇ϩⲏⲕⲉ	ⲙⲛⲧϩⲏⲕⲉ
ⲙⲛⲧ̇ϫⲁⲥⲓ̇ϩⲏⲧ	ⲙⲛⲧϫⲁⲥⲓϩⲏⲧ
ⲙⲛⲧ̇ⲁ̇ⲙⲉⲗⲏⲥ	ⲙⲛⲧⲁⲙⲉⲗⲏⲥ
ⲙⲛⲧ̇ⲁ̇ⲡⲟⲧⲁⲕⲧⲓ̇ⲕⲟⲥ	ⲙⲛⲧⲁⲡⲟⲧⲁⲕⲧⲓⲕⲟⲥ
ⲙⲛⲧ̇ⲁ̇ⲧϩ̇ⲛⲁⲁ̇ⲁⲩ	ⲙⲛⲧⲁⲧϩⲛⲁⲁⲩ
ⲙⲛⲧ̇ⲁ̇ⲧⲟⲡⲕ̇	ⲙⲛⲧⲁⲧⲟⲡⲕ
ⲙⲛⲧ̇ⲁⲧⲥⲓ̇	ⲙⲛⲧⲁⲧⲥⲓ
ⲙⲛⲧ̇ⲕⲱⲥⲙⲓ̇ⲕⲟⲛ	ⲙⲛⲧⲕⲱⲥⲙⲓⲕⲟⲛ
ⲙⲛⲧ̇ⲙⲟⲛⲁⲭⲟⲥ	ⲙⲛⲧⲙⲟⲛⲁⲭⲟⲥ
ⲙⲛⲧ̇ⲛⲟϭ	ⲙⲛⲧⲛⲟϭ
ⲙⲛⲧ̇ⲣⲉϥϣⲡ̇ϩ̇ⲙⲟⲧ	ⲙⲛⲧⲣⲉϥϣⲡϩⲙⲟⲧ
ⲙⲛⲧ̇ⲣⲉϥϥⲉⲓ̇	ⲙⲛⲧⲣⲉϥϥⲓ
ⲙⲛⲧ̇ⲣⲙ̇ⲣⲁϣ	ⲙⲛⲧⲣⲙⲣⲁϣ
ⲙⲛⲧ̇	ⲙⲛⲧ
ⲙⲛⲧ̣[ϣⲃ]ⲏ̣ⲣ	ⲙⲛⲧϣⲃⲏⲣ
ⲙⲛⲧϣⲁϥⲧⲉ	ⲙⲛⲧϣⲁϥⲧⲉ
ⲙⲛⲧϣⲁⲛϩⲧⲏϥ	ⲙⲛⲧϣⲁⲛϩⲧⲏϥ
ⲙⲛⲧϣⲁⲛϩⲧⲏ	ⲙⲛⲧϣⲁⲛϩⲧⲏ
ⲙⲛⲧϣⲁⲩ	ⲙⲛⲧϣⲁⲩ
ⲙⲛⲧϣⲁ	ⲙⲛⲧϣⲁ
ⲙⲛⲧϣⲃⲏⲣ	ⲙⲛⲧϣⲃⲏⲣ
ⲙⲛⲧϣⲙⲙⲟ	ⲙⲛⲧϣⲙⲙⲟ
ⲙⲛⲧϩⲁϩ	ⲙⲛⲧϩⲁϩ
ⲙⲛⲧϩⲁⲡⲗⲟⲩⲥ	ⲙⲛⲧϩⲁⲡⲗⲟⲩⲥ
ⲙⲛⲧϩⲁⲣϣϩⲏⲧ	ⲙⲛⲧϩⲁⲣϣϩⲏⲧ
ⲙⲛⲧϩⲏⲕⲉ	ⲙⲛⲧϩⲏⲕⲉ
ⲙⲛⲧϩⲗⲗⲟ	ⲙⲛⲧϩⲗⲗⲟ
ⲙⲛⲧϩⲗⲗⲱ	ⲙⲛⲧϩⲗⲗⲱ
ⲙⲛⲧϩⲙϩⲁⲗ	ⲙⲛⲧϩⲙϩⲁⲗ
ⲙⲛⲧϫⲁϫⲉ	ⲙⲛⲧϫⲁϫⲉ
ⲙⲛⲧϫⲁⲥⲓϩⲏⲧ	ⲙⲛⲧϫⲁⲥⲓϩⲏⲧ
ⲙⲛⲧϫⲱⲱⲣⲉ	ⲙⲛⲧϫⲱⲱⲣⲉ
ⲙⲛⲧϭⲁⲃϩⲏⲧ	ⲙⲛⲧϭⲁⲃϩⲏⲧ
ⲙⲛⲧϭⲁⲉⲓⲉ	ⲙⲛⲧϭⲁⲉⲓⲉ
ⲙⲛⲧϭⲁⲓⲉ	ⲙⲛⲧϭⲁⲓⲉ
ⲙⲛⲧϭⲱⲃ	ⲙⲛⲧϭⲱⲃ
ⲙⲛⲧⲁⲅⲁⲑⲟⲥ	ⲙⲛⲧⲁⲅⲁⲑⲟⲥ
ⲙⲛⲧⲁⲑⲏⲧ	ⲙⲛⲧⲁⲧϩⲏⲧ
ⲙⲛⲧⲁⲕⲁⲑⲁⲣⲧⲟⲥ	ⲙⲛⲧⲁⲕⲁⲑⲁⲣⲧⲟⲥ
ⲙⲛⲧⲁⲙⲉⲗⲏⲥ	ⲙⲛⲧⲁⲙⲉⲗⲏⲥ
ⲙⲛⲧⲁⲡⲓⲥⲧⲟⲥ	ⲙⲛⲧⲁⲡⲓⲥⲧⲟⲥ
ⲙⲛⲧⲁⲡⲟⲥⲧⲟⲗⲟⲥ	ⲙⲛⲧⲁⲡⲟⲥⲧⲟⲗⲟⲥ
ⲙⲛⲧⲁⲡⲟⲥⲧⲟⲥ	ⲙⲛⲧⲁⲡⲟⲥⲧⲟⲥ
ⲙⲛⲧⲁⲡⲟⲧⲁⲕⲧⲓⲕⲟⲥ	ⲙⲛⲧⲁⲡⲟⲧⲁⲕⲧⲓⲕⲟⲥ
ⲙⲛⲧⲁⲣⲅⲟⲥ	ⲙⲛⲧⲁⲣⲅⲟⲥ
ⲙⲛⲧⲁⲧϣⲁⲩ	ⲙⲛⲧⲁⲧϣⲁⲩ
ⲙⲛⲧⲁⲧϩⲏⲧ	ⲙⲛⲧⲁⲧϩⲏⲧ
ⲙⲛⲧⲁⲧϩⲛⲁⲁⲁⲩ	ⲙⲛⲧⲁⲧϩⲛⲁⲁⲩ
ⲙⲛⲧⲁⲧⲁⲙⲁϩⲧⲉ	ⲙⲛⲧⲁⲧⲁⲙⲁϩⲧⲉ
ⲙⲛⲧⲁⲧⲙⲟⲩ	ⲙⲛⲧⲁⲧⲙⲟⲩ
ⲙⲛⲧⲁⲧⲛⲁϩⲧⲉ	ⲙⲛⲧⲁⲧⲛⲁϩⲧⲉ
ⲙⲛⲧⲁⲧⲛⲟⲩⲧⲉ	ⲙⲛⲧⲁⲧⲛⲟⲩⲧⲉ
ⲙⲛⲧⲁⲧⲟⲡⲕ	ⲙⲛⲧⲁⲧⲟⲡⲕ
ⲙⲛⲧⲁⲧⲥⲃⲃⲉ	ⲙⲛⲧⲁⲧⲥⲃⲃⲉ
ⲙⲛⲧⲁⲧⲥⲃⲱ	ⲙⲛⲧⲁⲧⲥⲃⲱ
ⲙⲛⲧⲁⲧⲥⲓ	ⲙⲛⲧⲁⲧⲥⲓ
ⲙⲛⲧⲁⲧⲥⲟⲟⲩⲛ	ⲙⲛⲧⲁⲧⲥⲟⲟⲩⲛ
ⲙⲛⲧⲁⲧⲥⲟⲟⲩ⳯	ⲙⲛⲧⲁⲧⲥⲟⲟⲩⲛ
ⲙⲛⲧⲁⲧⲥⲱⲧⲙ	ⲙⲛⲧⲁⲧⲥⲱⲧⲙ
ⲙⲛⲧⲁⲧⲧⲁⲕⲟ	ⲙⲛⲧⲁⲧⲧⲁⲕⲟ
ⲙⲛⲧⲁⲩⲑⲁⲧⲏⲥ	ⲙⲛⲧⲁⲩⲑⲁⲇⲏⲥ
ⲙⲛⲧⲁ	ⲙⲛⲧⲁ
ⲙⲛⲧⲃⲁⲃⲉⲣⲱⲙⲉ	ⲙⲛⲧⲃⲁⲃⲉⲣⲱⲙⲉ
ⲙⲛⲧⲃⲁⲃⲉ	ⲙⲛⲧⲃⲁⲃⲉ
ⲙⲛⲧⲃⲗⲗⲉ	ⲙⲛⲧⲃⲗⲗⲉ
ⲙⲛⲧⲉⲣⲟ	ⲙⲛⲧⲉⲣⲟ
ⲙⲛⲧⲉ	ⲙⲛⲧⲏ
ⲙⲛⲧⲏ	ⲙⲛⲧⲏ
ⲙⲛⲧⲕⲁⲑⲁⲣⲟⲥ	ⲙⲛⲧⲕⲁⲑⲁⲣⲟⲥ
ⲙⲛⲧⲕⲟⲥⲙⲓⲕⲟⲛ	ⲙⲛⲧⲕⲟⲥⲙⲓⲕⲟⲛ
ⲙⲛⲧⲕⲟⲩⲉⲓ	ⲙⲛⲧⲕⲟⲩⲓ
ⲙⲛⲧⲕⲟⲩⲓ	ⲙⲛⲧⲕⲟⲩⲓ
ⲙⲛⲧⲕⲱⲥⲙⲓⲕⲟⲛ	ⲙⲛⲧⲕⲱⲥⲙⲓⲕⲟⲛ
ⲙⲛⲧⲗⲏⲥⲧⲏⲥ	ⲙⲛⲧⲗⲏⲥⲧⲏⲥ
ⲙⲛⲧⲙⲁⲓϩⲟⲙⲛⲧ	ⲙⲛⲧⲙⲁⲓϩⲟⲙⲛⲧ
ⲙⲛⲧⲙⲁⲓⲛⲟⲩⲧⲉ	ⲙⲛⲧⲙⲁⲓⲛⲟⲩⲧⲉ
ⲙⲛⲧⲙⲁⲓⲣⲱⲙⲉ	ⲙⲛⲧⲙⲁⲓⲣⲱⲙⲉ
ⲙⲛⲧⲙⲁⲓⲧⲟ	ⲙⲛⲧⲙⲁⲓⲧⲟ
ⲙⲛⲧⲙⲁⲓⲭⲣⲏⲙⲁ	ⲙⲛⲧⲙⲁⲓⲭⲣⲏⲙⲁ
ⲙⲛⲧⲙⲁⲓ	ⲙⲛⲧⲙⲁⲓ
ⲙⲛⲧⲙⲛⲧⲣⲉ	ⲙⲛⲧⲙⲛⲧⲣⲉ
ⲙⲛⲧⲙⲟⲛⲁⲭⲟⲥ	ⲙⲛⲧⲙⲟⲛⲁⲭⲟⲥ
ⲙⲛⲧⲛⲁϣⲧϩⲏⲧ	ⲙⲛⲧⲛⲁϣⲧϩⲏⲧ
ⲙⲛⲧⲛⲁ	ⲙⲛⲧⲛⲁ
ⲙⲛⲧⲛⲟϭ	ⲙⲛⲧⲛⲟϭ
ⲙⲛⲧⲛⲟⲉⲓⲕ	ⲙⲛⲧⲛⲟⲉⲓⲕ
ⲙⲛⲧⲛⲟⲩϫ	ⲙⲛⲧⲛⲟⲩϫ
ⲙⲛⲧⲛⲟⲩⲧⲉ	ⲙⲛⲧⲛⲟⲩⲧⲉ
ⲙⲛⲧⲡⲁⲣⲑⲉⲛⲟⲥ	ⲙⲛⲧⲡⲁⲣⲑⲉⲛⲟⲥ
ⲙⲛⲧⲡⲣⲟⲇⲟⲧⲏⲥ	ⲙⲛⲧⲡⲣⲟⲇⲟⲧⲏⲥ
ⲙⲛⲧⲣ̇ⲣⲟ	ⲙⲛⲧⲣⲣⲟ
ⲙⲛⲧⲣⲉϥϣⲙ̇ϣⲉⲛⲟⲩⲧⲉ	ⲙⲛⲧⲣⲉϥϣⲙϣⲉⲛⲟⲩⲧⲉ
ⲙⲛⲧⲣⲉϥϣⲙϣⲉⲛⲟⲩⲧⲉ	ⲙⲛⲧⲣⲉϥϣⲙϣⲉⲛⲟⲩⲧⲉ
ⲙⲛⲧⲣⲉϥϣⲙϣⲉ	ⲙⲛⲧⲣⲉϥϣⲙϣⲉ
ⲙⲛⲧⲣⲉϥϣⲡϩⲙⲟⲧ	ⲙⲛⲧⲣⲉϥϣⲡϩⲙⲟⲧ
ⲙⲛⲧⲣⲉϥϥⲉⲓ	ⲙⲛⲧⲣⲉϥϥⲓ
ⲙⲛⲧⲣⲉϥϩⲉⲧⲃⲯⲩⲭⲏ	ⲙⲛⲧⲣⲉϥϩⲉⲧⲃⲯⲩⲭⲏ
ⲙⲛⲧⲣⲉϥϩⲓⲗⲁ	ⲙⲛⲧⲣⲉϥϩⲓⲗⲁ
ⲙⲛⲧⲣⲉϥϩⲱⲧⲃ	ⲙⲛⲧⲣⲉϥϩⲱⲧⲃ
ⲙⲛⲧⲣⲉϥϫⲓ̈ϩⲟ	ⲙⲛⲧⲣⲉϥϫⲓϩⲟ
ⲙⲛⲧⲣⲉϥϫⲓϩⲟ	ⲙⲛⲧⲣⲉϥϫⲓϩⲟ
ⲙⲛⲧⲣⲉϥϫⲓⲛϭⲟⲛⲥ	ⲙⲛⲧⲣⲉϥϫⲓⲛϭⲟⲛⲥ
ⲙⲛⲧⲣⲉϥϫⲓⲟⲩⲁ	ⲙⲛⲧⲣⲉϥϫⲓⲟⲩⲁ
ⲙⲛⲧⲣⲉϥϫⲓⲟⲩⲉ	ⲙⲛⲧⲣⲉϥϫⲓⲟⲩⲉ
ⲙⲛⲧⲣⲉϥϫⲱϩⲙ	ⲙⲛⲧⲣⲉϥϫⲱϩⲙ
ⲙⲛⲧⲣⲉϥϭⲛ	ⲙⲛⲧⲣⲉϥϭⲛ
ⲙⲛⲧⲣⲉϥϯϭⲱⲛⲧ	ⲙⲛⲧⲣⲉϥϯϭⲱⲛⲧ
ⲙⲛⲧⲣⲉϥⲁⲣⲉⲥⲕⲉ	ⲙⲛⲧⲣⲉϥⲁⲣⲉⲥⲕⲉ
ⲙⲛⲧⲣⲉϥⲣϩⲓⲕ	ⲙⲛⲧⲣⲉϥⲣϩⲓⲕ
ⲙⲛⲧⲣⲉϥⲣϩⲟⲦⲉ	ⲙⲛⲧⲣⲉϥⲣϩⲟⲧⲉ
ⲙⲛⲧⲣⲉϥⲧⲱϩ	ⲙⲛⲧⲣⲉϥⲧⲱϩ
ⲙⲛⲧⲣⲉϥⲧⲱⲣⲡ	ⲙⲛⲧⲣⲉϥⲧⲱⲣⲡ
ⲙⲛⲧⲣⲉ	ⲙⲛⲧⲣⲉ
ⲙⲛⲧⲣⲙϩⲉ	ⲙⲛⲧⲣⲙϩⲉ
ⲙⲛⲧⲣⲙⲙⲁⲟ	ⲙⲛⲧⲣⲙⲙⲁⲟ
ⲙⲛⲧⲣⲙⲛϩⲏⲧ	ⲙⲛⲧⲣⲙⲛϩⲏⲧ
ⲙⲛⲧⲣⲙⲣⲁϣ	ⲙⲛⲧⲣⲙⲣⲁϣ
ⲙⲛⲧⲣⲣⲟ	ⲙⲛⲧⲣⲣⲟ
ⲙⲛⲧⲣⲱⲙⲉ	ⲙⲛⲧⲣⲱⲙⲉ
ⲙⲛⲧⲥⲁⲃⲉ	ⲙⲛⲧⲥⲁⲃⲉ
ⲙⲛⲧⲥⲁⲛⲕⲟⲧⲥ	ⲙⲛⲧⲥⲁⲛⲕⲟⲧⲥ
ⲙⲛⲧⲥⲛⲟⲟⲩⲥ	ⲙⲛⲧⲥⲛⲟⲟⲩⲥ
ⲙⲛⲧⲥⲟϭ	ⲙⲛⲧⲥⲟϭ
ⲙⲛⲧⲥⲧⲙⲏⲧ	ⲙⲛⲧⲥⲧⲙⲏⲧ
ⲙⲛⲧⲥⲧⲣⲁⲧⲏⲗⲁⲧⲏⲗⲁⲧⲏⲥ	ⲙⲛⲧⲥⲧⲣⲁⲧⲏⲗⲁⲧⲏⲥ
ⲙⲛⲧⲥⲩⲛⲕ̇ⲗⲏⲧⲓ̇ⲕⲟ̇ⲥ	ⲙⲛⲧⲥⲩⲛⲕⲗⲏⲧⲓⲕⲟⲥ
ⲙⲛⲧⲥⲩⲛⲕⲗⲏⲧⲓⲕⲟⲥ	ⲙⲛⲧⲥⲩⲛⲕⲗⲏⲧⲓⲕⲟⲥ
ⲙⲛⲧⲧⲉ·ⲗⲓⲟⲥ	ⲙⲛⲧⲧⲉⲗⲓⲟⲥ
ⲙⲛⲧⲧⲉⲗⲓⲟⲥ	ⲙⲛⲧⲧⲉⲗⲓⲟⲥ
ⲙⲛⲧⲭⲣⲏⲥⲧⲟⲥ	ⲙⲛⲧⲭⲣⲏⲥⲧⲟⲥ
ⲙⲛⲧⲯⲓⲧⲉ	ⲙⲛⲧⲯⲓⲧⲉ
ⲙⲛⲧ	ⲙⲛⲧ
ⲙⲛⲧ 	ⲙⲛⲧ
ⲙⲛ︤ⲧ︥ⲁⲣⲅⲟⲥ	ⲙⲛⲧⲁⲣⲅⲟⲥ
ⲙⲛ︤ⲧ︥ⲛⲟⲩⲧⲉ	ⲙⲛⲧⲛⲟⲩⲧⲉ
ⲙⲛ︤ⲧ︦ⲣ︥ⲉ	ⲙⲛⲧⲣⲉ
ⲙⲛ︥	ⲙⲛ
ⲙⲛ︦ⲧϩⲙϩⲁⲗ	ⲙⲛⲧϩⲙϩⲁⲗ
ⲙⲛ︦ⲧⲛⲁ	ⲙⲛⲧⲛⲁ
ⲙⲛ︦ⲧ︥ⲁⲧⲥⲱⲧ︤ⲙ̣︥	ⲙⲛⲧⲁⲧⲥⲱⲧⲙ
ⲙⲛ	ⲙⲛ
ⲙⲟ̇ⲟϣⲉ	ⲙⲟⲟϣⲉ
ⲙⲟ̇ⲟⲩϣⲉ	ⲙⲟⲟⲩϣⲉ
ⲙⲟ̣ⲟϣⲉ	ⲙⲟⲟϣⲉ
ⲙⲟϣⲧ︤	ⲙⲟϣⲧ
ⲙⲟϣⲧ	ⲙⲟϣⲧ
ⲙⲟϩⲕⲥ	ⲙⲟϩⲕⲥ
ⲙⲟϫϩ	ⲙⲟϫϩ
ⲙⲟϫⲧ	ⲙⲟϫⲧ
ⲙⲟϫ	ⲙⲟϫ
ⲙⲟⲅⲓⲥ	ⲙⲟⲅⲓⲥ
ⲙⲟⲅⲓⲥ`	ⲙⲟⲅⲓⲥ
ⲙⲟⲉⲓ̈ⲧ	ⲙⲟⲉⲓⲧ
ⲙⲟⲉⲓⲧ	ⲙⲟⲉⲓⲧ
ⲙⲟⲓ̈Ϩⲉ	ⲙⲟⲓϩⲉ
ⲙⲟⲓ̈ϩⲉ	ⲙⲟⲓϩⲉ
ⲙⲟⲓϨⲉ	ⲙⲟⲓϩⲉ
ⲙⲟⲓϩⲉ	ⲙⲟⲉⲓϩⲉ
ⲙⲟⲓⲧ	ⲙⲟⲉⲓⲧ
ⲙⲟⲕϩ̄	ⲙⲟⲕϩ
ⲙⲟⲕϩⲥ	ⲙⲟⲕϩⲥ
ⲙⲟⲕϩ︤ⲥ︥	ⲙⲟⲕϩⲥ
ⲙⲟⲕϩ	ⲙⲟⲕϩ
ⲙⲟⲕⲙⲉⲕ	ⲙⲟⲕⲙⲉⲕ
ⲙⲟⲕ︤ϩ︥	ⲙⲟⲕϩ
ⲙⲟⲛⲁⲭⲟⲥ	ⲙⲟⲛⲁⲭⲟⲥ
ⲙⲟⲛⲕ	ⲙⲟⲛⲕ
ⲙⲟⲛⲟⲅⲏⲛⲏⲥ	ⲙⲟⲛⲟⲅⲉⲛⲏⲥ
ⲙⲟⲛⲟⲛ	ⲙⲟⲛⲟⲛ
ⲙⲟⲛⲟ⳯	ⲙⲟⲛⲟⲛ
ⲙⲟⲟ̇ϣⲉ	ⲙⲟⲟϣⲉ
ⲙⲟⲟ̇ⲛⲉ	ⲙⲟⲟⲛⲉ
ⲙⲟⲟϣⲉ	ⲙⲟⲟϣⲉ
ⲙⲟⲟϣⲉ`	ⲙⲟⲟϣⲉ
ⲙⲟⲟⲛⲉ	ⲙⲟⲟⲛⲉ
ⲙⲟⲟⲧ	ⲙⲟⲟⲧ
ⲙⲟⲟⲩϣⲉ	ⲙⲟⲟⲩϣⲉ
ⲙⲟⲟⲩⲧⲧ	ⲙⲟⲟⲩⲧ
ⲙⲟⲟⲩⲧ	ⲙⲟⲟⲩⲧ
ⲙⲟⲟⲩ	ⲙⲟⲟⲩ
ⲙⲟⲣⲥ	ⲙⲟⲣⲥ
ⲙⲟⲣⲫⲏ̂	ⲙⲟⲣⲫⲏ
ⲙⲟⲣⲫⲏ	ⲙⲟⲣⲫⲏ
ⲙⲟⲣⲫⲏ`	ⲙⲟⲣⲫⲏ
ⲙⲟⲣ︤ⲥ︥	ⲙⲟⲣⲥ
ⲙⲟⲣ	ⲙⲟⲣ
ⲙⲟⲥⲧⲉ	ⲙⲟⲥⲧⲉ
ⲙⲟⲥⲧⲉ`	ⲙⲟⲥⲧⲉ
ⲙⲟⲧⲉ	ⲙⲟⲧⲉ
ⲙⲟⲧⲛ	ⲙⲟⲧⲛ
ⲙⲟⲨⲧⲉ	ⲙⲟⲩⲧⲉ
ⲙⲟⲩ̣ⲓ̣	ⲙⲟⲩⲓ
ⲙⲟⲩϣⲧ	ⲙⲟⲩϣⲧ
ⲙⲟⲩϩ⳿	ⲙⲟⲩϩ
ⲙⲟⲩϩ	ⲙⲟⲩϩ
ⲙⲟⲩϩ`	ⲙⲟⲩϩ
ⲙⲟⲩϫϭ	ⲙⲟⲩϫϭ
ⲙⲟⲩϫⲧ	ⲙⲟⲩϫⲧ
ⲙⲟⲩϫ︤ϭ︥	ⲙⲟⲩϫϭ
ⲙⲟⲩϫ︤ⲧ	ⲙⲟⲩϫⲧ
ⲙⲟⲩⲓ̈	ⲙⲟⲩⲓ
ⲙⲟⲩⲓ	ⲙⲟⲩⲓ
ⲙⲟⲩⲛ̄ⲅ̄	ⲙⲟⲩⲛⲅ
ⲙⲟⲩⲛ̇	ⲙⲟⲩⲛ
ⲙⲟⲩⲛⲅ	ⲙⲟⲩⲛⲅ
ⲙⲟⲩⲛ	ⲙⲟⲩⲛ
ⲙⲟⲩⲟⲩⲧ	ⲙⲟⲩⲟⲩⲧ
ⲙⲟⲩⲟⲩⲧ`	ⲙⲟⲩⲟⲩⲧ
ⲙⲟⲩⲣ⳿	ⲙⲟⲩⲣ
ⲙⲟⲩⲣ	ⲙⲟⲩⲣ
ⲙⲟⲩⲥ	ⲙⲟⲩⲥ
ⲙⲟⲩⲧⲉ	ⲙⲟⲩⲧⲉ
ⲙⲟⲩⲧⲉ`	ⲙⲟⲩⲧⲉ
ⲙⲟⲩ	ⲙⲟⲩ
ⲙⲟ	ⲙⲙⲟ
ⲙⲡ̣ϣ̣ⲁ̣	ⲙⲡϣⲁ
ⲙⲡϣⲁ	ⲙⲡϣⲁ
ⲙⲡⲁⲧⲉ̣	ⲙⲡⲁⲧⲉ
ⲙⲡⲁⲧⲉ	ⲙⲡⲁⲧⲉ
ⲙⲡⲁⲧ	ⲙⲡⲁⲧ
ⲙⲡⲁ	ⲙⲡⲁ
ⲙⲡⲉϥ	ⲙⲡⲉϥ
ⲙⲡⲉⲕⲉ	ⲙⲡⲕ
ⲙⲡⲉⲣ	ⲙⲡⲣ
ⲙⲡⲉ	ⲙⲡⲉ
ⲙⲡⲟⲩ	ⲙⲡⲟⲩ
ⲙⲡⲟ	ⲙⲡⲟ
ⲙⲡⲣ̇ⲧ̇ⲣⲉ	ⲙⲡⲣⲧⲣⲉ
ⲙⲡⲣ̇	ⲙⲡⲣ
ⲙⲡⲣⲧⲣⲉ	ⲙⲡⲣⲧⲣⲉ
ⲙⲡⲣ	ⲙⲡⲣ
ⲙⲡⲱⲣ	ⲙⲡⲱⲣ
ⲙⲡ︤	ⲙⲡ
ⲙⲡ	ⲙⲡ
ⲙⲡ]	ⲙⲡ
ⲙⲣ̄ⲣⲉ	ⲙⲣⲣⲉ
ⲙⲣⲣⲉ	ⲙⲣⲣⲉ
ⲙⲧⲟ̂	ⲙⲧⲟ
ⲙⲧⲟⲛ	ⲙⲧⲟⲛ
ⲙⲧⲟⲛ`	ⲙⲧⲟⲛ
ⲙⲧⲟ	ⲙⲧⲟ
ⲙⲧⲟ`	ⲙⲧⲟ
ⲙⲩⲥⲧⲏⲣⲓ̈ⲟⲛ	ⲙⲩⲥⲧⲏⲣⲓⲟⲛ
ⲙⲩⲥⲧⲏⲣⲓⲟⲛ	ⲙⲩⲥⲧⲏⲣⲓⲟⲛ
ⲙⲱⲅⲓ̇ⲥ	ⲙⲱⲅⲓⲥ
ⲙⲱⲅⲓⲥ	ⲙⲱⲅⲓⲥ
ⲙⲱⲛⲟⲛ	ⲙⲱⲛⲟⲛ
ⲙⲱⲩ̈ⲥⲏⲥ	ⲙⲱⲩⲥⲏⲥ
ⲙⲱⲩⲥⲏⲥ	ⲙⲱⲩⲥⲏⲥ
ⲙⲱ	ⲙⲙⲟ
ⲙ̣︤ⲛ̣︥	ⲙⲛ
ⲙ̣︤ⲛ︥	ⲙⲛ
ⲙ︤ⲕ︥ⲁϩ	ⲙⲕⲁϩ
ⲙ︤ⲛ︤︥ⲧⲣⲉϥⲁⲣⲉⲥⲕⲉ	ⲙⲛⲧⲣⲉϥⲁⲣⲉⲥⲕⲉ
ⲙ︤ⲛ̣︥	ⲙⲛ
ⲙ︤ⲛ︥ⲛ̄Ⲥⲁ	ⲙⲛⲛⲥⲁ
ⲙ︤ⲛ︥ⲛ̄ⲥⲁ	ⲙⲛⲛⲥⲁ
ⲙ︤ⲛ︥ⲛⲥⲁ	ⲙⲛⲛⲥⲁ
ⲙ︤ⲛ︥ⲧ̄ⲛⲟⲩⲧⲉ	ⲙⲛⲧⲛⲟⲩⲧⲉ
ⲙ︤ⲛ︥ⲧϣⲁⲛ̄ϩⲧⲏϥ	ⲙⲛⲧϣⲁⲛϩⲧⲏϥ
ⲙ︤ⲛ︥ⲧϩ︤ⲙ︥ϩⲁⲗ	ⲙⲛⲧϩⲙϩⲁⲗ
ⲙ︤ⲛ︥ⲧⲁⲧⲥⲟⲟⲩⲛ	ⲙⲛⲧⲁⲧⲥⲟⲟⲩⲛ
ⲙ︤ⲛ︥ⲧⲁ	ⲙⲛⲧⲁ
ⲙ︤ⲛ︥ⲧⲉⲣⲟ	ⲙⲛⲧⲉⲣⲟ
ⲙ︤ⲛ︥ⲧⲙⲁⲓ̈ⲭⲣⲏⲙⲁ	ⲙⲛⲧⲙⲁⲓⲭⲣⲏⲙⲁ
ⲙ︤ⲛ︥ⲧⲣⲱⲙⲉ	ⲙⲛⲧⲣⲱⲙⲉ
ⲙ︤ⲛ︥ⲧⲥⲁⲃⲉ	ⲙⲛⲧⲥⲁⲃⲉ
ⲙ︤ⲛ︥ⲧ︤	ⲙⲛⲧ
ⲙ︤ⲛ︥ⲧ	ⲙⲛⲧ
ⲙ︤ⲛ︥︤ⲧ︥ⲣⲉϥϫⲓϩⲟ̂	ⲙⲛⲧⲣⲉϥϫⲓϩⲟ
ⲙ︤ⲛ︥	ⲙⲛ
ⲙ︤ⲛ︥`	ⲙⲛ
ⲙ︤ⲛ︦ⲛ︥ⲥⲁ	ⲙⲛⲛⲥⲁ
ⲙ︤ⲛ︦ⲧϫⲁⲥⲓϩⲏⲧ	ⲙⲛⲧϫⲁⲥⲓϩⲏⲧ
ⲙ︤ⲛ︦ⲧⲃⲗⲗⲉ	ⲙⲛⲧⲃⲗⲗⲉ
ⲙ︤ⲛ︦ⲧⲣⲉϥϫⲓϩⲟ	ⲙⲛⲧⲣⲉϥϫⲓϩⲟ
ⲙ︤ⲛ︦ⲧⲣ︤ⲙ︥ⲙⲁⲟ̂	ⲙⲛⲧⲣⲙⲙⲁⲟ
ⲙ︤ⲛ︦ⲧ︥ϣⲁϥⲧⲉ	ⲙⲛⲧϣⲁϥⲧⲉ
ⲙ︤ⲛ︦ⲧ︥ϣⲁϥⲧⲉ`	ⲙⲛⲧϣⲁϥⲧⲉ
ⲙ︤ⲛ︦ⲧ︥ϣⲁⲛϩⲧⲏϥ	ⲙⲛⲧϣⲁⲛϩⲧⲏϥ
ⲙ︤ⲛ︦ⲧ︥ϣⲁⲛϩⲧⲏ	ⲙⲛⲧϣⲁⲛϩⲧⲏ
ⲙ︤ⲛ︦ⲧ︥ϣⲁⲩ	ⲙⲛⲧϣⲁⲩ
ⲙ︤ⲛ︦ⲧ︥ϣⲁ	ⲙⲛⲧϣⲁ
ⲙ︤ⲛ︦ⲧ︥ϣ︤ⲙ︥ⲙⲟ̂	ⲙⲛⲧϣⲙⲙⲟ
ⲙ︤ⲛ︦ⲧ︥ϩⲁϩ	ⲙⲛⲧϩⲁϩ
ⲙ︤ⲛ︦ⲧ︥ϩⲁⲡⲗⲟⲩⲥ	ⲙⲛⲧϩⲁⲡⲗⲟⲩⲥ
ⲙ︤ⲛ︦ⲧ︥ϩⲁⲣ︤ϣϩⲏⲧ︥	ⲙⲛⲧϩⲁⲣϣϩⲏⲧ
ⲙ︤ⲛ︦ⲧ︥ϩⲁⲣ︤ϣϩⲏⲧ`︥	ⲙⲛⲧϩⲁⲣϣϩⲏⲧ
ⲙ︤ⲛ︦ⲧ︥ϩⲏⲕⲉ	ⲙⲛⲧϩⲏⲕⲉ
ⲙ︤ⲛ︦ⲧ︥ϩ︤ⲗ︥ⲗⲟ	ⲙⲛⲧϩⲗⲗⲟ
ⲙ︤ⲛ︦ⲧ︥ϩ︤ⲗ︥ⲗⲱ̂	ⲙⲛⲧϩⲗⲗⲱ
ⲙ︤ⲛ︦ⲧ︥ϩ︤ⲙ︥ϩⲁⲗ	ⲙⲛⲧϩⲙϩⲁⲗ
ⲙ︤ⲛ︦ⲧ︥ϫⲁϫⲉ	ⲙⲛⲧϫⲁϫⲉ
ⲙ︤ⲛ︦ⲧ︥ϫⲁⲥⲓϩⲏⲧ	ⲙⲛⲧϫⲁⲥⲓϩⲏⲧ
ⲙ︤ⲛ︦ⲧ︥ϫⲁⲥⲓϩⲏⲧ`	ⲙⲛⲧϫⲁⲥⲓϩⲏⲧ
ⲙ︤ⲛ︦ⲧ︥ϫⲱⲱⲣⲉ	ⲙⲛⲧϫⲱⲱⲣⲉ
ⲙ︤ⲛ︦ⲧ︥ϭⲁⲉⲓⲉ	ⲙⲛⲧϭⲁⲉⲓⲉ
ⲙ︤ⲛ︦ⲧ︥ⲁⲅⲁⲑⲟⲥ`	ⲙⲛⲧⲁⲅⲁⲑⲟⲥ
ⲙ︤ⲛ︦ⲧ︥ⲁⲑⲏⲧ⳿	ⲙⲛⲧⲁⲑⲏⲧ
ⲙ︤ⲛ︦ⲧ︥ⲁⲑⲏⲧ	ⲙⲛⲧⲁⲧϩⲏⲧ
ⲙ︤ⲛ︦ⲧ︥ⲁⲑⲏⲧ`	ⲙⲛⲧⲁⲧϩⲏⲧ
ⲙ︤ⲛ︦ⲧ︥ⲁⲕⲁⲑⲁⲣⲧⲟⲥ⳿	ⲙⲛⲧⲁⲕⲁⲑⲁⲣⲧⲟⲥ
ⲙ︤ⲛ︦ⲧ︥ⲁⲙⲉⲗⲏⲥ	ⲙⲛⲧⲁⲙⲉⲗⲏⲥ
ⲙ︤ⲛ︦ⲧ︥ⲁⲡⲓⲥⲧⲟⲥ⳿	ⲙⲛⲧⲁⲡⲓⲥⲧⲟⲥ
ⲙ︤ⲛ︦ⲧ︥ⲁⲡⲟⲥⲧⲟⲗⲟⲥ	ⲙⲛⲧⲁⲡⲟⲥⲧⲟⲗⲟⲥ
ⲙ︤ⲛ︦ⲧ︥ⲁⲡⲟⲥⲧⲟⲥ⳿	ⲙⲛⲧⲁⲡⲟⲥⲧⲟⲥ
ⲙ︤ⲛ︦ⲧ︥ⲁⲣⲅⲟⲥ	ⲙⲛⲧⲁⲣⲅⲟⲥ
ⲙ︤ⲛ︦ⲧ︥ⲁⲧϩⲏⲧ	ⲙⲛⲧⲁⲧϩⲏⲧ
ⲙ︤ⲛ︦ⲧ︥ⲁⲧⲛⲟⲩⲧⲉ	ⲙⲛⲧⲁⲧⲛⲟⲩⲧⲉ
ⲙ︤ⲛ︦ⲧ︥ⲁⲧⲛⲟⲩⲧⲉ`	ⲙⲛⲧⲁⲧⲛⲟⲩⲧⲉ
ⲙ︤ⲛ︦ⲧ︥ⲁⲧⲥⲃⲱ̂	ⲙⲛⲧⲁⲧⲥⲃⲱ
ⲙ︤ⲛ︦ⲧ︥ⲁⲧⲥⲃⲱ̂`	ⲙⲛⲧⲁⲧⲥⲃⲱ
ⲙ︤ⲛ︦ⲧ︥ⲁⲧⲥⲃⲱ	ⲙⲛⲧⲁⲧⲥⲃⲱ
ⲙ︤ⲛ︦ⲧ︥ⲁⲧⲥⲟⲟⲩⲛ	ⲙⲛⲧⲁⲧⲥⲟⲟⲩⲛ
ⲙ︤ⲛ︦ⲧ︥ⲁⲧⲥⲟⲟⲩ⳯	ⲙⲛⲧⲁⲧⲥⲟⲟⲩⲛ
ⲙ︤ⲛ︦ⲧ︥ⲁⲧⲥⲱⲧⲙ̄	ⲙⲛⲧⲁⲧⲥⲱⲧⲙ
ⲙ︤ⲛ︦ⲧ︥ⲁⲧⲥⲱⲧ︤ⲙ︥	ⲙⲛⲧⲁⲧⲥⲱⲧⲙ
ⲙ︤ⲛ︦ⲧ︥ⲁ	ⲙⲛⲧⲁ
ⲙ︤ⲛ︦ⲧ︥ⲃⲁⲃⲉⲣⲱⲙⲉ	ⲙⲛⲧⲃⲁⲃⲉⲣⲱⲙⲉ
ⲙ︤ⲛ︦ⲧ︥ⲃⲁⲃⲉ`	ⲙⲛⲧⲃⲁⲃⲉ
ⲙ︤ⲛ︦ⲧ︥ⲉⲣⲟ̂	ⲙⲛⲧⲉⲣⲟ
ⲙ︤ⲛ︦ⲧ︥ⲉⲣⲟ`	ⲙⲛⲧⲉⲣⲟ
ⲙ︤ⲛ︦ⲧ︥ⲕⲟⲥⲙⲓⲕⲟⲛ⳿	ⲙⲛⲧⲕⲟⲥⲙⲓⲕⲟⲛ
ⲙ︤ⲛ︦ⲧ︥ⲗⲏⲥⲧⲏⲥ⳿	ⲙⲛⲧⲗⲏⲥⲧⲏⲥ
ⲙ︤ⲛ︦ⲧ︥ⲙⲁⲓ̈ⲧⲟ	ⲙⲛⲧⲙⲁⲓⲧⲟ
ⲙ︤ⲛ︦ⲧ︥ⲙⲁⲓ̈	ⲙⲛⲧⲙⲁⲓ
ⲙ︤ⲛ︦ⲧ︥ⲙⲁⲓⲛⲟⲩⲧⲉ	ⲙⲛⲧⲙⲁⲓⲛⲟⲩⲧⲉ
ⲙ︤ⲛ︦ⲧ︥ⲛⲟϭ	ⲙⲛⲧⲛⲟϭ
ⲙ︤ⲛ︦ⲧ︥ⲛⲟⲩϫ	ⲙⲛⲧⲛⲟⲩϫ
ⲙ︤ⲛ︦ⲧ︥ⲛⲟⲩⲧⲉ	ⲙⲛⲧⲛⲟⲩⲧⲉ
ⲙ︤ⲛ︦ⲧ︥ⲡⲁⲣⲑⲉⲛⲟⲥ	ⲙⲛⲧⲡⲁⲣⲑⲉⲛⲟⲥ
ⲙ︤ⲛ︦ⲧ︥ⲡⲣⲟⲇⲟⲧⲏⲥ	ⲙⲛⲧⲡⲣⲟⲇⲟⲧⲏⲥ
ⲙ︤ⲛ︦ⲧ︥ⲣⲉϥ̣ϩⲓⲗⲁ	ⲙⲛⲧⲣⲉϥϩⲓⲗⲁ
ⲙ︤ⲛ︦ⲧ︥ⲣⲉϥϩⲉⲧⲃ̄ⲯⲩⲭⲏ	ⲙⲛⲧⲣⲉϥϩⲉⲧⲃⲯⲩⲭⲏ
ⲙ︤ⲛ︦ⲧ︥ⲣⲉϥϫⲓϩⲟ̂	ⲙⲛⲧⲣⲉϥϫⲓϩⲟ
ⲙ︤ⲛ︦ⲧ︥ⲣⲉϥϫⲓⲛϭⲟⲛ︤ⲥ︥	ⲙⲛⲧⲣⲉϥϫⲓⲛϭⲟⲛⲥ
ⲙ︤ⲛ︦ⲧ︥ⲣⲉϥϭ︤ⲛ︥	ⲙⲛⲧⲣⲉϥϭⲛ
ⲙ︤ⲛ︦ⲧ︥ⲣⲉϥϯϭⲱⲛ︤ⲧ︥	ⲙⲛⲧⲣⲉϥϯϭⲱⲛⲧ
ⲙ︤ⲛ︦ⲧ︥ⲣⲉϥⲧⲱϩ	ⲙⲛⲧⲣⲉϥⲧⲱϩ
ⲙ︤ⲛ︦ⲧ︥ⲣⲉϥⲧⲱϩ`	ⲙⲛⲧⲣⲉϥⲧⲱϩ
ⲙ︤ⲛ︦ⲧ︥ⲣⲉ	ⲙⲛⲧⲣⲉ
ⲙ︤ⲛ︦ⲧ︥ⲣ︤ⲙ︥ϩⲉ⳿	ⲙⲛⲧⲣⲙϩⲉ
ⲙ︤ⲛ︦ⲧ︥ⲣ︤ⲙ︥ϩⲉ	ⲙⲛⲧⲣⲙϩⲉ
ⲙ︤ⲛ︦ⲧ︥ⲣ︤ⲙ︥ⲛ̄ϩⲏⲧ	ⲙⲛⲧⲣⲙⲛϩⲏⲧ
ⲙ︤ⲛ︦ⲧ︥ⲥⲁⲃⲉ	ⲙⲛⲧⲥⲁⲃⲉ
ⲙ︤ⲛ︦ⲧ︥ⲥⲟϭ	ⲙⲛⲧⲥⲟϭ
ⲙ︤ⲛ︦ⲧ︥ⲥⲧⲙⲏⲧ	ⲙⲛⲧⲥⲧⲙⲏⲧ
ⲙ︤ⲛ︦ⲧ︥ⲧⲉ·ⲗⲓⲟⲥ	ⲙⲛⲧⲧⲉⲗⲓⲟⲥ
ⲙ︤ⲛ︦ⲧ︥`ⲛⲟⲩϫ`	ⲙⲛⲧⲛⲟⲩϫ
ⲙ︤ⲛ︦︦ⲧ︥ⲣ︤ⲙ︥ⲛ̄ϩⲏⲧ	ⲙⲛⲧⲣⲙⲛϩⲏⲧ
ⲙ︤ⲛ	ⲙⲛ
ⲙ︤ⲡ̣︥	ⲙⲡ
ⲙ︤︥ⲛⲛ̄ⲥⲁ	ⲙⲛⲛⲥⲁ
ⲙ︤︥ⲛⲛⲥⲁ	ⲙⲛⲛⲥⲁ
ⲙ︤︥ⲛ	ⲙⲛ
ⲙ︤	ⲙ
ⲙ︥ⲙⲁⲩ	ⲙⲙⲁⲩ
ⲙ︥ⲡϣⲁ	ⲙⲡϣⲁ
ⲙ︥	ⲛ
ⲙ︦ⲙⲟ	ⲙⲙⲟ
ⲙ︦ⲛ︦ⲧ︥ϩ︤ⲙ︥ϩⲁⲗ	ⲙⲛⲧϩⲙϩⲁⲗ
ⲙ	ⲙ
ⲙ 	ⲙ[ ]
ⲙ.....ⲟⲓ	ⲙ[.....]ⲟⲓ
ⲙ[ⲁ	ⲙⲁ
ⲙ[ⲙⲁⲩ	ⲙⲙⲁⲩ
ⲙ[ⲛ]	ⲙⲛ
ⲙ]ⲙ̣ⲁⲩ	ⲙⲙⲁⲩ
ⲙ]ⲛ	ⲙⲛ
ⲙ]	ⲙ
Ⲛ̣̄	ⲛ
Ⲛ̄ⲁ	ⲛⲁ
Ⲛ̄ⲦⲈ	ⲛⲧⲉ
Ⲛ̄Ⲧ	ⲛⲧ
Ⲛ̄ⲧⲟⲕ	ⲛⲧⲟⲕ
Ⲛ̄ⲧⲱⲧ︤ⲛ︥	ⲛⲧⲱⲧⲛ
Ⲛ̄ⲧ	ⲛⲧⲁ
Ⲛ̄	ⲛ
Ⲛϭⲓ̇	ⲛϭⲓ
Ⲛϭⲓ	ⲛϭⲓ
ⲚⲀⲘⲈ	ⲛⲁⲙⲉ
ⲚⲀ	ⲛⲁ
Ⲛⲁϣⲱ	ⲛⲁϣⲱ
Ⲛⲁⲓ̈	ⲛⲁⲓ
Ⲛⲁⲓ	ⲛⲁⲓ
Ⲛⲁ	ⲛⲁ
ⲚⲈϥ	ⲛⲉϥ
Ⲛⲉ̇	ⲛⲉ
Ⲛⲉⲓ̇	ⲛⲉⲓ
Ⲛⲉⲓ	ⲛⲉⲓ
Ⲛⲉ	ⲛⲉ
Ⲛⲓⲙ	ⲛⲓⲙ
ⲚⲞⲨⲦⲈ	ⲛⲟⲩⲧⲉ
ⲚⲦⲈ	ⲛⲧⲉ
ⲚⲦ	ⲛⲧ
Ⲛⲧⲟϥ	ⲛⲧⲟϥ
Ⲛⲧⲟⲕ	ⲛⲧⲟⲕ
Ⲛⲧⲟⲟⲩ	ⲛⲧⲟⲟⲩ
Ⲛⲧⲱⲧⲛ	ⲛⲧⲱⲧⲛ
Ⲛⲧ	ⲛⲧⲁ
Ⲛ	ⲛ
ⲛ·	ⲛ
ⲛ̄·	ⲛ
ⲛ̣̄	ⲛ
ⲛ̣̄[ϭⲓ]	ⲛϭⲓ
ⲛ̄ϥⲓ	ⲛϥⲓ
ⲛ̄ϩⲏ̣[ⲧ	ⲛϩⲏⲧ
ⲛ̄ϩⲏⲧ︤	ⲛϩⲏⲧ
ⲛ̄ϩⲏⲧ	ⲛϩⲏⲧ
ⲛ̄ϩⲟⲩⲛ	ⲛϩⲟⲩⲛ
ⲛ̄ϩⲧⲏ	ⲛϩⲧⲏ
ⲛ̄ϭⲓ	ⲛϭⲓ
ⲛ̄ϭ[ⲓ	ⲛϭⲓ
ⲛ̄ⲁ	ⲛⲁ
ⲛ̄ⲃⲗ̄ⲗⲁ	ⲛⲃⲗⲗⲁ
ⲛ̄ⲃ︤ⲗ︥ⲁ	ⲛⲃⲗⲁ
ⲛ̄ⲉϥ	ⲛⲉϥ
ⲛ̄ⲕⲁ⳿	ⲛⲕⲁ
ⲛ̄ⲕⲟⲧⲕ̄	ⲛⲕⲟⲧⲕ
ⲛ̄ⲕⲟⲧⲕ	ⲛⲕⲟⲧⲕ
ⲛ̄ⲕⲟⲧ︤ⲕ︥	ⲛⲕⲟⲧⲕ
ⲛ̄ⲗⲓⲃⲁⲛⲟⲥ	ⲛⲗⲓⲃⲁⲛⲟⲥ
ⲛ̄ⲙ̄ⲙⲁ	ⲛⲙⲙⲁ
ⲛ̄ⲙ̄ⲙ	ⲛⲙⲙ
ⲛ̄ⲙⲙⲁ	ⲛⲙⲙⲁ
ⲛ̄ⲛ̄ⲁ̇ϩⲣⲙ	ⲛⲛⲁϩⲣⲙ
ⲛ̄ⲛ̄	ⲛ
ⲛ̄ⲛ̣ⲁϩⲣⲁ	ⲛⲛⲁϩⲣⲁ
ⲛ̄ⲛ̣ⲉ	ⲛⲛⲉ
ⲛ̄ⲛⲁ̂ϩ︤ⲣ︦ⲙ︥	ⲛⲛⲁϩⲣⲙ
ⲛ̄ⲛⲁϩ̄︤ⲣ︤̄ⲙ̄︥	ⲛⲛⲁϩⲣⲙ
ⲛ̄ⲛⲁϩⲣⲙ̇	ⲛⲛⲁϩⲣⲙ
ⲛ̄ⲛⲁϩⲣⲛ̄	ⲛⲛⲁϩⲣⲛ
ⲛ̄ⲛⲁϩⲣ︤ⲙ︥	ⲛⲛⲁϩⲣⲙ
ⲛ̄ⲛⲁϩ︤ⲣ︦ⲙ︥	ⲛⲛⲁϩⲣⲙ
ⲛ̄ⲛⲁϩ︤ⲣ︦ⲛ︥	ⲛⲛⲁϩⲣⲛ
ⲛ̄ⲛⲉ	ⲛⲛⲉ
ⲛ̄ⲛ	ⲛⲛ
ⲛ̄ⲟⲓ	ⲛⲟⲉⲓ
ⲛ̄ⲟⲩⲧⲉ	ⲛⲟⲩⲧⲉ
ⲛ̄ⲟⲩ	ⲛⲟⲩ
ⲛ̄ⲥⲁⲃⲏⲗ	ⲛⲥⲁⲃⲏⲗ
ⲛ̄ⲥⲁ	ⲛⲥⲁ
ⲛ̄ⲥⲱ̂	ⲛⲥⲱ
ⲛ̄ⲥⲱ	ⲛⲥⲱ
ⲛ̄Ⲧ	ⲛⲧ
ⲛ̄ⲧ̄ⲕ	ⲛⲧⲕ
ⲛ̄ⲧⲁ	ⲛⲧⲁ
ⲛ̄ⲧⲉⲣⲉ	ⲛⲧⲉⲣⲉ
ⲛ̄ⲧⲉⲣ	ⲛⲧⲉⲣ
ⲛ̄ⲧⲉⲧ︤ⲛ︥	ⲛⲧⲉⲧⲛ
ⲛ̄ⲧⲉ	ⲛⲧⲉ
ⲛ̄ⲧⲕ̄	ⲛⲧⲕ
ⲛ̄ⲧⲟ̂	ⲛⲧⲟ
ⲛ̄ⲧⲟϣ`	ⲛⲧⲟϣ
ⲛ̄ⲧⲟϥ	ⲛⲧⲟϥ
ⲛ̄ⲧⲟϥ`	ⲛⲧⲟϥ
ⲛ̄ⲧⲟⲕ	ⲛⲧⲟⲕ
ⲛ̄ⲧⲟⲗⲏ	ⲉⲛⲧⲟⲗⲏ
ⲛ̄ⲧⲟⲟⲧ︤	ⲛⲧⲟⲟⲧ
ⲛ̄ⲧⲟⲟⲧ	ⲛⲧⲟⲟⲧ
ⲛ̄ⲧⲟⲟⲩⲛ	ⲛⲧⲟⲟⲩⲛ
ⲛ̄ⲧⲟⲟⲩ	ⲛⲧⲟⲟⲩ
ⲛ̄ⲧⲟⲟⲩ`	ⲛⲧⲟⲟⲩ
ⲛ̄ⲧⲟⲥ	ⲛⲧⲟⲥ
ⲛ̄ⲧⲟ	ⲛⲧⲟ
ⲛ̄ⲧⲱⲧⲛ̄	ⲛⲧⲱⲧⲛ
ⲛ̄ⲧⲱⲧ︤ⲛ︥	ⲛⲧⲱⲧⲛ
ⲛ̄ⲧⲱⲧ︤ⲛ︥`	ⲛⲧⲱⲧⲛ
ⲛ̄ⲧ︤ⲕ︥	ⲛⲧⲕ
ⲛ̄ⲧ︤	ⲛⲧ
ⲛ̄ⲧ	ⲛⲧ
ⲛ̄	ⲛ
ⲛ̄[.]ⲁ	ⲛⲥⲁ
ⲛ̄]	ⲛ
ⲛ̅	ⲛ
ⲛ̇ϣⲁ	ⲛϣⲁ
ⲛ̇ϣⲟ	ⲛϣⲟ
ⲛ̇ϩⲏⲧ	ⲛϩⲏⲧ
ⲛ̇ϫⲓ̇	ⲛϫⲓ
ⲛ̇ϭⲓ̇	ⲛϭⲓ
ⲛ̇ϭⲓ	ⲛϭⲓ
ⲛ̇ⲉⲛ	ⲛⲉⲛ
ⲛ̇ⲕⲟⲧⲕ̇	ⲛⲕⲟⲧⲕ
ⲛ̇ⲛⲁϩⲣⲁ	ⲛⲛⲁϩⲣⲁ
ⲛ̇ⲛⲉ	ⲛⲛⲉ
ⲛ̇ⲛ	ⲛ
ⲛ̇ⲟϫ	ⲛⲟϫ
ⲛ̇ⲟⲩⲧⲉ	ⲛⲟⲩⲧⲉ
ⲛ̇ⲥⲁ	ⲛⲥⲁ
ⲛ̇ⲥⲱ	ⲛⲥⲱ
ⲛ̇ⲧⲉⲣⲉ	ⲛⲧⲉⲣⲉ
ⲛ̇ⲧⲉⲣ	ⲛⲧⲉⲣ
ⲛ̇ⲧⲉ	ⲛⲧⲉ
ⲛ̇ⲧⲕ̇	ⲛⲧⲕ
ⲛ̇ⲧⲟϥ	ⲛⲧⲟϥ
ⲛ̇ⲧⲟⲕ	ⲛⲧⲟⲕ
ⲛ̇ⲧⲟⲕ 	ⲛⲧⲟⲕ
ⲛ̇ⲧⲟⲗⲏ̇	ⲛⲧⲟⲗⲏ
ⲛ̇ⲧⲟⲟⲧ	ⲛⲧⲟⲟⲧ
ⲛ̇ⲧⲟⲟⲩ	ⲛⲧⲟⲟⲩ
ⲛ̇ⲧⲱⲧⲛ̇	ⲛⲧⲱⲧⲛ
ⲛ̇ⲧ	ⲛⲧ
ⲛ̇	ⲛ
ⲛ̇ 	ⲛ
ⲛ̣̄ⲣⲙ̣	ⲛⲣⲙ
ⲛ̣̄ⲧⲟϥ̣	ⲛⲧⲟϥ
ⲛ̣̄ⲧⲟⲟⲧ︤	ⲛⲧⲟⲟⲧ
ⲛ̣̄	ⲛ
ⲛ̣ⲁⲓ̈	ⲛⲁⲓ
ⲛ̣ⲁ	ⲛⲁ
ⲛ̣ⲉϥ	ⲛⲉϥ
ⲛ̣ⲉϩ	ⲛⲉϩ
ⲛ̣ⲉⲛ	ⲛⲉⲛ
ⲛ̣ⲉⲣⲉ	ⲛⲉⲣⲉ
ⲛ̣ⲉⲩ	ⲛⲉⲩ
ⲛ̣ⲉ	ⲛⲉ
ⲛ̣ⲏ̣	ⲛⲏ
ⲛ̣ⲏ	ⲛⲏ
ⲛ̣ⲓ̣ⲙ̣	ⲛⲓⲙ
ⲛ̣ⲓⲙ̣	ⲛⲓⲙ
ⲛ̣ⲛ̣ⲉ	ⲛⲛⲉ
ⲛ̣ⲛ	ⲛ
ⲛ̣ⲟϭ	ⲛⲟϭ
ⲛ̣ⲟⲩⲧⲉ	ⲛⲟⲩⲧⲉ
ⲛ̣ⲥⲱ	ⲛⲥⲱ
ⲛ̣ⲧ̣	ⲛⲧ
ⲛ̣ⲧⲁ̣	ⲛⲧⲁ
ⲛ̣︥	ⲛ
ⲛ̣	ⲛ
ⲛ̣[ϩⲏ]ⲧ	ⲛϩⲏⲧ
ⲛ̣[ⲉ	ⲛⲉ
ⲛϣⲁ	ⲛϣⲁ
ⲛϣⲟⲧ	ⲛϣⲟⲧ
ⲛϣⲟ	ⲛϣⲟ
ⲛϥⲓ	ⲛϥⲓ
ⲛϩⲏⲧ︤	ⲛϩⲏⲧ
ⲛϩⲏⲧ	ⲛϩⲏⲧ
ⲛϩⲏ	ⲛϩⲏ
ⲛϩⲏ[ⲧ]	ⲛϩⲏⲧ
ⲛϩⲟⲧ	ⲛϩⲟⲧ
ⲛϩⲟⲩⲛ	ⲛϩⲟⲩⲛ
ⲛϩⲟⲩⲟ	ⲛϩⲟⲩⲟ
ⲛϩⲣⲁⲓ	ⲛϩⲣⲁⲓ
ⲛϩⲧⲏ	ⲛϩⲧⲏ
ⲛϫⲓ	ⲛϫⲓ
ⲛϫⲧⲁ	ⲛϫⲧⲁ
ⲛϭ̣ⲓ̣	ⲛϭⲓ
ⲛϭⲓ̇	ⲛϭⲓ
ⲛϭⲓ	ⲛϭⲓ
ⲛⲁ·	ⲛⲁ
ⲛⲁ̂	ⲛⲁ
ⲛⲁ̣	ⲛⲁ
ⲛⲁϣⲉ	ⲛⲁϣⲉ
ⲛⲁϣⲧ̇	ⲛⲁϣⲧ
ⲛⲁϣⲧⲉ	ⲛⲁϣⲧⲉ
ⲛⲁϣⲧ	ⲛⲁϣⲧ
ⲛⲁϣⲱ	ⲛⲁϣⲱ
ⲛⲁϩⲙⲉⲃⲱⲕ	ⲛⲁϩⲙⲉⲃⲱⲕ
ⲛⲁϩⲙⲉ	ⲛⲁϩⲙⲉ
ⲛⲁϩⲙ	ⲛⲁϩⲙ
ⲛⲁϩⲣ̇ⲁ	ⲛⲁϩⲣⲁ
ⲛⲁϩⲣⲁ	ⲛⲁϩⲣⲁ
ⲛⲁϩⲣⲛ	ⲛⲁϩⲣⲛ
ⲛⲁϩⲣ︤ⲛ︥	ⲛⲁϩⲣⲛ
ⲛⲁϩⲧⲉ	ⲛⲁϩⲧⲉ
ⲛⲁϩ︤ⲙ︦	ⲛⲁϩⲙ
ⲛⲁϫ	ⲛⲁϫ
ⲛⲁⲁⲕⲉ	ⲛⲁⲁⲕⲉ
ⲛⲁⲁ	ⲛⲁⲁ
ⲛⲁⲃⲟⲩⲭⲟⲇⲟⲛⲟ̂ⲥⲟⲣ⳿	ⲛⲁⲃⲟⲩⲭⲟⲇⲟⲛⲟⲥⲟⲣ
ⲛⲁⲃⲟⲩⲭⲟⲇⲟⲛⲟⲥⲟⲣ	ⲛⲁⲃⲟⲩⲭⲟⲇⲟⲛⲟⲥⲟⲣ
ⲛⲁⲉ	ⲛⲁⲉ
ⲛⲁⲍⲁⲣⲁⲓⲟⲥ	ⲛⲁⲍⲁⲣⲁⲓⲟⲥ
ⲛⲁⲍⲁⲣⲉⲑ	ⲛⲁⲍⲁⲣⲉⲑ
ⲛⲁⲍⲁⲣⲏⲛⲟⲥ	ⲛⲁⲍⲁⲣⲏⲛⲟⲥ
ⲛⲁⲍⲱⲣⲁⲓⲟⲥ	ⲛⲁⲍⲱⲣⲁⲓⲟⲥ
ⲛⲁⲓ̇	ⲛⲁⲓ
ⲛⲁⲓ̣̈	ⲛⲁⲓ
ⲛⲁⲓ̈ⲁⲧ︤	ⲛⲁⲓⲁⲧ
ⲛⲁⲓ̈ⲁⲧ	ⲛⲁⲓⲁⲧ
ⲛⲁⲓ̈	ⲛⲁⲓ
ⲛⲁⲓⲁⲧ︤	ⲛⲁⲓⲁⲧ
ⲛⲁⲓⲁⲧ	ⲛⲁⲓⲁⲧ
ⲛⲁⲓ	ⲛⲁⲓ
ⲛⲁⲙⲉ⳿	ⲛⲁⲙⲉ
ⲛⲁⲙⲉ	ⲛⲁⲙⲉ
ⲛⲁⲙⲉ`	ⲛⲁⲙⲉ
ⲛⲁⲛ̣ⲉ	ⲛⲁⲛⲉ
ⲛⲁⲛⲉ	ⲛⲁⲛⲉ
ⲛⲁⲛⲟⲩ	ⲛⲁⲛⲟⲩ
ⲛⲁⲛ	ⲛⲁⲛⲟⲩ
ⲛⲁⲣⲇⲟⲥ	ⲛⲁⲣⲇⲟⲥ
ⲛⲁⲩⲉ	ⲛⲁⲩ
ⲛⲁⲩⲏ̇	ⲛⲁⲩⲏ
ⲛⲁⲩⲏ	ⲛⲁⲩⲏ
ⲛⲁⲩ⳿	ⲛⲁⲩ
ⲛⲁⲩ	ⲛⲁⲩ
ⲛⲁⲩ`	ⲛⲁⲩ
ⲛⲁ⳿	ⲛⲁ
ⲛⲁ	ⲛⲁ
ⲛⲁ]	ⲛⲁ
ⲛⲁ`	ⲛⲁ
ⲛⲃⲗⲁ	ⲛⲃⲗⲁ
ⲛⲃⲗⲗⲁ	ⲛⲃⲗⲗⲁ
ⲛⲅⲥⲟⲧ	ⲥⲟⲧ
ⲛⲇⲉ	ⲇⲉ
ⲛⲉ̇	ⲛⲉ
ⲛⲉϥ	ⲛⲉϥ
ⲛⲉϩϣⲗϥ̇	ⲛⲉϩϣⲗϥ
ⲛⲉϩϣⲗϥ	ⲛⲉϩϣⲗϥ
ⲛⲉϩⲡ̣ⲉ	ⲛⲉϩⲡⲉ
ⲛⲉϩⲡⲉ	ⲛⲉϩⲡⲉ
ⲛⲉϩⲥⲉ	ⲛⲉϩⲥⲉ
ⲛⲉϩ⳿	ⲛⲉϩ
ⲛⲉϩ	ⲛⲉϩ
ⲛⲉϩ`	ⲛⲉϩ
ⲛⲉϫⲕⲁϩ	ⲛⲉϫⲕⲁϩ
ⲛⲉϫⲧⲁϥ	ⲛⲉϫⲧⲁϥ
ⲛⲉϫ⳿	ⲛⲉϫ
ⲛⲉϫ	ⲛⲉϫ
ⲛⲉϭⲛⲟⲩϭ	ⲛⲉϭⲛⲟⲩϭ
ⲛⲉⲉϥ	ⲛⲉⲉϥ
ⲛⲉⲉⲓ	ⲛⲉⲓ
ⲛⲉⲓ̄	ⲛⲉⲓ
ⲛⲉⲓ̇	ⲛⲉⲓ
ⲛⲉⲓ̈	ⲛⲉⲓ
ⲛⲉⲓ	ⲛⲉⲓ
ⲛⲉⲕ̇	ⲛⲉⲕ
ⲛⲉⲕ⳿	ⲛⲉⲕ
ⲛⲉⲕ	ⲛⲉⲕ
ⲛⲉⲛ̄	ⲛⲉⲛ
ⲛⲉⲛ̣	ⲛⲉⲛ
ⲛⲉⲛ	ⲛⲉⲛ
ⲛⲉⲣⲉ	ⲛⲉⲣⲉ
ⲛⲉⲣ	ⲛⲉⲣ
ⲛⲉⲥⲱ	ⲛⲉⲥⲱ
ⲛⲉⲥ	ⲛⲉⲥ
ⲛⲉⲧⲛ̄	ⲛⲉⲧⲛ
ⲛⲉⲧⲛ̇	ⲛⲉⲧⲛ
ⲛⲉⲧⲛⲛⲉⲧⲛ	ⲛⲉⲧⲛ
ⲛⲉⲧⲛ︥	ⲛⲉⲧⲛ
ⲛⲉⲧⲛ	ⲛⲉⲧⲛ
ⲛⲉⲧ︤ⲛ︥ⲛⲉⲧ︤ⲛ︥	ⲛⲉⲧⲛ
ⲛⲉⲧ︤ⲛ︥	ⲛⲉⲧⲛ
ⲛⲉⲧ	ⲛⲉⲧ
ⲛⲉⲧ`	ⲛⲉⲧ
ⲛⲉⲩ	ⲛⲉⲩ
ⲛⲉ⳯	ⲛⲉⲛ
ⲛⲉ⳿	ⲛⲉ
ⲛⲉ	ⲛⲉ
ⲛⲉ 	ⲛⲉ
ⲛⲉ]ⲛ	ⲛⲉⲛ
ⲛⲉ]	ⲛⲉ
ⲛⲉ`	ⲛⲉ
ⲛⲏ̂	ⲛⲏ
ⲛⲏϫ	ⲛⲏϫ
ⲛⲏⲏ̇ⲃ	ⲛⲏⲏⲃⲉ
ⲛⲏⲏⲃ	ⲛⲏⲏⲃⲉ
ⲛⲏⲡϩⲉ	ⲛⲏⲫⲉ
ⲛⲏⲥⲧⲉⲓⲁ⳿	ⲛⲏⲥⲧⲉⲓⲁ
ⲛⲏⲥⲧⲉⲓⲁ	ⲛⲏⲥⲧⲉⲓⲁ
ⲛⲏⲥⲧⲉⲩⲉ̇	ⲛⲏⲥⲧⲉⲩⲉ
ⲛⲏⲥⲧⲉⲩⲉ	ⲛⲏⲥⲧⲉⲩⲉ
ⲛⲏⲥⲧⲓⲁ⳿	ⲛⲏⲥⲧⲉⲓⲁ
ⲛⲏⲥⲧⲓⲁ	ⲛⲏⲥⲧⲓⲁ
ⲛⲏⲩ	ⲛⲏⲩ
ⲛⲏⲫⲉ̇	ⲛⲏⲫⲉ
ⲛⲏⲫⲉ	ⲛⲏⲫⲉ
ⲛⲏ	ⲛⲏ
ⲛⲓ̇ⲙ	ⲛⲓⲙ
ⲛⲓ̈ⲙ	ⲛⲓⲙ
ⲛⲓ̣ⲙ	ⲛⲓⲙ
ⲛⲓϥⲉ	ⲛⲓϥⲉ
ⲛⲓϥⲉ`	ⲛⲓϥⲉ
ⲛⲓⲙ̇	ⲛⲓⲙ
ⲛⲓⲙ̣	ⲛⲓⲙ
ⲛⲓⲙ⳿	ⲛⲓⲙ
ⲛⲓⲙ	ⲛⲓⲙ
ⲛⲓⲙ`	ⲛⲓⲙ
ⲛⲓⲛⲉⲩⲏ	ⲛⲓⲛⲉⲩⲏ
ⲛⲓ⳿	ⲛⲓ
ⲛⲓ	ⲛⲓ
ⲛⲕⲁ	ⲛⲕⲁ
ⲛⲕⲟⲧⲕ	ⲛⲕⲟⲧⲕ
ⲛⲗⲓⲃⲁⲛⲟⲥ	ⲛⲗⲓⲃⲁⲛⲟⲥ
ⲛⲙ̄ⲙⲁ	ⲛⲙⲙⲁ
ⲛⲙ̇ⲙⲁ	ⲛⲙⲙⲁ
ⲛⲙⲙⲁ	ⲛⲙⲙⲁ
ⲛⲙⲙⲏ	ⲛⲙⲙⲏ
ⲛⲙⲙ	ⲛⲙⲙ
ⲛⲙⲛⲁ	ⲛⲙⲛⲁ
ⲛⲙ︥ⲙⲁ	ⲛⲙⲙⲁ
ⲛⲙ	ⲛⲙ
ⲛⲛⲁϩⲣⲁ	ⲛⲛⲁϩⲣⲁ
ⲛⲛⲁϩⲣⲙ	ⲛⲛⲁϩⲣⲙ
ⲛⲛⲁϩⲣⲛ	ⲛⲛⲁϩⲣⲛ
ⲛⲛⲉⲛ	ⲛⲉⲛ
ⲛⲛⲉ	ⲛⲛⲉ
ⲛⲛⲏⲩ	ⲛⲏⲩ
ⲛⲛ	ⲛⲛ
ⲛⲟ̣ϭ	ⲛⲟϭ
ⲛⲟ̣ⲃ̣ⲉ̣	ⲛⲟⲃⲉ
ⲛⲟϣⲡ	ⲛⲟϣⲡ
ⲛⲟϥⲣⲉ	ⲛⲟϥⲣⲉ
ⲛⲟϥⲣⲉ`	ⲛⲟϥⲣⲉ
ⲛⲟϫⲟⲩ	ⲛⲟϫⲟⲩ
ⲛⲟϫ︤	ⲛⲟϫ
ⲛⲟϫ	ⲛⲟϫ
ⲛⲟϭ̂	ⲛⲟϭ
ⲛⲟϭⲛⲉϭ	ⲛⲟϭⲛⲉϭ
ⲛⲟϭ	ⲛⲟϭ
ⲛⲟⲃⲉ	ⲛⲟⲃⲉ
ⲛⲟⲃⲉ`	ⲛⲟⲃⲉ
ⲛⲟⲉⲓ̂	ⲛⲟⲉⲓ
ⲛⲟⲉⲓⲉ	ⲛⲟⲉⲓ
ⲛⲟⲉⲓⲕ	ⲛⲟⲉⲓⲕ
ⲛⲟⲉⲓⲛ	ⲛⲟⲉⲓⲛ
ⲛⲟⲉⲓ⳿	ⲛⲟⲉⲓ
ⲛⲟⲉⲓ	ⲛⲟⲉⲓ
ⲛⲟⲏ̂`	ⲛⲟⲏ
ⲛⲟⲏ	ⲛⲟⲏ
ⲛⲟⲓ̈	ⲛⲟⲓ
ⲛⲟⲓⲛ	ⲛⲟⲉⲓⲛ
ⲛⲟⲓ	ⲛⲟⲓ
ⲛⲟⲙⲟⲥ	ⲛⲟⲙⲟⲥ
ⲛⲟⲙⲟⲥ`	ⲛⲟⲙⲟⲥ
ⲛⲟⲛ	ⲛⲟⲛ
ⲛⲟⲩϥ	ⲛⲟⲩϥ
ⲛⲟⲩϫϭ	ⲛⲟⲩϫϭ
ⲛⲟⲩϫⲉ⳿	ⲛⲟⲩϫⲉ
ⲛⲟⲩϫⲉ	ⲛⲟⲩϫⲉ
ⲛⲟⲩϫⲕ	ⲛⲟⲩϫⲕ
ⲛⲟⲩϫ︤ϭ︥	ⲛⲟⲩϫϭ
ⲛⲟⲩϫ	ⲛⲟⲩϫ
ⲛⲟⲩϫ`	ⲛⲟⲩϫ
ⲛⲟⲩϭⲥ	ⲛⲟⲩϭⲥ
ⲛⲟⲩϭ︤ⲥ︥	ⲛⲟⲩϭⲥ
ⲛⲟⲩϭ	ⲛⲟⲩϫ
ⲛⲟⲩⲃ	ⲛⲟⲩⲃ
ⲛⲟⲩⲓ	ⲛⲟⲩⲓ
ⲛⲟⲩⲕ	ⲛⲟⲩⲕ
ⲛⲟⲩⲛⲉ⳿	ⲛⲟⲩⲛⲉ
ⲛⲟⲩⲛⲉ	ⲛⲟⲩⲛⲉ
ⲛⲟⲩⲥ	ⲛⲟⲩⲥ
ⲛⲟⲩⲧ̇ⲉ	ⲛⲟⲩⲧⲉ
ⲛⲟⲩⲧⲉ⳿	ⲛⲟⲩⲧⲉ
ⲛⲟⲩⲧⲉ	ⲛⲟⲩⲧⲉ
ⲛⲟⲩⲧⲉ`	ⲛⲟⲩⲧⲉ
ⲛⲟⲩ	ⲛⲟⲩ
ⲛⲟⲩ[ⲃ	ⲛⲟⲩⲃ
ⲛⲟⲩ[ⲧⲉ]	ⲛⲟⲩⲧⲉ
ⲛⲟⲩ]ⲧⲉ	ⲛⲟⲩⲧⲉ
ⲛⲣϣⲁⲩ	ⲛⲣϣⲁⲩ
ⲛⲣⲙ	ⲛⲣⲙ
ⲛⲥⲁⲃⲏⲗ	ⲛⲥⲁⲃⲏⲗ
ⲛⲥⲁ⳿	ⲛⲥⲁ
ⲛⲥⲁ	ⲛⲥⲁ
ⲛⲥⲱ	ⲛⲥⲱ
ⲛⲦ	ⲛⲧ
ⲛⲧ̄	ⲛⲧ
ⲛⲧⲁ	ⲛⲧⲁ
ⲛⲧⲉⲣⲉⲣ	ⲛⲧⲉⲣⲉ
ⲛⲧⲉⲣⲉ	ⲛⲧⲉⲣⲉ
ⲛⲧⲉⲣ	ⲛⲧⲉⲣ
ⲛⲧⲉⲧⲛ	ⲛⲧⲉⲧⲛ
ⲛⲧⲉⲧ︤ⲛ︥	ⲛⲧⲉⲧⲛ
ⲛⲧⲉⲧ︤︥ⲛ	ⲛⲧⲉⲧⲛ
ⲛⲧⲉⲩⲛⲟⲩ	ⲛⲧⲉⲩⲛⲟⲩ
ⲛⲧⲉ	ⲛⲧⲉ
ⲛⲧⲕ	ⲛⲧⲕ
ⲛⲧⲙ	ⲛⲧⲙ
ⲛⲧⲛ	ⲛⲧⲛ
ⲛⲧⲟϣ	ⲛⲧⲟϣ
ⲛⲧⲟϥ	ⲛⲧⲟϥ
ⲛⲧⲟⲕ	ⲛⲧⲟⲕ
ⲛⲧⲟⲕ 	ⲛⲧⲟⲕ
ⲛⲧⲟⲗⲏ	ⲉⲛⲧⲟⲗⲏ
ⲛⲧⲟⲟⲧ	ⲛⲧⲟⲟⲧ
ⲛⲧⲟⲟⲩⲛ	ⲛⲧⲟⲟⲩⲛ
ⲛⲧⲟⲟⲩ	ⲛⲧⲟⲟⲩ
ⲛⲧⲟⲥ	ⲛⲧⲟⲥ
ⲛⲧⲟ	ⲛⲧⲟ
ⲛⲧⲱⲕ	ⲛⲧⲱⲕ
ⲛⲧⲱⲧⲛ	ⲛⲧⲱⲧⲛ
ⲛⲧ︤︥	ⲛⲧ
ⲛⲧ	ⲛⲧ
ⲛⲧ[ⲉ]	ⲛⲧⲉ
ⲛⲩⲕⲧⲉⲣⲓⲥ	ⲛⲩⲕⲧⲉⲣⲓⲥ
ⲛⲩⲕⲧⲉⲣⲓⲥ`	ⲛⲩⲕⲧⲉⲣⲓⲥ
ⲛⲱϩⲉ	ⲛⲱϩⲉ
ⲛ⳯	ⲛⲉⲛ
ⲛ⳿	ⲛ
ⲛ︤ⲅ︥ⲥⲟⲧ	ⲥⲟⲧ
ⲛ︤ⲙ︥ⲙⲁ	ⲛⲙⲙⲁ
ⲛ︤ⲙ︥ⲙⲏ	ⲛⲙⲙⲏ
ⲛ︤ⲙ︥ⲙ	ⲛⲙⲙ
ⲛ︤ⲧ︥	ⲛⲧ
ⲛ︤	ⲛ
ⲛ︥ϩⲏⲧ︤	ⲛϩⲏⲧ
ⲛ︥ϩⲏⲧ	ⲛϩⲏⲧ
ⲛ︥ϩⲟⲧ	ⲛϩⲟⲧ
ⲛ︥ⲕⲟⲧ︤ⲕ︥	ⲛⲕⲟⲧⲕ
ⲛ︥	ⲛ
ⲛ︥`	ⲛ
ⲛ	ⲛ
ⲛ ́ 	ⲛ
ⲛ 	ⲛ
ⲛ.ⲁ	ⲛⲥⲁ
ⲛ[ϭ]ⲓ	ⲛϭⲓ
ⲛ]	ⲛ
ⲛ`	ⲛ
ⲝⲉⲥⲧⲏⲥ	ⲝⲉⲥⲧⲏⲥ
ⲝⲟⲩⲣ	ⲝⲟⲩⲣ
Ⲟⲛ⳿	ⲟⲛ
Ⲟⲛ	ⲟⲛ
ⲞⲨϪⲀⲒ	ⲟⲩϫⲁⲓ
ⲞⲨⲀⲀⲂ	ⲟⲩⲁⲁⲃ
ⲞⲨ	ⲟⲩ
Ⲟⲩⲟⲓ̈	ⲟⲩⲟⲓ
Ⲟⲩⲟⲓ	ⲟⲩⲟⲓ
Ⲟⲩⲟⲛ	ⲟⲩⲟⲛ
Ⲟⲩ	ⲟⲩ
ⲟ̂ⲃ︤ϣ︥	ⲟⲃϣ
ⲟ̂ⲉⲓⲕ⳿	ⲟⲉⲓⲕ
ⲟ̂	ⲟ
ⲟ̄ⲛϩ̄	ⲟⲛϩ
ⲟ̇ⲃⲉ	ⲟⲃⲉ
ⲟ̇ⲉⲓ̇ϣ	ⲟⲉⲓϣ
ⲟ̇ⲉⲓ̇ⲕ	ⲟⲉⲓⲕ
ⲟ̇ⲕⲙ̇	ⲟⲕⲙ
ⲟ̇ⲛ	ⲟⲛ
ⲟ̇ⲡ	ⲟⲡ
ⲟ̇ⲣⲅⲏ	ⲟⲣⲅⲏ
ⲟ̇ⲥⲉ	ⲟⲥⲉ
ⲟ̇ⲧⲡ̇	ⲟⲧⲡ
ⲟ̇ⲧⲡ	ⲟⲧⲡ
ⲟ̇ⲩⲉ̇ϣ	ⲟⲩⲉϣ
ⲟ̇ⲩⲱ̇ⲙ	ⲟⲩⲱⲙ
ⲟ̇ⲩ	ⲟⲩ
ⲟ̇	ⲟ
ⲟ̣ⲩ̣	ⲟⲩ
ⲟ̣ⲩⲁ`	ⲟⲩⲁ
ⲟ̣ⲩⲏϩ̣	ⲟⲩⲏϩ
ⲟ̣ⲩ	ⲟⲩ
ⲟ̣`	ⲟ
ⲟϣⲉ̣	ⲟϣⲉ
ⲟϣⲉ	ⲟϣⲉ
ⲟϣ⳿	ⲟϣ
ⲟϣ	ⲟϣ
ⲟϩⲉ	ⲟϩⲉ
ⲟϭⲉ	ⲟϭⲉ
ⲟϭⲧ	ⲟϭⲧ
ⲟ᷍ⲩ	ⲟⲩ
ⲟⲃϣ︤	ⲟⲃϣ
ⲟⲃϣ	ⲟⲃϣ
ⲟⲃϩⲉ	ⲟⲃϩⲉ
ⲟⲃⲃⲣⲣⲉ	ⲟⲃⲣⲣⲉ
ⲟⲃⲉ	ⲟⲃⲉ
ⲟⲃⲧ	ⲟⲃⲧ
ⲟⲇⲟⲗⲗⲁ	ⲟⲇⲟⲗⲗⲁ
ⲟⲇⲟⲗⲗⲁ`	ⲟⲇⲟⲗⲗⲁ
ⲟⲉⲓϣ	ⲟⲉⲓϣ
ⲟⲉⲓⲉ⳿	ⲟⲉⲓⲉ
ⲟⲉⲓⲉ	ⲟⲉⲓⲉ
ⲟⲉⲓⲕ	ⲟⲉⲓⲕ
ⲟⲓ̇[ⲕ]ⲟ̣ⲛ̣ⲟ̣ⲙⲓⲁ	ⲟⲓⲕⲟⲛⲟⲙⲓⲁ
ⲟⲓ̈	ⲟⲓ
ⲟⲓⲕⲟⲛⲟⲙⲓⲁ	ⲟⲓⲕⲟⲛⲟⲙⲓⲁ
ⲟⲓⲕⲟⲛⲟⲙⲟⲥ⳿	ⲟⲓⲕⲟⲛⲟⲙⲟⲥ
ⲟⲓⲕⲟⲛⲟⲙⲟⲥ	ⲟⲓⲕⲟⲛⲟⲙⲟⲥ
ⲟⲓⲕⲟⲩⲙⲉⲛⲏ⳿	ⲟⲓⲕⲟⲩⲙⲉⲛⲏ
ⲟⲓⲕⲟⲩⲙⲉⲛⲏ	ⲟⲓⲕⲟⲩⲙⲉⲛⲏ
ⲟⲓⲕⲟⲩⲙⲉⲛⲏ`	ⲟⲓⲕⲟⲩⲙⲉⲛⲏ
ⲟⲓⲕ	ⲟⲉⲓⲕ
ⲟⲓ	ⲟⲓ
ⲟⲕⲙ	ⲟⲕⲙ
ⲟⲗⲟⲕⲁⲩⲧⲱⲙⲁ	ⲟⲗⲟⲕⲁⲩⲧⲱⲙⲁ
ⲟⲗ	ⲟⲗ
ⲟⲙⲉ	ⲟⲙⲉ
ⲟⲙⲕ	ⲟⲙⲕ
ⲟⲙⲥ	ⲟⲙⲥ
ⲟⲙ	ⲟⲙ
ⲟⲛ̄	ⲟⲛ
ⲟⲛϩ̄	ⲟⲛϩ
ⲟⲛϩ̇	ⲟⲛϩ
ⲟⲛϩ̣	ⲟⲛϩ
ⲟⲛϩ	ⲟⲛϩ
ⲟⲛⲕ	ⲟⲛⲕ
ⲟⲛⲧⲱⲥ	ⲟⲛⲧⲱⲥ
ⲟⲛ⳿	ⲟⲛ
ⲟⲛ︤ϩ︥	ⲟⲛϩ
ⲟⲛ	ⲟⲛ
ⲟⲛ`	ⲟⲛ
ⲟⲟϩ⳿	ⲟⲟϩ
ⲟⲟϩ	ⲟⲟϩ
ⲟⲟⲟⲩ⳿	ϩⲟⲟⲩ
ⲟⲟⲟⲩ	ϩⲟⲟⲩ
ⲟⲟⲧⲉ	ⲟⲟⲧⲉ
ⲟⲟⲧⲉ`	ⲟⲟⲧⲉ
ⲟⲟⲩ	ϩⲟⲟⲩ
ⲟⲟⲩ`	ϩⲟⲟⲩ
ⲟⲡⲥ	ⲟⲡⲥ
ⲟⲡⲧⲉⲩⲉ	ⲟⲡⲧⲉⲩⲉ
ⲟⲡ	ⲟⲡ
ⲟⲣϫ	ⲟⲣϫ
ⲟⲣⲃ	ⲟⲣⲃ
ⲟⲣⲅⲏ̂`	ⲟⲣⲅⲏ
ⲟⲣⲅⲏ⳿	ⲟⲣⲅⲏ
ⲟⲣⲅⲏ	ⲟⲣⲅⲏ
ⲟⲣⲅⲏ`	ⲟⲣⲅⲏ
ⲟⲣⲇⲓⲛⲟⲛ	ⲟⲣⲇⲓⲛⲟⲛ
ⲟⲣⲛⲏ	ⲟⲣⲛⲏ
ⲟⲣⲪⲁⲛⲟⲥ	ⲟⲣⲫⲁⲛⲟⲥ
ⲟⲣⲫⲁⲛⲟⲥ⳿	ⲟⲣⲫⲁⲛⲟⲥ
ⲟⲣⲫⲁⲛⲟⲥ	ⲟⲣⲫⲁⲛⲟⲥ
ⲟⲣⲭⲉ	ⲟⲣⲭⲉ
ⲟⲣ︤ϫ︥	ⲟⲣϫ
ⲟⲥⲉ	ⲟⲥⲉ
ⲟⲥ	ϫⲟⲉⲓⲥ
ⲟⲧ̇ⲉ	ϩⲟⲧⲉ
ⲟⲧϩ	ⲟⲧϩ
ⲟⲧⲉ	ϩⲟⲧⲉ
ⲟⲧⲉ`	ϩⲟⲧⲉ
ⲟⲧⲡ̄	ⲟⲧⲡ
ⲟⲧⲡ	ⲟⲧⲡ
ⲟⲨ	ⲟⲩ
ⲟⲩ·	ⲟⲩ
ⲟⲩ̂	ⲟⲩ
ⲟⲩ̇ⲱ̇ϩ	ⲟⲩⲱⲙ
ⲟⲩ̇	ⲟⲩ
ⲟⲩ̣	ⲟⲩ
ⲟⲩϣⲏ	ⲟⲩϣⲏ
ⲟⲩϩⲟⲟⲣ	ⲟⲩϩⲟⲟⲣ
ⲟⲩϫⲁⲉⲓ	ⲟⲩϫⲁⲉⲓ
ⲟⲩϫⲁⲓ̇	ⲟⲩϫⲁⲓ
ⲟⲩϫⲁⲓ̈	ⲟⲩϫⲁⲓ
ⲟⲩϫⲁⲓ	ⲟⲩϫⲁⲓ
ⲟⲩϭⲥ	ⲟⲩϭⲥ
ⲟⲩϭ︤ⲥ︥	ⲟⲩϭⲥ
ⲟⲩϯ	ⲟⲩϯ
ⲟⲩ᷍ⲙ̄	ⲟⲩⲙ
ⲟⲩ᷍ⲙ	ⲟⲩⲙ
ⲟⲩ᷍	ⲟⲩ
ⲟⲩⲁ̂ϣ	ⲟⲩⲁϣ
ⲟⲩⲁ̂	ⲟⲩⲁ
ⲟⲩⲁ̄ϣ	ⲟⲩⲁϣ
ⲟⲩⲁ̄	ⲟⲩⲁ
ⲟⲩⲁ̇ⲁⲃ	ⲟⲩⲁⲁⲃ
ⲟⲩⲁ̇	ⲟⲩⲁ
ⲟⲩⲁϣ︤	ⲟⲩⲁϣ
ⲟⲩⲁϣ	ⲟⲩⲁϣ
ⲟⲩⲁϩⲙⲉ	ⲟⲩⲁϩⲙⲉ
ⲟⲩⲁϩⲙ	ⲟⲩⲁϩⲙ
ⲟⲩⲁϩ︤	ⲟⲩⲁϩ
ⲟⲩⲁϩ	ⲟⲩⲁϩ
ⲟⲩⲁⲁⲃ⳿	ⲟⲩⲁⲁⲃ
ⲟⲩⲁⲁⲃ	ⲟⲩⲁⲁⲃ
ⲟⲩⲁⲁⲃ`	ⲟⲩⲁⲁⲃ
ⲟⲩⲁⲁ	ⲟⲩⲁⲁ
ⲟⲩⲁⲧϥⲉ	ⲟⲩⲁⲧϥⲉ
ⲟⲩⲁⲧ	ⲟⲩⲁⲧ
ⲟⲩⲁ⳿	ⲟⲩⲁ
ⲟⲩⲁ	ⲟⲩⲁ
ⲟⲩⲁ`	ⲟⲩⲁ
ⲟⲩⲃⲁϣ	ⲟⲩⲃⲁϣ
ⲟⲩⲃⲉ̇	ⲟⲩⲃⲉ
ⲟⲩⲃⲉ	ⲟⲩⲃⲉ
ⲟⲩⲃⲏ	ⲟⲩⲃⲏ
ⲟⲩⲇ̣ⲉ	ⲟⲩⲇⲉ
ⲟⲩⲇⲉ	ⲟⲩⲇⲉ
ⲟⲩⲇ︤ⲉ	ⲟⲩⲇⲉ
ⲟⲩⲇ.......	ⲟⲩⲇ[.......]
ⲟⲩⲇ[.......]	ⲟⲩⲇ[.......]
ⲟⲩⲉ̇ϣ	ⲟⲩⲉϣ
ⲟⲩⲉϣϫⲱⲕⲙ	ⲟⲩⲉϣϫⲱⲕⲙ
ⲟⲩⲉϣϫⲱⲕ︤ⲙ︥	ⲟⲩⲉϣϫⲱⲕⲙ
ⲟⲩⲉϣⲛ	ⲟⲩⲉϣⲛ
ⲟⲩⲉϣ	ⲟⲩⲉϣ
ⲟⲩⲉϩⲥⲁϩⲛⲉ	ⲟⲩⲉϩⲥⲁϩⲛⲉ
ⲟⲩⲉϩⲥⲟⲓ	ⲟⲩⲉϩⲥⲟⲓ
ⲟⲩⲉϩ	ⲟⲩⲉϩ
ⲟⲩⲉϭⲡ	ⲟⲩⲉϭⲡ
ⲟⲩⲉϭⲣⲟ̂	ⲟⲩⲉϭⲣⲟ
ⲟⲩⲉϭⲣⲟ	ⲟⲩⲉϭⲣⲟ
ⲟⲩⲉⲓ̂	ⲟⲩⲉⲓ
ⲟⲩⲉⲓ̇ⲛⲉ̣	ⲟⲩⲉⲓⲛⲉ
ⲟⲩⲉⲓ̈ⲏ	ⲟⲩⲉⲓⲏ
ⲟⲩⲉⲓⲉⲕ	ⲟⲩⲉⲓⲉⲕ
ⲟⲩⲉⲓⲉⲛⲓⲛ	ⲟⲩⲉⲉⲓⲉⲛⲓⲛ
ⲟⲩⲉⲓⲉ	ⲟⲩⲉⲓⲉ
ⲟⲩⲉⲓⲏ	ⲟⲩⲉⲓⲏ
ⲟⲩⲉⲓⲛⲉ	ⲟⲩⲉⲓⲛⲉ
ⲟⲩⲉⲓ	ⲟⲩⲉⲓ
ⲟⲩⲉⲙⲁϥ	ⲟⲩⲉⲙⲁϥ
ⲟⲩⲉⲙ	ⲟⲩⲉⲙ
ⲟⲩⲉⲛ	ⲟⲩⲉⲛ
ⲟⲩⲉⲣⲏⲧⲉ	ⲟⲩⲉⲣⲏⲧⲉ
ⲟⲩⲉⲧⲟⲩⲱⲧ	ⲟⲩⲉⲧⲟⲩⲱⲧ
ⲟⲩⲉⲧ	ⲟⲩⲉⲧ
ⲟⲩⲉ⳿	ⲟⲩⲉ
ⲟⲩⲉ	ⲟⲩⲉ
ⲟⲩⲉ`	ⲟⲩⲉ
ⲟⲩⲏ̇ϩ	ⲟⲩⲏϩ
ⲟⲩⲏ̇ⲣ	ⲟⲩⲏⲣ
ⲟⲩⲏϩ⳿	ⲟⲩⲏϩ
ⲟⲩⲏϩ	ⲟⲩⲏϩ
ⲟⲩⲏϩ`	ⲟⲩⲏϩ
ⲟⲩⲏⲏⲃ⳿	ⲟⲩⲏⲏⲃ
ⲟⲩⲏⲏⲃ	ⲟⲩⲏⲏⲃ
ⲟⲩⲏⲏⲃ`	ⲟⲩⲏⲏⲃ
ⲟⲩⲏⲏⲩ	ⲟⲩⲏⲩ
ⲟⲩⲏⲣ	ⲟⲩⲏⲣ
ⲟⲩⲏⲣ`	ⲟⲩⲏⲣ
ⲟⲩⲏⲩ	ⲟⲩⲏⲩ
ⲟⲩⲏⲩ`	ⲟⲩⲏⲩ
ⲟⲩⲕ	ⲟⲩⲕ
ⲟⲩⲛ̄ⲧⲁ	ⲟⲩⲛⲧⲁ
ⲟⲩⲛ̄ⲧⲉ	ⲟⲩⲛⲧⲉ
ⲟⲩⲛ̄ⲧⲏ	ⲟⲩⲛⲧⲏ
ⲟⲩⲛ̄ⲧ︤	ⲟⲩⲛⲧ
ⲟⲩⲛ̄ⲧ	ⲟⲩⲛⲧ
ⲟⲩⲛ̄	ⲟⲩⲛ
ⲟⲩⲛ̇ⲧⲁ	ⲟⲩⲛⲧⲁ
ⲟⲩⲛ̇	ⲟⲩⲛ
ⲟⲩⲛϩ	ⲟⲩⲏϩ
ⲟⲩⲛⲁⲙ	ⲟⲩⲛⲁⲙ
ⲟⲩⲛⲟϥ	ⲟⲩⲛⲟϥ
ⲟⲩⲛⲟⲩ	ⲟⲩⲛⲟⲩ
ⲟⲩⲛⲣⲟ	ⲟⲩⲛⲣⲟ
ⲟⲩⲛⲧⲁ	ⲟⲩⲛⲧⲁ
ⲟⲩⲛⲧⲉ	ⲟⲩⲛⲧⲉ
ⲟⲩⲛⲧⲏ	ⲟⲩⲛⲧⲏ
ⲟⲩⲛⲧ︤	ⲟⲩⲛⲧ
ⲟⲩⲛⲧ	ⲟⲩⲛⲧ
ⲟⲩⲛ⳿	ⲟⲩⲛ
ⲟⲩⲛ	ⲟⲩⲛ
ⲟⲩⲟ̂ⲉⲓϣ	ⲟⲩⲟⲉⲓϣ
ⲟⲩⲟ̂ⲛ	ⲟⲩⲟⲛ
ⲟⲩⲟ̄ⲃϣ̄	ⲟⲩⲟⲃϣ
ⲟⲩⲟ̄ⲉⲓⲛ	ⲟⲩⲟⲉⲓⲛ
ⲟⲩⲟ̄ⲉⲓ⳯	ⲟⲩⲟⲉⲓⲛ
ⲟⲩⲟ̇ⲉⲓ̇ϣ	ⲟⲩⲟⲉⲓϣ
ⲟⲩⲟ̇ⲙ	ⲟⲩⲟⲙ
ⲟⲩⲟ̇ⲛ	ⲟⲩⲟⲛ
ⲟⲩⲟ̣ⲉ̣ⲓ̇ϣ	ⲟⲩⲟⲉⲓϣ
ⲟⲩⲟ̣ⲛ	ⲟⲩⲟⲛ
ⲟⲩⲟϣⲙ	ⲟⲩⲟϣⲙ
ⲟⲩⲟϣ︤ⲙ︥	ⲟⲩⲟϣⲙ
ⲟⲩⲟϫ	ⲟⲩⲟϫ
ⲟⲩⲟϭⲉ	ⲟⲩⲟϭⲉ
ⲟⲩⲟϭⲡ	ⲟⲩⲟϭⲡ
ⲟⲩⲟϭ︤ⲡ︥	ⲟⲩⲟϭⲡ
ⲟⲩⲟⲃϣ	ⲟⲩⲟⲃϣ
ⲟⲩⲟⲉ̇ⲓ̇ϣ	ⲟⲩⲟⲉⲓϣ
ⲟⲩⲟⲉ̣ⲓ̣ϣ	ⲟⲩⲟⲉⲓϣ
ⲟⲩⲟⲉⲓ̇ϣ	ⲟⲩⲟⲉⲓϣ
ⲟⲩⲟⲉⲓ̈ϣ	ⲟⲩⲟⲉⲓϣ
ⲟⲩⲟⲉⲓ̣ϣ	ⲟⲩⲟⲉⲓϣ
ⲟⲩⲟⲉⲓϣ̣	ⲟⲩⲟⲉⲓϣ
ⲟⲩⲟⲉⲓϣ	ⲟⲩⲟⲉⲓϣ
ⲟⲩⲟⲉⲓϣ`	ⲟⲩⲟⲉⲓϣ
ⲟⲩⲟⲉⲓⲉ	ⲟⲩⲟⲉⲓⲉ
ⲟⲩⲟⲉⲓⲛ	ⲟⲩⲟⲉⲓⲛ
ⲟⲩⲟⲉⲓⲛ`	ⲟⲩⲟⲉⲓⲛ
ⲟⲩⲟⲉⲓⲧ	ⲟⲩⲟⲉⲓⲧ
ⲟⲩⲟⲉⲓ⳯	ⲟⲩⲟⲉⲓⲛ
ⲟⲩⲟⲉⲓ⳿	ⲟⲩⲟⲓ
ⲟⲩⲟⲉⲓ	ⲟⲩⲟⲉⲓ
ⲟⲩⲟⲓ̈ϣ	ⲟⲩⲟⲓⲉϣ
ⲟⲩⲟⲓ̈	ⲟⲩⲟⲓ
ⲟⲩⲟⲓϣ	ⲟⲩⲟⲉⲓϣ
ⲟⲩⲟⲓⲉϣ	ⲟⲩⲟⲓⲉϣ
ⲟⲩⲟⲓⲕ	ⲟⲩⲟⲉⲓⲕ
ⲟⲩⲟⲓⲛ	ⲟⲩⲟⲉⲓⲛ
ⲟⲩⲟⲓ	ⲟⲩⲟⲉⲓ
ⲟⲩⲟⲗⲥ	ⲟⲩⲟⲗⲥ
ⲟⲩⲟⲗ︤ⲥ︥	ⲟⲩⲟⲗⲥ
ⲟⲩⲟⲙ︤	ⲟⲩⲟⲙ
ⲟⲩⲟⲙ	ⲟⲩⲟⲙ
ⲟⲩⲟⲛϩ	ⲟⲩⲟⲛϩ
ⲟⲩⲟⲛⲧ	ⲟⲩⲟⲛⲧ
ⲟⲩⲟⲛ⳿	ⲟⲩⲟⲛ
ⲟⲩⲟⲛ︤ϩ︥	ⲟⲩⲟⲛϩ
ⲟⲩⲟⲛ︤ⲧ︥	ⲟⲩⲟⲛⲧ
ⲟⲩⲟⲛ	ⲟⲩⲟⲛ
ⲟⲩⲟⲛ`	ⲟⲩⲟⲛ
ⲟⲩⲟⲟϭⲉ	ⲟⲩⲟⲟϭⲉ
ⲟⲩⲟⲟⲗⲉ	ⲟⲩⲟⲟⲗⲉ
ⲟⲩⲟⲟⲙ	ⲟⲩⲟⲟⲙ
ⲟⲩⲟⲟⲧⲉ	ⲟⲩⲟⲟⲧⲉ
ⲟⲩⲟⲡ	ⲟⲩⲟⲡ
ⲟⲩⲟⲥϥ	ⲟⲩⲟⲥϥ
ⲟⲩⲟⲧⲟⲩⲉⲧ⳿	ⲟⲩⲟⲧⲟⲩⲉⲧ
ⲟⲩⲟⲧⲟⲩⲉⲧ	ⲟⲩⲟⲧⲟⲩⲉⲧ
ⲟⲩⲟⲩⲟ̇ⲉⲓ̇ϣ	ⲟⲩⲟⲉⲓϣ
ⲟⲩⲟⲩⲟⲉⲓϣ	ⲟⲩⲟⲉⲓϣ
ⲟⲩⲣⲟⲧ	ⲟⲩⲣⲟⲧ
ⲟⲩⲥⲓⲁ	ⲟⲩⲥⲓⲁ
ⲟⲩⲧⲁϩ	ⲟⲩⲧⲁϩ
ⲟⲩⲧⲃⲁ	ⲟⲩⲧⲃⲁ
ⲟⲩⲧⲃⲁ`	ⲟⲩⲧⲃⲁ
ⲟⲩⲧⲉ	ⲟⲩⲧⲉ
ⲟⲩⲰϣ	ⲟⲩⲱϣ
ⲟⲩⲰϣ`	ⲟⲩⲱϣ
ⲟⲩⲱ̂ϣ︤ⲧ︥	ⲟⲩⲱϣⲧ
ⲟⲩⲱ̂ϭ︤ⲡ︥	ⲟⲩⲱϭⲡ
ⲟⲩⲱ̂ⲧ︤ⲛ︥	ⲟⲩⲱⲧⲛ
ⲟⲩⲱ̄ϣⲧ̄	ⲟⲩⲱϣⲧ
ⲟⲩⲱ̄ⲛϩ̄	ⲟⲩⲱⲛϩ
ⲟⲩⲱ̄	ⲟⲩⲱ
ⲟⲩⲱ̇ϣⲃ̇	ⲟⲩⲱϣⲃ
ⲟⲩⲱ̇ϣⲃ	ⲟⲩⲱϣⲃ
ⲟⲩⲱ̇ϣ	ⲟⲩⲱϣ
ⲟⲩⲱ̇ⲙ	ⲟⲩⲱⲙ
ⲟⲩⲱ̇ⲛϩ	ⲟⲩⲱ̇ⲛϩ
ⲟⲩⲱ̇ⲛⲁϩ	ⲟⲩⲱⲛϩ
ⲟⲩⲱ̇ⲛ	ⲟⲩⲱⲛ
ⲟⲩⲱ̇ⲧ̇	ⲟⲩⲱⲧ
ⲟⲩⲱ̇ⲧ	ⲟⲩⲱⲧ
ⲟⲩⲱϣ̇ⲃ	ⲟⲩⲱϣⲃ
ⲟⲩⲱϣⲃ̄	ⲟⲩⲱϣⲃ
ⲟⲩⲱϣⲃ̇	ⲟⲩⲱϣⲃ
ⲟⲩⲱϣⲃ	ⲟⲩⲱϣⲃ
ⲟⲩⲱϣⲙ	ⲟⲩⲱϣⲙ
ⲟⲩⲱϣⲥ	ⲟⲩⲱϣⲥ
ⲟⲩⲱϣⲧ̄	ⲟⲩⲱϣⲧ
ⲟⲩⲱϣⲧ	ⲟⲩⲱϣⲧ
ⲟⲩⲱϣ⳿	ⲟⲩⲱϣ
ⲟⲩⲱϣ︤ⲃ︥	ⲟⲩⲱϣⲃ
ⲟⲩⲱϣ	ⲟⲩⲱϣ
ⲟⲩⲱϣ`	ⲟⲩⲱϣ
ⲟⲩⲱϩⲉ	ⲟⲩⲱϩⲉ
ⲟⲩⲱϩⲙ	ⲟⲩⲱϩⲙ
ⲟⲩⲱϩ⳿	ⲟⲩⲱϩ
ⲟⲩⲱϩ︤ⲙ̣︥	ⲟⲩⲱϩⲙ
ⲟⲩⲱϩ	ⲟⲩⲱϩ
ⲟⲩⲱϭⲡ	ⲟⲩⲱϭⲡ
ⲟⲩⲱϭⲥ	ⲟⲩⲱϭⲥ
ⲟⲩⲱⲃϣ	ⲟⲩⲟⲃϣ
ⲟⲩⲱⲙ⳿	ⲟⲩⲱⲙ
ⲟⲩⲱⲙ	ⲟⲩⲱⲙ
ⲟⲩⲱⲛϣ̄	ⲟⲩⲱⲛϣ
ⲟⲩⲱⲛϣ	ⲟⲩⲱⲛϣ
ⲟⲩⲱⲛϩ̄	ⲟⲩⲱⲛϩ
ⲟⲩⲱⲛϩ	ⲟⲩⲱⲛϩ
ⲟⲩⲱⲛⲁϩ	ⲟⲩⲱⲛⲁϩ
ⲟⲩⲱⲛ︤ϣ︥	ⲟⲩⲱⲛϣ
ⲟⲩⲱⲛ︤ϩ︥	ⲟⲩⲱⲛϩ
ⲟⲩⲱⲛ	ⲟⲩⲱⲛ
ⲟⲩⲱⲥϥ̇	ⲟⲩⲱⲥϥ
ⲟⲩⲱⲥϥ	ⲟⲩⲱⲥϥ
ⲟⲩⲱⲧⲃ̇	ⲟⲩⲱⲧⲃ
ⲟⲩⲱⲧⲃ	ⲟⲩⲱⲧⲃ
ⲟⲩⲱⲧⲛ	ⲟⲩⲱⲧⲛ
ⲟⲩⲱⲧ⳿	ⲟⲩⲱⲧ
ⲟⲩⲱⲧ︤ⲃ︥	ⲟⲩⲱⲧⲃ
ⲟⲩⲱⲧ	ⲟⲩⲱⲧ
ⲟⲩⲱⲧ`	ⲟⲩⲱⲧ
ⲟⲩⲱ	ⲟⲩⲱ
ⲟⲩ⳿	ⲟⲩ
ⲟⲩ︥ⲱϣⲥ	ⲟⲩⲱϣⲥ
ⲟⲩ	ⲟⲩ
ⲟⲩ 	ⲟⲩ
ⲟⲩ[ⲁⲁⲃ]	ⲟⲩⲁⲁⲃ
ⲟⲩ]	ⲟⲩ
ⲟⲩ`	ⲟⲩ
ⲟⲯⲱⲛⲓⲟⲛ	ⲟⲯⲱⲛⲓⲟⲛ
ⲟ⳿	ⲟ
ⲟ	ⲟ
ⲟ ̂ⲩ	ⲟⲩ
ⲟ ⲩ	ⲟⲩ
ⲟ]ⲩ̣ⲁⲁⲃ	ⲟⲩⲁⲁⲃ
ⲟ]ⲩ	ⲟⲩ
ⲟ`	ⲟ
Ⲡ̇ⲉϫⲁ	ⲡⲉϫⲁ
Ⲡⲁⲓ̇	ⲡⲁⲓ
Ⲡⲁⲓ̈	ⲡⲁⲓ
Ⲡⲁⲓ	ⲡⲁⲓ
Ⲡⲁⲗⲓⲛ	ⲡⲁⲗⲓⲛ
Ⲡⲁ	ⲡⲁ
ⲠⲈϤ	ⲡⲉϥ
ⲠⲈ	ⲡⲉ
Ⲡⲉϫⲁ	ⲡⲉϫⲁ
Ⲡⲉϫⲉ	ⲡⲉϫⲉ
Ⲡⲗⲏⲛ⳿	ⲡⲗⲏⲛ
Ⲡⲗⲏⲛ	ⲡⲗⲏⲛ
Ⲡ	ⲡ
ⲡ̄ⲉϫⲁ	ⲡⲉϫⲁ
ⲡ̄	ⲡ
ⲡ̣̇	ⲡ
ⲡ̇ⲉⲓ̇	ⲡⲉⲓ
ⲡ̇ⲉⲕ	ⲡⲉⲕ
ⲡ̇ⲗⲏⲛ	ⲡⲗⲏⲛ
ⲡ̇ⲟⲗⲓ̇ⲥ̣	ⲡⲟⲗⲓⲥ
ⲡ̇	ⲡ
ⲡ̣ⲁ̣ⲣⲁⲇⲓⲇⲟⲩ	ⲡⲁⲣⲁⲇⲓⲇⲟⲩ
ⲡ̣ⲁⲓ̈	ⲡⲁⲓ
ⲡ̣ⲁⲣⲁⲃⲁ	ⲡⲁⲣⲁⲃⲁ
ⲡ̣ⲉ̣	ⲡⲉ
ⲡ̣ⲉⲛ	ⲡⲉⲛ
ⲡ̣ⲉⲩ	ⲡⲉⲩ
ⲡ̣ⲉ	ⲡⲉ
ⲡ̣ⲏⲧ	ⲡⲏⲧ
ⲡ̣ⲟⲟⲩ	ⲡⲟⲟⲩ
ⲡ̣︤ⲣ︤︥ϣ̣︥	ⲡⲣϣ
ⲡ̣	ⲡ
ⲡ̣[…]ⲡⲟⲥ	ⲡ̣[…]ⲡⲟⲥ
ⲡϥ	ⲡⲉϥ
ⲡ…ⲡⲟⲥ	ⲡ̣[…]ⲡⲟⲥ
ⲡⲁ̇ⲡⲛⲟⲩⲧⲉ	ⲡⲁⲡⲛⲟⲩⲧⲉ
ⲡⲁ̇ⲥⲧⲁⲙⲱⲛ	ⲡⲁⲥⲧⲁⲙⲱⲛ
ⲡⲁ̣[…]ϥⲟϭⲉ`	ⲡⲁ[…]ϥⲟϭⲉ
ⲡⲁϣⲉ	ⲡⲁϣⲉ
ⲡⲁϣ	ⲡⲁϣ
ⲡⲁϩⲟⲩ	ⲡⲁϩⲟⲩ
ⲡⲁϩⲟ	ⲡⲁϩⲟ
ⲡⲁϩⲟ]ⲩ	ⲡⲁϩⲟⲩ
ⲡⲁϩⲣⲉ	ⲡⲁϩⲣⲉ
ⲡⲁϩⲧ̇	ⲡⲁϩⲧ
ⲡⲁϩⲧ︤	ⲡⲁϩⲧ
ⲡⲁϩⲧ	ⲡⲁϩⲧ
ⲡⲁϩⲱⲙⲱ	ⲡⲁϩⲱⲙⲱ
ⲡⲁϩ	ⲡⲁϩ
ⲡⲁϭⲥⲉ	ⲡⲁϭⲥⲉ
ⲡⲁ…ϥⲟϭⲉ	ⲡⲁ[…]ϥⲟϭⲉ
ⲡⲁⲅⲁⲛⲱⲥ	ⲡⲁⲅⲁⲛⲱⲥ
ⲡⲁⲏⲥⲉ	ⲡⲁⲏⲥⲉ
ⲡⲁⲑⲟⲥ	ⲡⲁⲑⲟⲥ
ⲡⲁⲓ̇	ⲡⲁⲓ
ⲡⲁⲓ̈	ⲡⲁⲓ
ⲡⲁⲓⲇⲁⲅⲱⲅⲟⲥ	ⲡⲁⲓⲇⲁⲅⲱⲅⲟⲥ
ⲡⲁⲓⲇⲉⲥ	ⲡⲁⲓⲇⲉⲥ
ⲡⲁⲓⲇⲉⲩⲉ	ⲡⲁⲓⲇⲉⲩⲉ
ⲡⲁⲓ	ⲡⲁⲓ
ⲡⲁⲗⲓⲛ	ⲡⲁⲗⲓⲛ
ⲡⲁⲗⲗⲁϯⲟⲛ	ⲡⲁⲗⲗⲁϯⲟⲛ
ⲡⲁⲙⲃⲱ̇	ⲡⲁⲙⲃⲱ
ⲡⲁⲙⲃⲱ	ⲡⲁⲙⲃⲱ
ⲡⲁⲛⲟⲩⲣⲅⲓⲁ	ⲡⲁⲛⲟⲩⲣⲅⲓⲁ
ⲡⲁⲛⲧⲟⲕⲣⲁⲧⲱⲣ⳿	ⲡⲁⲛⲧⲟⲕⲣⲁⲧⲱⲣ
ⲡⲁⲛⲧⲟⲕⲣⲁⲧⲱⲣ	ⲡⲁⲛⲧⲟⲕⲣⲁⲧⲱⲣ
ⲡⲁⲛⲧⲱⲕⲣⲁⲧⲱⲣ	ⲡⲁⲛⲧⲱⲕⲣⲁⲧⲱⲣ
ⲡⲁⲛⲧⲱⲥ	ⲡⲁⲛⲧⲱⲥ
ⲡⲁⲡⲁⲗⲓⲛ	ⲡⲁⲗⲓⲛ
ⲡⲁⲡⲁⲥ	ⲡⲁⲡⲁⲥ
ⲡⲁⲡⲛⲟⲩⲧⲉ	ⲡⲁⲡⲛⲟⲩⲧⲉ
ⲡⲁⲣϩⲓⲥⲧⲁ	ⲡⲁⲣϩⲓⲥⲧⲁ
ⲡⲁⲣϩⲟⲩⲥⲓⲁ	ⲡⲁⲣϩⲟⲩⲥⲓⲁ
ⲡⲁⲣⲁⲃⲁ⳿	ⲡⲁⲣⲁⲃⲁ
ⲡⲁⲣⲁⲃⲁ	ⲡⲁⲣⲁⲃⲁ
ⲡⲁⲣⲁⲃⲟⲗⲏ	ⲡⲁⲣⲁⲃⲟⲗⲏ
ⲡⲁⲣⲁⲅⲅⲉⲓⲗⲉ	ⲡⲁⲣⲁⲅⲅⲉⲓⲗⲉ
ⲡⲁⲣⲁⲅⲉ	ⲡⲁⲣⲁⲅⲉ
ⲡⲁⲣⲁⲇⲉⲓⲥⲟⲥ	ⲡⲁⲣⲁⲇⲉⲓⲥⲟⲥ
ⲡⲁⲣⲁⲇⲓⲅⲙⲁⲧⲓⲍⲉ⳿	ⲡⲁⲣⲁⲇⲓⲅⲙⲁⲧⲓⲍⲉ
ⲡⲁⲣⲁⲇⲓⲅⲙⲁⲧⲓⲍⲉ	ⲡⲁⲣⲁⲇⲓⲅⲙⲁⲧⲓⲍⲉ
ⲡⲁⲣⲁⲇⲓⲇⲟⲩ	ⲡⲁⲣⲁⲇⲓⲇⲟⲩ
ⲡⲁⲣⲁⲇⲓⲥⲟⲥ	ⲡⲁⲣⲁⲇⲓⲥⲟⲥ
ⲡⲁⲣⲁⲇⲓⲥⲟⲥ`	ⲡⲁⲣⲁⲇⲓⲥⲟⲥ
ⲡⲁⲣⲁⲇⲟⲥⲓⲥ	ⲡⲁⲣⲁⲇⲟⲥⲓⲥ
ⲡⲁⲣⲁⲓⲧⲉⲓ⳿	ⲡⲁⲣⲁⲓⲧⲉⲓ
ⲡⲁⲣⲁⲓⲧⲉⲓ	ⲡⲁⲣⲁⲓⲧⲉⲓ
ⲡⲁⲣⲁⲕⲁⲗⲉⲓ̇	ⲡⲁⲣⲁⲕⲁⲗⲉⲓ
ⲡⲁⲣⲁⲕⲁⲗⲉⲓ̈	ⲡⲁⲣⲁⲕⲁⲗⲉⲓ
ⲡⲁⲣⲁⲕⲁⲗⲉⲓ	ⲡⲁⲣⲁⲕⲁⲗⲉⲓ
ⲡⲁⲣⲁⲕⲁⲗⲉⲓ`	ⲡⲁⲣⲁⲕⲁⲗⲉⲓ
ⲡⲁⲣⲁⲣⲟ	ⲡⲁⲣⲁⲣⲟ
ⲡⲁⲣⲁⲥⲕⲉⲩⲏ	ⲡⲁⲣⲁⲥⲕⲉⲩⲏ
ⲡⲁⲣⲁⲧⲏⲣⲉⲓ̂	ⲡⲁⲣⲁⲧⲏⲣⲉⲓ
ⲡⲁⲣⲁⲧⲏⲣⲉⲓ̈	ⲡⲁⲣⲁⲧⲏⲣⲉⲓ
ⲡⲁⲣⲁⲧⲏⲣⲉⲓ	ⲡⲁⲣⲁⲧⲏⲣⲉⲓ
ⲡⲁⲣⲁⲧⲏⲣⲓ	ⲡⲁⲣⲁⲧⲏⲣⲉⲓ
ⲡⲁⲣⲁ	ⲡⲁⲣⲁ
ⲡⲁⲣⲃⲁⲥⲓⲥ	ⲡⲁⲣⲃⲁⲥⲓⲥ
ⲡⲁⲣⲃⲁⲥⲓⲥ`	ⲡⲁⲣⲃⲁⲥⲓⲥ
ⲡⲁⲣⲑⲉⲛⲟⲥ	ⲡⲁⲣⲑⲉⲛⲟⲥ
ⲡⲁⲣⲓⲅⲟⲣⲓ	ⲡⲁⲣⲓⲅⲟⲣⲓ
ⲡⲁⲣⲙⲟⲩⲧⲉ	ⲡⲁⲣⲙⲟⲩⲧⲉ
ⲡⲁⲣⲟⲩⲥⲓ̇ⲁ̇	ⲡⲁⲣⲟⲩⲥⲓⲁ
ⲡⲁⲣⲟⲩⲥⲓⲁ	ⲡⲁⲣⲟⲩⲥⲓⲁ
ⲡⲁⲣⲣⲏ̣ⲥⲓⲁ`	ⲡⲁⲣⲣⲏⲥⲓⲁ
ⲡⲁⲣⲣⲏⲥⲓ̈ⲁ	ⲡⲁⲣⲣⲏⲥⲓⲁ
ⲡⲁⲣⲣⲏⲥⲓⲁ	ⲡⲁⲣⲣⲏⲥⲓⲁ
ⲡⲁⲣⲣⲏⲥⲓⲁ`	ⲡⲁⲣⲣⲏⲥⲓⲁ
ⲡⲁⲥⲧⲁⲙⲱⲛ	ⲡⲁⲥⲧⲁⲙⲱⲛ
ⲡⲁⲥⲧ	ⲡⲁⲥⲧ
ⲡⲁⲥⲭⲁ⳿	ⲡⲁⲥⲭⲁ
ⲡⲁⲥⲭⲁ	ⲡⲁⲥⲭⲁ
ⲡⲁⲧⲁⲥⲥⲉ	ⲡⲁⲧⲁⲥⲥⲉⲓ
ⲡⲁⲧⲣⲓⲁⲣⲭⲏⲥ	ⲡⲁⲧⲣⲓⲁⲣⲭⲏⲥ
ⲡⲁⲧ	ⲡⲁⲧ
ⲡⲁⲩⲗⲟⲥ	ⲡⲁⲩⲗⲟⲥ
ⲡⲁⲩⲗⲟⲥ`	ⲡⲁⲩⲗⲟⲥ
ⲡⲁ	ⲡⲁ
ⲡⲉ̇	ⲡⲉⲧ
ⲡⲉ̣[ϫ]ⲁ	ⲡⲉϫⲁ
ⲡⲉϣⲛ	ⲡⲉϣⲛ
ⲡⲉϣ	ⲡⲉϣ
ⲡⲉϥϥ	ⲡⲉϥ
ⲡⲉϥ	ⲡⲉϥ
ⲡⲉϩ	ⲡⲉϩ
ⲡⲉϪⲁ	ⲡⲉϫⲁ
ⲡⲉϫⲁ	ⲡⲉϫⲁ
ⲡⲉϫⲉ̇̇	ⲡⲉϫⲉ
ⲡⲉϫⲉ	ⲡⲉϫⲉ
ⲡⲉⲉⲓ	ⲡⲉⲓ
ⲡⲉⲑⲟⲟⲩ	ⲡⲉⲑⲟⲟⲩ
ⲡⲉⲓ̇	ⲡⲉⲓ
ⲡⲉⲓ̈ⲑⲉ	ⲡⲉⲓⲑⲉ
ⲡⲉⲓ̈	ⲡⲉⲓ
ⲡⲉⲓⲑⲉ⳿	ⲡⲉⲓⲑⲉ
ⲡⲉⲓⲑⲉ	ⲡⲉⲓⲑⲉ
ⲡⲉⲓⲣⲁⲍⲉ	ⲡⲉⲓⲣⲁⲍⲉ
ⲡⲉⲓⲣⲁⲥⲙⲟⲥ	ⲡⲉⲓⲣⲁⲥⲙⲟⲥ
ⲡⲉⲓ	ⲡⲉⲓ
ⲡⲉⲕ	ⲡⲉⲕ
ⲡⲉⲗϭⲉ	ⲡⲉⲗϭⲉ
ⲡⲉⲗⲁⲅⲟⲥ	ⲡⲉⲗⲁⲅⲟⲥ
ⲡⲉⲗⲁⲕ	ⲡⲉⲗⲁⲕ
ⲡⲉⲗⲓⲥ	ⲡⲉⲗⲓⲥ
ⲡⲉⲛⲉ	ⲡⲉⲛⲉ
ⲡⲉⲛⲧⲏⲕⲟⲥⲧⲏ	ⲡⲉⲛⲧⲏⲕⲟⲥⲧⲏ
ⲡⲉⲛ	ⲡⲉⲛ
ⲡⲉⲣⲓⲍⲱⲙⲁ	ⲡⲉⲣⲓⲍⲱⲙⲁ
ⲡⲉⲣⲓⲕⲁⲑⲁⲣⲙⲁ	ⲡⲉⲣⲓⲕⲁⲑⲁⲣⲙⲁ
ⲡⲉⲥⲏⲧ	ⲡⲉⲥⲏⲧ
ⲡⲉⲥ	ⲡⲉⲥ
ⲡⲉⲧⲛ̇	ⲡⲉⲧⲛ
ⲡⲉⲧⲛⲁⲛⲟⲩϥ	ⲡⲉⲧⲛⲁⲛⲟⲩϥ
ⲡⲉⲧⲛⲁⲛ[ⲟⲩϥ]	ⲡⲉⲧⲛⲁⲛⲟⲩϥ
ⲡⲉⲧⲛ	ⲡⲉⲧⲛ
ⲡⲉⲧⲣⲁ	ⲡⲉⲧⲣⲁ
ⲡⲉⲧⲣⲟⲥ	ⲡⲉⲧⲣⲟⲥ
ⲡⲉⲧ︤ⲛ︥	ⲡⲉⲧⲛ
ⲡⲉⲧ	ⲡⲉⲧ
ⲡⲉⲨ	ⲡⲉⲩ
ⲡⲉⲩ̣	ⲡⲉⲩ
ⲡⲉⲩ	ⲡⲉⲩ
ⲡⲉⲭ	ⲡⲉⲕ
ⲡⲉ⳯	ⲡⲉⲛ
ⲡⲉ⳿	ⲡⲉ
ⲡⲉ	ⲡⲉ
ⲡⲉ`	ⲡⲉ
ⲡⲏϣ	ⲡⲏϣ
ⲡⲏϩ	ⲡⲏϩ
ⲡⲏⲅⲏ̂	ⲡⲏⲅⲏ
ⲡⲏⲅⲏ	ⲡⲏⲅⲏ
ⲡⲏⲟⲩⲉ	ⲡⲏⲩⲉ
ⲡⲏⲣⲁ	ⲡⲏⲣⲁ
ⲡⲏⲧ	ⲡⲏⲧ
ⲡⲏⲧ`	ⲡⲏⲧ
ⲡⲏⲩ̣ⲉ̇	ⲡⲏⲩ̣ⲉ
ⲡⲏⲩⲉ	ⲡⲏⲩⲉ
ⲡⲏⲩⲉ`	ⲡⲏⲩⲉ
ⲡⲏ	ⲡⲏ
ⲡⲓ̇ⲣⲁⲍⲉ	ⲡⲉⲓⲣⲁⲍⲉ
ⲡⲓ̇ⲣⲁⲥⲙⲟⲥ	ⲡⲓⲣⲁⲥⲙⲟⲥ
ⲡⲓ̇ⲥⲧⲉⲩⲉ̇	ⲡⲓⲥⲧⲉⲩⲉ
ⲡⲓ̇ⲥⲧⲓ̇ⲥ	ⲡⲓⲥⲧⲓⲥ
ⲡⲓ̈	ⲡⲉⲓ
ⲡⲓⲑⲉ	ⲡⲉⲓⲑⲉ
ⲡⲓⲑⲩⲙⲓⲁ	ⲉⲡⲓⲑⲩⲙⲓⲁ
ⲡⲓⲗⲁⲧⲟⲥ	ⲡⲓⲗⲁⲧⲟⲥ
ⲡⲓⲛⲁⲝ	ⲡⲓⲛⲁⲝ
ⲡⲓⲛⲟⲩ	ⲡⲓⲛⲟⲩ
ⲡⲓⲣⲁⲍⲉ	ⲡⲉⲓⲣⲁⲍⲉ
ⲡⲓⲣⲁⲥⲙⲟ̣ⲥ̣	ⲡⲓⲣⲁⲥⲙⲟⲥ
ⲡⲓⲣⲁⲥⲙⲟⲥ	ⲡⲓⲣⲁⲥⲙⲟⲥ
ⲡⲓⲣⲉ	ⲡⲓⲣⲉ
ⲡⲓⲥⲧⲉⲩⲉ̄	ⲡⲓⲥⲧⲉⲩⲉ
ⲡⲓⲥⲧⲉⲩⲉ	ⲡⲓⲥⲧⲉⲩⲉ
ⲡⲓⲥⲧⲉⲩⲉ`	ⲡⲓⲥⲧⲉⲩⲉ
ⲡⲓⲥⲧⲓⲥ	ⲡⲓⲥⲧⲓⲥ
ⲡⲓⲥⲧⲟⲥ	ⲡⲓⲥⲧⲟⲥ
ⲡⲓⲧϩⲉ	ⲡⲉⲓⲑⲉ
ⲡⲓ	ⲡⲓ
ⲡⲗϭⲉ	ⲡⲗϭⲉ
ⲡⲗⲁⲛⲁ	ⲡⲗⲁⲛⲁ
ⲡⲗⲁⲛⲁ`	ⲡⲗⲁⲛⲁ
ⲡⲗⲁⲛⲏ	ⲡⲗⲁⲛⲏ
ⲡⲗⲁⲛⲟⲥ	ⲡⲗⲁⲛⲟⲥ
ⲡⲗⲁⲥⲥⲉ	ⲡⲗⲁⲥⲥⲉ
ⲡⲗⲉⲁ	ⲡⲗⲉⲁ
ⲡⲗⲉⲟⲛⲉⲕⲧⲉⲓ̈	ⲡⲗⲉⲟⲛⲉⲕⲧⲉ
ⲡⲗⲉⲟⲛⲉⲕⲧⲉⲓ	ⲡⲗⲉⲟⲛⲉⲕⲧⲉ
ⲡⲗⲏⲅⲉ	ⲡⲗⲏⲅⲉ
ⲡⲗⲏⲅⲏ	ⲡⲗⲏⲅⲏ
ⲡⲗⲏⲛ	ⲡⲗⲏⲛ
ⲡⲗⲏⲥⲧⲏⲥ	ⲡⲗⲏⲥⲧⲏⲥ
ⲡⲗⲩⲅⲏ	ⲡⲗⲩⲅⲏ
ⲡⲛⲁ	ⲡⲛⲉⲩⲙⲁ
ⲡⲛⲉⲩⲙⲁⲧⲓⲕⲏ	ⲡⲛⲉⲩⲙⲁⲧⲓⲕⲏ
ⲡⲛⲉⲩⲙⲁⲧⲓⲕⲟⲛ	ⲡⲛⲉⲩⲙⲁⲧⲓⲕⲟⲛ
ⲡⲛⲉⲩⲙⲁⲧⲓⲕⲟⲥ	ⲡⲛⲉⲩⲙⲁⲧⲓⲕⲟⲥ
ⲡⲛⲉⲩⲙⲁⲧⲓⲕⲱⲥ	ⲡⲛⲉⲩⲙⲁⲧⲓⲕⲱⲥ
ⲡⲛⲉⲩⲙⲁ	ⲡⲛⲉⲩⲙⲁ
ⲡⲛⲏ⳿	ⲡⲛⲏ
ⲡⲛⲏ	ⲡⲛⲏ
ⲡⲛⲟⲩⲧⲉ	ⲡⲛⲟⲩⲧⲉ
ⲡⲛⲟⲩⲧⲉ`	ⲡⲛⲟⲩⲧⲉ
ⲡⲛ︤ⲁ︥	ⲡⲛⲉⲩⲙⲁ
ⲡⲛ︤︥ⲁ	ⲡⲛⲉⲩⲙⲁ
ⲡⲟϣ︤	ⲡⲟϣ
ⲡⲟϣ	ⲡⲟϣ
ⲡⲟϩⲥ	ⲡⲟϩⲥ
ⲡⲟⲓ̈ⲙⲏⲛ	ⲡⲟⲓⲙⲏⲛ
ⲡⲟⲓⲙⲏⲛ	ⲡⲟⲓⲙⲏⲛ
ⲡⲟⲗⲉⲙⲓ̈ⲕⲟⲛ	ⲡⲟⲗⲉⲙⲓⲕⲟⲛ
ⲡⲟⲗⲉⲙⲓⲕⲟⲛ	ⲡⲟⲗⲉⲙⲓⲕⲟⲛ
ⲡⲟⲗⲉⲙⲟⲥ	ⲡⲟⲗⲉⲙⲟⲥ
ⲡⲟⲗⲓ̇ⲥ	ⲡⲟⲗⲓⲥ
ⲡⲟⲗⲓⲥ	ⲡⲟⲗⲓⲥ
ⲡⲟⲗⲓⲧⲏⲥ	ⲡⲟⲗⲓⲧⲏⲥ
ⲡⲟⲗⲩⲙⲉⲓ	ⲡⲟⲗⲩⲙⲉⲓ
ⲡⲟⲗⲩⲙⲟⲥ	ⲡⲟⲗⲉⲙⲟⲥ
ⲡⲟⲛⲏ̣ⲣ̣ⲟⲥ	ⲡⲟⲛⲏⲣⲟⲥ
ⲡⲟⲛⲏⲣⲉⲩⲉ	ⲡⲟⲛⲏⲣⲉⲩⲉ
ⲡⲟⲛⲏⲣⲓⲁ⳿	ⲡⲟⲛⲏⲣⲓⲁ
ⲡⲟⲛⲏⲣⲓⲁ	ⲡⲟⲛⲏⲣⲓⲁ
ⲡⲟⲛⲏⲣⲓⲁ`	ⲡⲟⲛⲏⲣⲓⲁ
ⲡⲟⲛⲏⲣⲟⲛ⳿	ⲡⲟⲛⲏⲣⲟⲛ
ⲡⲟⲛⲏⲣⲟⲛ	ⲡⲟⲛⲏⲣⲟⲛ
ⲡⲟⲛⲏⲣⲟⲛ`	ⲡⲟⲛⲏⲣⲟⲛ
ⲡⲟⲛⲏⲣⲟⲥ⳿	ⲡⲟⲛⲏⲣⲟⲥ
ⲡⲟⲛⲏⲣⲟⲥ	ⲡⲟⲛⲏⲣⲟⲥ
ⲡⲟⲛⲏⲣⲟ⳯	ⲡⲟⲛⲏⲣⲟⲛ
ⲡⲟⲛ	ⲡⲟⲛ
ⲡⲟⲟⲩ	ⲡⲟⲟⲩ
ⲡⲟⲣϣ̄	ⲡⲟⲣϣ
ⲡⲟⲣϣ̣︤	ⲡⲟⲣϣ
ⲡⲟⲣϣ	ⲡⲟⲣϣ
ⲡⲟⲣϫ̇	ⲡⲟⲣϫ
ⲡⲟⲣϫ	ⲡⲟⲣϫ
ⲡⲟⲣⲕ	ⲡⲟⲣⲕ
ⲡⲟⲣⲛⲉⲓⲁ	ⲡⲟⲣⲛⲉⲓⲁ
ⲡⲟⲣⲛⲉⲩⲉ	ⲡⲟⲣⲛⲉⲩⲉ
ⲡⲟⲣⲛⲏ	ⲡⲟⲣⲛⲏ
ⲡⲟⲣⲛⲓⲁ	ⲡⲟⲣⲛⲉⲓⲁ
ⲡⲟⲣⲛⲟⲥ	ⲡⲟⲣⲛⲟⲥ
ⲡⲟⲥⲉ	ⲡⲟⲥⲉ
ⲡⲟⲩ	ⲡⲟⲩ
ⲡⲣϣ	ⲡⲣϣ
ⲡⲣⲁⲓⲧⲱⲣⲓⲟⲛ	ⲡⲣⲁⲓⲧⲱⲣⲓⲟⲛ
ⲡⲣⲁⲝⲉⲓⲥ	ⲡⲣⲁⲝⲉⲓⲥ
ⲡⲣⲁⲝⲓⲥⲟⲛ	ⲡⲣⲁⲝⲓⲥⲟⲛ
ⲡⲣⲁⲝⲓⲥ	ⲡⲣⲁⲝⲓⲥ
ⲡⲣⲉⲥ̣[ⲃⲩ]ⲧ̣ⲉⲣⲟⲥ	ⲡⲣⲉⲥⲃⲩⲧⲉⲣⲟⲥ
ⲡⲣⲉⲥⲃⲉⲩⲉ	ⲡⲣⲉⲥⲃⲉⲩⲉ
ⲡⲣⲉⲥⲃⲩⲧⲉⲣⲟⲥ⳿	ⲡⲣⲉⲥⲃⲩⲧⲉⲣⲟⲥ
ⲡⲣⲉⲥⲃⲩⲧⲉⲣⲟⲥ	ⲡⲣⲉⲥⲃⲩⲧⲉⲣⲟⲥ
ⲡⲣⲏϣ	ⲡⲣⲏϣ
ⲡⲣⲓⲥⲕⲁ	ⲡⲣⲓⲥⲕⲁ
ⲡⲣⲟϩⲓⲥⲧⲁ	ⲡⲣⲟϩⲓⲥⲧⲁ
ⲡⲣⲟϩⲓⲥⲧⲁ`	ⲡⲣⲟϩⲓⲥⲧⲁ
ⲡⲣⲟⲇⲟⲧⲏⲥ	ⲡⲣⲟⲇⲟⲧⲏⲥ
ⲡⲣⲟⲑⲉⲥⲓⲥ	ⲡⲣⲟⲑⲉⲥⲓⲥ
ⲡⲣⲟⲕⲓⲙⲉⲛⲟⲛ	ⲡⲣⲟⲕⲓⲙⲉⲛⲟⲛ
ⲡⲣⲟⲕⲟⲡⲧⲉ	ⲡⲣⲟⲕⲟⲡⲧⲉ
ⲡⲣⲟⲥⲉⲭⲉ	ⲡⲣⲟⲥⲉⲭⲉ
ⲡⲣⲟⲥⲕⲁⲣⲧⲉⲣⲉⲓ	ⲡⲣⲟⲥⲕⲁⲣⲧⲉⲣⲉⲓ
ⲡⲣⲟⲥⲕⲁⲣⲧⲉⲣⲓ	ⲡⲣⲟⲥⲕⲁⲣⲧⲉⲣⲉⲓ
ⲡⲣⲟⲥⲟⲩⲟⲉⲓϣ	ⲡⲣⲟⲥⲟⲩⲟⲉⲓϣ
ⲡⲣⲟⲥⲫⲟⲣⲁ⳿	ⲡⲣⲟⲥⲫⲟⲣⲁ
ⲡⲣⲟⲥⲫⲟⲣⲁ	ⲡⲣⲟⲥⲫⲟⲣⲁ
ⲡⲣⲟⲥ	ⲡⲣⲟⲥ
ⲡⲣⲟⲧⲉⲕⲧⲱⲣ	ⲡⲣⲟⲧⲉⲕⲧⲱⲣ
ⲡⲣⲟⲫⲏⲧⲉⲩⲉ	ⲡⲣⲟⲫⲏⲧⲉⲩⲉ
ⲡⲣⲟⲫⲏⲧⲏⲥ⳿	ⲡⲣⲟⲫⲏⲧⲏⲥ
ⲡⲣⲟⲫⲏⲧⲏⲥ	ⲡⲣⲟⲫⲏⲧⲏⲥ
ⲡⲣⲟⲫⲏⲧⲏⲥ`	ⲡⲣⲟⲫⲏⲧⲏⲥ
ⲡⲣⲟⲫⲏⲧⲓⲁ	ⲡⲣⲟⲫⲏⲧⲓⲁ
ⲡⲣⲱ	ⲡⲣⲱ
ⲡⲣ	ⲡⲉ
ⲡⲩⲅⲏ	ⲡⲩⲅⲏ
ⲡⲩⲕⲧⲉⲩⲉ	ⲡⲩⲕⲧⲉⲩⲉ
ⲡⲩⲗⲏ	ⲡⲩⲗⲏ
ⲡⲩⲣⲅⲟⲥ	ⲡⲩⲣⲅⲟⲥ
ⲡⲱ̇ⲱ̇ⲛⲉ	ⲡⲱⲱⲛⲉ
ⲡⲱϣⲥ̇	ⲡⲱϣⲥ
ⲡⲱϣⲥ	ⲡⲱϣⲥ
ⲡⲱϣ	ⲡⲱϣ
ⲡⲱϥ	ⲡⲱϥ
ⲡⲱϩⲥ	ⲡⲱϩⲥ
ⲡⲱϩⲧ̄	ⲡⲱϩⲧ
ⲡⲱϩⲧ	ⲡⲱϩⲧ
ⲡⲱϩ︤ⲧ︥	ⲡⲱϩⲧ
ⲡⲱϩ︤ⲧ︥`	ⲡⲱϩⲧ
ⲡⲱϩ	ⲡⲱϩ
ⲡⲱⲓ	ⲡⲱⲓ
ⲡⲱⲗⲁϩ	ⲡⲱⲗⲁϩ
ⲡⲱⲛⲅ	ⲡⲱⲛⲕ
ⲡⲱⲛ︤ⲅ︥	ⲡⲱⲛⲅ
ⲡⲱⲛ	ⲡⲱⲛ
ⲡⲱⲣ̇ϫ	ⲡⲱⲣϫ
ⲡⲱⲣϣ̇	ⲡⲱⲣϣ
ⲡⲱⲣϣ	ⲡⲱⲣϣ
ⲡⲱⲣϫ̄	ⲡⲱⲣϫ
ⲡⲱⲣϫ	ⲡⲱⲣϫ
ⲡⲱⲣ︤ϣ︥	ⲡⲱⲣϣ
ⲡⲱⲣ︤ϫ︥	ⲡⲱⲣϫ
ⲡⲱⲣ︤︥ϫ	ⲡⲱⲣϫ
ⲡⲱⲥ	ⲡⲱⲥ
ⲡⲱⲧⲛ	ⲡⲱⲧⲛ
ⲡⲱⲧ⳿	ⲡⲱⲧ
ⲡⲱⲧ	ⲡⲱⲧ
ⲡⲱⲧ`	ⲡⲱⲧ
ⲡⲱⲱⲛⲉ̇	ⲡⲱⲱⲛⲉ
ⲡⲱⲱⲛⲉ	ⲡⲱⲱⲛⲉ
ⲡⲱⲱⲣⲉ	ⲡⲱⲱⲣⲉ
ⲡⲱ	ⲡⲱ
ⲡ︤ⲛ︥ⲁ	ⲡⲛⲉⲩⲙⲁ
ⲡ︤ⲛ︦ⲁ︥	ⲡⲛⲉⲩⲙⲁ
ⲡ︤︥ⲛ︤︥ⲁ	ⲡⲛⲉⲩⲙⲁ
ⲡ︤	ⲡ
ⲡ︥ⲟⲛⲏⲣⲟⲥ	ⲡⲟⲛⲏⲣⲟⲥ
ⲡ︥	ⲡ
ⲡ︦ⲛ︦ⲁ︦	ⲡⲛⲉⲩⲙⲁ
ⲡ	ⲡ
ⲡ 	ⲡ
ⲡ[ⲉ]	ⲡⲉ
ⲡ]	ⲡ
Ⲣⲱⲙⲉ	ⲣⲱⲙⲉ
ⲣ·	ⲣ
ⲣ̂̂ⲙⲁⲅⲓⲁⲉⲣⲟ̂	ⲣⲙⲁⲅⲓⲁⲉⲣⲟ
ⲣ̂̄ⲛⲟⲃⲉ	ⲣⲛⲟⲃⲉ
ⲣ̂ϣⲁⲩ	ⲣϣⲁⲩ
ⲣ̂ϣⲁ⳿	ⲣϣⲁ
ⲣ̂ϣⲟⲣ︤ⲡ︥	ⲣϣⲟⲣⲡ
ⲣ̂ϣⲡⲣⲉ	ⲣϣⲡⲣⲉ
ⲣ̂ϩⲁϩ	ⲣϩⲁϩ
ⲣ̂ϩⲃⲁ	ⲣϩⲃⲁ
ⲣ̂ϩⲏⲃⲉ⳿	ⲣϩⲏⲃⲉ
ⲣ̂ϩⲏⲃⲉ	ⲣϩⲏⲃⲉ
ⲣ̂ϩⲙⲟⲧ	ⲣϩⲙⲟⲧ
ⲣ̂ϩⲟⲧⲉ	ⲣϩⲟⲧⲉ
ⲣ̂ϩⲟⲩⲉⲥⲁⲃⲉ	ⲣϩⲟⲩⲉⲥⲁⲃⲉ
ⲣ̂ϩⲟⲩⲟ̂	ⲣϩⲟⲩⲟ
ⲣ̂ϩⲟⲩⲟ	ⲣϩⲟⲩⲟ
ⲣ̂ϩⲱⲃ	ⲣϩⲱⲃ
ⲣ̂ϩⲱⲧ	ⲣϩⲱⲧ
ⲣ̂ϩ︤ⲙ︥ϩⲁⲗ	ⲣϩⲙϩⲁⲗ
ⲣ̂ϫⲟⲉⲓⲥ	ⲣϫⲟⲉⲓⲥ
ⲣ̂ϭⲱⲃ	ⲣϭⲱⲃ
ⲣ̂ⲁⲛⲁϣ	ⲣⲁⲛⲁϣ
ⲣ̂ⲁⲡⲟⲥⲧⲟⲗⲟⲥ	ⲣⲁⲡⲟⲥⲧⲟⲗⲟⲥ
ⲣ̂ⲁⲧⲥⲟⲟⲩⲛ	ⲣⲁⲧⲥⲟⲟⲩⲛ
ⲣ̂ⲇⲓⲁⲃⲟⲗⲟⲥ	ⲣⲇⲓⲁⲃⲟⲗⲟⲥ
ⲣ̂ⲕⲃⲁ̂	ⲣⲕⲃⲁ
ⲣ̂ⲕⲃⲁ⳿	ⲣⲕⲃⲁ
ⲣ̂ⲕⲣⲟϥ⳿	ⲣⲕⲣⲟϥ
ⲣ̂ⲙⲉ	ⲣⲙⲉ
ⲣ̂ⲙⲛ︤ⲧ︥ⲣⲉ⳿	ⲣⲙⲛⲧⲣⲉ
ⲣ̂ⲙⲟⲛⲁⲭⲟⲥ	ⲣⲙⲟⲛⲁⲭⲟⲥ
ⲣ̂ⲛⲟϭ	ⲣⲛⲟϭ
ⲣ̂ⲛⲟⲃⲉ	ⲣⲛⲟⲃⲉ
ⲣ̂ⲟⲩⲏⲏⲃ	ⲣⲟⲩⲏⲏⲃ
ⲣ̂ⲟⲩⲟⲉⲓⲛ	ⲣⲟⲩⲟⲉⲓⲛ
ⲣ̂ⲡⲁⲣⲑⲉⲛⲟⲥ	ⲣⲡⲁⲣⲑⲉⲛⲟⲥ
ⲣ̂ⲡⲙⲉⲉⲩⲉ	ⲣⲡⲙⲉⲉⲩⲉ
ⲣ̂ⲡⲟⲗⲉⲙⲟⲥ	ⲣⲡⲟⲗⲉⲙⲟⲥ
ⲣ̂ⲧⲁⲃ⳿	ⲣⲧⲁⲃ
ⲣ̂	ⲣ
ⲣ̄ϣ̣[ⲁⲩ	ⲣϣⲁⲩ
ⲣ̄ϣⲁⲩ	ⲣϣⲁⲩ
ⲣ̄ϩ̄ⲛⲁ	ⲣϩⲛⲁ
ⲣ̄ϩⲁϩ	ⲣϩⲁϩ
ⲣ̄ϩⲁⲗ	ⲣϩⲁⲗ
ⲣ̄ϩⲙⲟⲧ	ⲣϩⲙⲟⲧ
ⲣ̄ϩⲟⲧⲉ	ⲣϩⲟⲧⲉ
ⲣ̄ϩⲟⲩⲉⲥⲁⲃⲉ	ⲣϩⲟⲩⲉⲥⲁⲃⲉ
ⲣ̄ϩⲟⲩⲟ	ⲣϩⲟⲩⲟ
ⲣ̄ϩⲟⲩⲟ`	ⲣϩⲟⲩⲟ
ⲣ̄ϩⲱⲃ	ⲣϩⲱⲃ
ⲣ̄ϩ︤ⲙ︥ⲙⲉ	ⲣϩⲙⲙⲉ
ⲣ̄ϯⲟⲩ	ⲣϯⲟⲩ
ⲣ̄ⲁⲧⲥⲟⲟⲩⲛ	ⲣⲁⲧⲥⲟⲟⲩⲛ
ⲣ̄ⲁⲫⲛⲡⲛⲉⲩⲉ̄	ⲣⲁⲡⲟⲡⲛⲓⲅⲉ
ⲣ̄ⲕⲁⲕⲉ	ⲣⲕⲁⲕⲉ
ⲣ̄ⲗⲁⲁⲩ	ⲣⲗⲁⲁⲩ
ⲣ̄ⲙⲏ̂	ⲣⲙⲏ
ⲣ̄ⲛⲁⲃⲉ	ⲣⲛⲟⲃⲉ
ⲣ̄ⲛⲟⲃⲉ	ⲣⲛⲟⲃⲉ
ⲣ̄ⲛⲟⲃⲉ`	ⲣⲛⲟⲃⲉ
ⲣ̄ⲟⲩⲟ̄ⲉⲓⲛ	ⲣⲟⲩⲟⲉⲓⲛ
ⲣ̄ⲟⲩⲟⲉⲓⲛ	ⲣⲟⲩⲟⲉⲓⲛ
ⲣ̄ⲡⲁⲣⲑⲉⲛⲟⲥ	ⲣⲡⲁⲣⲑⲉⲛⲟⲥ
ⲣ̄ⲡⲉ	ⲣⲡⲉ
ⲣ̄ⲣ̄ⲟ	ⲣⲣⲟ
ⲣ̄ⲣⲟ	ⲣⲣⲟ
ⲣ̄ⲥⲟϭ	ⲣⲥⲟϭ
ⲣ̄ⲭⲣⲉⲓⲁ	ⲣⲭⲣⲉⲓⲁ
ⲣ̄ⲭⲣⲓⲁ	ⲣⲭⲣⲉⲓⲁ
ⲣ̄ⲱ[ⲙⲉ]	ⲣⲱⲙⲉ
ⲣ̄	ⲣ
ⲣ̇ϣ̇ⲡⲏⲣⲉ	ⲣϣⲡⲏⲣⲉ
ⲣ̇ϩ̇ⲟⲧⲉ	ⲣϩⲟⲧⲉ
ⲣ̇ϩⲁⲗ	ⲣϩⲁⲗ
ⲣ̇ϩⲟ̇ⲧⲉ	ⲣϩⲟⲧⲉ
ⲣ̇ϩⲟⲧⲉ	ⲣϩⲟⲧⲉ
ⲣ̇ⲁ̇ⲧϭⲟⲙ	ⲣⲁⲧϭⲟⲙ
ⲣ̇ⲁⲗ̇	ⲣⲁⲗ
ⲣ̇ⲙⲟⲛⲁⲭⲟⲥ	ⲣⲙⲟⲛⲁⲭⲟⲥ
ⲣ̇ⲛⲟⲃⲉ	ⲣⲛⲟⲃⲉ
ⲣ̇ⲛⲟⲃⲣⲉ	ⲣⲛⲟⲃⲣⲉ
ⲣ̇ⲣ̇ⲟ	ⲣⲣⲟ
ⲣ̇ⲧⲁⲓ̇ⲟⲩ	ⲣⲧⲁⲓⲟⲩ
ⲣ̇ⲱⲙⲉ	ⲣⲱⲙⲉ
ⲣ̇	ⲣ
ⲣ̣̂ⲛ̣ⲟⲃⲉ	ⲣⲛⲟⲃⲉ
ⲣ̣ⲁ̣[ϣ]ⲉ	ⲣⲁϣⲉ
ⲣ̣ⲁⲛ	ⲣⲁⲛ
ⲣ̣ⲱⲙⲉ	ⲣⲱⲙⲉ
ⲣ̣	ⲣ
ⲣϣϥⲉ	ⲣϣϥⲉ
ⲣϣⲁⲩ	ⲣϣⲁⲩ
ⲣϣⲁ	ⲣϣⲁ
ⲣϣⲟⲣⲡ	ⲣϣⲟⲣⲡ
ⲣϣⲟⲣ︤ⲡ︥	ⲣϣⲟⲣⲡ
ⲣϣⲡⲏⲣⲉ	ⲣϣⲡⲏⲣⲉ
ⲣϣⲡⲣⲉ	ⲣϣⲡⲣⲉ
ⲣϣⲣⲡⲛⲁⲩ	ⲣϣⲣⲡⲛⲁⲩ
ⲣϣⲣⲡ	ⲣϣⲣⲡ
ⲣϣⲱⲛ	ⲣϣⲱⲛ
ⲣϩ̇ⲟⲧⲉ	ⲣϩⲟⲧⲉ
ⲣϩⲁϩ	ⲣϩⲁϩ
ⲣϩⲁⲉ	ⲣϩⲁⲉ
ⲣϩⲁⲗ	ⲣϩⲁⲗ
ⲣϩⲃⲁ	ⲣϩⲃⲁ
ⲣϩⲃⲃⲉ	ⲣϩⲃⲃⲉ
ⲣϩⲏⲃⲉ	ⲣϩⲏⲃⲉ
ⲣϩⲏⲕⲉ	ⲣϩⲏⲕⲉ
ⲣϩⲏⲧ	ⲣϩⲏⲧ
ⲣϩⲙϩⲁⲗ	ⲣϩⲙϩⲁⲗ
ⲣϩⲙⲉ	ⲣϩⲙⲉ
ⲣϩⲙⲙⲉ	ⲣϩⲙⲙⲉ
ⲣϩⲙⲟⲧ	ⲣϩⲙⲟⲧ
ⲣϩⲛⲁⲩ	ⲣϩⲛⲁⲩ
ⲣϩⲛⲁ	ⲣϩⲛⲁ
ⲣϩⲛⲏ	ⲣϩⲛⲏ
ⲣϩⲟⲧⲉ	ⲣϩⲟⲧⲉ
ⲣϩⲟⲩⲉⲥⲁⲃⲉ	ⲣϩⲟⲩⲉⲥⲁⲃⲉ
ⲣϩⲟⲩⲉ	ⲣϩⲟⲩⲉ
ⲣϩⲟⲩⲟ	ⲣϩⲟⲩⲟ
ⲣϩⲱⲃ	ⲣϩⲱⲃ
ⲣϩⲱⲧ	ⲣϩⲱⲧ
ⲣϩ︤ⲙ︥ⲙⲉ	ⲣϩⲙⲙⲉ
ⲣϩ[ⲛⲁ]ⲩ	ⲣϩⲛⲁⲩ
ⲣϫⲟⲉⲓⲥ	ⲣϫⲟⲉⲓⲥ
ⲣϫⲟⲩⲱⲧ	ⲣϫⲟⲩⲱⲧ
ⲣϭⲟⲙ	ⲣϭⲟⲙ
ⲣϭⲣⲱϩ	ⲣϭⲣⲱϩ
ⲣϭⲱⲃ	ⲣϭⲱⲃ
ⲣϯⲟⲩ	ⲣϯⲟⲩ
ⲣⲁ̇ⲧⲟⲩⲱ[ⲛ	ⲣⲁⲧⲟⲩⲱⲛ
ⲣⲁϣⲉ	ⲣⲁϣⲉ
ⲣⲁϩⲧ	ⲣⲁϩⲧ
ⲣⲁⲕⲟⲧⲉ	ⲣⲁⲕⲟⲧⲉ
ⲣⲁⲗ	ⲣⲁⲗ
ⲣⲁⲛ̄	ⲣⲁⲛ
ⲣⲁⲛⲁϣ	ⲣⲁⲛⲁϣ
ⲣⲁⲛⲁ	ⲣⲁⲛⲁ
ⲣⲁⲛ⳿	ⲣⲁⲛ
ⲣⲁⲛ	ⲣⲁⲛ
ⲣⲁⲛ`	ⲣⲁⲛ
ⲣⲁⲡⲟⲥⲧⲟⲗⲟⲥ	ⲣⲁⲡⲟⲥⲧⲟⲗⲟⲥ
ⲣⲁⲥⲟⲩ	ⲣⲁⲥⲟⲩ
ⲣⲁⲥⲟⲩ`	ⲣⲁⲥⲟⲩ
ⲣⲁⲥⲧⲉ	ⲣⲁⲥⲧⲉ
ⲣⲁⲧϣⲁⲩ	ⲣⲁⲧϣⲁⲩ
ⲣⲁⲧϭⲟⲙ	ⲣⲁⲧϭⲟⲙ
ⲣⲁⲧⲛⲁϩⲧⲉ	ⲣⲁⲧⲛⲁϩⲧⲉ
ⲣⲁⲧⲟⲟⲧ	ⲣⲁⲧⲟⲟⲧ
ⲣⲁⲧⲟⲩⲱⲛϩ	ⲣⲁⲧⲟⲩⲱⲛϩ
ⲣⲁⲧⲟⲩⲱⲛ	ⲣⲁⲧⲟⲩⲱⲛ
ⲣⲁⲧⲥⲟⲟⲩⲛ	ⲣⲁⲧⲥⲟⲟⲩⲛ
ⲣⲁⲧ︤	ⲣⲁⲧ
ⲣⲁⲧ	ⲣⲁⲧ
ⲣⲁⲫⲛⲡⲛⲉⲩⲉ	ⲣⲁⲡⲟⲡⲛⲓⲅⲉ
ⲣⲃⲟⲗ	ⲣⲃⲟⲗ
ⲣⲃⲟⲟⲛⲉ	ⲣⲃⲟⲟⲛⲉ
ⲣⲇⲓⲁⲃⲟⲗⲟⲥ	ⲣⲇⲓⲁⲃⲟⲗⲟⲥ
ⲣⲉϥϣⲉⲡϩⲓ̇ⲥⲉ	ⲣⲉϥϣⲡϩⲓⲥⲉ
ⲣⲉϥϣⲉⲡϩⲓⲥⲉ	ⲣⲉϥϣⲡϩⲓⲥⲉ
ⲣⲉϥϣⲙϣⲉⲉⲓⲇⲱⲗⲟⲛ	ⲣⲉϥϣⲙϣⲉⲉⲓⲇⲱⲗⲟⲛ
ⲣⲉϥϣⲙϣⲉ	ⲣⲉϥϣⲙϣⲉ
ⲣⲉϥϣⲟⲟⲣ	ⲣⲉϥϣⲟⲟⲣ
ⲣⲉϥϣ︤ⲙ︥ϣⲉⲉⲓⲇⲱⲗⲟⲛ⳿	ⲣⲉϥϣⲙϣⲉⲉⲓⲇⲱⲗⲟⲛ
ⲣⲉϥϩⲟⲧⲃ	ⲣⲉϥϩⲱⲧⲃ
ⲣⲉϥϩⲱϥⲧ	ⲣⲉϥϩⲱϥⲧ
ⲣⲉϥϩⲱⲧⲃ̄	ⲣⲉϥϩⲱⲧⲃ
ⲣⲉϥϩⲱⲧⲃ	ⲣⲉϥϩⲱⲧⲃ
ⲣⲉϥϩⲱⲧ︤ⲃ︥	ⲣⲉϥϩⲱⲧⲃ
ⲣⲉϥϫⲓϣⲟϫⲛⲉ	ⲣⲉϥϫⲓϣⲟϫⲛⲉ
ⲣⲉϥϫⲓⲕⲟⲗⲩⲙⲃⲟⲛ	ⲣⲉϥϫⲓⲕⲟⲗⲩⲙⲃⲟⲛ
ⲣⲉϥϫⲓⲛϭⲟⲛⲥ	ⲣⲉϥϫⲓⲛϭⲟⲛⲥ
ⲣⲉϥϫⲓⲛϭⲟⲛ︤ⲥ︥	ⲣⲉϥϫⲓⲛϭⲟⲛⲥ
ⲣⲉϥϫⲓⲟⲩⲉ	ⲣⲉϥϫⲓⲟⲩⲉ
ⲣⲉϥϫⲓⲟⲩⲉ`	ⲣⲉϥϫⲓⲟⲩⲉ
ⲣⲉϥϫⲓ	ⲣⲉϥϫⲓ
ⲣⲉϥϫⲱⲱⲗⲉ	ⲣⲉϥϫⲱⲱⲗⲉ
ⲣⲉϥϭⲉⲡⲣⲱⲙⲉ	ⲣⲉϥϭⲉⲡⲣⲱⲙⲉ
ⲣⲉϥϯϩⲁⲡ	ⲣⲉϥϯϩⲁⲡ
ⲣⲉϥϯϩⲉ	ⲣⲉϥϯϩⲉ
ⲣⲉϥϯⲱⲛϩ	ⲣⲉϥϯⲱⲛϩ
ⲣⲉϥϯ	ⲣⲉϥϯ
ⲣⲉϥⲃⲱϭⲉ	ⲣⲉϥⲃⲱϭⲉ
ⲣⲉϥⲃⲱⲗ	ⲣⲉϥⲃⲱⲗ
ⲣⲉϥⲉⲡⲉⲓⲑⲩⲙⲉⲓ	ⲣⲉϥⲉⲡⲉⲓⲑⲩⲙⲉⲓ
ⲣⲉϥⲉⲡⲓⲑⲩⲙⲉⲓ	ⲣⲉϥⲉⲡⲓⲑⲩⲙⲉⲓ
ⲣⲉϥⲉⲡⲓⲑⲩⲙⲓ	ⲣⲉϥⲉⲡⲓⲑⲩⲙⲉⲓ
ⲣⲉϥⲕⲱϩ	ⲣⲉϥⲕⲱϩ
ⲣⲉϥⲙⲓ̄ϣⲉ	ⲣⲉϥⲙⲓϣⲉ
ⲣⲉϥⲙⲓϣⲉ	ⲣⲉϥⲙⲓϣⲉ
ⲣⲉϥⲙⲟⲟⲩⲧ	ⲣⲉϥⲙⲟⲟⲩⲧ
ⲣⲉϥⲛ̄ⲕⲟⲧ︤ⲕ︥	ⲣⲉϥⲛⲕⲟⲧⲕ
ⲣⲉϥⲛⲕⲟⲧⲕ	ⲣⲉϥⲛⲕⲟⲧⲕ
ⲣⲉϥⲣ̂ϩ︤ⲙ︥ⲙⲉ…	ⲣⲉϥⲣϩⲙⲙⲉ
ⲣⲉϥⲣ̂ⲁⲛⲁϣ	ⲣⲉϥⲣⲁⲛⲁϣ
ⲣⲉϥⲣ̂ⲛⲟⲃⲉ	ⲣⲉϥⲣⲛⲟⲃⲉ
ⲣⲉϥⲣ̂ⲡⲉⲑⲟⲟⲩ	ⲣⲉϥⲣⲡⲉⲧϩⲟⲟⲩ
ⲣⲉϥⲣ̄ⲛⲟⲃⲉ	ⲣⲉϥⲣⲛⲟⲃⲉ
ⲣⲉϥⲣ̄ⲡⲉⲑⲟⲟⲩ	ⲣⲉϥⲣⲡⲉⲧϩⲟⲟⲩ
ⲣⲉϥⲣ̄	ⲣⲉϥⲣ
ⲣⲉϥⲣ̇ⲛⲟⲃⲉ	ⲣⲉϥⲣⲛⲟⲃⲉ
ⲣⲉϥⲣϩⲙⲙⲉ…	ⲣⲉϥⲣϩⲙⲙⲉ
ⲣⲉϥⲣⲁⲛⲁϣ	ⲣⲉϥⲣⲁⲛⲁϣ
ⲣⲉϥⲣⲛⲟⲃⲉ	ⲣⲉϥⲣⲛⲟⲃⲉ
ⲣⲉϥⲣⲡⲉⲑⲟⲟⲩ	ⲣⲉϥⲣⲡⲉⲧϩⲟⲟⲩ
ⲣⲉϥⲣ	ⲣⲉϥⲣ
ⲣⲉϥⲥⲁϩⲟⲩ	ⲣⲉϥⲥⲁϩⲟⲩ
ⲣⲉϥⲧⲁⲕⲟ	ⲣⲉϥⲧⲁⲕⲟ
ⲣⲉϥⲧⲁⲛϩⲟ	ⲣⲉϥⲧⲁⲛϩⲟ
ⲣⲉϥⲧⲱⲣⲡ	ⲣⲉϥⲧⲱⲣⲡ
ⲣⲉϥⲧⲱⲣ︤ⲡ︥	ⲣⲉϥⲧⲱⲣⲡ
ⲣⲉϥⲱ̇ϫⲛ̇	ⲣⲉϥⲱϫⲛ
ⲣⲉϥⲱϫⲛ	ⲣⲉϥⲱϫⲛ
ⲣⲉϩⲧ	ⲣⲉϩⲧ
ⲣⲉⲃⲏ	ⲣⲉⲃⲏ
ⲣⲉⲓⲣⲏⲛⲏ	ⲣⲉⲓⲣⲏⲛⲏ
ⲣⲉⲙⲏⲧ	ⲣⲉⲙⲏⲧ
ⲣⲉ	ⲣⲉ
ⲣⲏⲥ	ⲣⲏⲥ
ⲣⲏⲧ⳿	ⲣⲏⲧ
ⲣⲏⲧ	ⲣⲏⲧ
ⲣⲏ⳿	ⲣⲏ
ⲣⲏ	ⲣⲏ
ⲣⲑⲉ	ⲣⲑⲉ
ⲣⲓ̇ⲙⲉ	ⲣⲓⲙⲉ
ⲣⲓ̇ⲣ	ⲣⲓⲣ
ⲣⲓ̇	ⲣⲓ
ⲣⲓ̣ⲣ	ⲣⲓⲣ
ⲣⲓⲕⲉ	ⲣⲓⲕⲉ
ⲣⲓⲙⲉ	ⲣⲓⲙⲉ
ⲣⲓⲣ⳿	ⲣⲓⲣ
ⲣⲓⲣ	ⲣⲓⲣ
ⲣⲓ	ⲣⲓ
ⲣⲓ[ⲙ]ⲉ	ⲣⲓⲙⲉ
ⲣⲕⲁⲕⲉ	ⲣⲕⲁⲕⲉ
ⲣⲕⲃⲁ	ⲣⲕⲃⲁ
ⲣⲕⲟⲓⲛⲱⲛⲟⲥ	ⲣⲕⲟⲓⲛⲱⲛⲟⲥ
ⲣⲕⲟⲩⲓ	ⲣⲕⲟⲩⲉⲓ
ⲣⲕⲣⲟϥ	ⲣⲕⲣⲟϥ
ⲣⲗⲁⲁⲩ	ⲣⲗⲁⲁⲩ
ⲣⲙ̄ϩⲉ	ⲣⲙϩⲉ
ⲣⲙ̣ⲉⲓⲟⲟⲩⲉ	ⲣⲙⲉⲓⲟⲟⲩⲉ
ⲣⲙϩⲉ	ⲣⲙϩⲉ
ⲣⲙϩⲏ	ⲣⲙϩⲏ
ⲣⲙⲁⲅⲓⲁⲉⲣⲟ	ⲣⲙⲁⲅⲓⲁⲉⲣⲟ
ⲣⲙⲁⲓⲧⲟ	ⲣⲙⲁⲓⲧⲟ
ⲣⲙⲁⲗⲁⲕⲟⲥ	ⲣⲙⲁⲗⲁⲕⲟⲥ
ⲣⲙⲁⲣⲧⲏⲣⲟⲥ	ⲣⲙⲁⲣⲧⲏⲣⲟⲥ
ⲣⲙⲁⲧⲟⲓ	ⲣⲙⲁⲧⲟⲓ
ⲣⲙⲉⲉⲩⲉ	ⲣⲙⲉⲉⲩⲉ
ⲣⲙⲉⲓⲟⲟⲩⲉ	ⲣⲙⲉⲓⲟⲟⲩⲉ
ⲣⲙⲉ	ⲣⲙⲉ
ⲣⲙⲏ	ⲣⲙⲏ
ⲣⲙⲙⲁⲟ	ⲣⲙⲙⲁⲟ
ⲣⲙⲙⲙⲉ	ⲣⲙⲙⲙⲉ
ⲣⲙⲛϩⲏⲧ	ⲣⲙⲛϩⲏⲧ
ⲣⲙⲛⲁⲥ	ⲣⲙⲛⲁⲥ
ⲣⲙⲛⲕⲁϩ	ⲣⲙⲛⲕⲁϩ
ⲣⲙⲛⲧⲣⲉ	ⲣⲙⲛⲧⲣⲉ
ⲣⲙⲛ	ⲣⲙⲛ
ⲣⲙⲟⲛⲁⲭⲟⲥ	ⲣⲙⲟⲛⲁⲭⲟⲥ
ⲣⲙⲣⲁϣ	ⲣⲙⲣⲁϣ
ⲣⲙ	ⲣⲙ
ⲣⲛ̄	ⲣⲛ
ⲣⲛⲁⲃⲉ	ⲣⲛⲟⲃⲉ
ⲣⲛⲟϥⲣⲉ	ⲣⲛⲟϥⲣⲉ
ⲣⲛⲟϭ	ⲣⲛⲟϭ
ⲣⲛⲟⲃⲉ	ⲣⲛⲟⲃⲉ
ⲣⲛⲟⲃⲣⲉ	ⲣⲛⲟⲃⲣⲉ
ⲣⲛⲟⲉⲓⲕ	ⲣⲛⲟⲉⲓⲕ
ⲣⲛⲟⲓⲕ	ⲣⲛⲟⲉⲓⲕ
ⲣⲛⲟ[ⲃⲉ]	ⲣⲛⲟⲃⲉ
ⲣⲛⲧ	ⲣⲛⲧ
ⲣⲛ	ⲣⲛ
ⲣⲟ̂	ⲣⲟ
ⲣⲟⲉⲓ̈ⲥ	ⲣⲟⲉⲓⲥ
ⲣⲟⲉⲓⲥ⳿	ⲣⲟⲉⲓⲥ
ⲣⲟⲉⲓⲥ	ⲣⲟⲉⲓⲥ
ⲣⲟⲙⲡⲉ	ⲣⲟⲙⲡⲉ
ⲣⲟⲟⲩϣ⳿	ⲣⲟⲟⲩϣ
ⲣⲟⲟⲩϣ	ⲣⲟⲟⲩϣ
ⲣⲟⲟⲩϣ`	ⲣⲟⲟⲩϣ
ⲣⲟⲟⲩⲉ	ⲣⲟⲟⲩⲉ
ⲣⲟⲟⲩⲧ	ⲣⲟⲟⲩⲧ
ⲣⲟⲩϩⲉ	ⲣⲟⲩϩⲉ
ⲣⲟⲩⲏⲏⲃ	ⲣⲟⲩⲏⲏⲃ
ⲣⲟⲩⲟⲉⲓϣ	ⲟⲩⲟⲉⲓϣ
ⲣⲟⲩⲟⲉⲓⲛ	ⲣⲟⲩⲟⲉⲓⲛ
ⲣⲟⲩⲟ[ⲉⲓ]ⲛ̣	ⲣⲟⲩⲟⲉⲓⲛ
ⲣⲟⲩⲱ	ⲣⲟⲩⲱ
ⲣⲟⲩ	ⲣⲟⲩ
ⲣⲟ	ⲣⲟ
ⲣⲡⲁⲓ	ⲣⲡⲁⲓ
ⲣⲡⲁⲣⲑⲉⲛⲟⲥ	ⲣⲡⲁⲣⲑⲉⲛⲟⲥ
ⲣⲡⲉⲑⲟⲟⲩ	ⲣⲡⲉⲑⲟⲟⲩ
ⲣⲡⲉⲣⲡⲉⲣⲟⲥ	ⲣⲡⲉⲣⲡⲉⲣⲟⲥ
ⲣⲡⲉ	ⲣⲡⲉ
ⲣⲡⲏⲩⲉ	ⲣⲡⲏⲩⲉ
ⲣⲡⲓⲑⲉ	ⲣⲡⲉⲓⲑⲉⲓ
ⲣⲡⲓⲥⲧⲟⲥ	ⲣⲡⲓⲥⲧⲟⲥ
ⲣⲡⲙⲉⲉⲩⲉ	ⲣ
ⲣⲡⲟⲗⲉⲙⲟⲥ	ⲣⲡⲟⲗⲉⲙⲟⲥ
ⲣⲡⲟⲗⲩⲙⲟⲥ	ⲣⲡⲟⲗⲩⲙⲟⲥ
ⲣⲡⲟⲥⲉ	ⲣⲡⲟⲥⲉ
ⲣⲡⲣⲟⲫⲏⲧⲏⲥ	ⲣⲡⲣⲟⲫⲏⲧⲏⲥ
ⲣⲣⲙϩⲉ	ⲣⲣⲙϩⲉ
ⲣⲣⲙⲙ⟨ⲁ⟩ⲟ	ⲣⲣⲙⲙⲁⲟ
ⲣⲣⲙⲙⲁⲟ	ⲣⲣⲙⲙⲁⲟ
ⲣⲣⲙ	ⲣⲣⲙ
ⲣⲣⲟⲟⲩϣ	ⲣⲣⲟⲟⲩϣ
ⲣⲣⲟ	ⲣⲣⲟ
ⲣⲣⲣⲟ	ⲣⲣⲣⲟ
ⲣⲣⲱⲙⲉ	ⲣⲱⲙⲉ
ⲣⲣⲱⲟⲩ	ⲣⲣⲱⲟⲩ
ⲣⲣⲱ	ⲣⲱ
ⲣⲣ︤ⲙ︥ⲙⲁⲟ	ⲣⲣⲙⲙⲁⲟ
ⲣⲥϩⲓⲙⲉ	ⲣⲥϩⲓⲙⲉ
ⲣⲥⲁϣϥ	ⲣⲥⲁϣϥ
ⲣⲥⲁϩ	ⲣⲥⲁϩ
ⲣⲥⲁⲃⲉ	ⲣⲥⲁⲃⲉ
ⲣⲥⲙⲟⲧ	ⲣⲥⲙⲟⲧ
ⲣⲥⲛⲁⲩ	ⲣⲥⲛⲁⲩ
ⲣⲥⲟϭ	ⲣⲥⲟϭ
ⲣⲥⲧ	ⲣⲥⲧ
ⲣⲧⲁⲃ	ⲣⲧⲁⲃ
ⲣⲧⲁⲓⲟⲩ	ⲣⲧⲁⲓⲟⲩ
ⲣⲧⲉⲗⲓⲟⲥ	ⲣⲧⲉⲗⲓⲟⲥ
ⲣⲧⲱⲛ	ⲣⲧⲱⲛ
ⲣⲫⲟⲛⲟⲥ	ⲣⲫⲟⲛⲟⲥ
ⲣⲭⲣⲉⲓⲁ	ⲣⲭⲣⲉⲓⲁ
ⲣⲭⲣⲏⲥⲧⲟⲥ	ⲣⲭⲣⲏⲥⲧⲟⲥ
ⲣⲭⲣⲓⲁ	ⲣⲭⲣⲉⲓⲁ
ⲣⲱ̂	ⲣⲱ
ⲣⲱϣⲉ	ⲣⲱϣⲉ
ⲣⲱϩⲧ̇	ⲣⲱϩⲧ
ⲣⲱϩⲧ	ⲣⲱϩⲧ
ⲣⲱϩ︤ⲧ︥	ⲣⲱϩⲧ
ⲣⲱⲃ	ⲣⲱⲃ
ⲣⲱⲕϩ	ⲣⲱⲕϩ
ⲣⲱⲘⲉ	ⲣⲱⲙⲉ
ⲣⲱⲙⲉ⳿	ⲣⲱⲙⲉ
ⲣⲱⲙⲉ	ⲣⲱⲙⲉ
ⲣⲱⲙⲉ`	ⲣⲱⲙⲉ
ⲣⲱⲟⲩ	ⲣⲱⲟⲩ
ⲣⲱⲧ	ⲣⲱⲧ
ⲣⲱⲧ`	ⲣⲱⲧ
ⲣⲱ⳿	ⲣⲱ
ⲣⲱ	ⲣⲱ
ⲣ⳿ϭⲣⲱϩ⳿	ⲣϭⲣⲱϩ
ⲣ⳿ⲛⲟϭ	ⲣⲛⲟϭ
ⲣ⳿ⲣⲱⲟⲩ	ⲣⲣⲱⲟⲩ
ⲣ⳿ⲥⲧ	ⲣⲥⲧ
ⲣ︤ⲙ︥ⲉⲓⲟⲟⲩⲉ	ⲣⲙⲉⲓⲟⲟⲩⲉ
ⲣ︤ⲙ︥ⲙⲁⲟ̂	ⲣⲙⲙⲁⲟ
ⲣ︤ⲙ︥ⲛ̄ϩⲏⲧ	ⲣⲙⲛϩⲏⲧ
ⲣ︤ⲙ︥ⲛ̄	ⲣⲙⲛ
ⲣ︤ⲙ︥	ⲣⲙ
ⲣ︤ⲙ︦ⲛ︥	ⲣⲙⲛ
ⲣ︤︤ⲣ︤ⲙ︥ⲙ⟨ⲁ⟩ⲟ̂	ⲣⲣⲙⲙⲁⲟ
ⲣ︥ϣⲱⲛ	ⲣϣⲱⲛ
ⲣ︥ϩⲟⲧⲉ	ⲣϩⲟⲧⲉ
ⲣ︥ⲙ̄ⲣⲁϣ	ⲣⲙⲣⲁϣ
ⲣ︥ⲣⲟ`	ⲣⲣⲟ
ⲣ︥	ⲣ
ⲣ	ⲣ
ⲣ`	ⲣ
Ⲥⲉ	ⲥⲉ
ⲤⲘⲞⲨ	ⲥⲙⲟⲩ
ⲤⲞⲠ	ⲥⲟⲡ
ⲤⲞⲨ	ⲥⲟⲩ
Ⲥⲟⲟⲩⲛ	ⲥⲟⲟⲩⲛ
ⲤⲦⲢⲀⲦⲎⲖⲀⲦⲎⲤ	ⲥⲧⲣⲁⲧⲏⲗⲁⲧⲏⲥ
ⲥ̄ⲕⲉⲩⲏ̄	ⲥⲕⲉⲩⲏ
ⲥ̄ⲛⲁⲩ	ⲥⲛⲁⲩ
ⲥ̄ⳁⲟ︤ⲥ︥	ⲥⲧⲁⲩⲣⲟⲥ
ⲥ̄ⳁⲟ︤ⲩ︥	ⲥⲧⲁⲩⲣⲟⲩ
ⲥ̄⳨ⲟ︤ⲥ︥	ⲥⲧⲁⲩⲣⲟⲥ
ⲥ̄	ⲥ
ⲥ̇ϭⲏⲣ	ⲥϭⲏⲣ
ⲥ̇ϭⲣⲁϩⲧ̇	ⲥϭⲣⲁϩⲧ
ⲥ̇ⲃⲏⲧⲉ	ⲥϩⲃⲏⲏⲧⲉ
ⲥ̇ⲗⲥⲱⲗ	ⲥⲗⲥⲱⲗ
ⲥ̇ⲙⲛ̇ⲛⲟⲙⲟⲥ	ⲥⲙⲛⲛⲟⲙⲟⲥ
ⲥ̇ⲙⲟⲧ	ⲥⲙⲟⲧ
ⲥ̇ⲛⲁⲩ	ⲥⲛⲁⲩ
ⲥ̇ⲧⲱⲧ	ⲥⲧⲱⲧ
ⲥ̇ⲭⲩⲙⲁ	ⲥⲭⲏⲙⲁ
ⲥ̇	ⲥ
ⲥ̣ⲁ̣ⲃ̣ⲉ̣	ⲥⲁⲃⲉ
ⲥ̣ⲟ̣ⲛ	ⲥⲟⲛ
ⲥ̣ⲣ̣	ⲥⲣ
ⲥ̣ⲱⲧ[ⲙ	ⲥⲱⲧⲙ
ⲥ̣	ⲥ
ⲥϣϥⲉ	ⲥⲁϣϥⲉ
ⲥϥ̇	ⲥϥ
ⲥϥ	ⲥϥ
ⲥϩⲁⲉⲓ	ⲥϩⲁⲓ
ⲥϩⲁⲓ̈ⲥ	ⲥϩⲁⲓⲥ
ⲥϩⲁⲓ̈	ⲥϩⲁⲓ
ⲥϩⲁⲓⲥ	ⲥϩⲁⲓⲥ
ⲥϩⲁⲓ	ⲥϩⲁⲓ
ⲥϩⲓ̈ⲙⲉ	ⲥϩⲓⲙⲉ
ⲥϩⲓⲙⲉ̂	ⲥϩⲓⲙⲉ
ⲥϩⲓⲙⲉ	ⲥϩⲓⲙⲉ
ⲥϩⲓⲙⲉ`	ⲥϩⲓⲙⲉ
ⲥϩⲟⲩⲟⲢⲧ	ⲥϩⲟⲩⲟⲣⲧ
ⲥϩⲟⲩⲟⲢⲧ`	ⲥϩⲟⲩⲟⲣⲧ
ⲥϩⲟⲩⲟⲣⲧ	ⲥϩⲟⲩⲟⲣⲧ
ⲥϩⲟⲩⲟⲣ︤ⲧ︥	ⲥϩⲟⲩⲟⲣⲧ
ⲥϩⲟⲩⲟⲣ︤ⲧ︥`	ⲥϩⲟⲩⲟⲣⲧ
ⲥϩⲟⲩⲣ̄	ⲥϩⲟⲩⲣ
ⲥϩⲟⲩⲣⲟⲣⲧ	ⲥϩⲟⲩⲟⲣⲧ
ⲥϩⲟⲩⲣ	ⲥϩⲟⲩⲣ
ⲥϩⲟⲩⲱ̣ⲣ	ⲥϩⲟⲩⲱⲣ
ⲥϩⲟⲩⲱⲣ	ⲥϩⲟⲩⲱⲣ
ⲥϩ[ⲟⲩⲟⲣⲧ]	ⲥϩⲟⲩⲟⲣⲧ
ⲥϭⲏⲣ⳿	ⲥϭⲏⲣ
ⲥϭⲏⲣ	ⲥϭⲏⲣ
ⲥϭⲣⲁϩⲧ	ⲥϭⲣⲁϩⲧ
ⲥϯⲛⲟⲩⲃⲉ	ⲥϯⲛⲟⲩϥⲉ
ⲥϯⲣⲁⲧⲉⲩⲙⲁ	ⲥⲧⲣⲁⲧⲉⲩⲙⲁ
ⲥϯⲱ̄ϩⲉ	ⲥⲧⲉⲓⲱϩⲉ
ⲥϯⲱϩⲉ	ⲥⲧⲉⲓⲱϩⲉ
ⲥⲁ̂	ⲥⲁ
ⲥⲁϣϥ̄	ⲥⲁϣϥ
ⲥⲁϣϥ	ⲥⲁϣϥ
ⲥⲁϣⲉ	ⲥⲁϣⲉ
ⲥⲁϣ︤ϥ︥	ⲥⲁϣϥ
ⲥⲁϩ̣	ⲥⲁϩ
ⲥⲁϩⲃⲟⲩⲣ	ⲥⲁϩⲃⲟⲩⲣ
ⲥⲁϩⲉ	ⲥⲁϩⲉ
ⲥⲁϩⲛⲉ	ⲥⲁϩⲛⲉ
ⲥⲁϩⲛⲉ`	ⲥⲁϩⲛⲉ
ⲥⲁϩⲟⲩ	ⲥⲁϩⲟⲩ
ⲥⲁϩⲟⲩ`	ⲥⲁϩⲟⲩ
ⲥⲁϩⲟ[ⲩ	ⲥⲁϩⲟⲩ
ⲥⲁϩⲱ̂	ⲥⲁϩⲱ
ⲥⲁϩⲱ	ⲥⲁϩⲱ
ⲥⲁϩ︤ⲛ︥ⲉ	ⲥⲁϩⲛⲉ
ⲥⲁϩ	ⲥⲁϩ
ⲥⲁϩ`	ⲥⲁϩ
ⲥⲁⲁⲧⲉ	ⲥⲁⲁⲧⲉ
ⲥⲁⲁⲧ	ⲥⲁⲁⲧ
ⲥⲁⲃϩ	ⲥⲁⲃϩ
ⲥⲁⲃⲃⲁⲧⲟⲛ	ⲥⲁⲃⲃⲁⲧⲟⲛ
ⲥⲁⲃⲉⲉⲩ	ⲥⲁⲃⲉⲉⲩ
ⲥⲁⲃⲉ	ⲥⲁⲃⲉ
ⲥⲁⲃ︤ϩ︥	ⲥⲁⲃϩ
ⲥⲁⲇⲇⲟⲩⲕⲁⲓⲟⲥ	ⲥⲁⲇⲇⲟⲩⲕⲁⲓⲟⲥ
ⲥⲁⲉⲓ̈ⲛ	ⲥⲁⲉⲓⲛ
ⲥⲁⲉⲓⲛ	ⲥⲁⲉⲓⲛ
ⲥⲁⲓⲛ	ⲥⲁⲓⲛ
ⲥⲁⲗⲡⲓⲅⲝ	ⲥⲁⲗⲡⲓⲅⲝ
ⲥⲁⲗⲡⲓⲅ︤ⲝ︥	ⲥⲁⲗⲡⲓⲅⲝ
ⲥⲁⲗⲡⲓⲍⲉ	ⲥⲁⲗⲡⲓⲍⲉ
ⲥⲁⲗⲱⲙⲏ	ⲥⲁⲗⲱⲙⲏ
ⲥⲁⲙⲓⲧ	ⲥⲁⲙⲓⲧ
ⲥⲁⲙⲟⲩⲏⲗ	ⲥⲁⲙⲟⲩⲏⲗ
ⲥⲁⲙⲯⲱⲛ	ⲥⲁⲙⲯⲱⲛ
ⲥⲁⲙⲯⲱⲛ`	ⲥⲁⲙⲯⲱⲛ
ⲥⲁⲛϣ	ⲥⲁⲛϣ
ⲥⲁⲛⲇⲁⲗⲓⲟⲛ	ⲥⲁⲛⲇⲁⲗⲓⲟⲛ
ⲥⲁⲛⲟⲩϣ	ⲥⲁⲛⲟⲩϣ
ⲥⲁⲛ︤ϣ︥	ⲥⲁⲛϣ
ⲥⲁⲟⲩⲗ̄	ⲥⲁⲟⲩⲗ
ⲥⲁⲟⲩⲗ	ⲥⲁⲟⲩⲗ
ⲥⲁⲣⲁⲡⲓ̇ⲟⲛ	ⲥⲁⲣⲁⲡⲓⲟⲛ
ⲥⲁⲣⲁⲡⲓⲟⲛ	ⲥⲁⲣⲁⲡⲓⲟⲛ
ⲥⲁⲣⲁ	ⲥⲁⲣⲁ
ⲥⲁⲣⲕⲓⲕⲟⲛ	ⲥⲁⲣⲕⲓⲕⲟⲛ
ⲥⲁⲣⲕⲓⲕⲟⲥ	ⲥⲁⲣⲕⲓⲕⲟⲥ
ⲥⲁⲣⲝ̇	ⲥⲁⲣⲝ
ⲥⲁⲣⲝ	ⲥⲁⲣⲝ
ⲥⲁⲣⲣⲁ	ⲥⲁⲣⲣⲁ
ⲥⲁⲣⲣⲁ`	ⲥⲁⲣⲣⲁ
ⲥⲁⲣ︤ⲝ︥	ⲥⲁⲣⲝ
ⲥⲁⲣ︤ⲝ︥`	ⲥⲁⲣⲝ
ⲥⲁⲧⲁⲛⲁⲥ⳿	ⲥⲁⲧⲁⲛⲁⲥ
ⲥⲁⲧⲁⲛⲁⲥ	ⲥⲁⲧⲁⲛⲁⲥ
ⲥⲁⲧⲁⲛⲁⲥ`	ⲥⲁⲧⲁⲛⲁⲥ
ⲥⲁⲧⲁ[ⲛ]ⲁⲥ	ⲥⲁⲧⲁⲛⲁⲥ
ⲥⲁⲧⲉⲉⲣⲉ	ⲥⲁⲧⲉⲉⲣⲉ
ⲥⲁⲧⲉ	ⲥⲁⲧⲉ
ⲥⲁⲧⲉ`	ⲥⲁⲧⲉ
ⲥⲁⲭⲑⲁⲛⲉⲓ	ⲥⲁⲭⲑⲁⲛⲉⲓ
ⲥⲁ	ⲥⲁ
ⲥⲃ̇ⲧⲱ̣[ⲧ]	ⲥⲃⲧⲱⲧ
ⲥⲃⲃⲉ	ⲥⲃⲃⲉ
ⲥⲃⲃⲏⲧ	ⲥⲃⲃⲏⲧ
ⲥⲃⲃⲏⲩ	ⲥⲃⲃⲏⲩ
ⲥⲃⲏⲓⲧⲉ	ⲥⲃⲏⲓⲧⲉ
ⲥⲃⲏⲧⲉ	ⲥϩⲃⲏⲏⲧⲉ
ⲥⲃⲟⲟⲩⲉ	ⲥⲃⲟⲟⲩⲉ
ⲥⲃⲟ	ⲥⲃⲟ
ⲥⲃⲧⲉ	ⲥⲃⲧⲉ
ⲥⲃⲧⲱⲧ	ⲥⲃⲧⲱⲧ
ⲥⲃⲱ̂	ⲥⲃⲱ
ⲥⲃⲱ	ⲥⲃⲱ
ⲥⲉϩ	ⲥⲉϩ
ⲥⲉⲉ̇ⲡⲉ	ⲥⲉⲉⲡⲉ
ⲥⲉⲉⲡⲉ	ⲥⲉⲉⲡⲉ
ⲥⲉⲏ̇ⲣⲡ̇	ⲥⲉⲏⲣⲡ
ⲥⲉⲏⲣⲡ	ⲥⲉⲏⲣⲡ
ⲥⲉⲓ̂	ⲥⲉⲓ
ⲥⲉⲓ	ⲥⲉⲓ
ⲥⲉⲕⲙⲟⲟⲩ	ⲥⲉⲕⲙⲟⲟⲩ
ⲥⲉⲕ	ⲥⲉⲕ
ⲥⲉⲗⲓⲥ⳿	ⲥⲉⲗⲓⲥ
ⲥⲉⲗⲓⲥ	ⲥⲉⲗⲓⲥ
ⲥⲉⲙⲛ	ⲥⲉⲙⲛ
ⲥⲉⲛϩ	ⲥⲉⲛϩ
ⲥⲉⲛⲟⲩⲑⲓⲟⲩ	ⲥⲉⲛⲟⲩⲑⲓⲟⲩ
ⲥⲉⲡⲥⲱⲡ	ⲥⲉⲡⲥⲱⲡ
ⲥⲉⲡ	ⲥⲉⲡ
ⲥⲉⲧⲡ	ⲥⲉⲧⲡ
ⲥⲉⲧ︤ⲡ︥	ⲥⲉⲧⲡ
ⲥⲉⲩϩ⳿	ⲥⲉⲩϩ
ⲥⲉⲩϩ	ⲥⲉⲩϩ
ⲥⲉ⳿	ⲥⲉ
ⲥⲉ	ⲥⲉ
ⲥⲏϣ	ⲥⲏϣ
ⲥⲏϥⲉ	ⲥⲏϥⲉ
ⲥⲏϩ⳿	ⲥⲏϩ
ⲥⲏϩ	ⲥⲏϩ
ⲥⲏϩ`	ⲥⲏϩ
ⲥⲏϭ	ⲥⲏϭ
ⲥⲏⲃⲉ	ⲥⲏⲃⲉ
ⲥⲏⲧ	ⲥⲏⲧ
ⲥⲏⲩ	ⲥⲏⲩ
ⲥⲓϣⲉ	ⲥⲓϣⲉ
ⲥⲓⲇⲱⲛ	ⲥⲓⲇⲱⲛ
ⲥⲓⲕⲉ	ⲥⲓⲕⲉ
ⲥⲓⲙⲱⲛ	ⲥⲓⲙⲱⲛ
ⲥⲓⲛⲇⲱⲛ	ⲥⲓⲛⲇⲱⲛ
ⲥⲓⲟⲟⲩⲛⲉ⳿	ⲥⲓⲟⲟⲩⲛⲉ
ⲥⲓⲟⲟⲩⲛⲉ	ⲥⲓⲟⲟⲩⲛⲉ
ⲥⲓⲟⲩⲣ	ⲥⲓⲟⲩⲣ
ⲥⲓⲟⲩⲣ`	ⲥⲓⲟⲩⲣ
ⲥⲓⲟⲩ	ⲥⲓⲟⲩ
ⲥⲓⲧⲉ	ⲥⲓⲧⲉ
ⲥⲓ	ⲥⲉⲓ
ⲥⲓ....ⲟⲩ	ⲥⲓ[....]ⲟⲩ
ⲥⲓ[....]ⲟⲩ	ⲥⲓ[....]ⲟⲩ
ⲥⲕⲁⲓ	ⲥⲕⲁⲓ
ⲥⲕⲁⲛⲇⲁⲗⲓⲍⲉ	ⲥⲕⲁⲛⲇⲁⲗⲓⲍⲉ
ⲥⲕⲁⲛⲇⲁⲗⲟⲛ	ⲥⲕⲁⲛⲇⲁⲗⲟⲛ
ⲥⲕⲉⲡⲁⲥⲧⲏⲥ	ⲥⲕⲉⲡⲁⲥⲧⲏⲥ
ⲥⲕⲉⲩⲏ	ⲥⲕⲉⲩⲏ
ⲥⲕⲏⲛⲏ	ⲥⲕⲏⲛⲏ
ⲥⲕⲗⲁⲇⲟⲥ	ⲥⲕⲗⲁⲇⲟⲥ
ⲥⲕⲣⲕⲣ	ⲥⲕⲣⲕⲣ
ⲥⲕⲩⲛⲏ	ⲥⲕⲩⲛⲏ
ⲥⲗⲁⲁⲧⲉ	ⲥⲗⲁⲁⲧⲉ
ⲥⲗⲡ	ⲥⲗⲡ
ⲥⲗⲥⲱⲗ	ⲥⲗⲥⲱⲗ
ⲥⲙ̣ⲁⲧⲁ̣ⲁ̣ⲁ̣	ⲥⲙⲁⲧⲁⲁⲁ
ⲥⲙⲁⲙⲁⲁⲧ⳿	ⲥⲙⲁⲙⲁⲁⲧ
ⲥⲙⲁⲙⲁⲁⲧ	ⲥⲙⲁⲙⲁⲁⲧ
ⲥⲙⲁⲧⲁⲁⲁ	ⲥⲙⲁⲧⲁⲁⲁ
ⲥⲙⲏ⳿	ⲥⲙⲏ
ⲥⲙⲏ	ⲥⲙⲏ
ⲥⲙⲓⲛⲉ	ⲥⲙⲓⲛⲉ
ⲥⲙⲓ︤ⲛ︥ⲉ`	ⲥⲙⲓⲛⲉ
ⲥⲙⲙⲉ	ⲥⲙⲙⲉ
ⲥⲙⲛ̄ⲧ	ⲥⲙⲛⲧ
ⲥⲙⲛ̄	ⲥⲙⲛ
ⲥⲙⲛⲛⲟⲙⲟⲥ	ⲥⲙⲛⲛⲟⲙⲟⲥ
ⲥⲙⲛⲟⲛ	ⲥⲙⲛⲟⲛ
ⲥⲙⲛⲧ	ⲥⲙⲛⲧ
ⲥⲙⲛ	ⲥⲙⲛ
ⲥⲙⲟⲛⲧ	ⲥⲙⲟⲛⲧ
ⲥⲙⲟⲛ︤ⲧ︥	ⲥⲙⲟⲛⲧ
ⲥⲙⲟⲧ	ⲥⲙⲟⲧ
ⲥⲙⲟⲧ`	ⲥⲙⲟⲧ
ⲥⲙⲟⲩ̣`	ⲥⲙⲟⲩ
ⲥⲙⲟⲩ	ⲥⲙⲟⲩ
ⲥⲙⲟⲩ`	ⲥⲙⲟⲩ
ⲥⲙ	ⲥⲙ
ⲥⲛ̇ⲧⲉ	ⲥⲛⲧⲉ
ⲥⲛⲁⲩ̂	ⲥⲛⲁⲩ
ⲥⲛⲁⲩϩ	ⲥⲛⲁⲩϩ
ⲥⲛⲁⲩ	ⲥⲛⲁⲩ
ⲥⲛⲁⲩ`	ⲥⲛⲁⲩ
ⲥⲛⲏⲩ̣	ⲥⲛⲏⲩ
ⲥⲛⲏⲩ⳿	ⲥⲛⲏⲩ
ⲥⲛⲏⲩ	ⲥⲛⲏⲩ
ⲥⲛⲏⲩ`	ⲥⲛⲏⲩ
ⲥⲛⲟϥ	ⲥⲛⲟϥ
ⲥⲛⲟⲟϥ	ⲥⲛⲟⲟϥ
ⲥⲛⲧⲉ	ⲥⲛⲧⲉ
ⲥⲛⲧ	ⲥⲛⲧ
ⲥⲟ̂	ⲥⲟ
ⲥⲟ̇ⲟ	ⲥⲟⲟ
ⲥⲟϣϥ	ⲥⲟϣϥ
ⲥⲟϣ︤ϥ︥	ⲥⲟϣϥ
ⲥⲟϣ	ⲥⲟϣ
ⲥⲟϭⲛ	ⲥⲟϭⲛ
ⲥⲟϭ︤ⲛ︥	ⲥⲟϭⲛ
ⲥⲟϭ	ⲥⲟϭ
ⲥⲟⲃϩ	ⲥⲟⲃϩ
ⲥⲟⲃⲕ	ⲥⲟⲃⲕ
ⲥⲟⲃⲧⲉ	ⲥⲟⲃⲧⲉ
ⲥⲟⲃⲧ	ⲥⲟⲃⲧ
ⲥⲟⲃ︤ⲧ︥	ⲥⲟⲃⲧ
ⲥⲟⲉⲓⲧ	ⲥⲟⲉⲓⲧ
ⲥⲟⲉⲓⲧ`	ⲥⲟⲉⲓⲧ
ⲥⲟⲉⲓ	ⲥⲟⲉⲓ
ⲥⲟⲓ	ⲥⲟⲓ
ⲥⲟⲗⲟⲙⲱⲛ	ⲥⲟⲗⲟⲙⲱⲛ
ⲥⲟⲗⲥⲗ	ⲥⲟⲗⲥⲗ
ⲥⲟⲛ̇	ⲥⲟⲛ
ⲥⲟⲛϩ̄	ⲥⲟⲛϩ
ⲥⲟⲛϩ︤	ⲥⲟⲛϩ
ⲥⲟⲛϩ	ⲥⲟⲛϩ
ⲥⲟⲛⲧ	ⲥⲟⲛⲧ
ⲥⲟⲛ	ⲥⲟⲛ
ⲥⲟⲛ`	ⲥⲟⲛ
ⲥⲟⲟ̇ⲩⲛ̇	ⲥⲟⲟⲩⲛ
ⲥⲟⲟϥ	ⲥⲟⲟϥ
ⲥⲟⲟϩⲉ	ⲥⲟⲟϩⲉ
ⲥⲟⲟϩⲉ`	ⲥⲟⲟϩⲉ
ⲥⲟⲟⲛⲉ	ⲥⲟⲟⲛⲉ
ⲥⲟⲟⲧ	ⲥⲟⲟⲧ
ⲥⲟⲟⲩϩⲥ̇	ⲥⲟⲟⲩϩⲥ
ⲥⲟⲟⲩϩⲥ	ⲥⲟⲟⲩϩⲥ
ⲥⲟⲟⲩϩ	ⲥⲟⲟⲩϩ
ⲥⲟⲟⲩⲛ̄	ⲥⲟⲟⲩⲛ
ⲥⲟⲟⲩⲛ̇	ⲥⲟⲟⲩⲛ
ⲥⲟⲟⲩⲛ⳿	ⲥⲟⲟⲩⲛ
ⲥⲟⲟⲩⲛ	ⲥⲟⲟⲩⲛ
ⲥⲟⲟⲩⲛ`	ⲥⲟⲟⲩⲛ
ⲥⲟⲟⲩⲧⲛ̄	ⲥⲟⲟⲩⲧⲛ
ⲥⲟⲟⲩⲧⲛ	ⲥⲟⲟⲩⲧⲛ
ⲥⲟⲟⲩⲧ︤ⲛ︥	ⲥⲟⲟⲩⲧⲛ
ⲥⲟⲟⲩ⳯	ⲥⲟⲟⲩⲛ
ⲥⲟⲟⲩ⳯ ⳿	ⲥⲟⲟⲩⲛ
ⲥⲟⲟⲩ⳯ 	ⲥⲟⲟⲩⲛ
ⲥⲟⲟⲩ	ⲥⲟⲟⲩ
ⲥⲟⲟ	ⲥⲟⲟ
ⲥⲟⲟ[ⲩⲛ]	ⲥⲟⲟⲩⲛ
ⲥⲟⲡ̣ⲥ	ⲥⲟⲡⲥ
ⲥⲟⲡⲥ̄	ⲥⲟⲡⲥ
ⲥⲟⲡⲥ	ⲥⲟⲡⲥ
ⲥⲟⲡ︤ⲥ︥	ⲥⲟⲡⲥ
ⲥⲟⲡ	ⲥⲟⲡ
ⲥⲟⲡ.	ⲥⲟⲡ[.]
ⲥⲟⲡ[.]	ⲥⲟⲡ[.]
ⲥⲟⲡ`	ⲥⲟⲡ
ⲥⲟⲣⲙ̇	ⲥⲟⲣⲙ
ⲥⲟⲣⲙⲉ	ⲥⲟⲣⲙⲉ
ⲥⲟⲣⲙ	ⲥⲟⲣⲙ
ⲥⲟⲣ︤	ⲥⲟⲣ
ⲥⲟⲣ	ⲥⲟⲣ
ⲥⲟⲣ]ⲙ	ⲥⲟⲣⲙ
ⲥⲟⲧϥ	ⲥⲟⲧϥ
ⲥⲟⲧⲙ	ⲥⲟⲧⲙ
ⲥⲟⲧⲡ︤	ⲥⲟⲧⲡ
ⲥⲟⲧⲡ	ⲥⲟⲧⲡ
ⲥⲟⲧ︤ϥ︥	ⲥⲟⲧϥ
ⲥⲟⲧ︤ⲡ︥	ⲥⲟⲧⲡ
ⲥⲟⲧ︤ⲡ︥`	ⲥⲟⲧⲡ
ⲥⲟⲧ︤︥ⲡ	ⲥⲟⲧⲡ
ⲥⲟⲧ︤	ⲥⲟⲧ
ⲥⲟⲧ	ⲥⲟⲧ
ⲥⲟⲩⲁ	ⲥⲟⲩⲟⲩⲁ
ⲥⲟⲩⲉ̇ⲛ	ⲥⲟⲩⲉⲛ
ⲥⲟⲩⲉⲛⲧ	ⲥⲟⲩⲉⲛⲧ
ⲥⲟⲩⲉⲛ	ⲥⲟⲩⲛ
ⲥⲟⲩⲛ̄	ⲥⲟⲩⲛ
ⲥⲟⲩⲛ̇ⲧ	ⲥⲟⲩⲛⲧ
ⲥⲟⲩⲛ⟨ⲛ⟩	ⲥⲟoⲩⲛ
ⲥⲟⲩⲛⲧ	ⲥⲟⲩⲛⲧ
ⲥⲟⲩⲛ	ⲥⲟⲩⲛ
ⲥⲟⲩⲟ̂	ⲥⲟⲩⲟ
ⲥⲟⲩⲟ	ⲥⲟⲩⲟ
ⲥⲟⲩⲧⲛ	ⲥⲟⲩⲧⲛ
ⲥⲟⲩⲧⲱⲛ	ⲥⲟⲩⲧⲱⲛ
ⲥⲟⲩⲧ︤ⲛ︥	ⲥⲟⲩⲧⲛ
ⲥⲟⲩⲱ̂ⲛ̄	ⲥⲟⲩⲱⲛ
ⲥⲟⲩⲱ̂ⲛ︤	ⲥⲟⲩⲱⲛ
ⲥⲟⲩⲱ̇ⲛ	ⲥⲟⲩⲱⲛ
ⲥⲟⲩⲱⲛ︤	ⲥⲟⲩⲱⲛ
ⲥⲟⲩⲱⲛ	ⲥⲟⲩⲱⲛ
ⲥⲟⲩ	ⲥⲟⲩ
ⲥⲟⲫⲓⲁ	ⲥⲟⲫⲓⲁ
ⲥⲟⲫⲟⲥ	ⲥⲟⲫⲟⲥ
ⲥⲟ⳿	ⲥⲟ
ⲥⲟ	ⲥⲟ
ⲥⲟ`	ⲥⲟ
ⲥⲡⲉⲕⲟⲩⲗⲁⲧⲱⲣ	ⲥⲡⲉⲕⲟⲩⲗⲁⲧⲱⲣ
ⲥⲡⲉⲣⲙⲁ	ⲥⲡⲉⲣⲙⲁ
ⲥⲡⲉⲣⲙⲁ`	ⲥⲡⲉⲣⲙⲁ
ⲥⲡⲏⲗⲁⲓⲟⲛ	ⲥⲡⲏⲗⲁⲓⲟⲛ
ⲥⲡⲓⲣⲁ	ⲥⲡⲓⲣⲁ
ⲥⲡⲟⲅⲅⲟⲥ	ⲥⲡⲟⲅⲅⲟⲥ
ⲥⲡⲟⲧⲟⲩ	ⲥⲡⲟⲧⲟⲩ
ⲥⲡⲟⲩⲇⲁⲍⲉ	ⲥⲡⲟⲩⲇⲁⲍⲉ
ⲥⲡⲟⲩⲇⲏ	ⲥⲡⲟⲩⲇⲏ
ⲥⲡ	ⲥⲡ
ⲥⲣϥⲉ	ⲥⲣϥⲉ
ⲥⲣⲁϩⲧ	ⲥⲣⲁϩⲧ
ⲥⲣⲁϩ︤ⲧ︥	ⲥⲣⲁϩⲧ
ⲥⲣⲉϥⲣⲓϥⲉ	ⲥⲣⲉϥⲣⲓϥⲉ
ⲥⲣⲙⲣⲱⲙ	ⲥⲣⲙⲣⲱⲙ
ⲥⲣⲟϥⲧ	ⲥⲣⲟϥⲧ
ⲥⲣ︤ⲙ︥ⲣⲱⲙ	ⲥⲣⲙⲣⲱⲙ
ⲥⲣ	ⲥⲣ
ⲥⲧⲁⲇⲓⲟⲛ	ⲥⲧⲁⲇⲓⲟⲛ
ⲥⲧⲁⲥⲓⲁⲍⲉ	ⲥⲧⲁⲥⲓⲁⲍⲉ
ⲥⲧⲁⲥⲓⲥ	ⲥⲧⲁⲥⲓⲥ
ⲥⲧⲁⲩⲣⲟⲥ	ⲥⲧⲁⲩⲣⲟⲥ
ⲥⲧⲁⲩⲣⲟⲩ	ⲥⲧⲁⲩⲣⲟⲩ
ⲥⲧⲉⲣⲉⲱⲙⲁ	ⲥⲧⲉⲣⲉⲱⲙⲁ
ⲥⲧⲉⲫⲁⲛⲁ	ⲥⲧⲉⲫⲁⲛⲁ
ⲥⲧⲏⲗⲏ	ⲥⲧⲏⲗⲏ
ⲥⲧⲏⲙ	ⲥⲧⲏⲙ
ⲥⲧⲟⲓ̈	ⲥⲧⲟⲓ
ⲥⲧⲟⲓⲭⲉⲓ	ⲥⲧⲟⲓⲭⲉⲓ
ⲥⲧⲟⲓ	ⲥⲧⲟⲓ
ⲥⲧⲟⲗⲁⲣⲭⲏ	ⲥⲧⲟⲗⲁⲣⲭⲏⲥ
ⲥⲧⲟⲗⲏ	ⲥⲧⲟⲗⲏ
ⲥⲧⲟ	ⲥⲧⲟ
ⲥⲧⲣⲁⲧⲉⲩⲙⲁ	ⲥⲧⲣⲁⲧⲉⲩⲙⲁ
ⲥⲧⲣⲁⲧⲏⲗⲁⲧⲏⲥ	ⲥⲧⲣⲁⲧⲏⲗⲁⲧⲏⲥ
ⲥⲧⲩⲗⲏ	ⲥⲧⲩⲗⲏ
ⲥⲧⲩⲗⲗⲟⲥ	ⲥⲧⲩⲗⲗⲟⲥ
ⲥⲧⲱⲧ	ⲥⲧⲱⲧ
ⲥⲩⲅⲅⲉⲛⲏⲥ	ⲥⲩⲅⲅⲉⲛⲏⲥ
ⲥⲩⲅⲕⲗⲏⲧⲓ̇ⲕⲏ	ⲥⲩⲅⲕⲗⲏⲧⲓⲕⲏ
ⲥⲩⲅⲕⲗⲏⲧⲓⲕⲏ	ⲥⲩⲅⲕⲗⲏⲧⲓⲕⲏ
ⲥⲩⲙⲃⲟⲩⲗⲉⲩⲉ	ⲥⲩⲙⲃⲟⲩⲗⲉⲩⲉ
ⲥⲩⲙⲃⲟⲩⲗⲉⲩⲉ`	ⲥⲩⲙⲃⲟⲩⲗⲉⲩⲉ
ⲥⲩⲛϩⲉⲇⲣⲓⲟⲛ	ⲥⲩⲛϩⲉⲇⲣⲓⲟⲛ
ⲥⲩⲛⲁⲅⲟⲅⲏ	ⲥⲩⲛⲁⲅⲱⲅⲏ
ⲥⲩⲛⲁⲅⲟⲅⲏ`	ⲥⲩⲛⲁⲅⲱⲅⲏ
ⲥⲩⲛⲁⲅⲱⲅⲏ	ⲥⲩⲛⲁⲅⲱⲅⲏ
ⲥⲩⲛⲁⲅⲱⲅⲏ`	ⲥⲩⲛⲁⲅⲱⲅⲏ
ⲥⲩⲛⲁⲝⲓⲥ	ⲥⲩⲛⲁⲝⲓⲥ
ⲥⲩⲛⲃⲓⲁ	ⲥⲩⲛⲃⲓⲁ
ⲥⲩⲛⲅⲛⲱⲙⲏ	ⲥⲩⲛⲅⲛⲱⲙⲏ
ⲥⲩⲛⲉⲓⲇⲏⲥⲓⲥ	ⲥⲩⲛⲉⲓⲇⲏⲥⲓⲥ
ⲥⲩⲛⲍⲏⲧⲏⲧⲏⲥ	ⲥⲩⲛⲍⲏⲧⲏⲧⲏⲥ
ⲥⲩⲛⲏⲑⲓⲁ	ⲥⲩⲛⲏⲑⲓⲁ
ⲥⲩⲛⲓⲇⲏⲥⲓⲥ	ⲥⲩⲛⲉⲓⲇⲏⲥⲓⲥ
ⲥⲩⲛⲓⲑⲓⲁ	ⲥⲩⲛⲏⲑⲉⲓⲁ
ⲥⲩⲛⲕ̇ⲗⲏⲧⲓ̇ⲕⲏ	ⲥⲩⲛⲕⲗⲏⲧⲓⲕⲏ
ⲥⲩⲛⲕ̇ⲗⲏⲧⲓ̇ⲕⲟⲥ	ⲥⲩⲛⲕⲗⲏⲧⲓⲕⲟⲥ
ⲥⲩⲛⲕⲉⲣⲁ	ⲥⲩⲅⲕⲉⲣⲁ
ⲥⲩⲛⲕⲗⲏⲧⲓⲕⲏ	ⲥⲩⲛⲕⲗⲏⲧⲓⲕⲏ
ⲥⲩⲛⲕⲗⲏⲧⲓⲕⲟⲥ	ⲥⲩⲛⲕⲗⲏⲧⲓⲕⲟⲥ
ⲥⲩⲛⲕⲗⲓϯⲕⲟⲥ	ⲥⲩⲛⲕⲗⲓϯⲕⲟⲥ
ⲥⲩⲛⲧⲉⲗⲉⲓⲁ	ⲥⲩⲛⲧⲉⲗⲉⲓⲁ
ⲥⲩⲛⲧⲉⲗⲓⲁ	ⲥⲩⲛⲧⲉⲗⲓⲁ
ⲥⲩⲛⲧⲉⲗⲓⲁ`	ⲥⲩⲛⲧⲉⲗⲓⲁ
ⲥⲩⲛ	ⲥⲩⲛ
ⲥⲩⲣⲁ	ⲥⲩⲣⲁ
ⲥⲩⲣⲁ`	ⲥⲩⲣⲁ
ⲥⲩⲣⲉ	ⲥⲩⲣⲉ
ⲥⲩⲣⲓⲁ	ⲥⲩⲣⲓⲁ
ⲥⲫⲁⲅⲓⲁ	ⲥⲫⲁⲅⲓⲁ
ⲥⲫⲁⲗⲙⲁ	ⲥⲫⲁⲗⲙⲁ
ⲥⲫⲣⲁⲅⲓⲥ	ⲥⲫⲣⲁⲅⲓⲥ
ⲥⲭⲏⲙⲁ	ⲥⲭⲏⲙⲁ
ⲥⲭⲩⲙⲁ	ⲥⲭⲏⲙⲁ
ⲥⲱ̇	ⲥⲱ
ⲥⲱϣϥ	ⲥⲱϣϥ
ⲥⲱϣⲉ	ⲥⲱϣⲉ
ⲥⲱϣⲉ`	ⲥⲱϣⲉ
ⲥⲱϣⲙ	ⲥⲱϣⲙ
ⲥⲱϣ︤ϥ︥	ⲥⲱϣϥ
ⲥⲱϣ	ⲥⲱϣ
ⲥⲱ᷍	ⲥⲱ
ⲥⲱⲃⲁϩ	ⲥⲱⲃⲁϩ
ⲥⲱⲃⲉ	ⲥⲱⲃⲉ
ⲥⲱⲕ	ⲥⲱⲕ
ⲥⲱⲙⲁ	ⲥⲱⲙⲁ
ⲥⲱⲙⲁ`	ⲥⲱⲙⲁ
ⲥⲱⲛ̄ⲧ	ⲥⲱⲛⲧ
ⲥⲱⲛⲉ	ⲥⲱⲛⲉ
ⲥⲱⲛⲉ`	ⲥⲱⲛⲉ
ⲥⲱⲛⲧ	ⲥⲱⲛⲧ
ⲥⲱⲛ︤ⲧ︥	ⲥⲱⲛⲧ
ⲥⲱⲛ	ⲥⲱⲛ
ⲥⲱⲟⲩϩ̄	ⲥⲱⲟⲩϩ
ⲥⲱⲟⲩϩ̇	ⲥⲱⲟⲩϩ
ⲥⲱⲟⲩϩ⳿	ⲥⲱⲟⲩϩ
ⲥⲱⲟⲩϩ	ⲥⲱⲟⲩϩ
ⲥⲱⲟⲩ	ⲥⲱⲟⲩ
ⲥⲱⲣⲙ̄	ⲥⲱⲣⲙ
ⲥⲱⲣⲙ	ⲥⲱⲣⲙ
ⲥⲱⲣ︤ⲙ︥	ⲥⲱⲣⲙ
ⲥⲱⲥⲑⲉⲛⲏⲥ	ⲥⲱⲥⲑⲉⲛⲏⲥ
ⲥⲱⲧϥ	ⲥⲱⲧϥ
ⲥⲱⲧⲉ⳿	ⲥⲱⲧⲉ
ⲥⲱⲧⲉ	ⲥⲱⲧⲉ
ⲥⲱⲧⲉ`	ⲥⲱⲧⲉ
ⲥⲱⲧⲏⲣⲓⲁ	ⲥⲱⲧⲏⲣⲓⲁ
ⲥⲱⲧⲏⲣ	ⲥⲱⲧⲏⲣ
ⲥⲱⲧⲙ̄	ⲥⲱⲧⲙ
ⲥⲱⲧⲙ̇	ⲥⲱⲧⲙ
ⲥⲱⲧⲙ	ⲥⲱⲧⲙ
ⲥⲱⲧⲡ̇	ⲥⲱⲧⲡ
ⲥⲱⲧⲡ⳯	ⲥⲱⲧⲡ
ⲥⲱⲧⲡ	ⲥⲱⲧⲡ
ⲥⲱⲧ⳿	ⲥⲱⲧ
ⲥⲱⲧ︤ⲙ︥	ⲥⲱⲧⲙ
ⲥⲱⲧ︤︥ⲙ	ⲥⲱⲧⲙ
ⲥⲱⲧ	ⲥⲱⲧ
ⲥⲱⲧ`	ⲥⲱⲧ
ⲥⲱⲱϥ⳿	ⲥⲱⲱϥ
ⲥⲱⲱϥ	ⲥⲱⲱϥ
ⲥⲱⲱⲡ	ⲥⲱⲱⲡ
ⲥⲱⲱ	ⲥⲱⲱ
ⲥⲱ⳯	ⲥⲱⲛ
ⲥⲱ	ⲥⲱ
ⲥⳁⲟⲥ	ⲥⲧⲁⲩⲣⲟⲥ
ⲥⳁⲟⲥ`	ⲥⲧⲁⲩⲣⲟⲥ
ⲥⳁⲟⲩ	ⲥⲧⲁⲩⲣⲟⲩ
ⲥ⳨ⲟⲥ	ⲥⲧⲁⲩⲣⲟⲥ
ⲥ⳿ϩⲟⲩⲟⲣ︤ⲧ︥	ⲥϩⲟⲩⲟⲣⲧ
ⲥ⳿	ⲥ
ⲥ︤ϩ︥ⲟⲩⲟⲣ︤ⲧ︥	ⲥϩⲟⲩⲟⲣⲧ
ⲥ︤ⲃ︥ⲧⲱⲧ	ⲥⲃⲧⲱⲧ
ⲥ︤ⲙ︥ⲙⲉ	ⲥⲙⲙⲉ
ⲥ︤ⲙ︥	ⲥⲙ
ⲥ︤ⲛ︥ⲧⲉ`	ⲥⲛⲧⲉ
ⲥ︤ⲣ︥ϥⲉ⳿	ⲥⲣϥⲉ
ⲥ︤ⲣ︥ϥⲉ	ⲥⲣϥⲉ
ⲥ︥	ⲥ
ⲥ	ⲥ
ⲥ 	ⲥ 
ⲥ[ⲧⲟⲓⲭⲉⲓ]	ⲥⲧⲟⲓⲭⲉⲓ
ⲥ]ⲉ̣	ⲥⲉ
ⲥ`	ⲥ
ⲦⲀⲒⲎⲨ	ⲧⲁⲓⲏⲩ
Ⲧⲁⲓ̈	ⲧⲁⲓ
Ⲧⲁⲓ	ⲧⲁⲓ
Ⲧⲉ	ⲧⲉ
ⲦⲎⲢ	ⲧⲏⲣ
ⲦⲚ̄	ⲧⲛ
ⲦⲚ	ⲧⲛ
Ⲧⲟⲧⲉ	ⲧⲟⲧⲉ
Ⲧⲱⲙ̂	ⲧⲱⲙ
Ⲧⲱⲙ	ⲧⲱⲙ
Ⲧ	ⲧ
ⲧ̄ⲛ	ⲧⲛ
ⲧ̄ⲧ̄	ⲧⲧ
ⲧ̄	ⲧ
ⲧ̄[	ⲧ
ⲧ̇ϭⲁⲓ̇ⲟ	ⲧϭⲁⲓⲟ
ⲧ̇ⲙⲏ	ⲧⲙⲏ
ⲧ̇ⲣⲉ	ⲧⲣⲉ
ⲧ̇ⲣ	ⲧⲣ
ⲧ̇ⲱⲟⲩⲛ̇	ⲧⲱⲟⲩⲛ
ⲧ̇	ⲧ
ⲧ̣ⲁⲓ	ⲧⲁⲓ
ⲧ̣ⲉ	ⲧⲉ
ⲧ̣ⲙ̣	ⲧⲙ
ⲧ̣ⲙ	ⲧⲙ
ⲧ̣ⲛ	ⲧⲛ
ⲧ̣ⲟ̣ⲡⲟⲥ	ⲧⲟⲡⲟⲥ
ⲧ̣ⲟⲟⲧ	ⲧⲟⲟⲧ
ⲧ̣ⲣⲓⲧⲟⲛ	ⲧⲣⲓⲧⲟⲛ
ⲧ̣︤ⲛ̣̄	ⲧⲛ
ⲧ̣	ⲧ
ⲧϣⲟⲟⲡ	ⲧϣⲟⲟⲡ
ⲧϩⲛⲉⲣⲱⲙⲉ	ⲧϩⲛⲉⲣⲱⲙⲉ
ⲧϭⲁⲉⲓⲟ̂	ⲧϭⲁⲉⲓⲟ
ⲧϭⲁⲉⲓⲟ	ⲧϭⲁⲉⲓⲟ
ⲧϭⲁⲓ̈ⲉ	ⲧϭⲁⲓⲉ
ⲧϭⲁⲓ̈ⲏⲩ`	ⲧϭⲁⲓⲏⲩ
ⲧϭⲁⲓⲉ	ⲧϭⲁⲓⲉ
ⲧϭⲁⲓⲏⲩ	ⲧϭⲁⲓⲏⲩ
ⲧϭⲁⲓⲟ	ⲧϭⲁⲓⲟ
ⲧⲁ̇ⲁ	ⲧⲁⲁ
ⲧⲁϣⲉⲟ̄ⲉⲓϣ	ⲧⲁϣⲉⲟⲉⲓϣ
ⲧⲁϣⲉⲟⲉⲓϣ	ⲧⲁϣⲉⲟⲉⲓϣ
ⲧⲁϣⲉⲟⲓϣ	ⲧⲁϣⲉⲟⲉⲓϣ
ⲧⲁϣⲉ	ⲧⲁϣⲉ
ⲧⲁϣⲟ̂	ⲧⲁϣⲟ
ⲧⲁϣⲟ	ⲧⲁϣⲟ
ⲧⲁϥ	ⲧⲁϥ
ⲧⲁϩⲉ	ⲧⲁϩⲉ
ⲧⲁϩⲙ	ⲧⲁϩⲙ
ⲧⲁϩⲟ	ⲧⲁϩⲟ
ⲧⲁϩⲥ	ⲧⲁϩⲥ
ⲧⲁϩⲱ	ⲧⲁϩⲱ
ⲧⲁϩ︤ⲙ︥	ⲧⲁϩⲙ
ⲧⲁϩ︤ⲥ︥	ⲧⲁϩⲥ
ⲧⲁϩ	ⲧⲁϩ
ⲧⲁϫⲣⲉ	ⲧⲁϫⲣⲉ
ⲧⲁϫⲣⲏⲩ	ⲧⲁϫⲣⲏⲩ
ⲧⲁϫⲣⲟ̂	ⲧⲁϫⲣⲟ
ⲧⲁϫⲣⲟ	ⲧⲁϫⲣⲟ
ⲧⲁϭⲥⲉ	ⲧⲁϭⲥⲉ
ⲧⲁⲁⲁ̇	ⲧⲁⲁⲁ
ⲧⲁⲁⲁ	ⲧⲁⲁⲁ
ⲧⲁⲁⲧ	ⲧⲁⲁⲧ
ⲧⲁⲁ	ⲧⲁⲁ
ⲧⲁⲅⲙⲁ	ⲧⲁⲅⲙⲁ
ⲧⲁⲉ̣[ⲓⲏⲩ	ⲧⲁⲉⲓⲏⲩ
ⲧⲁⲉⲓ̇ⲏⲩ	ⲧⲁⲉⲓⲏⲩ
ⲧⲁⲉⲓⲉ	ⲧⲁⲉⲓⲉ
ⲧⲁⲉⲓⲏⲩ	ⲧⲁⲉⲓⲏⲩ
ⲧⲁⲉⲓⲟ̂	ⲧⲁⲉⲓⲟ
ⲧⲁⲉⲓⲟ	ⲧⲁⲉⲓⲟ
ⲧⲁⲓ̇ⲟ	ⲧⲁⲓⲟ
ⲧⲁⲓ̇	ⲧⲁⲓ
ⲧⲁⲓ̈ⲉ⳿	ⲧⲁⲓⲉ
ⲧⲁⲓ̈ⲏⲩ	ⲧⲁⲓⲏⲩ
ⲧⲁⲓ̈ⲟ̂	ⲧⲁⲓⲟ
ⲧⲁⲓ̈ⲟ	ⲧⲁⲓⲟ
ⲧⲁⲓ̈	ⲧⲁⲓ
ⲧⲁⲓⲉ	ⲧⲁⲓⲉ
ⲧⲁⲓⲏⲩ	ⲧⲁⲓⲏⲩ
ⲧⲁⲓⲟ̄	ⲧⲁⲉⲓⲟ
ⲧⲁⲓⲟ̇	ⲧⲁⲓⲟ
ⲧⲁⲓⲟⲩ	ⲧⲁⲉⲓⲟⲩ
ⲧⲁⲓⲟ	ⲧⲁⲉⲓⲟ
ⲧⲁⲓ	ⲧⲁⲓ
ⲧⲁⲕⲉϩⲟⲓⲛⲉ	ⲧⲁⲕⲉϩⲟⲓⲛⲉ
ⲧⲁⲕⲉ	ⲧⲁⲕⲉ
ⲧⲁⲕⲟ̂	ⲧⲁⲕⲟ
ⲧⲁⲕⲟ	ⲧⲁⲕⲟ
ⲧⲁⲗϭⲟ	ⲧⲁⲗϭⲟ
ⲧⲁⲗⲁⲓⲡⲱⲣⲟⲥ	ⲧⲁⲗⲁⲓⲡⲱⲣⲟⲥ
ⲧⲁⲗⲉⲓⲑⲁ	ⲧⲁⲗⲉⲓⲑⲁ
ⲧⲁⲗⲉ	ⲧⲁⲗⲉ
ⲧⲁⲗⲟ̂	ⲧⲁⲗⲟ
ⲧⲁⲗⲟ	ⲧⲁⲗⲟ
ⲧⲁⲙⲉⲓⲟⲛ	ⲧⲁⲙⲉⲓⲟⲛ
ⲧⲁⲙⲉ	ⲧⲁⲙⲉ
ⲧⲁⲙⲓ̈ⲟⲛ	ⲧⲁⲙⲓⲉⲓⲟⲛ
ⲧⲁⲙⲓ̈ⲟ	ⲧⲁⲙⲓⲟ
ⲧⲁⲙⲓⲉ	ⲧⲁⲙⲓⲉ
ⲧⲁⲙⲓⲟ̂	ⲧⲁⲙⲓⲟ
ⲧⲁⲙⲓⲟⲛ	ⲧⲁⲙⲉⲓⲟⲛ
ⲧⲁⲙⲓⲟ	ⲧⲁⲙⲓⲟ
ⲧⲁⲙⲓⲟ`	ⲧⲁⲙⲓⲟ
ⲧⲁⲙⲓⲱ	ⲧⲁⲙⲓⲱ
ⲧⲁⲙⲙⲉ	ⲧⲁⲙⲙⲉ
ⲧⲁⲙⲟ̂	ⲧⲁⲙⲟ
ⲧⲁⲙⲟⲓ̈	ⲧⲁⲙⲟⲓ
ⲧⲁⲙⲟⲓ	ⲧⲁⲙⲟⲓ
ⲧⲁⲙⲟ	ⲧⲁⲙⲟ
ⲧⲁⲙⲱ	ⲧⲁⲙⲱ
ⲧⲁⲛϩⲉ	ⲧⲁⲛϩⲉ
ⲧⲁⲛϩⲟⲩⲧ	ⲧⲁⲛϩⲟⲩⲧ
ⲧⲁⲛϩⲟ	ⲧⲁⲛϩⲟ
ⲧⲁⲝⲓⲥ	ⲧⲁⲝⲓⲥ
ⲧⲁⲟⲩⲉ	ⲧⲁⲟⲩⲉ
ⲧⲁⲟⲩⲟ	ⲧⲁⲟⲩⲟ
ⲧⲁⲡⲣⲟ̂	ⲧⲁⲡⲣⲟ
ⲧⲁⲡⲣⲟ	ⲧⲁⲡⲣⲟ
ⲧⲁⲡ[ⲣⲟ	ⲧⲁⲡⲣⲟ
ⲧⲁⲣⲉ	ⲧⲁⲣⲉ
ⲧⲁⲣⲧⲁⲣⲟⲥ	ⲧⲁⲣⲧⲁⲣⲟⲥ
ⲧⲁⲣ︤	ⲧⲁⲣ
ⲧⲁⲣ	ⲧⲁⲣ
ⲧⲁⲩⲉ̇	ⲧⲁⲩⲉ
ⲧⲁⲩⲉⲥϩⲃⲏⲓⲧⲉ	ⲧⲁⲩⲉⲥϩⲃⲏⲓⲧⲉ
ⲧⲁⲩⲉ⳿	ⲧⲁⲩⲉ
ⲧⲁⲩⲉ	ⲧⲁⲩⲉ
ⲧⲁⲩⲟ̂	ⲧⲁⲩⲟ
ⲧⲁⲩⲟⲩⲟ	ⲧⲁⲩⲟⲩⲟ
ⲧⲁⲩⲟ	ⲧⲁⲩⲟ
ⲧⲁⲭⲁ	ⲧⲁⲭⲁ
ⲧⲁⲭⲏ	ⲧⲁⲭⲏ
ⲧⲁⲭⲩ	ⲧⲁⲭⲩ
ⲧⲁ	ⲧⲁ
ⲧⲁ[ⲁ]	ⲧⲁⲁ
ⲧⲃ̄ⲃⲟ	ⲧⲃⲃⲟ
ⲧⲃ̄ⲧⲃ̄	ⲧⲟⲃⲧⲃ
ⲧⲃⲁ	ⲧⲃⲁ
ⲧⲃⲃⲉ	ⲧⲃⲃⲉ
ⲧⲃⲃⲏⲩ	ⲧⲃⲃⲏⲩ
ⲧⲃⲃⲟ	ⲧⲃⲃⲟ
ⲧⲃⲛⲏ	ⲧⲃⲛⲏ
ⲧⲃⲛⲟⲟⲩⲉ	ⲧⲃⲛⲟⲟⲩⲉ
ⲧⲃⲧⲃ	ⲧⲟⲃⲧⲃ
ⲧⲃⲧ	ⲧⲃⲧ
ⲧⲉ̇ⲓ̇	ⲧⲉⲓ
ⲧⲉϣ	ⲧⲉϣ
ⲧⲉϥ̣	ⲧⲉϥ
ⲧⲉϥ	ⲧⲉϥ
ⲧⲉϩⲙ	ⲧⲉϩⲙ
ⲧⲉϩⲛⲉ	ⲧⲉϩⲛⲉ
ⲧⲉϩⲥ	ⲧⲉϩⲥ
ⲧⲉϩ︤ⲥ︥	ⲧⲉϩⲥ
ⲧⲉⲉⲓ	ⲧⲉⲓ
ⲧⲉⲓ̇	ⲧⲉⲓ
ⲧⲉⲓ̈	ⲧⲉⲓ
ⲧⲉⲓ	ⲧⲉⲓ
ⲧⲉⲕⲙ	ⲧⲉⲕⲙ
ⲧⲉⲕ	ⲧⲉⲕ
ⲧⲉⲗⲉⲓⲟⲥ	ⲧⲉⲗⲉⲓⲟⲥ
ⲧⲉⲗⲱⲛⲏⲥ	ⲧⲉⲗⲱⲛⲏⲥ
ⲧⲉⲗⲱⲛⲏⲥ`	ⲧⲉⲗⲱⲛⲏⲥ
ⲧⲉⲗⲱⲛⲓⲟⲛ	ⲧⲉⲗⲱⲛⲓⲟⲛ
ⲧⲉⲚⲟⲩ	ⲧⲉⲛⲟⲩ
ⲧⲉⲛ̣[ⲟⲩ]	ⲧⲉⲛⲟⲩ
ⲧⲉⲛⲟⲩ⳿	ⲧⲉⲛⲟⲩ
ⲧⲉⲛⲟⲩ	ⲧⲉⲛⲟⲩ
ⲧⲉⲛⲟⲩ`	ⲧⲉⲛⲟⲩ
ⲧⲉⲛ	ⲧⲉⲛ
ⲧⲉⲛ[ⲟⲩ]	ⲧⲉⲛⲟⲩ
ⲧⲉⲥⲙⲛⲧ	ⲧⲉⲥ
ⲧⲉⲥⲙ︤ⲛ︦ⲧ︥	ⲧⲉⲥ
ⲧⲉⲥ	ⲧⲉⲥ
ⲧⲉⲧ̇ⲛ̇	ⲧⲉⲧⲛ
ⲧⲉⲧ̇ⲛ	ⲧⲉⲧⲛ
ⲧⲉⲧⲛ̄	ⲧⲉⲧⲛ
ⲧⲉⲧⲛ̇	ⲧⲉⲧⲛ
ⲧⲉⲧⲛ︥	ⲧⲉⲧⲛ
ⲧⲉⲧⲛ	ⲧⲉⲧⲛ
ⲧⲉⲧ︤ⲛ︥	ⲧⲉⲧⲛ
ⲧⲉⲧ	ⲧⲉⲧⲛ
ⲧⲉⲩ	ⲧⲉⲩ
ⲧⲉⲭⲛⲉ	ⲧⲉⲭⲛⲉ
ⲧⲉⲭⲛⲏ	ⲧⲉⲭⲛⲏ
ⲧⲉ⳯	ⲧⲉⲛ
ⲧⲉ⳿	ⲧⲉ
ⲧⲉ	ⲧⲉ
ⲧⲉ[ⲛ]ⲟⲩ	ⲧⲉⲛⲟⲩ
ⲧⲏ̇ⲣ	ⲧⲏⲣ
ⲧⲏ̇ⲩⲧ︤ⲛ︥	ⲧⲏⲩⲧⲛ
ⲧⲏ̣ϣ̣	ⲧⲏϣ
ⲧⲏϣ	ⲧⲏϣ
ⲧⲏϩ	ⲧⲏϩ
ⲧⲏϭ	ⲧⲏϭ
ⲧⲏⲏⲃⲉ	ⲧⲏⲏⲃⲉ
ⲧⲏⲕ	ⲧⲏⲕ
ⲧⲏⲙ	ⲧⲏⲙ
ⲧⲏⲛⲟⲩ	ⲧⲏⲛⲟⲩ
ⲧⲏⲣ̇	ⲧⲏⲣ
ⲧⲏⲣ̣	ⲧⲏⲣ
ⲧⲏⲣϥ	ⲧⲏⲣϥ
ⲧⲏⲣ︤ϥ︥	ⲧⲏⲣϥ
ⲧⲏⲣ︤	ⲧⲏⲣ
ⲧⲏⲣ	ⲧⲏⲣ
ⲧⲏⲧⲛ	ⲧⲏⲧⲛ
ⲧⲏⲩⲗⲟ	ⲧⲏⲩⲗⲟ
ⲧⲏⲩⲛ	ⲧⲏⲩⲧⲛ
ⲧⲏⲩⲧⲛ̄	ⲧⲏⲩⲧⲛ
ⲧⲏⲩⲧⲛ	ⲧⲏⲩⲧⲛ
ⲧⲏⲩⲧ︤ⲛ︥	ⲧⲏⲩⲧⲛ
ⲧⲏⲩⲧ︤︥ⲛ	ⲧⲏⲩⲧⲛ
ⲧⲏⲩ	ⲧⲏⲩ
ⲧⲏ	ⲧⲏ
ⲧⲓ̈	ⲧⲓ
ⲧⲓⲙⲁⲓⲟⲥ	ⲧⲓⲙⲁⲓⲟⲥ
ⲧⲓⲙⲏ⳿	ⲧⲓⲙⲏ
ⲧⲓⲙⲏ	ⲧⲓⲙⲏ
ⲧⲓⲙⲟⲑⲉⲟⲥ	ⲧⲓⲙⲟⲑⲉⲟⲥ
ⲧⲓⲙⲱⲣⲓⲁ	ⲧⲓⲙⲱⲣⲓⲁ
ⲧⲓⲟⲩ	ⲧⲓⲟⲩ
ⲧⲓⲭⲁⲣⲓⲥ	ϯⲭⲁⲣⲓⲥ
ⲧⲓ	ϯ
ⲧⲗⲧⲗ	ⲧⲗⲧⲗ
ⲧⲙ̄	ⲧⲙ
ⲧⲙ̇	ⲧⲙ
ⲧⲙⲁⲉⲓⲟ	ⲧⲙⲁⲉⲓⲟ
ⲧⲙⲁⲓ̈ⲟ`	ⲧⲙⲁⲓⲟ
ⲧⲙⲁⲓⲏⲩ	ⲧⲙⲁⲓⲏⲩ
ⲧⲙⲁⲓⲟ	ⲧⲙⲁⲓⲟ
ⲧⲙⲉ	ⲧⲙⲉ
ⲧⲙⲏ	ⲧⲙⲏ
ⲧⲙⲙⲁⲩ	ⲙⲙⲁⲩ
ⲧⲙⲙⲟⲩⲣ	ⲧⲙⲙⲟⲩⲣ
ⲧⲙⲙⲟ	ⲧⲙⲙⲟ
ⲧⲙ︤	ⲧⲙ
ⲧⲙ︥︥	ⲧⲙ
ⲧⲙ	ⲧⲙ
ⲧⲛ̄ⲛⲟⲟⲩ	ⲧⲛⲛⲟⲟⲩ
ⲧⲛ̄	ⲧⲛ
ⲧⲛ̇ⲧⲱⲛ	ⲧⲛⲧⲱⲛ
ⲧⲛ̇	ⲧⲛ
ⲧⲛⲉⲧ	ⲧⲛⲉⲧ
ⲧⲛⲛⲉⲩ	ⲧⲛⲛⲉⲩ
ⲧⲛⲛⲟⲟⲩ	ⲧⲛⲛⲟⲟⲩ
ⲧⲛⲛⲟ	ⲧⲛⲛⲟ
ⲧⲛⲦⲱⲛ	ⲧⲛⲧⲱⲛ
ⲧⲛⲧⲛ	ⲧⲛⲧⲛ
ⲧⲛⲧⲱⲛ	ⲧⲛⲧⲱⲛ
ⲧⲛⲧⲱⲛ`	ⲧⲛⲧⲱⲛ
ⲧⲛⲧⲱ⳯	ⲧⲛⲧⲱⲛ
ⲧⲛ︥	ⲧⲛ
ⲧⲛ	ⲧⲛ
ⲧⲟ̂	ⲧⲟ
ⲧⲟϣ︤	ⲧⲟϣ
ⲧⲟϣ	ⲧⲟϣ
ⲧⲟϭ︤	ⲧⲟϭ
ⲧⲟϭ	ⲧⲟϭ
ⲧⲟⲉⲓ̇ⲥ	ⲧⲟⲉⲓⲥ
ⲧⲟⲉⲓⲥ	ⲧⲟⲉⲓⲥ
ⲧⲟⲕⲙ	ⲧⲟⲕⲙ
ⲧⲟⲕ⳿	ⲧⲟⲕ
ⲧⲟⲕ	ⲧⲟⲕ
ⲧⲟⲗⲙⲁ	ⲧⲟⲗⲙⲁ
ⲧⲟⲗⲙⲏⲣⲓⲁ	ⲧⲟⲗⲙⲏⲣⲓⲁ
ⲧⲟⲗⲙ	ⲧⲟⲗⲙ
ⲧⲟⲗⲟⲙⲁ	ⲧⲟⲗⲟⲙⲁ
ⲧⲟⲙⲥ	ⲧⲟⲙⲥ
ⲧⲟⲛⲟⲩ	ⲧⲟⲛⲟⲩ
ⲧⲟⲟⲧ︤	ⲧⲟⲟⲧ
ⲧⲟⲟⲧ	ⲧⲟⲟⲧ
ⲧⲟⲟⲩⲉ	ⲧⲟⲟⲩⲉ
ⲧⲟⲟⲩⲧ	ⲧⲟⲟⲧ
ⲧⲟⲟⲩ	ⲧⲟⲟⲩ
ⲧⲟⲡⲟⲥ⳿	ⲧⲟⲡⲟⲥ
ⲧⲟⲡⲟⲥ	ⲧⲟⲡⲟⲥ
ⲧⲟⲡ	ⲧⲟⲡ
ⲧⲟⲣⲡ	ⲧⲟⲣⲡ
ⲧⲟⲧⲉ	ⲧⲟⲧⲉ
ⲧⲟⲩϫⲉ	ⲧⲟⲩϫⲉ
ⲧⲟⲩϫⲟ	ⲧⲟⲩϫⲟ
ⲧⲟⲩⲓⲏ	ⲧⲟⲩⲓⲏ
ⲧⲟⲩⲓⲟ	ⲧⲟⲩⲓⲟ
ⲧⲟⲩⲛⲉⲓⲁⲧ	ⲧⲟⲩⲛⲉⲓⲁⲧ
ⲧⲟⲩⲛⲉⲥ	ⲧⲟⲩⲛⲉⲥ
ⲧⲟⲩⲛⲟⲥ	ⲧⲟⲩⲛⲟⲥ
ⲧⲟⲩⲛⲟⲩⲥ	ⲧⲟⲩⲛⲟⲩⲥ
ⲧⲟⲩⲛ	ⲧⲟⲩⲛ
ⲧⲟⲩⲧⲟ	ⲧⲟⲩⲧⲟ
ⲧⲟⲩⲱ	ⲧⲟⲩⲱ
ⲧⲟⲩ	ⲧⲟⲩ
ⲧⲟ	ⲧⲟ
ⲧⲡⲉ	ⲧⲡⲉ
ⲧⲣ̄	ⲧⲣⲉ
ⲧⲣ̇ⲉ	ⲧⲣⲉ
ⲧⲣ̣ⲉ	ⲧⲣⲉ
ⲧⲣ̣[ⲉ	ⲧⲣⲉ
ⲧⲣⲁⲡⲉⲍⲁ	ⲧⲣⲁⲡⲉⲍⲁ
ⲧⲣⲁⲡⲩⲍⲁ	ⲧⲣⲁⲡⲉⲍⲁ
ⲧⲣⲁ	ⲧⲣⲁ
ⲧⲣⲉ̣	ⲧⲣⲉ
ⲧⲣⲉ	ⲧⲣⲉ
ⲧⲣⲓⲧⲟⲛ	ⲧⲣⲓⲧⲟⲛ
ⲧⲣⲣⲉ	ⲧⲣⲣⲉ
ⲧⲣⲩⲫⲁ⳿	ⲧⲣⲩⲫⲁ
ⲧⲣⲩⲫⲁ	ⲧⲣⲩⲫⲁ
ⲧⲣ	ⲧⲣ
ⲧⲥⲁⲃⲉ	ⲧⲥⲁⲃⲉ
ⲧⲥⲁⲃⲟ	ⲧⲥⲁⲃⲟ
ⲧⲥⲁⲃⲱ	ⲧⲥⲁⲃⲱ
ⲧⲥⲁⲛⲟ	ⲧⲥⲁⲛⲟ
ⲧⲥⲁⲛⲟ`	ⲧⲥⲁⲛⲟ
ⲧⲥⲃ	ⲧⲥⲃ
ⲧⲥⲉⲃⲉ	ⲧⲥⲉⲃⲉ
ⲧⲥⲉ	ⲧⲥⲉ
ⲧⲥⲓⲉ	ⲧⲥⲓⲉ
ⲧⲥⲓⲟ	ⲧⲥⲓⲟ
ⲧⲥⲛⲕⲟ	ⲧⲥⲛⲕⲟ
ⲧⲥⲟ̂	ⲧⲥⲟ
ⲧⲥⲟ	ⲧⲥⲟ
ⲧⲥⲧⲟ	ⲧⲥⲧⲟ
ⲧⲧ	ⲧⲧ
ⲧⲩⲡⲟⲥ	ⲧⲩⲡⲟⲥ
ⲧⲩⲣⲟⲥ	ⲧⲩⲣⲟⲥ
ⲧⲱ̂	ⲧⲱ
ⲧⲱϣ	ⲧⲱϣ
ⲧⲱϣ`	ⲧⲱϣ
ⲧⲱϥ	ⲧⲱϥ
ⲧⲱϩⲙ	ⲧⲱϩⲙ
ⲧⲱϩⲥ	ⲧⲱϩⲥ
ⲧⲱϩ⳿	ⲧⲱϩ
ⲧⲱϩ︤ⲙ︥	ⲧⲱϩⲙ
ⲧⲱϩ︤ⲥ︥	ⲧⲱϩⲥ
ⲧⲱϩ︤	ⲧⲱϩ
ⲧⲱϩ	ⲧⲱϩ
ⲧⲱϭⲉ	ⲧⲱϭⲉ
ⲧⲱϭⲉ`	ⲧⲱϭⲉ
ⲧⲱϭⲥ	ⲧⲱϭⲥ
ⲧⲱⲃϩ	ⲧⲱⲃϩ
ⲧⲱⲃⲁϩ	ⲧⲱⲃϩ
ⲧⲱⲃⲥ̇	ⲧⲱⲃⲥ
ⲧⲱⲃⲥ	ⲧⲱⲃⲥ
ⲧⲱⲃ︤ϩ︥	ⲧⲱⲃϩ
ⲧⲱⲕⲙ	ⲧⲱⲕⲙ
ⲧⲱⲕ	ⲧⲱⲕ
ⲧⲱⲗⲙ	ⲧⲱⲗⲙ
ⲧⲱⲗ̣︤ⲙ̣︥	ⲧⲱⲗⲙ
ⲧⲱⲙⲛⲧ̇	ⲧⲱⲙⲛⲧ
ⲧⲱⲙⲛⲧ	ⲧⲱⲙⲛⲧ
ⲧⲱⲙⲧ	ⲧⲱⲙⲧ
ⲧⲱⲙ︤ⲧ︥	ⲧⲱⲙⲧ
ⲧⲱⲙ	ⲧⲱⲙ
ⲧⲱⲙ`	ⲧⲱⲙ
ⲧⲱⲛⲉ	ⲧⲱⲛⲉ
ⲧⲱⲛⲟⲩ	ⲧⲱⲛⲟⲩ
ⲧⲱⲛ⳿	ⲧⲱⲛ
ⲧⲱⲛ	ⲧⲱⲛ
ⲧⲱⲛ`	ⲧⲱⲛ
ⲧⲱⲟⲩⲛ̇	ⲧⲱⲟⲩⲛ
ⲧⲱⲟⲩⲛ	ⲧⲱⲟⲩⲛ
ⲧⲱⲡ	ⲧⲱⲡ
ⲧⲱⲣⲡ	ⲧⲱⲣⲡ
ⲧⲱⲣ︤ⲡ︥	ⲧⲱⲣⲡ
ⲧⲱⲥ	ⲧⲱⲥ
ⲧⲱⲧ⳿	ⲧⲱⲧ
ⲧⲱⲧ	ⲧⲱⲧ
ⲧⲱⲧ]	ⲧⲱⲧ
ⲧⲱⲱⲃⲉ	ⲧⲱⲱⲃⲉ
ⲧⲱⲱⲃⲉ`	ⲧⲱⲱⲃⲉ
ⲧⲱ⳯	ⲧⲱⲛ
ⲧⲱ	ⲧⲱ
ⲧ⳿	ⲧ
ⲧ︤ⲃ︥ⲃⲉ	ⲧⲃⲃⲉ
ⲧ︤ⲃ︥ⲃⲏⲩ	ⲧⲃⲃⲏⲩ
ⲧ︤ⲃ︥ⲃⲟ̂	ⲧⲃⲃⲟ
ⲧ︤ⲃ︥ⲃⲟ	ⲧⲃⲃⲟ
ⲧ︤ⲃ︥ⲛ̣ⲏ	ⲧⲃⲛⲏ
ⲧ︤ⲃ︥ⲛⲟⲟⲩⲉ⳿	ⲧⲃⲛⲟⲟⲩⲉ
ⲧ︤ⲃ︥ⲛⲟⲟⲩⲉ	ⲧⲃⲛⲟⲟⲩⲉ
ⲧ︤ⲃ︥ⲛⲟⲟⲩⲉ`	ⲧⲃⲛⲟⲟⲩⲉ
ⲧ︤ⲃ︦ⲃ︥ⲟ	ⲧⲃⲃⲟ
ⲧ︤ⲗ︥ⲧ︤ⲗ︥	ⲧⲗⲧⲗ
ⲧ︤ⲙ̣︥	ⲧⲙ
ⲧ︤ⲙ̣︥	ⲧⲙ
ⲧ︤ⲙ︥ⲙⲟ	ⲧⲙⲙⲟ
ⲧ︤ⲙ︥	ⲧⲙ
ⲧ︤ⲙ	ⲧⲙ
ⲧ︤ⲛ̣︥	ⲧⲛ
ⲧ︤ⲛ︥ⲛⲟⲟⲩ	ⲧⲛⲛⲟⲟⲩ
ⲧ︤ⲛ︥ⲛⲟ	ⲧⲛⲛⲟ
ⲧ︤ⲛ︥Ⲧⲱⲛ`	ⲧⲛⲧⲱⲛ
ⲧ︤ⲛ︥ⲧⲱⲛ⳿	ⲧⲛⲧⲱⲛ
ⲧ︤ⲛ︥ⲧⲱⲛ	ⲧⲛⲧⲱⲛ
ⲧ︤ⲛ︥ⲧⲱⲛ`	ⲧⲛⲧⲱⲛ
ⲧ︤ⲛ︥ⲧⲱ⳯	ⲧⲛⲧⲱⲛ
ⲧ︤ⲛ︥	ⲧⲛ
ⲧ︤ⲣ︥ⲣⲉ⳿	ⲧⲣⲣⲉ
ⲧ︤ⲥ︥ⲧⲟ	ⲧⲥⲧⲟ
ⲧ︤︥ⲛ	ⲧⲛ
ⲧ︤	ⲧ
ⲧ︥ⲃⲃⲟ̂	ⲧⲃⲃⲟ
ⲧ︥	ⲧ
ⲧ	ⲧ
ⲧ[ⲏⲣ]	ⲧⲏⲣ
ⲧ[ⲛ]	ⲧⲛ
ⲧ]	ⲧ
ⲩ̂	ⲩ
ⲩ̇	ⲩ
ⲩ̣	ⲩ
ⲩϣⲏ̂	ⲩϣⲏ
ⲩϣⲏ	ⲩϣⲏ
ⲩϣⲟⲟⲩⲉ	ⲩϣⲟⲟⲩⲉ
ⲩϩⲟⲟⲣ	ⲟⲩϩⲟⲟⲣ
ⲩⲁ	ⲟⲩⲁ
ⲩⲉ̣ⲛⲧ̄	ⲩⲉⲛⲧ
ⲩⲉⲛⲧ	ⲩⲉⲛⲧ
ⲩⲛ̄ⲧⲁ	ⲩⲛⲧⲁ
ⲩⲛ̇	ⲩⲛ
ⲩⲛⲟⲩ	ⲩⲛⲟⲩ
ⲩⲛⲧⲁ	ⲩⲛⲧⲁ
ⲩⲛⲧ	ⲩⲛⲧ
ⲩⲛ	ⲩⲛ
ⲩⲟⲉⲓϣ	ⲟⲩⲟⲉⲓϣ
ⲩⲟⲓϣ	ⲩⲟⲉⲓϣ
ⲩⲟⲩⲟⲉⲓ	ⲩⲟⲩⲟⲉⲓ
ⲩⲡⲟⲕⲣⲏⲥⲓⲥ	ϩⲩⲡⲟⲕⲣⲓⲥⲓⲥ
ⲩⲡⲟⲕⲣⲓⲥⲓⲥ	ϩⲩⲡⲟⲕⲣⲓⲥⲓⲥ
ⲩⲡⲟⲙⲟⲛⲏ	ϩⲩⲡⲟⲙⲟⲛⲏ
ⲩ⳿	ⲩ
ⲩ	ⲩ
ⲩ]	ⲩ
ⲩ`	ⲩ
ⲪⲀⲢⲘⲞⲨⲦⲈ	ⲫⲁⲣⲙⲟⲩⲧⲉ
Ⲫⲟⲣⲉⲓ̇	ⲫⲟⲣⲉⲓ
Ⲫⲟⲣⲉⲓ	ⲫⲟⲣⲉⲓ
Ⲫⲟⲣⲓ̇	ⲫⲟⲣⲉⲓ
Ⲫⲟⲣⲓ	ⲫⲟⲣⲉⲓ
Ⲫⲩⲥⲓ̇	ⲫⲩⲥⲓ
Ⲫⲩⲥⲓ	ⲫⲩⲥⲓ
ⲫⲁⲛⲟⲩⲏⲗ	ⲫⲁⲛⲟⲩⲏⲗ
ⲫⲁⲛⲟⲩⲏⲗ`	ⲫⲁⲛⲟⲩⲏⲗ
ⲫⲁⲛⲧⲁⲥⲙⲁ	ⲫⲁⲛⲧⲁⲥⲙⲁ
ⲫⲁⲣⲁⲱ̂	ⲫⲁⲣⲁⲱ
ⲫⲁⲣⲁⲱ	ⲫⲁⲣⲁⲱ
ⲫⲁⲣⲓ̇ⲥⲥⲁⲓ̇ⲟⲥ	ⲫⲁⲣⲓⲥⲥⲁⲓⲟⲥ
ⲫⲁⲣⲓⲥⲥⲁⲓⲟⲥ	ⲫⲁⲣⲓⲥⲥⲁⲓⲟⲥ
ⲫⲁⲣⲣⲓⲥⲁⲓⲟⲥ	ⲫⲁⲣⲣⲓⲥⲁⲓⲟⲥ
ⲫⲁⲥⲅⲓⲁ̂	ⲫⲁⲥⲅⲓⲁ
ⲫⲁⲥⲅⲓⲁ	ⲫⲁⲥⲅⲓⲁ
ⲫⲑⲟⲛⲉⲓ	ⲫⲑⲟⲛⲉⲓ
ⲫⲑⲟⲛⲟⲥ	ⲫⲑⲟⲛⲟⲥ
ⲫⲓ̇ⲗⲁⲅⲣⲓ̇ⲟⲥ	ⲫⲓⲗⲁⲅⲣⲓⲟⲥ
ⲫⲓ̣ⲗ̣ⲟ̣ⲑⲉ̣ⲟ̣ⲥ̣	ⲫⲓⲗⲟⲑⲉⲟⲥ
ⲫⲓⲗⲁⲅⲣⲓⲟⲥ	ⲫⲓⲗⲁⲅⲣⲓⲟⲥ
ⲫⲓⲗⲓⲡⲡⲟⲥ	ⲫⲓⲗⲓⲡⲡⲟⲥ
ⲫⲓⲗⲟⲑⲉⲟⲥ	ⲫⲓⲗⲟⲑⲉⲟⲥ
ⲫⲓⲗⲟⲑⲉⲥ	ⲫⲓⲗⲟⲑⲉⲥ
ⲫⲟⲓⲃⲁⲙⲙⲱⲛ̣	ⲫⲟⲓⲃⲁⲙⲙⲱⲛ
ⲫⲟⲓⲃⲁⲙⲙⲱⲛ	ⲫⲟⲓⲃⲁⲙⲙⲱⲛ
ⲫⲟⲓⲛⲓⲕⲏ	ⲫⲟⲓⲛⲓⲕⲏ
ⲫⲟⲛⲟⲥ⳿	ⲫⲟⲛⲟⲥ
ⲫⲟⲛⲟⲥ	ⲫⲟⲛⲟⲥ
ⲫⲟⲣⲉⲓ̇	ⲫⲟⲣⲉⲓ
ⲫⲟⲣⲉⲓ	ⲫⲟⲣⲉⲓ
ⲫⲟⲣⲓ	ⲫⲟⲣⲉⲓ
ⲫⲟⲣⲧⲟⲩⲛⲁⲧⲟⲥ	ⲫⲟⲣⲧⲟⲩⲛⲁⲧⲟⲥ
ⲫⲣⲁⲅⲉⲗⲗⲟⲩ	ⲫⲣⲁⲅⲉⲗⲗⲟⲩ
ⲫⲣⲟⲛⲧⲓ̇ⲍⲉ	ⲫⲣⲟⲛⲧⲓⲍⲉ
ⲫⲣⲟⲛⲧⲓⲍⲉ	ⲫⲣⲟⲛⲧⲓⲍⲉ
ⲫⲩⲗⲓⲥⲧⲉⲓⲙ	ⲫⲩⲗⲓⲥⲧⲉⲓⲙ
ⲫⲩⲗⲓⲥⲧⲓⲉⲓⲙ	ⲫⲩⲗⲓⲥⲧⲓⲉⲓⲙ
ⲫⲩⲥⲓⲥ	ⲫⲩⲥⲓⲥ
ⲫⲱϭⲉ	ⲫⲱϭⲉ
ⲫⲱⲛⲉⲩⲥ	ⲫⲱⲛⲉⲩⲥ
ⲫⲱⲛⲏ	ⲫⲱⲛⲏ
ⲫⲱⲣⲉⲓ	ⲫⲱⲣⲉⲓ
ⲫⲱⲥⲥⲁ	ⲫⲱⲥⲥⲁ
ⲫ	ⲡ
ⲬⲢⲤ̄	ⲭⲣⲓⲥⲧⲟⲥ
ⲬⲢⲤ	ⲭⲣⲓⲥⲧⲟⲥ
Ⲭⲱⲣⲓⲥ	ⲭⲱⲣⲓⲥ
ⲭ̇ⲣⲏⲙⲁ	ⲭⲣⲏⲙⲁ
ⲭ̇ⲣⲓ̇ⲁ̇	ⲭⲣⲓⲁ
ⲭⲁⲏⲗ	ⲭⲁⲏⲗ
ⲭⲁⲓⲣⲉ	ⲭⲁⲓⲣⲉ
ⲭⲁⲗⲁ	ⲭⲁⲗⲁ
ⲭⲁⲗⲓⲛⲟⲥ	ⲭⲁⲗⲓⲛⲟⲥ
ⲭⲁⲗⲕⲓⲛ	ⲭⲁⲗⲕⲓⲛ
ⲭⲁⲟⲥ	ⲭⲁⲟⲥ
ⲭⲁⲣⲓⲍⲉ	ⲭⲁⲣⲓⲍⲉ
ⲭⲁⲣⲓⲥⲙⲁ	ⲭⲁⲣⲓⲥⲙⲁ
ⲭⲁⲣⲓⲥ	ⲭⲁⲣⲓⲥ
ⲭⲁⲣⲧⲏⲥ⳿	ⲭⲁⲣⲧⲏⲥ
ⲭⲁⲣⲧⲏⲥ	ⲭⲁⲣⲧⲏⲥ
ⲭⲉⲓⲙⲏⲧⲓ	ⲭⲉⲓⲙⲏⲧⲓ
ⲭⲉⲓⲙⲏⲧⲓ`	ⲭⲉⲓⲙⲏⲧⲓ
ⲭⲏⲣⲁ⳿	ⲭⲏⲣⲁ
ⲭⲏⲣⲁ	ⲭⲏⲣⲁ
ⲭⲓⲗⲓⲁⲣⲭⲟⲥ	ⲭⲓⲗⲓⲁⲣⲭⲟⲥ
ⲭⲗⲁⲙⲏⲥ	ⲭⲗⲁⲙⲏⲥ
ⲭⲗⲁⲙⲩⲥ	ⲭⲗⲁⲙⲩⲥ
ⲭⲗⲟⲏ	ⲭⲗⲟⲏ
ⲭⲟⲣⲧⲟⲥ	ⲭⲟⲣⲧⲟⲥ
ⲭⲣ̄ⲥ̄	ⲭⲣⲓⲥⲧⲟⲥ
ⲭⲣⲉⲓⲁ	ⲭⲣⲉⲓⲁ
ⲭⲣⲉⲓⲥⲧⲓⲁⲛⲟⲥ⳿	ⲭⲣⲉⲓⲥⲧⲓⲁⲛⲟⲥ
ⲭⲣⲉⲓⲥⲧⲓⲁⲛⲟⲥ	ⲭⲣⲓⲥⲧⲓⲁⲛⲟⲥ
ⲭⲣⲏⲙⲁ	ⲭⲣⲏⲙⲁ
ⲭⲣⲓ̇ⲁ̇	ⲭⲣⲓⲁ
ⲭⲣⲓⲁ	ⲭⲣⲉⲓⲁ
ⲭⲣⲓⲥϯⲁⲛⲟⲥ	ⲭⲣⲓⲥϯⲁⲛⲟⲥ
ⲭⲣⲓⲥⲧⲓⲁⲛⲟⲥ	ⲭⲣⲓⲥⲧⲓⲁⲛⲟⲥ
ⲭⲣⲓⲥⲧⲟⲥ	ⲭⲣⲓⲥⲧⲟⲥ
ⲭⲣⲓⲥⲧⲟⲫⲟ̣ⲣⲟⲥ̣	ⲭⲣⲓⲥⲧⲟⲫⲟⲣⲟⲥ
ⲭⲣⲓⲥⲧⲟⲫⲟⲣⲟⲥ	ⲭⲣⲓⲥⲧⲟⲫⲟⲣⲟⲥ
ⲭⲣⲥ	ⲭⲣⲓⲥⲧⲟⲥ
ⲭⲣⲱ	ⲭⲣⲱ
ⲭⲥ̄	ⲭⲣⲓⲥⲧⲟⲥ
ⲭⲥ	ⲭⲣⲓⲥⲧⲟⲥ
ⲭⲱⲣⲁ	ⲭⲱⲣⲁ
ⲭⲱⲣⲓ̇ⲥ	ⲭⲱⲣⲓⲥ
ⲭⲱⲣⲓⲥ	ⲭⲱⲣⲓⲥ
ⲭ︤ⲣ︦ⲥ︥	ⲭⲣⲓⲥⲧⲟⲥ
ⲭ︤ⲥ︥	ⲭⲣⲓⲥⲧⲟⲥ
ⲭ︤︥ⲥ	ⲭⲣⲓⲥⲧⲟⲥ
ⲭ︦ⲥ︦	ⲭⲣⲓⲥⲧⲟⲥ
ⲯⲁⲗⲗⲉⲓ	ⲯⲁⲗⲗⲉⲓ
ⲯⲁⲗⲙⲟⲥ	ⲯⲁⲗⲙⲟⲥ
ⲯⲉⲗⲓⲟⲛ	ⲯⲉⲗⲓⲟⲛ
ⲯⲓⲧⲉ	ⲯⲓⲧⲉ
ⲯⲩⲭⲏ̄	ⲯⲩⲭⲏ
ⲯⲩⲭⲏ̇	ⲯⲩⲭⲏ
ⲯⲩⲭⲏ	ⲯⲩⲭⲏ
ⲯⲩⲭⲏ`	ⲯⲩⲭⲏ
ⲯⲩⲭⲓⲕⲟⲛ	ⲯⲩⲭⲓⲕⲟⲛ
ⲯⲩⲭⲓⲕⲟⲥ	ⲯⲩⲭⲓⲕⲟⲥ
ⲯⲩⲭⲟ̇ⲟⲩⲉ̇	ⲯⲩⲭⲟⲟⲩⲉ
ⲯⲩⲭⲟⲟⲩⲉ	ⲯⲩⲭⲟⲟⲩⲉ
ⲯⲭⲏ	ⲯⲩⲭⲏ
ⲱ̂	ⲱ
ⲱ̄ⲛⲉ	ⲱⲛⲉ
ⲱ̄ⲣⲕ̄	ⲱⲣⲕ
ⲱ̄	ⲱ
ⲱ̇ⲛϩ̇	ⲱⲛϩ
ⲱ̇ⲛⲁϩ	ⲱⲛⲁϩ
ⲱ̇ⲡ	ⲱⲡ
ⲱ̇ⲧⲡ̇	ⲱⲧⲡ
ⲱ̣ϣ̣	ⲱϣ
ⲱϣ⳿	ⲱϣ
ⲱϣ	ⲱϣ
ⲱϣ`	ⲱϣ
ⲱϥⲉ	ⲱϥⲉ
ⲱϩⲉ	ⲱϩⲉ
ⲱϩⲥ̇	ⲱϩⲥ
ⲱϩⲥ	ⲱϩⲥ
ⲱϩⲧ	ⲱϩⲧ
ⲱϩ︤ⲥ︥	ⲱϩⲥ
ⲱϩ︤ⲧ︥	ⲱϩⲧ
ⲱϫⲛ̄	ⲱϫⲛ
ⲱϫⲛ	ⲱϫⲛ
ⲱϫ︤ⲛ︥	ⲱϫⲛ
ⲱϭⲉ	ⲱϭⲉ
ⲱϭⲧ	ⲱϭⲧ
ⲱⲁϫⲉ	ϣⲁϫⲉ
ⲱⲃϣ	ⲱⲃϣ
ⲱⲇⲏ⳿	ⲱⲇⲏ
ⲱⲇⲏ	ⲱⲇⲏ
ⲱⲕⲙ	ⲱⲕⲙ
ⲱⲕ	ⲱⲕ
ⲱⲗ⳿	ⲱⲗ
ⲱⲗ	ⲱⲗ
ⲱⲛϩ̄	ⲱⲛϩ
ⲱⲛϩ	ⲱⲛϩ
ⲱⲛⲁϩ	ⲱⲛϩ
ⲱⲛⲉ	ⲱⲛⲉ
ⲱⲛ︤ϩ︥	ⲱⲛϩ
ⲱⲛ︤ϩ︥`	ⲱⲛϩ
ⲱⲟⲟⲡ	ⲱⲟⲟⲡ
ⲱⲟⲟⲡ`	ⲱⲟⲟⲡ
ⲱⲟⲩⲉⲓ̇ⲧ	ⲱⲟⲩⲉⲓⲧ
ⲱⲟⲩⲉⲓⲧ	ⲱⲟⲩⲉⲓⲧ
ⲱⲡ⳿	ⲱⲡ
ⲱⲡ	ⲱⲡ
ⲱⲣϥ	ⲱⲣϥ
ⲱⲣϫ	ⲱⲣϫ
ⲱⲣⲅⲁⲛⲟⲛ	ⲱⲣⲅⲁⲛⲟⲛ
ⲱⲣⲕ	ⲱⲣⲕ
ⲱⲣ︤ϫ︥⳿	ⲱⲣϫ
ⲱⲣ︤ϫ︥	ⲱⲣϫ
ⲱⲥⲁⲛⲛⲁ	ⲱⲥⲁⲛⲛⲁ
ⲱⲥⲕ︥	ⲱⲥⲕ
ⲱⲥⲕ	ⲱⲥⲕ
ⲱⲥ︤ⲕ︥	ⲱⲥⲕ
ⲱⲧⲡ	ⲱⲧⲡ
ⲱⲱ̂̂	ⲱⲱ
ⲱⲱ	ⲱⲱ
ⲱ︤ⲣ̄ϫ︥	ⲱⲣϫ
ⲱ	ⲱ
ⲻ·	ⲻ·
ⲻ̇	.
ⲻ	ⲻ
⳯ⲧ	ⲛⲧ
⳯	ⲛ
⳾ⲻ	.
⳾⳾⳾	⳾⳾⳾
⳾	.
⸓	⸓
⸖	⸖
⸱	,
〚...〛	〚...〛
︤ⲅ	ⲅ
︥ⲛⲉϥ	ⲛⲉϥ
︥ⲡⲟⲩ	ⲡⲟⲩ
︥ⲡ	ⲡ
︥ⲣ̂ⲙⲁⲗⲁⲕⲟⲥ	ⲣⲙⲁⲗⲁⲕⲟⲥ
 ·	 ·
 ⲁ̇ⲗⲗⲁ	ⲁⲗⲗⲁ
 ⲁⲗⲗⲁ	ⲁⲗⲗⲁ
 ⲙ̄	ⲙ
 ⲙ	ⲙ
 ⲥⲛⲏⲩ	ⲥⲛⲏⲩ
 ⲥⲛⲏⲩ`	ⲥⲛⲏⲩ
 	 
  ϫⲉ	ϫⲉ
 --	--
 --]	--
 =–	.
 =–.	.
 =ⲻ	.
 =-.	.
,	,
-	-
--	--
----	----
.ⲉ	[.]ⲉ
.ⲙ	[.]ⲙ
.ⲛ	[.]ⲛ
.ⲻ	.
.	.
..ⲁⲩ	[..]ⲁⲩ
..ⲉ	ϫⲉ
..ⲙⲉ	[..]ⲙⲉ
..ⲥⲃⲱ	[..]ⲥⲃⲱ
..ⲱ	ϫⲱ
..	..
...ϥ	[...]ϥ̣
...ⲛ	[...]ⲛ
...ⲟⲧⲡ	[...]ⲟⲧⲡ
...ⲩ	[...]ⲩ
...	...
....ϫⲉ	[....]ϫⲉ
....ⲥⲧⲁ	[....]ⲥⲧⲁ
....ⲥ	[....]ⲥ
....	[....]
.....ⲟ...	.....ⲟ...
.....ⲡⲣ......ⲥ	[.....]ⲡⲣ[..][....]ⲥ
.....ⲩⲟ	[.....]ⲩⲟ
.....	[.....]
......	......
.......	[.......]
........	[........]
.........	[.........]
..........	[..........]
.]	[.]
1.400000	ⲓ
8/1/2016	ⲥⲟⲛ
:ⲻ	.
:ⲻ.	.
:	:
=	.
[·]	·
[ϣⲓⲡⲉ]	ϣⲓⲡⲉ
[ϥⲟ	ϥⲟ
[ϩ̣]ⲃⲏⲩⲉ	ϩⲃⲏⲩⲉ
[ϩⲁⲡ]	ϩⲁⲡ
[ϩⲁⲣⲟ	ϩⲁⲣⲟ
[ϩⲁ	ϩⲁ
[ϩⲓ]ⲧⲙ	ϩⲓⲧⲙ
[ϩⲛ	ϩⲛ
[ϩⲛ]	ϩⲛ
[ϩⲱ]ⲱ	ϩⲱⲱ
[ϫⲉ	ϫⲉ
[ϫⲟ]ⲉⲓⲥ`	ϫⲟⲉⲓⲥ
[ϫⲟ]ⲟ	ϫⲟⲟ
[ϭⲓ]ⲛ	ϭⲓⲛ
[…..]ⲉ̣ⲁ	[…..]ⲉⲁ
[…..]	[…..]
[…]	[…]
[ⲁϣⲏ]	ⲁϣⲏ
[ⲁⲛⲟⲙⲓⲁ]	ⲁⲛⲟⲙⲓⲁ
[ⲁ	ⲁ
[ⲁ]ⲙⲱⲛⲁ	ⲁⲙⲱⲛⲁ
[ⲃ̣ⲱ̣]ϣ̣	ⲃⲱϣ
[ⲉ̣ⲧ]	ⲉⲧ
[ⲉⲃⲟ]ⲗ	[ⲉⲃⲟ]ⲗ
[ⲉⲧⲃⲏ]ⲏⲧ	ⲉⲧⲃⲏⲏⲧ
[ⲉⲧ]	ⲉⲧ
[ⲉ	ⲉ
[ⲉ]ϣ̣ϫⲉ	ⲉϣϫⲉ
[ⲉ]ⲓ	ⲉⲓ
[ⲉ]ⲛϣⲁⲛ	ⲉⲛϣⲁⲛ
[ⲉ]ⲛⲧ	ⲉⲛⲧ
[ⲉ]ⲣ̣ⲟ	ⲉⲣⲟ
[ⲉ]ⲧ	ⲉⲧ
[ⲉ]	ⲉⲧ
[ⲏ	ⲏ
[ⲕⲏ	ⲕⲏ
[ⲕⲗⲏ]ⲣⲟⲛⲟⲙⲉⲓ	ⲕⲗⲏⲣⲟⲛⲟⲙⲉⲓ
[ⲙ̣ⲟⲧⲉ]	ⲙⲟⲧⲉ
[ⲙⲙ]ⲁⲩ	ⲙⲙⲁⲩ
[ⲙ]ⲁ̣ⲩⲁⲁ	ⲙⲁⲩⲁⲁ
[ⲙ]	ⲙ
[ⲛ̣̄	ⲛ
[ⲛ̣̄]	ⲛ
[ⲛ̄ⲧ	ⲛⲧ
[ⲛϩⲏ]	ⲛϩⲏ
[ⲛϭⲓ]	ⲛϭⲓ
[ⲛⲓⲙ]	ⲛⲓⲙ
[ⲛⲓ]ⲙ	ⲛⲓⲙ
[ⲛⲟϭ	ⲛⲟϭ
[ⲛⲟ]ϭ	ⲛⲟϭ
[ⲛ	ⲛ
[ⲛ]ϭⲓ	ⲛϭⲓ
[ⲛ]	ⲛ
[ⲟⲩⲁ]ⲁⲃ	ⲟⲩⲁⲁⲃ
[ⲟⲩⲉϩ]	ⲟⲩⲉϩ
[ⲟⲩⲟⲉⲓ]ϣ	ⲟⲩⲟⲉⲓϣ
[ⲟⲩ	ⲟⲩ
[ⲟⲩ]ⲛ	ⲟⲩⲛ
[ⲟⲩ]	ⲟⲩ
[ⲡ̇]	ⲡ
[ⲡⲁ]ⲑ̣ⲟⲥ	ⲡⲁⲑⲟⲥ
[ⲡ	ⲡ
[ⲡ]ⲉϫⲁ	ⲡⲉϫⲁ
[ⲡ]	ⲡ
[ⲥϩⲁⲓ	ⲥϩⲁⲓ
[ⲥⲏϩ̣	ⲥⲏϩ
[ⲥ]ⲱⲱ	ⲥⲱⲱ
[ⲧⲏ]ⲣ	ⲧⲏⲣ
[ⲧⲣⲉ	ⲧⲣⲉ
[ⲩ]	ⲩ
[	[
[ ]	[ ]
[----]	----
[--]	--
[..........	..........
[..........]	[..........]
[.........]	[.........]
[........]	[........]
[.......]	[.......]
[......]	......
[.....]ⲡ̣ⲣ̣[..][....]ⲥ̣	[.....]ⲡⲣ[..][....]ⲥ
[.....]ⲩⲟ	[.....]ⲩⲟ
[.....]	[.....]
[....]ϫ̣ⲉ	[....]ϫⲉ
[....]ⲥ̣	[....]ⲥ
[....]ⲥⲧⲁ`	[....]ⲥⲧⲁ
[....]	[....]
[...]ϥ̣	[...]ϥ̣
[...]ⲛ̄	[...]ⲛ
[...]ⲟⲧ︤ⲡ︥	[...]ⲟⲧⲡ
[...]ⲩ̣	[...]ⲩ
[...]	[...]
[..]ⲁⲩ	[..]ⲁⲩ
[..]ⲉ̣	ϫⲉ
[..]ⲙⲉ	[..]ⲙⲉ
[..]ⲥ̣ⲃⲱ`	[..]ⲥⲃⲱ
[..]ⲱ	ϫⲱ
[..]	[..]
[.]ⲉ	[.]ⲉ
[.]ⲙ	[.]ⲙ
[.]ⲛ	[.]ⲛ
[.]	[.]
]	]
cⲟ̇ⲛ	cⲟⲛ
cⲟⲛ	cⲟⲛ